Name, No. Methods, LCOM, AVCC, NOS, HBUG, HEFF, UWCS, INST, PACK, RFC, CBO, MI, CCML, NLOC, F-IN, DIT, MINC, S-R, R-R, COH, LMC, LCOM2, MAXCC, HVOL, HIER, NQU, FOUT, Superclass, SIX, EXT, NSUP, TCC, NSUB, MPC, NCO, INTR, CCOM, HLTH, MOD
"org.apache.solr.common.util.Base64",3,0.25,4.67,71,1.86,200994.00,5,2,0,9,5,33.37,30,95,5,1,81.85,0.00,0.00,0.33,1,5.00,8,5577.01,0,1,0,java.lang.Object,0.00,6,0,14,0,6,2,0,11,904,1
"org.apache.solr.common.util.ByteUtils",4,0.00,3.75,63,1.28,152892.77,4,0,1,10,3,90.98,17,74,3,1,90.74,0.00,0.00,0.00,1,4.00,7,3843.37,0,1,0,java.lang.Object,0.00,6,0,15,0,6,3,0,10,679,1
"org.apache.solr.common.util.ContentStream",6,0.00,1.00,7,0.02,93.53,6,0,3,6,59,113.50,48,8,59,1,161.61,0.00,0.00,0.00,0,6.00,1,73.02,0,6,0,,0.00,0,0,6,0,0,0,0,5,33,1
"org.apache.solr.common.util.ContentStreamBase",10,0.11,1.30,34,0.31,6551.97,15,5,12,17,38,170.85,29,54,37,1,130.96,0.00,0.00,0.10,2,50.00,3,940.86,0,6,1,java.lang.Object,0.00,7,0,13,6,7,4,1,12,228,2
"org.apache.solr.common.util.ContentStreamBase$FileStream",3,0.00,1.33,13,0.14,2306.12,4,1,12,10,1,175.75,5,21,0,2,125.75,0.00,0.50,1.00,1,0.00,2,426.79,1,2,1,org.apache.solr.common.util.ContentStreamBase,0.15,7,1,4,0,7,1,0,2,100,2
"org.apache.solr.common.util.ContentStreamBase$StringStream",3,0.50,1.33,13,0.14,2292.06,4,1,12,9,1,175.77,4,21,0,2,125.77,0.00,0.50,0.67,1,0.00,2,415.34,1,2,1,org.apache.solr.common.util.ContentStreamBase,0.15,6,1,4,0,6,1,0,1,98,2
"org.apache.solr.common.util.ContentStreamBase$URLStream",2,1.00,1.00,11,0.11,1722.53,3,1,12,8,1,121.81,0,15,0,2,121.81,0.00,0.50,0.50,0,2.00,1,333.40,0,1,1,org.apache.solr.common.util.ContentStreamBase,0.00,6,1,2,0,6,1,0,0,78,2
"org.apache.solr.common.util.ContentStreamTest",3,0.00,2.00,44,0.71,28418.15,3,0,15,39,2,146.77,4,62,0,2,96.77,0.00,0.50,0.00,0,3.00,4,2143.68,0,0,2,org.apache.lucene.util.LuceneTestCase,0.00,36,1,6,0,36,3,0,3,386,1
"org.apache.solr.common.util.DOMUtil",18,0.00,3.67,179,2.68,161831.13,18,0,5,57,19,71.75,113,231,16,1,103.97,0.00,0.00,0.00,9,18.00,14,8028.74,0,11,3,java.lang.Object,0.00,39,0,66,0,39,7,0,55,1493,1
"org.apache.solr.common.util.DOMUtilTest",2,0.00,1.00,31,0.52,20853.62,2,0,1,14,4,95.49,0,34,0,3,95.49,0.00,0.67,0.00,1,2.00,1,1553.08,1,0,4,org.apache.solr.util.DOMUtilTestBase,0.00,12,2,2,0,12,2,0,0,280,1
"org.apache.solr.common.util.DateUtil",5,0.00,5.20,94,1.47,117524.67,14,9,12,32,15,59.99,65,123,15,1,89.37,0.00,0.00,0.11,2,14.00,14,4402.32,0,5,0,java.lang.Object,0.00,27,0,26,0,27,0,0,27,798,1
"org.apache.solr.common.util.DateUtil$ThreadLocalDateFormat",2,0.00,1.00,9,0.08,1070.68,3,1,12,5,0,127.05,1,13,0,2,127.05,0.00,0.50,1.00,0,0.00,1,225.58,0,1,0,java.lang.ThreadLocal,0.00,3,1,2,0,3,1,0,1,59,2
"org.apache.solr.common.util.FastInputStream",26,0.02,1.88,114,1.34,64095.52,31,5,1,37,15,121.69,12,168,15,2,121.69,1.00,0.33,0.22,8,142.00,8,4012.70,0,3,0,java.io.InputStream,0.00,11,1,49,1,11,23,1,10,904,1
"org.apache.solr.common.util.FastOutputStream",25,0.02,1.40,106,1.20,44041.96,29,4,1,34,7,122.90,24,136,7,2,122.90,0.00,0.50,0.23,6,127.00,4,3614.62,0,1,0,java.io.OutputStream,0.00,9,1,35,0,9,24,1,15,822,1
"org.apache.solr.common.util.FastWriter",11,0.28,1.64,64,0.74,38840.22,15,4,2,17,6,166.87,11,86,6,2,116.87,1.00,0.33,0.50,2,0.00,3,2217.34,0,2,0,java.io.Writer,0.00,6,1,18,1,6,9,0,9,488,1
"org.apache.solr.common.util.FileUtils",3,0.00,5.00,34,0.46,25986.89,3,0,2,20,9,58.48,21,49,9,1,100.78,0.00,0.00,0.00,0,3.00,8,1392.62,0,1,0,java.lang.Object,0.00,17,0,15,0,17,2,0,5,266,1
"org.apache.solr.common.util.FileUtilsTest",1,0.00,1.00,6,0.12,3345.66,1,0,3,5,1,114.22,0,8,0,2,114.22,0.00,0.50,0.00,0,1.00,1,363.34,0,0,1,org.apache.lucene.util.LuceneTestCase,0.00,4,1,1,0,4,1,0,0,80,1
"org.apache.solr.common.util.Hash",5,0.00,5.60,196,3.17,675649.62,5,0,0,8,3,114.79,113,158,3,1,70.85,0.00,0.00,0.00,1,5.00,10,9521.61,0,0,0,java.lang.Object,0.00,3,0,28,0,3,5,0,40,1655,1
"org.apache.solr.common.util.IteratorChain",5,0.17,2.20,27,0.26,7860.49,8,3,3,12,2,159.46,12,37,2,1,119.57,0.00,0.00,0.47,1,1.00,4,794.87,0,0,0,java.lang.Object,0.00,7,0,11,0,7,5,1,6,189,1
"org.apache.solr.common.util.IteratorChainTest",9,0.00,1.56,51,0.60,15786.22,9,0,5,24,1,119.28,4,66,0,2,119.28,0.00,0.50,0.00,1,9.00,2,1809.19,0,2,1,org.apache.lucene.util.LuceneTestCase,0.00,15,1,14,0,15,7,0,4,395,1
"org.apache.solr.common.util.JavaBinCodec",44,0.02,2.91,441,5.52,221756.12,80,36,10,125,25,154.30,48,558,16,1,104.30,0.00,0.00,0.05,24,984.00,16,16549.40,0,12,9,java.lang.Object,0.00,81,0,128,1,81,32,0,18,3178,1
"org.apache.solr.common.util.JavaBinCodec$ObjectResolver",1,0.00,1.00,2,0.02,108.48,1,0,10,1,1,143.74,0,3,0,1,143.74,0.00,0.00,0.00,0,1.00,1,48.15,0,1,1,,0.00,0,0,1,0,0,0,0,0,16,2
"org.apache.solr.common.util.NamedList",24,0.43,1.79,117,1.35,45071.04,25,1,2,48,319,90.41,151,145,319,1,122.63,0.00,0.00,0.58,7,0.00,5,4035.43,0,6,0,java.lang.Object,0.00,24,0,43,1,24,18,3,27,901,1
"org.apache.solr.common.util.NamedList$Iterator<Map.Entry<String,T>>",3,0.50,1.00,10,0.10,1724.48,4,1,2,6,0,131.47,0,13,0,1,131.47,0.00,0.00,0.67,0,1.00,1,292.28,0,1,0,java.lang.Object,0.00,3,0,3,0,3,2,0,0,74,0
"org.apache.solr.common.util.NamedList$Iterator<Map.Entry<String,T>>$Map.Entry<String,T>",4,0.00,1.00,9,0.08,909.38,4,0,2,7,0,141.21,0,16,0,1,141.21,0.00,0.00,0.00,1,4.00,1,252.33,0,2,0,java.lang.Object,0.00,3,0,4,0,3,2,0,0,70,0
"org.apache.solr.common.util.NamedList$NamedListEntry",5,0.00,1.00,15,0.10,1595.36,7,2,2,5,0,133.48,0,21,0,1,133.48,0.00,0.00,0.50,0,1.00,1,291.68,0,1,0,java.lang.Object,0.00,0,0,5,0,0,4,1,0,82,3
"org.apache.solr.common.util.NamedListTest",1,0.00,1.00,9,0.10,2422.44,1,0,1,6,1,108.75,0,11,0,2,108.75,0.00,0.50,0.00,0,1.00,1,306.94,0,0,1,org.apache.lucene.util.LuceneTestCase,0.00,5,1,1,0,5,1,0,0,68,1
"org.apache.solr.common.util.RTimer",11,0.22,1.64,73,0.73,21149.44,19,8,3,29,5,155.89,25,90,3,1,116.00,0.00,0.00,0.33,1,11.00,4,2184.60,0,4,2,java.lang.Object,0.00,18,0,18,0,18,7,0,7,473,1
"org.apache.solr.common.util.RegexFileFilter",4,0.33,1.00,10,0.09,948.47,5,1,3,9,2,191.07,4,16,2,1,141.07,0.00,0.00,0.75,0,0.00,1,255.35,0,1,0,java.lang.Object,0.00,5,0,4,0,5,3,1,1,72,2
"org.apache.solr.common.util.SimpleOrderedMap",4,0.00,1.00,12,0.12,2643.95,4,0,1,8,87,98.77,24,18,86,2,130.99,0.00,0.50,0.00,0,6.00,1,370.25,0,1,1,org.apache.solr.common.util.NamedList,0.07,4,1,4,0,4,3,0,3,95,1
"org.apache.solr.common.util.StrUtils",10,1.00,6.90,159,2.13,136959.03,11,1,6,31,41,76.24,57,180,40,1,94.11,0.00,0.00,0.00,0,10.00,15,6388.00,0,6,1,java.lang.Object,0.00,21,0,69,0,21,4,0,16,1172,1
"org.apache.solr.common.util.SystemIdResolver",9,0.03,2.00,55,0.66,24886.31,13,4,16,32,11,154.60,26,77,10,1,114.71,0.00,0.00,0.22,2,18.00,6,1982.54,0,8,1,java.lang.Object,0.00,23,0,18,0,23,1,2,9,402,2
"org.apache.solr.common.util.SystemIdResolver$URIResolver",1,0.00,3.00,6,0.09,3457.00,1,0,16,4,1,113.85,0,9,0,1,113.85,0.00,0.00,0.00,0,1.00,3,273.00,0,1,1,java.lang.Object,0.00,3,0,3,0,3,0,0,0,57,0
"org.apache.solr.common.util.SystemIdResolver$XMLResolver",1,0.00,3.00,6,0.10,4071.25,1,0,16,4,1,113.29,0,9,0,1,113.29,0.00,0.00,0.00,0,1.00,3,295.53,0,1,1,java.lang.Object,0.00,3,0,3,0,3,0,0,0,61,0
"org.apache.solr.common.util.TestFastInputStream",3,0.00,3.00,43,0.82,56042.87,3,0,5,20,3,114.97,10,54,0,2,94.36,0.00,0.50,0.00,2,3.00,4,2453.25,0,0,3,org.apache.lucene.util.LuceneTestCase,0.00,17,1,9,0,17,3,0,5,452,1
"org.apache.solr.common.util.TestHash",3,0.00,2.33,57,0.73,40905.35,3,0,2,12,1,58.32,19,51,0,2,90.55,0.00,0.50,0.00,1,3.00,3,2186.82,0,0,1,org.apache.lucene.util.LuceneTestCase,0.00,9,1,7,0,9,3,0,6,410,1
"org.apache.solr.common.util.TestJavaBinCodec",1,0.00,2.00,13,0.14,3736.82,1,0,4,9,2,101.16,0,13,0,2,101.16,0.00,0.50,0.00,0,1.00,2,421.85,0,0,2,org.apache.lucene.util.LuceneTestCase,0.00,8,1,2,0,8,1,0,0,84,1
"org.apache.solr.common.util.TestNamedListCodec",9,0.50,1.89,165,2.45,97222.75,10,1,11,57,5,92.27,7,182,0,2,92.27,0.00,0.50,0.56,3,4.00,3,7363.65,0,4,5,org.apache.lucene.util.LuceneTestCase,0.00,48,1,17,0,48,5,0,7,1286,1
"org.apache.solr.common.util.TestSystemIdResolver",2,0.00,1.00,24,0.52,16983.72,2,0,7,19,4,139.69,5,33,0,2,99.80,0.00,0.50,0.00,1,2.00,1,1569.10,0,0,4,org.apache.lucene.util.LuceneTestCase,0.00,17,1,2,0,17,2,0,5,277,1
"org.apache.solr.common.util.TestXMLEscaping",8,0.00,1.00,20,0.17,2445.09,8,0,4,12,1,140.20,6,29,0,2,140.20,0.00,0.50,0.00,1,8.00,1,513.43,0,0,1,org.apache.lucene.util.LuceneTestCase,0.00,4,1,8,0,4,8,0,4,135,1
"org.apache.solr.common.util.XML",9,0.38,2.44,113,1.52,87703.49,11,2,3,14,10,81.26,45,125,10,1,99.13,0.00,0.00,0.17,3,26.00,4,4559.83,0,0,0,java.lang.Object,0.00,5,0,22,0,5,9,0,12,883,1
"org.apache.solr.common.util.XMLErrorLogger",8,0.71,1.12,21,0.30,5584.63,9,1,8,21,11,137.35,3,32,11,1,137.35,0.00,0.00,0.38,0,14.00,2,911.38,0,0,0,java.lang.Object,0.00,13,0,9,0,13,8,3,3,214,2
"org.apache.lucene.facet.search.aggregator.association.AssociationFloatSumAggregator",6,0.07,1.33,23,0.28,6328.98,9,3,5,14,6,149.94,22,34,2,1,129.33,0.00,0.00,0.39,0,6.00,2,848.28,0,0,4,java.lang.Object,0.00,8,0,8,0,8,6,1,2,198,1
"org.apache.lucene.facet.search.aggregator.association.AssociationIntSumAggregator",6,0.07,1.33,23,0.27,6099.99,9,3,5,13,6,150.07,22,34,2,1,129.46,0.00,0.00,0.39,0,6.00,2,817.20,0,0,4,java.lang.Object,0.00,7,0,8,0,7,6,1,2,192,1
"org.apache.lucene.codecs.perfield.PerFieldPostingsFormat",3,0.25,1.33,17,0.18,3802.44,7,4,27,6,19,102.55,16,23,2,2,120.43,0.00,0.50,0.08,0,4.00,2,542.11,0,2,17,org.apache.lucene.codecs.PostingsFormat,0.00,3,1,4,0,3,1,0,5,122,2
"org.apache.lucene.codecs.perfield.PerFieldPostingsFormat$FieldsConsumerAndID",2,0.50,1.00,8,0.06,840.67,4,2,27,3,1,127.88,0,12,0,1,127.88,0.00,0.00,0.25,0,2.00,1,186.42,0,0,1,java.lang.Object,0.00,1,0,2,0,1,2,1,0,52,1
"org.apache.lucene.codecs.perfield.PerFieldPostingsFormat$FieldsReader",8,0.29,1.38,28,0.38,9089.56,10,2,27,21,9,179.07,10,49,0,3,129.07,0.00,0.67,0.25,0,30.00,2,1128.39,0,4,9,org.apache.lucene.codecs.FieldsProducer,0.69,13,2,11,0,13,4,0,10,256,1
"org.apache.lucene.codecs.perfield.PerFieldPostingsFormat$FieldsReader$FieldsIterator",3,0.25,1.33,13,0.12,2240.12,5,2,27,7,2,125.85,0,21,0,2,125.85,0.00,0.50,0.67,0,0.00,2,350.61,0,2,2,org.apache.lucene.index.FieldsEnum,0.67,4,1,4,0,4,1,0,0,89,2
"org.apache.lucene.codecs.perfield.PerFieldPostingsFormat$FieldsReader$VisitPerFieldFile",2,0.00,1.00,6,0.11,1577.61,2,0,27,4,2,130.39,0,10,0,1,130.39,0.00,0.00,0.00,0,0.00,1,317.76,0,0,2,java.lang.Object,0.00,2,0,2,0,2,2,0,0,76,0
"org.apache.lucene.codecs.perfield.PerFieldPostingsFormat$FieldsReader$VisitPerFieldFile_0",3,0.00,2.33,33,0.44,24214.04,3,0,27,12,7,141.08,7,36,0,1,101.19,0.00,0.00,0.00,2,4.00,5,1309.05,0,0,7,java.lang.Object,0.00,9,0,7,0,9,3,0,7,228,2
"org.apache.lucene.codecs.perfield.PerFieldPostingsFormat$FieldsReader$VisitPerFieldFile_1",2,0.00,1.00,4,0.05,592.57,2,0,27,3,1,140.31,0,8,0,1,140.31,0.00,0.00,0.00,0,2.00,1,159.97,0,0,1,java.lang.Object,0.00,1,0,2,0,1,2,0,0,43,0
"org.apache.lucene.codecs.perfield.PerFieldPostingsFormat$FieldsWriter",3,0.67,2.67,40,0.68,33849.08,6,3,27,27,9,137.20,8,54,0,2,97.31,0.00,0.50,0.78,0,0.00,4,2035.96,0,1,9,org.apache.lucene.codecs.FieldsConsumer,0.33,24,1,8,0,24,2,0,8,369,1
"org.apache.lucene.codecs.perfield.TestPerFieldPostingsFormat",8,0.00,2.62,139,1.91,76643.65,8,0,26,48,22,114.14,25,152,0,2,93.53,0.00,0.50,0.00,5,8.00,6,5718.58,0,1,22,org.apache.lucene.util.LuceneTestCase,0.00,40,1,21,0,40,7,0,16,1012,1
"org.apache.lucene.codecs.perfield.TestPerFieldPostingsFormat$MockCodec",1,0.00,3.00,11,0.10,1890.42,4,3,26,5,5,106.10,0,15,0,3,106.10,0.00,0.67,1.00,0,0.00,3,308.66,0,1,5,org.apache.lucene.codecs.lucene40.Lucene40Codec,0.00,4,2,3,0,4,0,0,0,72,2
"org.apache.lucene.codecs.perfield.TestPerFieldPostingsFormat$MockCodec2",1,0.00,2.00,8,0.07,1180.22,3,2,26,4,4,112.96,0,13,0,3,112.96,0.00,0.67,1.00,0,0.00,2,210.60,0,1,4,org.apache.lucene.codecs.lucene40.Lucene40Codec,0.00,3,2,2,0,3,0,0,0,51,2
"org.apache.lucene.analysis.ngram.EdgeNGramTokenFilter",0,0.00,0.00,5,0.06,1257.86,3,3,5,0,11,171.00,7,5,7,4,171.00,0.00,0.75,0.00,0,0.00,0,174.17,0,0,4,org.apache.lucene.analysis.TokenFilter,0.00,0,3,0,0,0,0,0,2,41,2
"org.apache.lucene.analysis.ngram.EdgeNGramTokenFilter$Side",4,0.21,4.00,66,0.87,117123.23,15,11,5,19,2,58.37,26,89,0,1,90.59,0.00,0.00,0.25,0,6.00,13,2599.13,1,4,2,java.lang.Object,0.00,15,0,16,0,15,0,0,12,424,2
"org.apache.lucene.analysis.ngram.EdgeNGramTokenFilterTest",14,0.31,1.21,77,1.01,21054.48,15,1,11,23,10,119.86,8,86,0,3,119.86,0.00,0.67,0.71,0,0.00,2,3030.27,5,0,10,org.apache.lucene.analysis.BaseTokenStreamTestCase,0.00,9,2,17,0,9,14,0,6,650,1
"org.apache.lucene.analysis.ngram.EdgeNGramTokenFilterTest$Analyzer",1,0.00,1.00,6,0.09,1749.94,1,0,11,5,5,116.44,0,8,0,1,116.44,0.00,0.00,0.00,0,1.00,1,265.47,0,1,5,java.lang.Object,0.00,4,0,1,0,4,0,0,0,57,0
"org.apache.lucene.analysis.ngram.EdgeNGramTokenFilterTest$Analyzer_0",1,0.00,1.00,4,0.07,1236.33,1,0,11,4,3,124.19,0,7,0,1,124.19,0.00,0.00,0.00,0,1.00,1,200.72,0,1,3,java.lang.Object,0.00,3,0,1,0,3,0,0,0,45,0
"org.apache.lucene.analysis.ngram.EdgeNGramTokenFilterTest$Analyzer_1",1,0.00,1.00,4,0.07,1236.33,1,0,11,4,3,124.19,0,7,0,1,124.19,0.00,0.00,0.00,0,1.00,1,200.72,0,1,3,java.lang.Object,0.00,3,0,1,0,3,0,0,0,45,0
"org.apache.lucene.analysis.ngram.EdgeNGramTokenFilterTest$Analyzer_2",1,0.00,1.00,4,0.06,1080.75,1,0,11,4,3,124.65,0,7,0,1,124.65,0.00,0.00,0.00,0,1.00,1,177.64,0,1,3,java.lang.Object,0.00,3,0,1,0,3,0,0,0,41,0
"org.apache.lucene.analysis.ngram.EdgeNGramTokenFilterTest$Analyzer_3",1,0.00,1.00,4,0.06,1080.75,1,0,11,4,3,124.65,0,7,0,1,124.65,0.00,0.00,0.00,0,1.00,1,177.64,0,1,3,java.lang.Object,0.00,3,0,1,0,3,0,0,0,41,0
"org.apache.lucene.analysis.ngram.EdgeNGramTokenizer",0,0.00,0.00,7,0.10,2749.76,5,5,6,0,8,171.00,8,7,4,4,171.00,0.00,0.75,0.00,0,0.00,0,305.53,0,0,4,org.apache.lucene.analysis.Tokenizer,0.00,0,3,0,0,0,0,0,2,65,2
"org.apache.lucene.analysis.ngram.EdgeNGramTokenizer$Side",4,0.17,4.75,86,1.24,234640.27,12,8,6,18,0,83.30,67,118,0,1,83.77,0.00,0.00,0.25,0,6.00,16,3712.62,1,4,0,java.lang.Object,0.00,14,0,19,0,14,0,0,21,593,2
"org.apache.lucene.analysis.ngram.EdgeNGramTokenizerTest",11,0.10,1.27,68,0.77,16291.13,12,1,6,17,4,166.95,11,69,0,3,116.95,0.00,0.67,0.91,0,0.00,2,2323.50,3,0,4,org.apache.lucene.analysis.BaseTokenStreamTestCase,0.00,6,2,14,0,6,11,0,9,502,1
"org.apache.lucene.analysis.ngram.EdgeNGramTokenizerTest$Analyzer",1,0.00,1.00,4,0.05,1000.72,1,0,6,3,2,124.92,0,6,0,1,124.92,0.00,0.00,0.00,0,1.00,1,161.80,0,1,2,java.lang.Object,0.00,2,0,1,0,2,0,0,0,38,0
"org.apache.lucene.analysis.ngram.EdgeNGramTokenizerTest$Analyzer_0",1,0.00,1.00,4,0.05,1000.72,1,0,6,3,2,124.92,0,6,0,1,124.92,0.00,0.00,0.00,0,1.00,1,161.80,0,1,2,java.lang.Object,0.00,2,0,1,0,2,0,0,0,38,0
"org.apache.lucene.analysis.ngram.NGramTokenFilter",4,0.23,3.00,52,0.55,24404.01,17,13,5,14,9,81.51,20,67,5,4,99.39,0.00,0.75,0.25,0,6.00,7,1640.23,1,0,4,org.apache.lucene.analysis.TokenFilter,0.50,10,3,12,0,10,4,0,10,322,2
"org.apache.lucene.analysis.ngram.NGramTokenFilterTest",12,0.36,1.17,62,0.88,18365.30,13,1,11,21,10,119.81,8,73,0,3,119.81,0.00,0.67,0.67,0,0.00,2,2636.29,5,0,10,org.apache.lucene.analysis.BaseTokenStreamTestCase,0.00,9,2,14,0,9,12,0,6,557,1
"org.apache.lucene.analysis.ngram.NGramTokenFilterTest$Analyzer",1,0.00,1.00,6,0.08,1624.53,1,0,11,5,5,116.69,0,8,0,1,116.69,0.00,0.00,0.00,0,1.00,1,233.62,0,1,5,java.lang.Object,0.00,4,0,1,0,4,0,0,0,52,0
"org.apache.lucene.analysis.ngram.NGramTokenFilterTest$Analyzer_0",1,0.00,1.00,4,0.06,1051.87,1,0,11,4,3,124.74,0,7,0,1,124.74,0.00,0.00,0.00,0,1.00,1,173.06,0,1,3,java.lang.Object,0.00,3,0,1,0,3,0,0,0,40,0
"org.apache.lucene.analysis.ngram.NGramTokenFilterTest$Analyzer_1",1,0.00,1.00,4,0.05,790.45,1,0,11,4,3,125.72,0,7,0,1,125.72,0.00,0.00,0.00,0,1.00,1,148.55,0,1,3,java.lang.Object,0.00,3,0,1,0,3,0,0,0,36,0
"org.apache.lucene.analysis.ngram.NGramTokenizer",8,0.08,2.50,70,0.80,48560.01,20,12,6,17,7,107.55,39,94,3,4,107.31,0.00,0.75,0.16,1,24.00,11,2394.80,2,0,4,org.apache.lucene.analysis.Tokenizer,0.55,9,3,20,0,9,8,0,17,474,2
"org.apache.lucene.analysis.ngram.NGramTokenizerTest",9,0.12,1.22,53,0.65,13830.76,10,1,5,14,4,169.79,10,58,0,3,119.79,0.00,0.67,0.89,0,0.00,2,1963.50,3,0,4,org.apache.lucene.analysis.BaseTokenStreamTestCase,0.00,5,2,11,0,5,9,0,8,418,1
"org.apache.lucene.analysis.ngram.NGramTokenizerTest$Analyzer",1,0.00,1.00,4,0.04,722.24,1,0,5,3,2,126.03,0,6,0,1,126.03,0.00,0.00,0.00,0,1.00,1,133.34,0,1,2,java.lang.Object,0.00,2,0,1,0,2,0,0,0,33,0
"org.apache.lucene.queryparser.flexible.precedence.processors.BooleanModifiersQueryNodeProcessor",6,2.00,2.17,38,0.51,26943.37,8,2,10,16,7,152.92,17,56,1,2,113.03,0.00,0.50,0.00,1,6.00,5,1526.84,2,5,6,org.apache.lucene.queryparser.flexible.core.processors.QueryNodeProcessorImpl,0.00,10,1,13,0,10,1,0,3,318,1
"org.apache.lucene.queryparser.flexible.precedence.processors.PrecedenceQueryNodeProcessorPipeline",1,0.00,3.00,10,0.09,2155.87,1,0,4,4,5,116.32,17,11,1,3,107.19,0.00,0.67,0.00,0,1.00,3,260.68,3,0,5,org.apache.lucene.queryparser.flexible.standard.processors.StandardQueryNodeProcessorPipeline,0.00,3,2,3,0,3,1,0,2,57,1
"org.apache.lucene.search.grouping.dv.DVAllGroupHeadsCollector",5,0.08,1.40,33,0.61,22063.54,11,6,13,17,12,95.32,29,54,4,3,113.19,0.50,0.50,0.10,1,11.00,3,1816.32,0,2,8,org.apache.lucene.search.grouping.AbstractAllGroupHeadsCollector,0.00,12,2,7,1,12,3,0,7,352,2
"org.apache.lucene.search.grouping.dv.DVAllGroupHeadsCollector$GeneralAllGroupHeadsCollector",7,0.25,2.57,49,0.61,21036.92,9,2,13,16,5,111.87,0,53,0,4,111.87,0.00,0.75,0.29,1,10.00,4,1831.16,1,3,5,org.apache.lucene.search.grouping.dv.DVAllGroupHeadsCollector,0.33,9,3,18,0,9,4,0,0,377,2
"org.apache.lucene.search.grouping.dv.DVAllGroupHeadsCollector$GeneralAllGroupHeadsCollector$BR",4,1.00,1.25,10,0.12,1651.33,5,1,13,6,1,139.12,0,15,0,2,139.12,0.00,0.50,0.25,0,6.00,2,346.06,0,2,1,org.apache.lucene.search.grouping.dv.GeneralAllGroupHeadsCollector,0.00,2,1,5,0,2,2,0,0,90,1
"org.apache.lucene.search.grouping.dv.DVAllGroupHeadsCollector$GeneralAllGroupHeadsCollector$Dbl",4,1.00,1.25,10,0.10,1395.66,5,1,13,5,1,139.70,0,15,0,2,139.70,0.00,0.50,0.25,0,6.00,2,312.07,0,2,1,org.apache.lucene.search.grouping.dv.GeneralAllGroupHeadsCollector,0.00,1,1,5,0,1,2,0,0,83,1
"org.apache.lucene.search.grouping.dv.DVAllGroupHeadsCollector$GeneralAllGroupHeadsCollector$Lng",4,1.00,1.25,10,0.10,1395.66,5,1,13,5,1,139.70,0,15,0,2,139.70,0.00,0.50,0.25,0,6.00,2,312.07,0,2,1,org.apache.lucene.search.grouping.dv.GeneralAllGroupHeadsCollector,0.00,1,1,5,0,1,2,0,0,83,1
"org.apache.lucene.search.grouping.dv.DVAllGroupHeadsCollector$GeneralAllGroupHeadsCollector$SortedBR",5,1.00,1.20,12,0.16,2176.70,6,1,13,11,3,138.95,0,19,0,2,138.95,0.00,0.50,0.20,0,11.00,2,465.17,0,3,3,org.apache.lucene.search.grouping.dv.GeneralAllGroupHeadsCollector,0.00,6,1,6,0,6,2,0,0,119,1
"org.apache.lucene.search.grouping.dv.DVAllGroupHeadsCollector$GroupHead",3,0.00,2.67,26,0.35,13245.45,6,3,13,12,5,108.38,0,29,0,2,108.38,0.00,0.50,0.33,0,2.00,4,1061.50,0,0,5,AbstractAllGroupHeadsCollector.GroupHead,0.00,9,1,8,0,9,3,0,0,212,1
"org.apache.lucene.search.grouping.dv.DVAllGroupsCollector",6,0.08,1.33,35,0.61,17795.52,11,5,8,17,13,75.23,46,59,8,3,117.52,2.00,0.29,0.13,2,18.00,3,1824.88,0,3,5,org.apache.lucene.search.grouping.AbstractAllGroupsCollector,0.00,11,2,8,4,11,3,0,9,365,2
"org.apache.lucene.search.grouping.dv.DVAllGroupsCollector$BR",4,0.33,1.25,13,0.16,2792.02,6,2,8,10,3,130.76,0,19,0,4,130.76,0.00,0.75,0.25,0,4.00,2,482.95,0,1,3,org.apache.lucene.search.grouping.dv.DVAllGroupsCollector,0.44,6,3,5,0,6,3,0,0,115,1
"org.apache.lucene.search.grouping.dv.DVAllGroupsCollector$Dbl",4,1.00,1.25,12,0.14,1954.11,5,1,8,8,2,131.98,0,18,0,4,131.98,0.00,0.75,0.25,0,4.00,2,406.14,0,1,2,org.apache.lucene.search.grouping.dv.DVAllGroupsCollector,0.44,4,3,5,0,4,3,0,0,100,1
"org.apache.lucene.search.grouping.dv.DVAllGroupsCollector$Lng",4,1.00,1.25,12,0.14,1954.11,5,1,8,8,2,131.98,0,18,0,4,131.98,0.00,0.75,0.25,0,4.00,2,406.14,0,1,2,org.apache.lucene.search.grouping.dv.DVAllGroupsCollector,0.44,4,3,5,0,4,3,0,0,100,1
"org.apache.lucene.search.grouping.dv.DVAllGroupsCollector$SortedBR",5,0.00,1.60,25,0.32,6607.53,8,3,8,19,5,120.24,0,34,0,4,120.24,0.00,0.75,0.33,0,4.00,3,961.19,0,2,5,org.apache.lucene.search.grouping.dv.DVAllGroupsCollector,0.42,14,3,8,0,14,3,0,0,211,1
"org.apache.lucene.search.grouping.dv.DVDistinctValuesCollector",2,4.00,1.00,18,0.42,16185.12,6,4,9,8,10,56.15,20,36,4,3,104.63,1.00,0.40,0.00,0,2.00,1,1266.54,0,1,6,org.apache.lucene.search.grouping.AbstractDistinctValuesCollector,0.00,6,2,2,2,6,1,0,6,244,2
"org.apache.lucene.search.grouping.dv.DVDistinctValuesCollector$NonSorted<K>",4,0.11,1.50,22,0.33,9351.25,7,3,9,12,3,118.31,0,28,0,4,118.31,0.00,0.75,0.25,0,10.00,3,988.22,0,2,3,org.apache.lucene.search.grouping.dv.DVDistinctValuesCollector,0.31,8,3,6,0,8,2,0,0,211,2
"org.apache.lucene.search.grouping.dv.DVDistinctValuesCollector$NonSorted<K>$BR",2,1.00,2.50,13,0.21,4765.41,3,1,9,7,1,115.17,0,18,0,2,115.17,0.00,0.50,0.50,0,0.00,3,617.97,0,0,1,NonSorted,0.00,5,1,5,0,5,2,0,0,131,1
"org.apache.lucene.search.grouping.dv.DVDistinctValuesCollector$NonSorted<K>$Dbl",2,0.00,2.00,10,0.15,2919.14,2,0,9,4,0,119.85,0,14,0,2,119.85,0.00,0.50,0.00,0,0.00,2,452.84,0,0,0,NonSorted,0.00,2,1,4,0,2,2,0,0,100,1
"org.apache.lucene.search.grouping.dv.DVDistinctValuesCollector$NonSorted<K>$GroupCount",1,0.00,2.00,3,0.03,426.24,1,0,9,1,0,132.33,0,5,0,2,132.33,0.00,0.50,0.00,0,1.00,2,91.75,0,0,0,AbstractDistinctValuesCollector.GroupCount,0.00,0,1,2,0,0,1,0,0,27,1
"org.apache.lucene.search.grouping.dv.DVDistinctValuesCollector$NonSorted<K>$Lng",2,0.00,2.00,10,0.15,2919.14,2,0,9,4,0,119.85,0,14,0,2,119.85,0.00,0.50,0.00,0,0.00,2,452.84,0,0,0,NonSorted,0.00,2,1,4,0,2,2,0,0,100,1
"org.apache.lucene.search.grouping.dv.DVDistinctValuesCollector$NonSorted<K>$Sorted",4,0.13,1.50,24,0.34,9036.04,9,5,9,14,4,115.47,0,31,0,4,115.47,0.00,0.75,0.30,0,8.00,3,1021.81,0,2,4,org.apache.lucene.search.grouping.dv.DVDistinctValuesCollector,0.31,10,3,6,0,10,2,0,0,215,2
"org.apache.lucene.search.grouping.dv.DVDistinctValuesCollector$NonSorted<K>$Sorted$BR_0",4,1.00,3.75,41,0.63,28316.49,5,1,9,13,2,103.08,0,53,0,2,103.08,0.00,0.50,0.25,1,4.00,6,1890.61,1,0,2,org.apache.lucene.search.grouping.dv.Sorted,0.00,9,1,15,0,9,4,0,0,361,1
"org.apache.lucene.search.grouping.dv.DVDistinctValuesCollector$NonSorted<K>$Sorted$GroupCount_1",1,1.00,2.00,4,0.04,618.31,2,1,9,1,0,126.40,0,6,0,2,126.40,0.00,0.50,0.00,0,1.00,2,118.00,0,0,0,AbstractDistinctValuesCollector.GroupCount,0.00,0,1,2,0,0,1,0,0,32,1
"org.apache.lucene.search.grouping.dv.DVFirstPassGroupingCollector",5,0.17,1.40,32,0.57,18190.08,8,3,7,16,13,81.63,30,54,8,3,113.85,2.00,0.29,0.20,1,11.00,3,1696.41,1,2,5,org.apache.lucene.search.grouping.AbstractFirstPassGroupingCollector,0.00,11,2,7,4,11,3,0,8,334,2
"org.apache.lucene.search.grouping.dv.DVFirstPassGroupingCollector$BR",4,0.33,1.25,15,0.16,3105.24,6,2,7,8,2,130.39,0,22,0,4,130.39,0.00,0.75,0.25,0,6.00,2,474.61,0,2,2,org.apache.lucene.search.grouping.dv.DVFirstPassGroupingCollector,0.18,4,3,5,0,4,2,0,0,117,1
"org.apache.lucene.search.grouping.dv.DVFirstPassGroupingCollector$Dbl",4,1.00,1.00,10,0.10,1198.79,5,1,7,5,2,140.27,0,15,0,4,140.27,0.00,0.75,0.25,0,6.00,1,310.71,0,2,2,org.apache.lucene.search.grouping.dv.DVFirstPassGroupingCollector,0.18,1,3,4,0,1,2,0,0,82,1
"org.apache.lucene.search.grouping.dv.DVFirstPassGroupingCollector$Lng",4,1.00,1.00,10,0.10,1198.79,5,1,7,5,2,140.27,0,15,0,4,140.27,0.00,0.75,0.25,0,6.00,1,310.71,0,2,2,org.apache.lucene.search.grouping.dv.DVFirstPassGroupingCollector,0.18,1,3,4,0,1,2,0,0,82,1
"org.apache.lucene.search.grouping.dv.DVFirstPassGroupingCollector$SortedBR",5,0.38,1.20,17,0.21,4044.95,7,2,7,13,4,130.26,0,28,0,4,130.26,0.00,0.75,0.20,0,11.00,2,629.28,0,3,4,org.apache.lucene.search.grouping.dv.DVFirstPassGroupingCollector,0.17,8,3,6,0,8,2,0,0,152,1
"org.apache.lucene.search.grouping.dv.DVGroupFacetCollector",2,0.00,1.00,21,0.37,9429.74,8,6,11,7,10,67.21,24,44,3,3,104.77,0.50,0.50,0.17,0,2.00,1,1112.55,0,1,7,org.apache.lucene.search.grouping.AbstractGroupFacetCollector,0.00,5,2,2,1,5,1,0,2,217,2
"org.apache.lucene.search.grouping.dv.DVGroupFacetCollector$GroupSortedBR",2,3.00,1.00,13,0.28,6434.55,5,3,11,6,2,114.35,0,38,0,4,114.35,0.00,0.75,0.00,0,2.00,1,843.42,0,0,2,org.apache.lucene.search.grouping.dv.DVGroupFacetCollector,0.00,4,3,2,0,4,2,0,0,170,2
"org.apache.lucene.search.grouping.dv.DVGroupFacetCollector$GroupSortedBR$FacetSortedBR",5,0.50,3.20,61,0.89,41567.49,6,1,11,22,5,99.61,2,82,0,2,99.61,0.00,0.50,0.60,1,2.00,7,2656.57,0,2,5,org.apache.lucene.search.grouping.dv.GroupSortedBR,0.00,17,1,16,0,17,3,0,2,490,1
"org.apache.lucene.search.grouping.dv.DVGroupFacetCollector$GroupSortedBR$FacetSortedBR$SegmentResult",3,0.25,1.67,17,0.21,4233.99,5,2,11,5,1,170.01,3,22,0,2,120.01,0.00,0.50,0.67,0,0.00,2,631.14,0,0,1,AbstractGroupFacetCollector.SegmentResult,0.00,2,1,5,0,2,3,0,1,141,2
"org.apache.lucene.search.grouping.dv.DVGroupFacetCollector$GroupSortedBR$GroupedFacetHit",1,2.00,1.00,6,0.03,444.64,3,2,11,1,1,121.12,0,8,0,1,121.12,0.00,0.00,0.00,0,1.00,1,102.12,0,0,1,java.lang.Object,0.00,0,0,1,0,0,1,0,0,32,0
"org.apache.lucene.search.grouping.dv.DVSecondPassGroupingCollector",5,0.17,1.40,32,0.71,28218.14,8,3,10,16,14,70.06,36,64,7,3,112.35,2.00,0.29,0.20,1,11.00,3,2121.51,1,2,7,org.apache.lucene.search.grouping.AbstractSecondPassGroupingCollector,0.00,11,2,7,4,11,3,0,8,402,2
"org.apache.lucene.search.grouping.dv.DVSecondPassGroupingCollector$BR",3,0.25,1.00,9,0.17,3101.49,5,2,10,6,3,129.46,0,14,0,4,129.46,0.00,0.75,0.33,0,4.00,1,519.56,0,1,3,org.apache.lucene.search.grouping.dv.DVSecondPassGroupingCollector,0.21,3,3,3,0,3,2,0,0,116,1
"org.apache.lucene.search.grouping.dv.DVSecondPassGroupingCollector$Dbl",3,1.00,1.00,8,0.15,2287.50,4,1,10,5,3,137.07,0,12,0,4,137.07,0.00,0.75,0.33,0,4.00,1,448.40,0,1,3,org.apache.lucene.search.grouping.dv.DVSecondPassGroupingCollector,0.21,2,3,3,0,2,2,0,0,102,1
"org.apache.lucene.search.grouping.dv.DVSecondPassGroupingCollector$Lng",3,1.00,1.00,8,0.15,2287.50,4,1,10,5,3,137.07,0,12,0,4,137.07,0.00,0.75,0.33,0,4.00,1,448.40,0,1,3,org.apache.lucene.search.grouping.dv.DVSecondPassGroupingCollector,0.21,2,3,3,0,2,2,0,0,102,1
"org.apache.lucene.search.grouping.dv.DVSecondPassGroupingCollector$SortedBR",4,0.11,1.75,25,0.42,10613.71,7,3,10,16,5,114.88,0,32,0,4,114.88,0.00,0.75,0.42,0,0.00,3,1250.02,0,2,5,org.apache.lucene.search.grouping.dv.DVSecondPassGroupingCollector,0.20,12,3,7,0,12,2,0,0,249,1
"org.apache.solr.search.function.distance.DistanceFunctionTest",4,0.00,1.25,77,2.32,174938.65,4,0,6,10,2,54.48,25,146,0,3,86.70,0.00,0.67,0.00,0,4.00,2,6945.41,10,0,2,org.apache.solr.SolrTestCaseJ4,0.00,6,2,5,0,6,4,0,22,1112,1
"org.apache.solr.search.function.distance.GeohashFunction",6,0.20,1.67,28,0.32,9263.01,8,2,6,14,5,173.31,8,39,2,2,123.31,0.00,0.50,0.67,1,0.00,5,950.46,0,3,3,org.apache.lucene.queries.function.ValueSource,0.29,8,1,10,0,8,3,0,1,224,1
"org.apache.solr.search.function.distance.GeohashFunction$FunctionValues",2,0.00,1.00,9,0.13,3237.19,2,0,6,12,0,123.27,0,13,0,1,123.27,0.00,0.00,0.00,0,2.00,1,394.73,0,2,0,java.lang.Object,0.00,10,0,2,0,10,0,0,0,92,0
"org.apache.solr.search.function.distance.GeohashHaversineFunction",8,0.18,1.38,48,0.68,22420.29,12,4,14,29,8,164.75,12,66,3,2,114.75,0.00,0.50,0.41,1,4.00,3,2050.10,0,3,5,org.apache.lucene.queries.function.ValueSource,0.25,21,1,11,0,21,5,0,3,441,1
"org.apache.solr.search.function.distance.GeohashHaversineFunction$DoubleDocValues",2,0.00,1.00,9,0.12,2964.58,2,0,14,10,0,123.57,0,13,0,1,123.57,0.00,0.00,0.00,0,2.00,1,356.80,0,1,0,java.lang.Object,0.00,8,0,2,0,8,1,0,0,84,0
"org.apache.solr.search.function.distance.HaversineConstFunction",11,0.02,1.73,73,1.17,43905.10,20,9,21,34,20,113.49,8,98,6,2,113.49,0.00,0.50,0.13,2,36.00,3,3502.01,0,6,14,org.apache.lucene.queries.function.ValueSource,0.21,23,1,19,0,23,5,0,6,716,1
"org.apache.solr.search.function.distance.HaversineConstFunction$DoubleDocValues",2,0.00,1.00,12,0.25,8065.44,2,0,21,11,0,113.58,0,17,0,1,113.58,0.00,0.00,0.00,0,2.00,1,755.13,0,1,0,java.lang.Object,0.00,9,0,2,0,9,1,0,0,154,0
"org.apache.solr.search.function.distance.HaversineConstFunction$ValueSourceParser",1,0.00,17.00,53,0.83,137323.71,1,0,21,8,7,17.47,8,66,0,1,65.57,0.00,0.00,0.00,0,1.00,17,2484.95,0,1,7,java.lang.Object,0.00,7,0,17,0,7,0,0,8,420,0
"org.apache.solr.search.function.distance.HaversineFunction",9,0.16,1.33,62,0.79,30242.05,13,4,10,27,11,164.14,16,81,3,2,114.14,0.00,0.50,0.39,1,3.00,2,2370.82,0,3,8,org.apache.lucene.queries.function.ValueSource,0.24,18,1,12,0,18,6,0,2,510,1
"org.apache.solr.search.function.distance.HaversineFunction$DoubleDocValues",2,0.00,1.00,9,0.12,2964.58,2,0,10,10,0,123.57,0,13,0,1,123.57,0.00,0.00,0.00,0,2.00,1,356.80,0,1,0,java.lang.Object,0.00,8,0,2,0,8,1,0,0,84,0
"org.apache.solr.search.function.distance.SquaredEuclideanFunction",5,0.50,1.80,23,0.27,8425.84,6,1,3,10,5,173.00,8,33,2,3,123.00,0.00,0.67,0.60,0,5.00,5,818.89,2,1,3,org.apache.solr.search.function.distance.VectorDistanceFunction,0.29,5,2,9,0,5,4,0,3,191,1
"org.apache.solr.search.function.distance.StringDistanceFunction",5,0.58,2.00,30,0.39,11990.52,8,3,7,17,7,165.20,9,40,2,2,115.20,0.00,0.50,0.80,0,0.00,6,1163.47,0,2,5,org.apache.lucene.queries.function.ValueSource,0.31,12,1,10,0,12,3,0,2,264,1
"org.apache.solr.search.function.distance.StringDistanceFunction$FloatDocValues",2,0.00,1.00,9,0.16,3747.71,2,0,7,11,0,122.77,0,14,0,1,122.77,0.00,0.00,0.00,0,0.00,1,474.50,0,1,0,java.lang.Object,0.00,9,0,2,0,9,1,0,0,106,0
"org.apache.solr.search.function.distance.VectorDistanceFunction",8,0.29,1.75,46,0.60,17877.20,12,4,10,23,10,158.31,22,61,3,2,118.42,1.00,0.33,0.50,1,0.00,6,1790.05,0,3,7,org.apache.lucene.queries.function.ValueSource,0.25,15,1,14,1,15,5,0,3,398,1
"org.apache.solr.search.function.distance.VectorDistanceFunction$DoubleDocValues",2,0.00,1.00,11,0.15,3738.33,2,0,10,10,0,119.16,0,15,0,1,119.16,0.00,0.00,0.00,0,2.00,1,442.46,0,1,0,java.lang.Object,0.00,8,0,2,0,8,1,0,0,99,0
"org.apache.lucene.util.fst.Builder",12,0.14,3.67,203,3.08,376648.03,22,10,5,45,20,70.23,172,228,16,1,90.37,0.00,0.00,0.22,4,0.00,11,9249.71,0,0,6,java.lang.Object,0.00,33,0,44,0,33,12,0,84,1579,1
"org.apache.lucene.util.fst.Builder$Arc",0,0.00,0.00,6,0.04,566.52,5,5,5,0,0,171.00,1,7,0,1,171.00,0.00,0.00,0.00,0,0.00,0,134.89,0,0,0,java.lang.Object,0.00,0,0,0,0,0,0,0,1,33,2
"org.apache.lucene.util.fst.Builder$CompiledNode",1,1.00,1.00,4,0.02,179.59,2,1,5,1,0,130.79,0,6,0,1,130.79,0.00,0.00,0.00,0,1.00,1,63.86,0,0,0,java.lang.Object,0.00,0,0,1,0,0,1,1,0,20,2
"org.apache.lucene.util.fst.Builder$FreezeTail",1,0.00,1.00,2,0.04,463.05,1,0,5,1,1,138.78,0,3,0,1,138.78,0.00,0.00,0.00,0,1.00,1,109.24,0,0,1,java.lang.Object,0.00,0,0,1,0,0,1,0,0,28,3
"org.apache.lucene.util.fst.Builder$Node",1,0.00,1.00,2,0.01,23.00,1,0,5,1,0,149.05,0,3,0,1,149.05,0.00,0.00,0.00,0,1.00,1,18.00,0,0,0,,0.00,0,0,1,0,0,1,0,0,9,1
"org.apache.lucene.util.fst.Builder$UnCompiledNode",9,0.27,1.44,75,0.97,46082.39,16,7,5,15,3,158.02,15,81,0,1,108.02,0.00,0.00,0.38,0,0.00,3,2905.57,0,0,3,java.lang.Object,0.00,6,0,13,0,6,9,1,10,580,3
"org.apache.lucene.util.fst.ByteSequenceOutputs",9,0.19,2.11,68,0.86,73467.75,11,2,4,18,16,158.50,11,91,12,2,108.50,0.00,0.50,0.33,0,11.00,6,2566.20,0,7,4,org.apache.lucene.util.fst.Outputs,0.12,9,1,19,0,9,2,0,6,535,2
"org.apache.lucene.util.fst.BytesRefFSTEnum",11,0.07,1.27,50,0.52,12612.86,14,3,2,14,13,174.39,17,69,10,2,124.39,0.00,0.50,0.27,1,5.00,2,1551.58,4,6,3,org.apache.lucene.util.fst.FSTEnum,0.32,3,1,14,0,3,5,0,8,352,2
"org.apache.lucene.util.fst.BytesRefFSTEnum$InputOutput",0,0.00,0.00,3,0.02,271.02,2,2,2,0,1,171.00,0,4,0,1,171.00,0.00,0.00,0.00,0,0.00,0,64.53,0,0,1,java.lang.Object,0.00,0,0,0,0,0,0,0,0,18,2
"org.apache.lucene.util.fst.FST",35,0.10,5.37,789,10.90,1293298.37,75,40,21,100,57,40.44,416,948,46,1,84.57,0.00,0.00,0.12,13,266.00,43,32697.74,0,10,12,java.lang.Object,0.00,65,0,188,0,65,25,0,241,5317,2
"org.apache.lucene.util.fst.FST$Arc",5,0.34,2.40,50,0.50,15298.99,16,11,21,9,1,156.05,6,64,0,1,106.05,0.00,0.00,0.36,1,4.00,7,1499.59,0,2,1,java.lang.Object,0.00,4,0,12,0,4,3,0,6,309,3
"org.apache.lucene.util.fst.FST$ArcAndState<T>",1,2.00,1.00,6,0.06,989.29,3,2,21,1,1,118.39,0,8,0,1,118.39,0.00,0.00,0.00,0,1.00,1,169.81,0,0,1,java.lang.Object,0.00,0,0,1,0,0,1,0,0,44,2
"org.apache.lucene.util.fst.FST$BytesReader",3,2.00,1.00,8,0.07,976.71,5,2,21,3,1,139.98,0,10,0,2,139.98,0.00,0.50,0.00,0,3.00,1,204.36,0,0,1,org.apache.lucene.store.DataInput,0.00,0,1,3,0,0,3,0,0,57,3
"org.apache.lucene.util.fst.FST$BytesWriter",4,0.33,1.50,19,0.22,8089.70,5,1,21,6,2,122.42,2,28,0,2,122.42,0.00,0.50,0.75,0,0.00,2,666.86,0,0,2,org.apache.lucene.store.DataOutput,0.27,2,1,6,0,2,4,0,2,151,0
"org.apache.lucene.util.fst.FST$ForwardBytesReader",5,0.00,1.00,12,0.11,1604.64,5,0,21,6,0,140.03,0,20,0,2,140.03,0.00,0.50,0.00,0,7.00,1,335.54,0,0,0,org.apache.lucene.util.fst.BytesReader,0.00,1,1,5,0,1,5,0,0,90,2
"org.apache.lucene.util.fst.FST$INPUT_TYPE",0,0.00,0.00,2,0.01,71.32,0,0,21,0,0,171.00,0,1,0,1,171.00,0.00,0.00,0.00,0,0.00,0,28.53,0,0,0,java.lang.Object,0.00,0,0,0,0,0,0,0,0,9,2
"org.apache.lucene.util.fst.FST$NodeAndInCount",2,0.00,2.00,13,0.11,3305.87,4,2,21,2,0,116.47,1,18,0,1,116.47,0.00,0.00,0.50,0,2.00,3,331.18,0,0,0,java.lang.Object,0.00,0,0,4,0,0,2,1,1,83,2
"org.apache.lucene.util.fst.FST$NodeQueue",2,0.00,1.00,7,0.07,1655.51,2,0,21,3,1,130.22,0,11,0,2,130.22,0.00,0.50,0.00,0,2.00,1,210.79,0,0,1,org.apache.lucene.util.PriorityQueue,0.00,1,1,2,0,1,2,0,0,53,2
"org.apache.lucene.util.fst.FST$ReverseBytesReader",5,0.00,1.20,15,0.13,2736.53,5,0,21,5,0,131.60,0,21,0,2,131.60,0.00,0.50,0.00,0,7.00,2,393.60,0,0,0,org.apache.lucene.util.fst.BytesReader,0.00,0,1,6,0,0,5,0,0,101,2
"org.apache.lucene.util.fst.FSTEnum",14,0.15,5.14,272,3.74,561210.55,21,7,3,31,5,38.57,123,328,2,1,86.68,0.00,0.00,0.29,9,0.00,23,11213.70,0,1,3,java.lang.Object,0.00,17,0,72,2,17,13,0,117,1923,1
"org.apache.lucene.util.fst.IntSequenceOutputs",9,0.19,2.33,76,0.92,79617.63,11,2,4,16,6,156.04,11,95,2,2,106.04,0.00,0.50,0.33,0,11.00,6,2749.98,0,7,4,org.apache.lucene.util.fst.Outputs,0.12,7,1,21,0,7,2,0,6,566,2
"org.apache.lucene.util.fst.IntsRefFSTEnum",11,0.07,1.27,50,0.51,12272.74,14,3,2,14,5,174.49,17,69,2,2,124.49,0.00,0.50,0.27,1,5.00,2,1517.15,4,6,3,org.apache.lucene.util.fst.FSTEnum,0.32,3,1,14,0,3,5,0,8,346,2
"org.apache.lucene.util.fst.IntsRefFSTEnum$InputOutput",0,0.00,0.00,3,0.02,271.02,2,2,2,0,1,171.00,0,4,0,1,171.00,0.00,0.00,0.00,0,0.00,0,64.53,0,0,1,java.lang.Object,0.00,0,0,0,0,0,0,0,0,18,2
"org.apache.lucene.util.fst.NoOutputs",9,1.00,1.00,26,0.22,5136.84,10,1,2,11,11,188.06,9,44,8,2,138.06,0.00,0.50,0.11,0,16.00,1,650.13,0,7,3,org.apache.lucene.util.fst.Outputs,0.12,2,1,9,0,2,2,0,4,173,2
"org.apache.lucene.util.fst.NoOutputs$Object",2,0.00,1.00,5,0.03,408.06,2,0,2,2,0,191.58,2,9,0,1,141.58,0.00,0.00,0.00,0,2.00,1,100.05,0,0,0,java.lang.Object,0.00,0,0,2,0,0,2,0,2,30,0
"org.apache.lucene.util.fst.NodeHash",8,0.20,3.25,98,1.36,81984.89,13,5,1,21,2,138.78,18,119,1,1,98.89,0.00,0.00,0.38,4,10.00,6,4089.41,0,0,2,java.lang.Object,0.00,13,0,26,0,13,8,0,18,766,1
"org.apache.lucene.util.fst.Outputs",8,0.00,1.00,10,0.09,815.03,8,0,3,9,15,195.07,21,12,13,1,155.19,0.00,0.00,0.00,0,8.00,1,278.18,0,1,2,java.lang.Object,0.00,1,0,8,6,1,7,0,10,88,2
"org.apache.lucene.util.fst.PairOutputs",11,0.37,1.64,61,0.96,39394.56,14,3,3,23,8,116.83,8,91,5,2,116.83,0.00,0.50,0.67,2,0.00,5,2866.33,0,8,3,org.apache.lucene.util.fst.Outputs,0.11,12,1,18,0,12,3,0,4,625,1
"org.apache.lucene.util.fst.PairOutputs$Pair",3,0.25,1.67,16,0.17,4686.71,5,2,3,7,0,119.66,1,23,0,1,119.66,0.00,0.00,0.67,0,1.00,3,503.96,0,0,0,java.lang.Object,0.00,4,0,5,0,4,3,0,1,120,2
"org.apache.lucene.util.fst.PositiveIntOutputs",11,0.02,1.82,61,0.55,19932.22,15,4,3,18,16,119.13,6,85,13,2,119.13,0.00,0.50,0.23,1,19.00,4,1657.91,0,8,3,org.apache.lucene.util.fst.Outputs,0.11,7,1,20,0,7,3,0,1,387,2
"org.apache.lucene.util.fst.UpToTwoPositiveIntOutputs",14,0.08,2.07,102,1.07,48538.82,18,4,3,23,6,161.43,18,134,3,2,111.43,0.00,0.50,0.18,1,26.00,4,3204.54,0,10,3,org.apache.lucene.util.fst.Outputs,0.09,9,1,29,0,9,4,0,5,690,2
"org.apache.lucene.util.fst.UpToTwoPositiveIntOutputs$TwoLongs",4,0.33,1.25,18,0.18,5052.04,6,2,3,4,0,124.07,0,27,0,1,124.07,0.00,0.00,0.75,0,0.00,2,549.34,0,1,0,java.lang.Object,0.00,0,0,5,0,0,3,0,0,138,3
"org.apache.lucene.util.fst.UseNoMemoryExpensiveCodec",10,0.67,4.10,217,4.18,693763.04,11,1,43,55,35,133.23,19,230,0,2,83.23,0.00,0.50,0.40,3,18.00,15,12531.92,2,6,35,org.apache.lucene.util.LuceneTestCase,0.00,45,1,41,0,45,4,0,19,2033,1
"org.apache.lucene.util.fst.UseNoMemoryExpensiveCodec$FSTTester",31,0.03,8.35,1100,21.70,2903587.49,37,6,43,285,36,41.54,213,1269,0,1,73.76,0.00,0.00,0.14,10,90.00,55,65092.21,0,5,36,java.lang.Object,0.00,254,0,259,0,254,26,0,154,9865,2
"org.apache.lucene.util.fst.UseNoMemoryExpensiveCodec$FSTTester$Comparator<Long>",1,0.00,1.00,3,0.03,307.25,1,0,43,2,0,133.61,0,4,0,1,133.61,0.00,0.00,0.00,0,1.00,1,77.01,0,0,0,java.lang.Object,0.00,1,0,1,0,1,1,0,0,23,0
"org.apache.lucene.util.fst.UseNoMemoryExpensiveCodec$FSTTester$Comparator<Pair<Long,Long>>",1,0.00,1.00,3,0.05,950.00,1,0,43,2,0,129.75,0,4,0,1,129.75,0.00,0.00,0.00,0,1.00,1,145.00,0,0,0,java.lang.Object,0.00,1,0,1,0,1,1,0,0,39,0
"org.apache.lucene.util.fst.UseNoMemoryExpensiveCodec$FSTTester$CountMinOutput",0,0.00,0.00,6,0.04,672.19,5,5,43,0,0,171.00,0,7,0,1,171.00,0.00,0.00,0.00,0,0.00,0,129.27,0,0,0,java.lang.Object,0.00,0,0,0,0,0,0,0,0,31,2
"org.apache.lucene.util.fst.UseNoMemoryExpensiveCodec$FSTTester$InputOutput",2,0.50,1.50,11,0.11,2823.58,4,2,43,4,1,120.03,0,15,0,1,120.03,0.00,0.00,0.25,0,2.00,2,326.32,0,0,1,java.lang.Object,0.00,2,0,3,0,2,2,1,0,81,2
"org.apache.lucene.util.fst.UseNoMemoryExpensiveCodec$FSTTester$SyntheticData",3,0.00,3.67,40,0.62,35758.90,3,0,43,24,6,97.05,0,52,0,1,97.05,0.00,0.00,0.00,2,3.00,4,1865.69,0,1,6,java.lang.Object,0.00,21,0,11,0,21,2,0,0,343,0
"org.apache.lucene.util.fst.UseNoMemoryExpensiveCodec$FSTTester$TwoLongs",1,2.00,1.00,6,0.03,410.31,3,2,43,1,0,121.40,0,8,0,1,121.40,0.00,0.00,0.00,0,1.00,1,96.80,0,0,0,java.lang.Object,0.00,0,0,1,0,0,1,0,0,31,0
"org.apache.lucene.util.fst.UseNoMemoryExpensiveCodec$FSTTester$VisitTerms",3,0.33,8.67,97,1.91,210184.89,9,6,43,40,9,76.20,2,123,0,1,76.20,0.00,0.00,0.39,1,1.00,23,5725.14,0,0,9,java.lang.Object,0.00,37,0,26,0,37,3,0,2,838,3
"org.apache.lucene.util.fst.UseNoMemoryExpensiveCodec$FSTTester$VisitTerms<Long>",1,0.00,1.00,3,0.04,375.98,1,0,43,1,1,132.92,0,5,0,1,132.92,0.00,0.00,0.00,0,1.00,1,118.03,0,1,1,java.lang.Object,0.00,0,0,1,0,0,0,0,0,31,0
"org.apache.lucene.util.fst.UseNoMemoryExpensiveCodec$FSTTester$VisitTerms<Long>_0",1,0.00,2.00,6,0.08,1350.98,2,1,43,3,1,117.16,0,9,0,1,117.16,0.00,0.00,1.00,0,0.00,2,248.84,0,1,1,java.lang.Object,0.00,2,0,2,0,2,0,0,0,55,0
"org.apache.lucene.util.fst.UseNoMemoryExpensiveCodec$FSTTester$VisitTerms<Object>",1,0.00,1.00,3,0.04,326.00,1,0,43,1,1,133.41,0,5,0,1,133.41,0.00,0.00,0.00,0,1.00,1,110.41,0,1,1,java.lang.Object,0.00,0,0,1,0,0,0,0,0,29,0
"org.apache.lucene.util.fst.UseNoMemoryExpensiveCodec$FSTTester$VisitTerms<PairOutputs.Pair<Long,Long>>",1,0.00,2.00,6,0.12,2495.89,2,1,43,3,1,115.06,0,10,0,1,115.06,0.00,0.00,1.00,0,0.00,2,355.22,0,1,1,java.lang.Object,0.00,2,0,2,0,2,0,0,0,74,0
"org.apache.lucene.util.fst.Util",12,0.00,5.33,253,4.23,481690.84,12,0,4,59,23,40.91,143,302,20,1,85.04,0.00,0.00,0.00,1,12.00,21,12682.72,0,7,3,java.lang.Object,0.00,47,0,64,0,47,5,0,71,2063,2
"org.apache.lucene.util.fst.Util$FSTPath",3,0.25,1.33,17,0.23,7164.04,7,4,4,8,1,118.26,0,24,0,1,118.26,0.00,0.00,0.42,0,1.00,2,700.90,0,1,1,java.lang.Object,0.00,5,0,4,0,5,2,1,0,158,2
"org.apache.lucene.util.fst.Util$MinResult",2,0.33,1.50,14,0.16,4451.92,5,3,4,4,1,113.02,0,19,0,1,113.02,0.00,0.00,0.50,0,2.00,2,484.21,0,0,1,java.lang.Object,0.00,2,0,3,0,2,2,1,0,113,3
"org.apache.lucene.util.fst.Util$TopNSearcher",3,0.67,10.33,120,2.07,353519.63,9,6,4,27,1,79.90,51,147,0,1,70.77,0.00,0.00,0.61,1,1.00,23,6216.15,0,0,1,java.lang.Object,0.00,24,0,31,0,24,3,0,51,1030,2
"org.tartarus.snowball.ext.ArmenianStemmer",10,0.01,4.20,169,5.77,487084.62,19,9,2,14,4,70.97,53,433,2,2,88.84,0.00,0.50,0.12,0,0.00,13,17300.49,3,0,2,org.tartarus.snowball.SnowballProgram,0.05,4,1,42,0,4,10,0,50,2433,1
"org.tartarus.snowball.ext.BasqueStemmer",11,0.02,7.00,266,13.14,1257720.61,20,9,2,15,4,31.13,92,817,2,2,79.24,0.00,0.50,0.13,0,0.00,29,39416.71,4,0,2,org.tartarus.snowball.SnowballProgram,0.05,4,1,77,0,4,11,0,89,4854,1
"org.tartarus.snowball.ext.CatalanStemmer",12,0.00,6.58,250,17.15,1669477.07,22,10,2,16,4,33.43,106,931,2,2,81.53,0.00,0.50,0.10,0,0.00,20,51446.87,5,0,2,org.tartarus.snowball.SnowballProgram,0.05,4,1,79,0,4,12,0,103,5985,1
"org.tartarus.snowball.ext.DanishStemmer",7,0.19,5.86,210,2.56,165289.80,15,8,2,9,4,36.93,78,324,2,2,81.06,0.00,0.50,0.29,0,0.00,10,7686.56,9,0,2,org.tartarus.snowball.SnowballProgram,0.06,2,1,41,0,2,7,0,76,1361,1
"org.tartarus.snowball.ext.DutchStemmer",11,0.09,11.64,418,4.40,353945.64,23,12,2,12,4,65.65,167,642,2,2,76.01,0.00,0.50,0.17,0,0.00,60,13195.53,9,0,2,org.tartarus.snowball.SnowballProgram,0.05,1,1,128,0,1,11,0,165,2269,1
"org.tartarus.snowball.ext.EnglishStemmer",17,0.04,10.00,627,7.91,556638.64,34,17,2,18,4,66.50,259,1016,2,2,76.86,0.00,0.50,0.10,0,0.00,22,23715.70,12,0,2,org.tartarus.snowball.SnowballProgram,0.04,1,1,170,0,1,17,0,257,3876,1
"org.tartarus.snowball.ext.FinnishStemmer",13,0.10,9.23,517,6.70,564261.62,31,18,2,15,4,54.48,187,811,2,2,74.62,0.00,0.50,0.15,0,0.00,29,20088.70,10,0,2,org.tartarus.snowball.SnowballProgram,0.05,2,1,120,0,2,13,0,185,3321,1
"org.tartarus.snowball.ext.FrenchStemmer",14,0.07,12.64,731,10.02,869486.27,28,14,2,15,4,107.96,304,1164,2,2,68.66,0.00,0.50,0.14,0,0.00,71,30071.60,11,0,2,org.tartarus.snowball.SnowballProgram,0.05,1,1,177,0,1,14,0,302,4646,1
"org.tartarus.snowball.ext.German2Stemmer",8,0.12,12.12,368,3.98,369747.66,20,12,2,9,4,80.80,139,562,2,2,71.67,0.00,0.50,0.19,0,0.00,36,11938.45,8,0,2,org.tartarus.snowball.SnowballProgram,0.05,1,1,97,0,1,8,0,137,2028,1
"org.tartarus.snowball.ext.GermanStemmer",8,0.12,10.75,357,3.70,328881.14,19,11,2,9,3,72.34,131,533,1,2,72.82,0.00,0.50,0.19,0,0.00,36,11103.93,8,0,2,org.tartarus.snowball.SnowballProgram,0.05,1,1,86,0,1,8,0,129,1917,1
"org.tartarus.snowball.ext.HungarianStemmer",16,0.00,9.62,453,8.12,593316.73,30,14,2,17,4,80.04,258,862,2,2,80.52,0.00,0.50,0.07,0,0.00,33,24351.30,6,0,2,org.tartarus.snowball.SnowballProgram,0.04,1,1,154,0,1,16,0,256,3696,1
"org.tartarus.snowball.ext.IrishStemmer",12,0.02,6.58,247,3.68,235681.94,22,10,2,16,4,38.23,113,442,2,2,88.23,0.00,0.50,0.12,0,0.00,24,11040.24,4,0,2,org.tartarus.snowball.SnowballProgram,0.05,4,1,79,0,4,12,0,110,1846,1
"org.tartarus.snowball.ext.ItalianStemmer",12,0.06,11.00,522,9.35,896658.40,26,14,2,13,4,70.67,200,949,2,2,71.14,0.00,0.50,0.13,0,0.00,36,28060.51,9,0,2,org.tartarus.snowball.SnowballProgram,0.05,1,1,132,0,1,12,0,198,4211,1
"org.tartarus.snowball.ext.KpStemmer",18,0.06,19.00,1069,11.33,855356.90,37,19,2,20,3,115.26,502,1644,1,2,67.44,0.00,0.50,0.11,0,0.00,63,33994.26,10,0,2,org.tartarus.snowball.SnowballProgram,0.04,2,1,342,0,2,18,0,500,5574,1
"org.tartarus.snowball.ext.LovinsStemmer",34,0.23,5.29,817,15.90,1020296.10,38,4,2,35,3,35.77,294,1567,1,2,83.87,0.00,0.50,0.03,0,0.00,53,47714.39,5,0,2,org.tartarus.snowball.SnowballProgram,0.03,1,1,180,0,1,34,0,292,6934,1
"org.tartarus.snowball.ext.NorwegianStemmer",6,0.20,6.00,173,2.25,143216.45,13,7,2,7,4,33.65,61,277,2,2,82.13,0.00,0.50,0.31,0,0.00,12,6745.61,8,0,2,org.tartarus.snowball.SnowballProgram,0.06,1,1,36,0,1,6,0,59,1181,1
"org.tartarus.snowball.ext.PorterStemmer",13,0.05,8.85,439,5.26,381393.29,24,11,2,14,3,49.29,177,700,1,2,78.67,0.00,0.50,0.14,0,0.00,32,15768.85,10,0,2,org.tartarus.snowball.SnowballProgram,0.05,1,1,115,0,1,13,0,175,2603,1
"org.tartarus.snowball.ext.PortugueseStemmer",12,0.06,10.83,489,8.73,802187.19,25,13,2,13,4,62.34,186,900,2,2,72.70,0.00,0.50,0.13,0,0.00,39,26191.06,6,0,2,org.tartarus.snowball.SnowballProgram,0.05,1,1,130,0,1,12,0,184,3932,1
"org.tartarus.snowball.ext.RomanianStemmer",13,0.08,8.62,433,9.11,800267.28,24,11,2,14,4,32.02,151,845,2,2,76.15,0.00,0.50,0.16,0,0.00,29,27316.66,8,0,2,org.tartarus.snowball.SnowballProgram,0.05,1,1,112,0,1,13,0,149,3974,1
"org.tartarus.snowball.ext.RussianStemmer",12,0.02,6.92,315,5.50,437513.95,23,11,2,13,4,31.85,117,580,2,2,81.85,0.00,0.50,0.11,0,0.00,13,16491.41,5,0,2,org.tartarus.snowball.SnowballProgram,0.05,1,1,83,0,1,12,0,115,2611,1
"org.tartarus.snowball.ext.SpanishStemmer",12,0.06,11.58,511,9.27,892823.92,26,14,2,13,4,80.65,208,943,2,2,71.52,0.00,0.50,0.13,0,0.00,40,27801.19,7,0,2,org.tartarus.snowball.SnowballProgram,0.05,1,1,139,0,1,12,0,206,4174,1
"org.tartarus.snowball.ext.SwedishStemmer",6,0.17,5.50,164,2.31,153417.02,13,7,2,7,4,32.51,57,272,2,2,82.51,0.00,0.50,0.29,0,0.00,9,6925.29,6,0,2,org.tartarus.snowball.SnowballProgram,0.06,1,1,33,0,1,6,0,55,1204,1
"org.tartarus.snowball.ext.TurkishStemmer",42,0.00,7.45,1650,18.57,1772265.60,76,34,2,43,4,64.41,656,2392,2,2,74.76,0.00,0.50,0.03,0,1254.00,53,55710.81,9,0,2,org.tartarus.snowball.SnowballProgram,0.03,1,1,313,0,1,42,0,654,8933,1
"org.apache.solr.search.function.FileFloatSource",9,0.08,2.56,87,1.44,92792.52,14,5,34,44,27,143.47,18,120,5,2,103.59,0.00,0.50,0.13,2,18.00,14,4321.42,0,3,22,org.apache.lucene.queries.function.ValueSource,0.35,35,1,23,0,35,6,0,15,749,1
"org.apache.solr.search.function.FileFloatSource$Cache",1,0.00,1.00,3,0.03,477.11,1,0,34,2,1,132.11,0,5,0,1,132.11,0.00,0.00,0.00,0,1.00,1,100.00,0,1,1,java.lang.Object,0.00,1,0,1,0,1,0,0,0,27,0
"org.apache.solr.search.function.FileFloatSource$Cache_0",3,0.50,2.33,30,0.28,18751.94,4,1,34,9,1,103.61,2,41,0,1,103.61,0.00,0.00,0.67,0,1.00,5,825.15,0,2,1,java.lang.Object,0.00,6,0,7,0,6,1,0,2,181,2
"org.apache.solr.search.function.FileFloatSource$CreationPlaceholder",0,0.00,0.00,2,0.01,75.00,1,1,34,0,0,171.00,0,3,0,1,171.00,0.00,0.00,0.00,0,0.00,0,30.00,0,0,0,java.lang.Object,0.00,0,0,0,0,0,0,0,0,10,2
"org.apache.solr.search.function.FileFloatSource$Entry",3,0.50,1.33,10,0.09,2145.15,4,1,34,5,1,130.66,0,16,0,1,130.66,0.00,0.00,0.67,0,1.00,2,275.58,0,0,1,java.lang.Object,0.00,2,0,4,0,2,3,0,0,72,2
"org.apache.solr.search.function.FileFloatSource$FloatDocValues",2,0.00,1.00,5,0.04,574.09,2,0,34,2,0,140.42,1,9,0,1,140.42,0.00,0.00,0.00,1,2.00,1,131.80,0,1,0,java.lang.Object,0.00,0,0,2,0,0,1,0,1,37,0
"org.apache.solr.search.function.FileFloatSource$ReloadCacheRequestHandler",5,1.00,1.00,17,0.18,3174.85,6,1,34,14,6,131.13,0,33,0,2,131.13,0.00,0.50,0.20,0,8.00,1,550.67,0,4,6,org.apache.solr.handler.RequestHandlerBase,0.47,9,1,5,0,9,1,0,0,128,2
"org.apache.solr.search.function.NvlValueSourceParser",2,1.00,1.50,10,0.11,2015.53,3,1,7,6,7,73.08,17,16,0,2,121.18,0.00,0.50,0.00,0,2.00,2,327.71,0,1,7,org.apache.solr.search.ValueSourceParser,0.00,4,1,3,0,4,1,0,3,77,1
"org.apache.solr.search.function.NvlValueSourceParser$SimpleFloatFunction",2,0.00,1.50,9,0.07,1481.12,2,0,7,3,1,125.85,0,14,0,1,125.85,0.00,0.00,0.00,0,2.00,2,204.23,0,1,1,java.lang.Object,0.00,1,0,3,0,1,1,0,0,51,0
"org.apache.solr.search.function.SortByFunctionTest",4,0.00,1.00,27,0.58,10248.06,4,0,1,4,1,165.13,6,91,0,3,115.13,0.00,0.67,0.00,0,4.00,1,1741.70,5,2,1,org.apache.solr.util.AbstractSolrTestCase,0.16,0,2,4,0,0,2,0,3,317,1
"org.apache.solr.search.function.TestFunctionQuery",22,0.50,1.91,377,7.25,335563.49,24,2,19,89,10,92.25,99,483,0,3,92.01,0.00,0.67,0.02,6,58.00,8,21740.12,8,1,10,org.apache.solr.SolrTestCaseJ4,0.00,67,2,42,0,67,21,0,86,3513,1
"org.apache.solr.search.function.ValueSourceRangeFilter",11,0.10,2.36,54,0.71,33471.92,16,5,10,19,14,120.91,4,77,6,3,120.91,0.00,0.67,0.29,1,27.00,8,2131.85,0,5,8,org.apache.solr.search.SolrFilter,0.00,8,2,26,0,8,6,0,2,464,1
"org.apache.solr.search.function.ValueSourceRangeFilter$DocIdSet",2,0.00,1.00,5,0.06,798.93,2,0,10,4,1,139.28,1,9,0,1,139.28,0.00,0.00,0.00,0,2.00,1,183.93,0,2,1,java.lang.Object,0.00,2,0,2,0,2,0,0,1,46,0
"org.egothor.stemmer.Cell",3,0.62,1.00,13,0.11,1517.65,7,4,0,3,9,95.03,18,16,9,1,127.25,0.00,0.00,0.67,0,1.00,1,330.79,0,1,0,java.lang.Object,0.00,0,0,3,0,0,2,0,8,89,0
"org.egothor.stemmer.Compile",2,1.33,11.00,91,1.32,130177.50,5,3,10,33,8,28.58,15,107,1,1,70.87,0.00,0.00,1.00,1,0.00,20,3950.98,0,0,7,java.lang.Object,0.00,31,0,22,0,31,2,0,4,591,1
"org.egothor.stemmer.Diff",4,0.33,9.75,148,1.81,386579.09,12,8,0,14,4,62.36,60,165,4,1,72.72,0.00,0.00,0.38,0,4.00,26,5421.92,0,1,0,java.lang.Object,0.00,10,0,39,0,10,3,0,23,913,1
"org.egothor.stemmer.DiffIt",2,0.00,4.50,32,0.49,28517.75,2,0,5,15,1,50.73,15,39,0,1,93.03,0.00,0.00,0.00,1,2.00,7,1462.26,0,0,1,java.lang.Object,0.00,13,0,9,0,13,2,0,4,254,1
"org.egothor.stemmer.Gener",3,0.00,3.67,41,0.57,46352.53,3,0,4,9,6,53.87,22,44,2,2,96.16,0.00,0.50,0.00,1,3.00,7,1707.33,0,0,4,org.egothor.stemmer.Reduce,0.33,6,1,11,0,6,3,0,4,318,1
"org.egothor.stemmer.Lift",3,1.00,4.00,45,0.59,39893.03,4,1,4,13,6,44.34,28,52,2,2,94.34,0.00,0.50,0.33,1,4.00,9,1779.38,0,0,4,org.egothor.stemmer.Reduce,0.33,10,1,12,0,10,3,0,4,335,1
"org.egothor.stemmer.MultiTrie",8,0.11,2.38,70,0.84,37028.62,12,4,5,26,6,65.96,57,78,4,2,108.25,1.00,0.33,0.34,0,0.00,4,2525.72,0,2,2,org.egothor.stemmer.Trie,0.00,18,1,19,1,18,6,0,9,512,1
"org.egothor.stemmer.MultiTrie2",12,0.00,3.92,147,1.87,190189.45,12,0,5,26,7,65.13,74,184,4,3,97.36,0.00,0.67,0.00,3,38.00,8,5604.70,1,4,3,org.egothor.stemmer.MultiTrie,0.00,14,2,47,0,14,8,0,20,1064,1
"org.egothor.stemmer.Optimizer",4,0.00,5.25,84,0.99,103503.80,4,0,4,22,7,38.44,33,93,3,2,86.55,1.00,0.33,0.00,1,4.00,9,2974.78,0,0,4,org.egothor.stemmer.Reduce,0.29,18,1,21,1,18,4,0,6,570,1
"org.egothor.stemmer.Optimizer2",2,0.00,1.50,9,0.10,5539.66,2,0,0,3,4,72.86,20,13,2,3,121.34,0.00,0.67,0.00,0,2.00,2,311.43,0,0,2,org.egothor.stemmer.Optimizer,0.33,1,2,3,0,1,2,0,3,72,1
"org.egothor.stemmer.Reduce",3,0.00,1.67,25,0.37,16804.50,3,0,4,15,8,89.81,16,27,6,1,107.68,0.00,0.00,0.00,1,3.00,3,1118.35,0,1,3,java.lang.Object,0.00,12,0,5,4,12,2,0,4,224,1
"org.egothor.stemmer.Reduce$Remap",1,0.00,3.00,17,0.17,7110.55,1,0,4,7,2,62.29,6,18,0,2,94.52,0.00,0.50,0.00,0,0.00,3,518.26,0,0,2,org.egothor.stemmer.Row,0.00,6,1,3,0,6,1,0,1,103,0
"org.egothor.stemmer.Row",15,0.07,2.53,135,1.36,47525.33,18,3,5,33,8,89.75,84,147,7,1,107.62,0.00,0.00,0.27,1,0.00,8,4070.96,0,0,1,java.lang.Object,0.00,18,0,38,1,18,15,0,15,841,1
"org.egothor.stemmer.TestCompile",5,0.00,2.60,61,0.91,39790.87,5,0,11,36,4,99.81,1,76,0,2,99.81,0.00,0.50,0.00,2,5.00,8,2731.23,0,1,4,org.apache.lucene.util.LuceneTestCase,0.00,31,1,13,0,31,4,0,1,510,1
"org.egothor.stemmer.TestStemmer",7,0.00,2.14,74,0.93,28235.43,7,0,1,22,7,155.13,8,75,0,2,105.13,0.00,0.50,0.00,1,7.00,3,2778.75,0,0,7,org.apache.lucene.util.LuceneTestCase,0.00,15,1,15,0,15,7,0,2,545,1
"org.egothor.stemmer.Trie",14,0.23,3.64,197,2.08,136411.05,18,4,5,36,15,64.32,90,208,13,1,96.54,0.00,0.00,0.46,1,0.00,14,6250.91,0,5,3,java.lang.Object,0.00,22,0,51,2,22,9,0,15,1207,1
"org.egothor.stemmer.Trie$StrEnum",3,0.50,1.33,18,0.11,1772.82,6,3,5,5,0,159.97,6,23,0,1,120.08,0.00,0.00,0.67,0,0.00,2,331.03,0,0,0,java.lang.Object,0.00,2,0,4,0,2,3,0,1,87,0
"org.apache.solr.spelling.suggest.LookupFactory",2,0.00,1.00,3,0.02,120.68,2,0,3,2,8,206.98,3,4,5,1,156.98,0.00,0.00,0.00,0,2.00,1,60.34,0,2,3,java.lang.Object,0.00,0,0,2,4,0,0,0,1,21,2
"org.apache.solr.spelling.suggest.Suggester",4,0.51,6.25,92,1.47,72583.34,19,15,27,42,18,86.48,18,123,1,2,86.25,0.00,0.50,0.45,1,0.00,9,4401.81,1,2,17,org.apache.solr.spelling.SolrSpellChecker,0.00,38,1,25,0,38,2,0,10,748,1
"org.apache.solr.spelling.suggest.SuggesterFSTTest",1,0.00,1.00,3,0.02,130.68,1,0,0,1,1,136.07,16,5,0,4,136.54,0.00,0.75,0.00,0,1.00,1,48.73,0,0,1,org.apache.solr.spelling.suggest.SuggesterTest,0.00,0,3,1,0,0,1,0,1,16,1
"org.apache.solr.spelling.suggest.SuggesterTSTTest",1,0.00,1.00,3,0.02,130.68,1,0,0,1,1,136.07,16,5,0,4,136.54,0.00,0.75,0.00,0,1.00,1,48.73,0,0,1,org.apache.solr.spelling.suggest.SuggesterTest,0.00,0,3,1,0,0,1,0,1,16,1
"org.apache.solr.spelling.suggest.SuggesterTest",7,0.17,1.29,47,0.59,10707.85,9,2,7,17,7,166.84,7,79,3,3,116.84,1.50,0.33,0.36,1,21.00,2,1755.04,7,0,4,org.apache.solr.SolrTestCaseJ4,0.00,10,2,9,3,10,7,0,5,363,1
"org.apache.solr.spelling.suggest.SuggesterWFSTTest",1,0.00,1.00,3,0.02,130.68,1,0,0,1,1,136.07,16,5,0,4,136.54,0.00,0.75,0.00,0,1.00,1,48.73,0,0,1,org.apache.solr.spelling.suggest.SuggesterTest,0.00,0,3,1,0,0,1,0,1,16,1
"org.apache.solr.spelling.suggest.TestPhraseSuggestions",2,0.00,1.00,8,0.12,1376.72,3,1,3,2,2,126.19,0,20,0,3,126.19,0.00,0.67,1.00,0,0.00,1,352.14,3,0,2,org.apache.solr.SolrTestCaseJ4,0.00,0,2,2,0,0,2,0,0,80,1
"org.apache.lucene.queries.function.BoostedQuery",9,0.06,1.22,38,0.48,13783.72,11,2,8,23,14,123.41,4,51,6,2,123.41,0.00,0.50,0.44,1,3.00,2,1437.50,2,5,8,org.apache.lucene.search.Query,0.11,14,1,11,0,14,4,0,2,331,1
"org.apache.lucene.queries.function.BoostedQuery$BoostedWeight",6,0.00,1.33,33,0.43,11865.23,9,3,8,19,11,118.90,1,49,0,2,118.90,0.00,0.50,0.33,0,0.00,2,1278.16,0,3,11,org.apache.lucene.search.Weight,0.50,13,1,8,0,13,3,0,1,273,1
"org.apache.lucene.queries.function.BoostedQuery$CustomScorer",6,0.16,1.33,31,0.41,10567.43,11,5,8,19,7,119.30,3,46,0,3,119.30,0.00,0.67,0.33,0,0.00,2,1244.78,0,1,7,org.apache.lucene.search.Scorer,0.75,13,2,8,0,13,5,0,3,271,1
"org.apache.lucene.queries.function.FunctionQuery",8,0.71,1.38,22,0.28,6858.81,9,1,8,14,24,186.60,15,38,16,2,136.60,0.00,0.50,0.38,1,14.00,3,847.88,1,4,8,org.apache.lucene.search.Query,0.11,6,1,11,0,6,4,0,6,204,1
"org.apache.lucene.queries.function.FunctionQuery$AllScorer",6,0.23,1.67,41,0.45,11496.56,13,7,8,15,7,166.01,8,53,0,3,116.01,0.00,0.67,0.33,1,0.00,4,1359.84,0,1,7,org.apache.lucene.search.Scorer,0.75,9,2,10,0,9,5,0,8,292,1
"org.apache.lucene.queries.function.FunctionQuery$FunctionWeight",6,0.10,1.00,21,0.24,4038.82,10,4,8,11,9,130.93,0,34,0,2,130.93,0.00,0.50,0.17,1,10.00,1,733.00,0,3,9,org.apache.lucene.search.Weight,0.50,5,1,6,0,5,3,0,0,178,1
"org.apache.lucene.queries.function.FunctionValues",25,0.00,1.24,75,0.60,12961.70,25,0,5,31,130,181.77,33,75,125,1,131.78,0.00,0.00,0.00,3,25.00,6,1807.26,0,7,6,java.lang.Object,0.00,6,0,31,11,6,18,0,22,455,2
"org.apache.lucene.queries.function.FunctionValues$ValueFiller",2,0.00,1.00,3,0.02,117.79,2,0,5,2,1,207.06,2,4,0,1,157.06,0.00,0.00,0.00,0,2.00,1,55.02,0,1,1,java.lang.Object,0.00,0,0,2,0,0,1,0,2,20,3
"org.apache.lucene.queries.function.FunctionValues$ValueFiller_0",2,0.00,1.00,6,0.05,661.73,3,1,5,3,2,133.36,0,10,0,1,133.36,0.00,0.00,1.00,0,0.00,1,153.37,0,1,2,java.lang.Object,0.00,1,0,2,0,1,1,0,0,43,0
"org.apache.lucene.queries.function.FunctionValues$ValueSourceScorer",1,0.00,1.00,4,0.04,809.86,1,0,5,2,0,125.64,0,6,0,1,125.64,0.00,0.00,0.00,0,1.00,1,127.88,0,0,0,java.lang.Object,0.00,1,0,1,0,1,1,0,0,32,0
"org.apache.lucene.queries.function.FunctionValues$ValueSourceScorer_1",1,0.00,1.00,4,0.04,809.86,1,0,5,2,0,125.64,0,6,0,1,125.64,0.00,0.00,0.00,0,1.00,1,127.88,0,0,0,java.lang.Object,0.00,1,0,1,0,1,1,0,0,32,0
"org.apache.lucene.queries.function.FunctionValues$ValueSourceScorer_2",1,0.00,1.00,4,0.04,809.86,1,0,5,2,0,125.64,0,6,0,1,125.64,0.00,0.00,0.00,0,1.00,1,127.88,0,0,0,java.lang.Object,0.00,1,0,1,0,1,1,0,0,32,0
"org.apache.lucene.queries.function.FunctionValues$ValueSourceScorer_3",1,0.00,1.00,4,0.04,809.86,1,0,5,2,0,125.64,0,6,0,1,125.64,0.00,0.00,0.00,0,1.00,1,127.88,0,0,0,java.lang.Object,0.00,1,0,1,0,1,1,0,0,32,0
"org.apache.lucene.queries.function.Ignore",7,0.05,2.14,76,1.10,38381.09,21,14,17,34,15,104.31,34,108,0,2,104.08,0.00,0.50,0.11,2,24.00,8,3303.83,0,2,15,org.apache.lucene.util.LuceneTestCase,0.00,27,1,15,0,27,5,0,14,603,2
"org.apache.lucene.queries.function.TestFieldScoreQuery",11,0.00,1.18,55,0.76,21282.17,11,0,13,28,11,158.89,31,74,0,2,119.01,0.00,0.50,0.00,2,11.00,2,2274.11,0,0,11,FunctionTestSetup,0.00,17,1,13,0,17,11,0,21,442,1
"org.apache.lucene.queries.function.TestOrdValues",8,0.00,1.88,68,1.07,49466.59,8,0,7,30,11,127.93,30,85,0,2,107.31,0.00,0.50,0.00,2,8.00,5,3208.43,0,0,11,FunctionTestSetup,0.00,22,1,15,0,22,8,0,12,560,1
"org.apache.lucene.queries.function.ValueSource",8,0.00,1.00,17,0.15,1888.94,8,0,12,11,176,123.21,40,25,167,1,141.08,0.00,0.00,0.00,1,8.00,1,459.87,0,4,9,java.lang.Object,0.00,3,0,8,76,3,4,1,10,126,2
"org.apache.lucene.queries.function.ValueSource$ValueSourceComparator",7,0.12,1.57,34,0.32,8710.43,11,4,12,8,3,124.07,0,50,0,2,124.07,0.00,0.50,0.36,0,0.00,3,973.84,0,2,3,org.apache.lucene.search.FieldComparator,0.67,1,1,11,0,1,5,0,0,226,0
"org.apache.lucene.queries.function.ValueSource$ValueSourceComparatorSource",2,1.00,1.00,6,0.07,1068.45,3,1,12,3,2,131.72,0,11,0,2,131.72,0.00,0.50,0.50,0,2.00,1,204.78,0,1,2,org.apache.lucene.search.FieldComparatorSource,0.00,1,1,2,0,1,1,0,0,51,0
"org.apache.lucene.queries.function.ValueSource$ValueSourceSortField",2,0.00,1.00,7,0.08,1279.53,2,0,12,7,2,131.11,0,11,0,2,131.11,0.00,0.50,0.00,0,2.00,1,239.52,1,1,2,org.apache.lucene.search.SortField,0.00,5,1,2,0,5,1,0,0,59,0
"org.apache.lucene.queries.function.ValueSourceScorer",9,0.02,1.33,37,0.32,5547.61,15,6,5,14,12,126.51,1,49,8,3,126.51,0.00,0.67,0.19,3,30.00,4,959.85,0,1,5,org.apache.lucene.search.Scorer,0.63,5,2,12,0,5,8,0,1,233,1
"org.apache.lucene.queries.function.docvalues.BoolDocValues",12,1.00,1.58,25,0.31,5012.79,13,1,4,15,8,139.03,0,48,4,2,139.03,0.00,0.50,0.08,1,22.00,2,937.09,1,4,4,org.apache.lucene.queries.function.FunctionValues,0.59,3,1,19,0,3,8,0,0,242,2
"org.apache.lucene.queries.function.docvalues.BoolDocValues$ValueFiller",2,0.00,1.00,7,0.06,920.28,3,1,4,3,2,132.23,0,11,0,1,132.23,0.00,0.00,1.00,0,0.00,1,187.05,0,1,2,java.lang.Object,0.00,1,0,2,0,1,1,0,0,51,0
"org.apache.lucene.queries.function.docvalues.DoubleDocValues",12,1.00,1.08,25,0.26,3534.45,13,1,4,15,15,140.31,0,48,11,2,140.31,1.00,0.33,0.08,1,22.00,2,770.18,1,4,4,org.apache.lucene.queries.function.FunctionValues,0.59,3,1,13,1,3,8,0,0,210,2
"org.apache.lucene.queries.function.docvalues.DoubleDocValues$ValueFiller",2,0.00,1.00,7,0.06,920.28,3,1,4,3,2,132.23,0,11,0,1,132.23,0.00,0.00,1.00,0,0.00,1,187.05,0,1,2,java.lang.Object,0.00,1,0,2,0,1,1,0,0,51,0
"org.apache.lucene.queries.function.docvalues.FloatDocValues",11,1.00,1.09,23,0.24,3243.19,12,1,4,14,19,140.30,0,44,15,2,140.30,1.00,0.33,0.09,1,20.00,2,705.45,1,3,4,org.apache.lucene.queries.function.FunctionValues,0.56,3,1,12,1,3,8,0,0,193,2
"org.apache.lucene.queries.function.docvalues.FloatDocValues$ValueFiller",2,0.00,1.00,7,0.06,920.28,3,1,4,3,2,132.23,0,11,0,1,132.23,0.00,0.00,1.00,0,0.00,1,187.05,0,1,2,java.lang.Object,0.00,1,0,2,0,1,1,0,0,51,0
"org.apache.lucene.queries.function.docvalues.IntDocValues",11,1.00,1.09,23,0.24,3221.00,12,1,4,14,13,140.33,0,44,9,2,140.33,1.00,0.33,0.09,1,20.00,2,705.91,1,4,4,org.apache.lucene.queries.function.FunctionValues,0.56,3,1,12,1,3,7,0,0,193,2
"org.apache.lucene.queries.function.docvalues.IntDocValues$ValueFiller",2,0.00,1.00,7,0.06,920.28,3,1,4,3,2,132.23,0,11,0,1,132.23,0.00,0.00,1.00,0,0.00,1,187.05,0,1,2,java.lang.Object,0.00,1,0,2,0,1,1,0,0,51,0
"org.apache.lucene.queries.function.docvalues.LongDocValues",12,1.00,1.08,25,0.26,3534.45,13,1,4,15,8,140.31,0,48,4,2,140.31,0.00,0.50,0.08,1,22.00,2,770.18,1,4,4,org.apache.lucene.queries.function.FunctionValues,0.59,3,1,13,0,3,8,0,0,210,2
"org.apache.lucene.queries.function.docvalues.LongDocValues$ValueFiller",2,0.00,1.00,7,0.06,920.28,3,1,4,3,2,132.23,0,11,0,1,132.23,0.00,0.00,1.00,0,0.00,1,187.05,0,1,2,java.lang.Object,0.00,1,0,2,0,1,1,0,0,51,0
"org.apache.lucene.queries.function.docvalues.StrDocValues",6,1.00,1.17,13,0.13,1759.70,7,1,4,8,5,140.31,0,24,1,2,140.31,0.00,0.50,0.17,0,10.00,2,392.56,1,4,4,org.apache.lucene.queries.function.FunctionValues,0.32,2,1,7,0,2,2,0,0,106,2
"org.apache.lucene.queries.function.docvalues.StrDocValues$ValueFiller",2,0.00,1.00,6,0.06,746.06,3,1,4,3,2,132.95,0,10,0,1,132.95,0.00,0.00,1.00,0,0.00,1,167.05,0,1,2,java.lang.Object,0.00,1,0,2,0,1,1,0,0,46,0
"org.apache.lucene.queries.function.docvalues.StringIndexDocValues",11,0.04,2.00,58,0.72,32939.44,16,5,12,25,18,117.39,5,83,7,2,117.39,0.00,0.50,0.16,1,14.00,9,2170.05,0,7,11,org.apache.lucene.queries.function.FunctionValues,0.33,14,1,22,0,14,4,0,3,451,2
"org.apache.lucene.queries.function.docvalues.StringIndexDocValues$StringIndexException",1,0.00,1.00,3,0.03,343.27,1,0,12,1,0,133.23,0,7,0,2,133.23,0.00,0.50,0.00,0,1.00,1,96.34,0,0,0,java.lang.RuntimeException,0.00,0,1,1,0,0,1,0,0,27,3
"org.apache.lucene.queries.function.docvalues.StringIndexDocValues$ValueFiller",2,0.00,1.00,8,0.09,1543.37,3,1,12,3,2,125.80,0,12,0,1,125.80,0.00,0.00,1.00,0,0.00,1,258.74,0,1,2,java.lang.Object,0.00,1,0,2,0,1,1,0,0,65,0
"org.apache.lucene.queries.function.docvalues.StringIndexDocValues$ValueSourceScorer",1,0.00,1.00,4,0.05,1037.89,1,0,12,1,0,124.79,0,6,0,1,124.79,0.00,0.00,0.00,0,0.00,1,138.49,0,0,0,java.lang.Object,0.00,0,0,1,0,0,1,0,0,34,0
"org.apache.lucene.search.highlight.DefaultEncoder",2,0.00,1.00,4,0.02,168.02,2,0,0,2,5,94.62,19,10,4,1,144.62,0.00,0.00,0.00,0,2.00,1,53.51,0,1,1,java.lang.Object,0.00,0,0,2,0,0,1,1,2,20,1
"org.apache.lucene.search.highlight.Encoder",1,0.00,1.00,2,0.01,33.58,1,0,0,1,10,191.70,22,4,10,1,147.75,0.00,0.00,0.00,0,1.00,1,23.93,0,1,0,,0.00,0,0,1,0,0,0,0,3,11,1
"org.apache.lucene.search.highlight.Formatter",1,0.00,1.00,2,0.01,41.95,1,0,0,1,9,196.48,26,4,8,1,146.99,0.00,0.00,0.00,0,1.00,1,32.46,0,1,1,,0.00,0,0,1,0,0,0,0,3,13,1
"org.apache.lucene.search.highlight.FragmentQueue",2,0.00,1.50,5,0.08,3346.88,2,0,10,3,8,134.29,0,15,1,2,134.29,0.00,0.50,0.00,0,2.00,2,251.65,0,0,7,org.apache.lucene.util.PriorityQueue,0.00,1,1,3,0,1,2,0,0,63,0
"org.apache.lucene.search.highlight.Fragmenter",2,0.00,1.00,3,0.02,72.21,2,0,1,2,13,108.74,19,4,12,1,158.73,0.00,0.00,0.00,0,2.00,1,48.14,0,0,1,,0.00,0,0,2,0,0,2,0,3,18,1
"org.apache.lucene.search.highlight.GradientFormatter",7,0.24,3.00,96,1.32,58976.06,23,16,0,19,3,50.18,58,147,1,1,98.28,0.00,0.00,0.27,4,25.00,7,3972.45,0,4,2,java.lang.Object,0.00,12,0,21,1,12,3,1,6,768,1
"org.apache.lucene.search.highlight.Highlighter",18,0.07,2.78,194,2.74,339546.68,24,6,10,68,39,51.69,144,308,21,1,99.79,0.00,0.00,0.10,4,98.00,18,8229.01,0,6,18,java.lang.Object,0.00,50,0,50,0,50,12,0,42,1412,1
"org.apache.lucene.search.highlight.HighlighterPhraseTest",5,0.00,1.20,146,2.75,93569.96,6,1,29,43,32,82.77,0,209,0,2,82.77,0.00,0.50,1.00,0,0.00,2,8244.92,0,0,32,org.apache.lucene.util.LuceneTestCase,0.00,38,1,6,0,38,5,0,0,1307,1
"org.apache.lucene.search.highlight.HighlighterPhraseTest$Collector",4,1.00,1.00,9,0.11,1308.54,5,1,29,5,2,139.97,1,19,0,1,139.97,0.00,0.00,0.00,0,4.00,1,317.03,0,0,2,java.lang.Object,0.00,1,0,4,0,1,4,0,1,82,0
"org.apache.lucene.search.highlight.HighlighterPhraseTest$TokenStreamConcurrent",3,0.10,1.33,25,0.40,11527.20,8,5,29,13,5,109.02,0,34,0,3,109.02,0.00,0.67,0.27,1,4.00,2,1202.71,0,0,5,org.apache.lucene.analysis.TokenStream,0.55,10,2,4,0,10,3,0,0,242,3
"org.apache.lucene.search.highlight.HighlighterPhraseTest$TokenStreamSparse",3,0.10,1.33,25,0.40,10771.26,8,5,29,13,5,109.25,0,34,0,3,109.25,0.00,0.67,0.27,1,4.00,2,1196.94,0,0,5,org.apache.lucene.analysis.TokenStream,0.55,10,2,4,0,10,3,0,0,239,3
"org.apache.lucene.search.highlight.HighlighterTest",59,0.07,1.75,616,9.68,458802.05,71,12,38,144,78,152.93,85,694,25,3,102.93,0.00,0.67,0.16,8,521.00,8,29037.51,2,6,53,org.apache.lucene.analysis.BaseTokenStreamTestCase,0.00,85,2,103,0,85,53,1,48,5142,1
"org.apache.lucene.search.highlight.HighlighterTest$Scorer",4,0.00,1.00,8,0.04,260.54,4,0,38,4,2,145.49,0,12,0,1,145.49,0.00,0.00,0.00,0,4.00,1,107.35,0,1,2,java.lang.Object,0.00,0,0,4,0,0,3,0,0,37,0
"org.apache.lucene.search.highlight.HighlighterTest$TestHighlightRunner",1,0.00,1.00,4,0.04,466.10,1,0,38,2,1,127.53,0,6,0,1,127.53,0.00,0.00,0.00,0,0.00,1,113.42,0,0,1,java.lang.Object,0.00,1,0,1,0,1,1,0,0,28,0
"org.apache.lucene.search.highlight.HighlighterTest$TestHighlightRunner_0",1,0.00,1.00,4,0.04,466.10,1,0,38,2,1,127.53,0,6,0,1,127.53,0.00,0.00,0.00,0,0.00,1,113.42,0,0,1,java.lang.Object,0.00,1,0,1,0,1,1,0,0,28,0
"org.apache.lucene.search.highlight.HighlighterTest$TestHighlightRunner_1",1,0.00,1.00,4,0.04,466.10,1,0,38,2,1,127.53,0,6,0,1,127.53,0.00,0.00,0.00,0,0.00,1,113.42,0,0,1,java.lang.Object,0.00,1,0,1,0,1,1,0,0,28,0
"org.apache.lucene.search.highlight.HighlighterTest$TestHighlightRunner_10",1,0.00,1.00,10,0.17,4725.87,1,0,38,9,7,154.76,1,14,0,1,104.76,0.00,0.00,0.00,0,0.00,1,521.69,0,0,7,java.lang.Object,0.00,8,0,1,0,8,1,0,1,97,0
"org.apache.lucene.search.highlight.HighlighterTest$TestHighlightRunner_11",1,0.00,1.00,11,0.16,4137.30,1,0,38,9,5,153.67,1,14,0,1,103.67,0.00,0.00,0.00,0,0.00,1,482.52,0,0,5,java.lang.Object,0.00,8,0,1,0,8,1,0,1,92,0
"org.apache.lucene.search.highlight.HighlighterTest$TestHighlightRunner_12",1,0.00,1.00,11,0.17,3986.47,1,0,38,10,6,103.80,0,14,0,1,103.80,0.00,0.00,0.00,0,0.00,1,504.81,0,0,6,java.lang.Object,0.00,9,0,1,0,9,1,0,0,95,0
"org.apache.lucene.search.highlight.HighlighterTest$TestHighlightRunner_13",1,0.00,1.00,9,0.14,3430.73,1,0,38,8,4,107.56,0,12,0,1,107.56,0.00,0.00,0.00,0,0.00,1,417.34,0,0,4,java.lang.Object,0.00,7,0,1,0,7,1,0,0,82,0
"org.apache.lucene.search.highlight.HighlighterTest$TestHighlightRunner_14",1,0.00,5.00,33,0.53,37900.32,1,0,38,13,6,77.93,0,35,0,1,77.93,0.00,0.00,0.00,0,0.00,5,1597.96,0,0,6,java.lang.Object,0.00,12,0,5,0,12,1,0,0,270,0
"org.apache.lucene.search.highlight.HighlighterTest$TestHighlightRunner_15",1,0.00,1.00,22,0.44,20680.03,1,0,38,15,6,87.18,4,26,0,1,86.94,0.00,0.00,0.00,0,0.00,1,1325.71,0,0,6,java.lang.Object,0.00,14,0,1,0,14,1,0,4,228,0
"org.apache.lucene.search.highlight.HighlighterTest$TestHighlightRunner_16",1,0.00,1.00,15,0.30,10265.68,1,0,38,14,8,145.54,1,18,0,1,95.54,0.00,0.00,0.00,0,1.00,1,913.95,0,0,8,java.lang.Object,0.00,13,0,1,0,13,1,0,1,160,0
"org.apache.lucene.search.highlight.HighlighterTest$TestHighlightRunner_17",1,0.00,3.00,14,0.23,8043.57,1,0,38,10,5,147.24,1,16,0,1,97.24,0.00,0.00,0.00,0,0.00,3,699.24,0,0,5,java.lang.Object,0.00,9,0,3,0,9,1,0,1,122,0
"org.apache.lucene.search.highlight.HighlighterTest$TestHighlightRunner_18",1,0.00,4.00,21,0.41,18450.98,1,0,38,15,7,127.65,2,23,0,1,87.77,0.00,0.00,0.00,0,0.00,4,1217.49,0,0,7,java.lang.Object,0.00,14,0,4,0,14,1,0,2,202,0
"org.apache.lucene.search.highlight.HighlighterTest$TestHighlightRunner_19",1,0.00,1.00,9,0.14,3689.87,1,0,38,9,5,147.20,2,14,0,1,107.32,0.00,0.00,0.00,0,0.00,1,431.25,0,0,5,java.lang.Object,0.00,8,0,1,0,8,1,0,2,83,0
"org.apache.lucene.search.highlight.HighlighterTest$TestHighlightRunner_2",1,0.00,1.00,6,0.08,1462.26,1,0,38,6,3,117.05,0,9,0,1,117.05,0.00,0.00,0.00,0,0.00,1,240.04,0,0,3,java.lang.Object,0.00,5,0,1,0,5,1,0,0,50,0
"org.apache.lucene.search.highlight.HighlighterTest$TestHighlightRunner_20",1,0.00,2.00,26,0.39,15595.75,1,0,38,19,9,40.91,11,28,0,1,85.04,0.00,0.00,0.00,0,1.00,2,1170.42,0,0,9,java.lang.Object,0.00,18,0,2,0,18,1,0,11,200,0
"org.apache.lucene.search.highlight.HighlighterTest$TestHighlightRunner_21",1,0.00,1.00,11,0.19,3572.46,1,0,38,15,9,104.18,0,15,0,1,104.18,0.00,0.00,0.00,0,1.00,1,560.36,0,0,9,java.lang.Object,0.00,14,0,1,0,14,1,0,0,104,0
"org.apache.lucene.search.highlight.HighlighterTest$TestHighlightRunner_22",1,0.00,4.00,22,0.44,17315.33,1,0,38,16,13,43.10,11,24,0,1,87.23,0.00,0.00,0.00,0,0.00,4,1317.66,0,0,13,java.lang.Object,0.00,15,0,4,0,15,1,0,11,210,0
"org.apache.lucene.search.highlight.HighlighterTest$TestHighlightRunner_23",1,0.00,2.00,9,0.12,2670.02,1,0,38,8,5,108.26,0,12,0,1,108.26,0.00,0.00,0.00,0,0.00,2,357.03,0,0,5,java.lang.Object,0.00,7,0,2,0,7,1,0,0,71,0
"org.apache.lucene.search.highlight.HighlighterTest$TestHighlightRunner_24",1,0.00,5.00,25,0.40,16083.85,1,0,38,13,9,125.24,2,31,0,1,85.36,0.00,0.00,0.00,0,0.00,5,1198.51,0,0,9,java.lang.Object,0.00,12,0,5,0,12,1,0,2,209,0
"org.apache.lucene.search.highlight.HighlighterTest$TestHighlightRunner_26",1,0.00,1.00,57,0.94,90807.38,1,0,38,9,6,106.34,2,59,0,1,66.46,0.00,0.00,0.00,0,1.00,1,2828.41,0,0,6,java.lang.Object,0.00,8,0,1,0,8,1,0,2,509,0
"org.apache.lucene.search.highlight.HighlighterTest$TestHighlightRunner_3",1,0.00,1.00,8,0.11,2165.24,1,0,38,7,4,111.05,0,11,0,1,111.05,0.00,0.00,0.00,0,0.00,1,330.41,0,0,4,java.lang.Object,0.00,6,0,1,0,6,1,0,0,65,0
"org.apache.lucene.search.highlight.HighlighterTest$TestHighlightRunner_4",1,0.00,1.00,8,0.11,2092.58,1,0,38,7,4,111.16,0,11,0,1,111.16,0.00,0.00,0.00,0,0.00,1,315.36,0,0,4,java.lang.Object,0.00,6,0,1,0,6,1,0,0,63,0
"org.apache.lucene.search.highlight.HighlighterTest$TestHighlightRunner_5",1,0.00,1.00,8,0.11,2092.58,1,0,38,7,4,111.16,0,11,0,1,111.16,0.00,0.00,0.00,0,0.00,1,315.36,0,0,4,java.lang.Object,0.00,6,0,1,0,6,1,0,0,63,0
"org.apache.lucene.search.highlight.HighlighterTest$TestHighlightRunner_6",1,0.00,1.00,9,0.12,2734.17,1,0,38,7,4,128.96,3,16,0,1,108.34,0.00,0.00,0.00,0,0.00,1,372.69,0,0,4,java.lang.Object,0.00,6,0,1,0,6,1,0,3,73,0
"org.apache.lucene.search.highlight.HighlighterTest$TestHighlightRunner_7",1,0.00,1.00,9,0.12,2639.36,1,0,38,7,3,158.46,1,12,0,1,108.46,0.00,0.00,0.00,0,0.00,1,349.22,0,0,3,java.lang.Object,0.00,6,0,1,0,6,1,0,1,70,0
"org.apache.lucene.search.highlight.HighlighterTest$TestHighlightRunner_8",1,0.00,1.00,8,0.13,3002.62,1,0,38,7,5,159.93,1,12,0,1,109.93,0.00,0.00,0.00,0,0.00,1,388.39,0,0,5,java.lang.Object,0.00,6,0,1,0,6,1,0,1,75,0
"org.apache.lucene.search.highlight.HighlighterTest$TestHighlightRunner_9",1,0.00,1.00,7,0.10,1836.05,1,0,38,10,6,113.77,0,9,0,1,113.77,0.00,0.00,0.00,0,0.00,1,305.25,0,0,6,java.lang.Object,0.00,9,0,1,0,9,1,0,0,64,0
"org.apache.lucene.search.highlight.HighlighterTest$TokenStream",2,0.80,1.50,36,0.45,15891.56,7,5,38,16,4,93.37,0,43,0,1,93.37,0.00,0.00,0.60,0,0.00,2,1362.60,1,0,4,java.lang.Object,0.00,14,0,3,0,14,2,0,0,262,0
"org.apache.lucene.search.highlight.HighlighterTest$TokenStream_25",2,0.80,1.50,36,0.45,15891.56,7,5,38,16,4,93.37,0,43,0,1,93.37,0.00,0.00,0.60,0,0.00,2,1362.60,1,0,4,java.lang.Object,0.00,14,0,3,0,14,2,0,0,262,0
"org.apache.lucene.search.highlight.InvalidTokenOffsetsException",1,0.00,1.00,3,0.02,106.02,1,0,0,1,6,170.64,20,7,6,2,137.25,0.00,0.50,0.00,0,1.00,1,45.51,0,0,0,java.lang.Exception,0.00,0,1,1,0,0,1,0,2,16,1
"org.apache.lucene.search.highlight.NullFragmenter",2,0.00,1.00,4,0.02,133.81,2,0,1,2,10,185.28,4,7,8,1,145.40,0.00,0.00,0.00,0,2.00,1,68.04,0,0,2,java.lang.Object,0.00,0,0,2,0,0,2,1,1,23,1
"org.apache.lucene.search.highlight.OffsetLimitTokenFilter",3,0.17,1.33,16,0.16,3406.43,6,3,4,5,7,170.80,4,23,4,4,120.80,0.00,0.75,0.44,0,1.00,2,469.12,1,0,3,org.apache.lucene.analysis.TokenFilter,0.53,2,3,4,0,2,3,0,1,109,2
"org.apache.lucene.search.highlight.OffsetLimitTokenFilterTest",1,0.00,1.00,16,0.22,8658.75,1,0,3,6,4,134.96,2,24,0,3,95.08,0.00,0.67,0.00,0,1.00,1,654.60,2,0,4,org.apache.lucene.analysis.BaseTokenStreamTestCase,0.00,5,2,1,0,5,1,0,2,135,1
"org.apache.lucene.search.highlight.OffsetLimitTokenFilterTest$Analyzer",1,0.00,1.00,5,0.06,1383.12,1,0,3,5,2,120.19,0,7,0,1,120.19,0.00,0.00,0.00,0,1.00,1,193.47,0,0,2,java.lang.Object,0.00,4,0,1,0,4,1,0,0,45,0
"org.apache.lucene.search.highlight.PositionSpan",1,2.00,1.00,6,0.04,554.14,3,2,0,1,4,153.75,20,8,4,1,120.37,0.00,0.00,0.00,0,1.00,1,108.19,0,0,0,java.lang.Object,0.00,0,0,1,0,0,1,0,2,33,1
"org.apache.lucene.search.highlight.QueryScorer",19,0.03,1.53,97,1.03,25932.75,34,15,13,41,24,120.38,84,129,12,1,120.14,0.00,0.00,0.09,3,128.00,4,3101.22,0,4,12,java.lang.Object,0.00,22,0,29,1,22,15,1,20,669,1
"org.apache.lucene.search.highlight.QueryTermExtractor",7,0.00,2.43,44,0.75,34621.75,7,0,9,25,8,70.39,52,78,1,1,112.68,0.00,0.00,0.00,3,7.00,6,2263.70,0,4,7,java.lang.Object,0.00,18,0,17,0,18,3,0,10,433,2
"org.apache.lucene.search.highlight.QueryTermScorer",10,0.04,1.40,44,0.47,12374.56,16,6,6,23,13,91.89,60,58,5,1,124.11,0.00,0.00,0.20,0,34.00,3,1399.55,0,1,8,java.lang.Object,0.00,13,0,14,0,13,9,1,17,313,1
"org.apache.lucene.search.highlight.Scorer",4,0.00,1.00,5,0.03,143.81,4,0,2,4,8,110.64,33,6,6,1,158.75,0.00,0.00,0.00,0,4.00,1,77.87,0,1,2,,0.00,0,0,4,0,0,3,0,5,30,1
"org.apache.lucene.search.highlight.SimpleFragmenter",6,0.10,1.17,21,0.15,2457.28,10,4,2,8,13,153.21,20,29,10,1,132.60,0.00,0.00,0.33,0,10.00,2,460.63,0,0,3,java.lang.Object,0.00,2,0,7,1,2,6,1,6,120,1
"org.apache.lucene.search.highlight.SimpleHTMLEncoder",3,0.00,3.33,27,0.29,19022.81,3,0,0,9,6,62.90,22,47,5,1,105.19,0.00,0.00,0.00,1,3.00,8,882.54,0,2,1,java.lang.Object,0.00,6,0,10,0,6,1,1,3,169,1
"org.apache.lucene.search.highlight.SimpleHTMLFormatter",3,0.12,1.33,18,0.18,4973.57,7,4,0,8,14,68.45,26,23,12,1,116.55,0.00,0.00,0.33,0,5.00,2,544.46,0,1,2,java.lang.Object,0.00,5,0,4,0,5,2,1,6,129,1
"org.apache.lucene.search.highlight.SimpleSpanFragmenter",4,0.40,2.50,43,0.50,20261.08,14,10,6,12,10,104.55,17,51,1,1,104.31,0.00,0.00,0.40,0,6.00,7,1514.42,0,0,9,java.lang.Object,0.00,8,0,10,0,8,4,1,5,296,1
"org.apache.lucene.search.highlight.SpanGradientFormatter",2,0.50,3.00,24,0.29,10694.80,4,2,0,7,2,71.75,26,43,0,2,101.13,0.00,0.50,0.25,0,2.00,5,883.58,2,1,2,org.apache.lucene.search.highlight.GradientFormatter,0.00,5,1,6,0,5,1,0,4,180,1
"org.apache.lucene.search.highlight.SynonymAnalyzer",2,1.00,1.00,10,0.13,2930.19,3,1,38,6,22,140.61,6,14,1,2,120.00,0.00,0.50,0.50,0,2.00,1,398.35,0,0,21,org.apache.lucene.analysis.Analyzer,0.00,4,1,2,0,4,2,0,1,90,1
"org.apache.lucene.search.highlight.SynonymTokenizer",5,0.28,2.00,59,0.73,24716.78,15,10,38,27,20,102.90,1,74,1,3,102.90,0.00,0.67,0.32,3,7.00,6,2200.40,3,0,19,org.apache.lucene.analysis.TokenStream,0.92,22,2,10,0,22,5,0,1,431,1
"org.apache.lucene.search.highlight.SynonymTokenizer$TestHighlightRunner_27",7,0.21,2.57,52,0.70,19044.83,11,4,38,20,15,112.21,0,64,0,1,112.21,0.00,0.00,0.43,3,3.00,5,2085.21,0,3,15,java.lang.Object,0.00,13,0,18,0,13,4,0,0,409,2
"org.apache.lucene.search.highlight.TextFragment",7,0.03,1.00,23,0.17,2178.67,12,5,0,10,14,133.81,34,39,14,1,133.57,0.00,0.00,0.23,0,20.00,1,499.51,0,1,0,java.lang.Object,0.00,3,0,7,0,3,6,0,6,138,1
"org.apache.lucene.search.highlight.TokenGroup",10,0.13,1.40,55,0.50,19712.27,21,11,4,18,10,158.79,25,71,6,1,118.90,0.00,0.00,0.21,0,38.00,5,1514.47,0,1,4,java.lang.Object,0.00,8,0,14,0,8,9,0,7,329,1
"org.apache.lucene.search.highlight.TokenSourcesTest",4,0.00,1.00,106,1.95,54652.94,5,1,23,35,26,106.27,13,162,0,2,85.65,0.00,0.50,1.00,0,0.00,1,5844.69,0,0,26,org.apache.lucene.util.LuceneTestCase,0.00,31,1,4,0,31,4,0,13,939,1
"org.apache.lucene.search.highlight.TokenSourcesTest$OverlappingTokenStream",2,0.40,1.50,25,0.45,13329.56,7,5,23,12,5,100.54,0,33,0,3,100.54,0.00,0.67,0.40,0,2.00,2,1359.66,0,0,5,org.apache.lucene.analysis.TokenStream,0.60,10,2,3,0,10,2,0,0,262,3
"org.apache.lucene.search.highlight.TokenStreamFromTermPositionVector",3,0.30,3.00,57,0.77,40943.14,8,5,15,28,10,111.10,9,69,0,3,90.48,0.00,0.67,0.40,0,1.00,6,2310.05,0,0,10,org.apache.lucene.analysis.TokenStream,0.55,25,2,9,0,25,3,0,4,409,2
"org.apache.lucene.search.highlight.TokenStreamFromTermPositionVector$Comparator<Token>",1,0.00,1.00,3,0.03,607.54,1,0,15,2,1,131.28,0,4,0,1,131.28,0.00,0.00,0.00,0,1.00,1,103.41,0,0,1,java.lang.Object,0.00,1,0,1,0,1,1,0,0,29,0
"org.apache.lucene.search.highlight.WeightedSpanTerm",7,0.33,1.29,24,0.25,5044.95,9,2,3,11,9,151.26,24,34,7,2,130.64,0.00,0.50,0.21,0,18.00,3,744.79,0,1,2,org.apache.lucene.search.highlight.WeightedTerm,0.00,4,1,9,0,4,6,0,8,177,1
"org.apache.lucene.search.highlight.WeightedSpanTermExtractor",20,0.03,4.45,296,4.26,394009.80,28,8,27,100,32,76.21,100,349,4,1,94.09,0.00,0.00,0.09,10,154.00,28,12794.03,0,5,28,java.lang.Object,0.00,80,0,89,1,80,15,0,20,2158,1
"org.apache.lucene.search.highlight.WeightedSpanTermExtractor$SuppressWarnings",2,0.00,4.50,13,0.19,5634.62,2,0,27,2,1,114.46,0,19,0,2,114.46,0.00,0.50,0.00,0,2.00,6,562.10,1,1,1,java.util.HashMap,0.00,0,1,9,0,0,1,0,0,124,2
"org.apache.lucene.search.highlight.WeightedTerm",5,0.38,1.00,14,0.08,974.53,7,2,0,5,4,109.52,32,26,4,1,141.74,0.00,0.00,0.20,0,11.00,1,250.85,0,1,0,java.lang.Object,0.00,0,0,5,1,0,4,0,8,75,1
"org.apache.lucene.facet.index.attributes.CategoryAttribute",11,0.00,1.00,12,0.10,932.14,11,0,4,11,21,107.71,92,16,18,2,155.82,0.00,0.50,0.00,0,11.00,1,313.06,0,5,3,,0.00,0,1,11,0,0,6,0,13,101,1
"org.apache.lucene.facet.index.attributes.CategoryAttributeImpl",16,0.03,2.44,75,0.83,32799.33,18,2,5,32,11,162.14,43,119,7,2,122.26,0.00,0.50,0.53,2,0.00,6,2493.89,1,2,4,org.apache.lucene.util.AttributeImpl,0.19,16,1,39,0,16,14,1,8,563,2
"org.apache.lucene.facet.index.attributes.CategoryAttributeImplTest",3,0.00,2.33,56,0.83,49811.60,3,0,9,26,7,72.87,16,75,0,2,90.75,0.00,0.50,0.00,0,3.00,5,2480.97,0,0,7,org.apache.lucene.util.LuceneTestCase,0.00,23,1,7,0,23,3,0,1,456,1
"org.apache.lucene.facet.index.attributes.CategoryAttributesIterable",2,1.00,1.00,7,0.08,1216.99,3,1,3,3,5,87.15,23,10,3,1,131.28,0.00,0.00,0.00,0,2.00,1,226.02,0,1,2,java.lang.Object,0.00,1,0,2,0,1,1,1,2,58,1
"org.apache.lucene.facet.index.attributes.CategoryAttributesIterable$CategoryAttributesIterator",4,2.00,1.00,13,0.12,1700.17,6,2,3,7,3,132.50,0,19,0,1,132.50,0.00,0.00,0.00,3,4.00,1,361.95,0,1,3,java.lang.Object,0.00,3,0,4,0,3,3,1,0,97,2
"org.apache.lucene.facet.index.attributes.CategoryAttributesIterableTest",1,0.00,3.00,17,0.17,6012.83,1,0,9,7,4,104.22,17,17,0,3,95.09,0.00,0.67,0.00,0,0.00,3,512.34,0,0,4,org.apache.lucene.facet.index.CategoryContainerTestBase,0.00,6,2,3,0,6,1,0,2,100,1
"org.apache.lucene.facet.index.attributes.CategoryProperty",1,0.00,1.00,2,0.01,88.08,1,0,2,1,22,126.37,39,4,22,2,144.46,0.00,0.50,0.00,0,1.00,1,44.04,0,0,1,,0.00,0,1,1,0,0,1,0,3,15,1
"org.apache.lucene.facet.index.attributes.OrdinalProperty",7,1.00,1.29,21,0.17,3337.04,8,1,0,8,6,152.67,25,34,5,1,132.05,0.00,0.00,0.14,0,12.00,3,509.74,0,0,1,java.lang.Object,0.00,1,0,9,0,1,7,1,2,131,1
"org.apache.solr.BaseDistributedSearchTestCase",41,0.00,2.98,416,5.58,351101.74,67,26,32,132,26,152.48,57,468,11,3,102.48,5.00,0.15,0.04,18,677.00,16,16725.27,2,22,15,org.apache.solr.SolrTestCaseJ4,0.06,91,2,122,10,91,19,0,32,3143,2
"org.apache.solr.BaseDistributedSearchTestCase$RandDate",1,0.00,1.00,6,0.07,1176.00,2,1,32,4,1,117.79,0,9,0,2,117.79,0.00,0.50,1.00,0,0.00,1,196.89,0,1,1,org.apache.solr.RandVal,0.00,3,1,1,0,3,0,0,0,48,2
"org.apache.solr.BaseDistributedSearchTestCase$RandVal",1,0.00,1.00,3,0.02,222.80,1,0,32,1,0,134.71,0,5,0,1,134.71,0.00,0.00,0.00,0,0.00,1,58.19,0,1,0,java.lang.Object,0.00,0,0,1,0,0,0,0,0,18,0
"org.apache.solr.BaseDistributedSearchTestCase$RandVal_0",1,0.00,1.00,3,0.02,222.80,1,0,32,1,0,134.71,0,5,0,1,134.71,0.00,0.00,0.00,0,0.00,1,58.19,0,1,0,java.lang.Object,0.00,0,0,1,0,0,0,0,0,18,0
"org.apache.solr.BaseDistributedSearchTestCase$RandVal_1",1,0.00,1.00,3,0.02,222.80,1,0,32,1,0,134.71,0,5,0,1,134.71,0.00,0.00,0.00,0,0.00,1,58.19,0,1,0,java.lang.Object,0.00,0,0,1,0,0,0,0,0,18,0
"org.apache.solr.BaseDistributedSearchTestCase$RandVal_2",1,0.00,1.00,3,0.02,222.80,1,0,32,1,0,134.71,0,5,0,1,134.71,0.00,0.00,0.00,0,0.00,1,58.19,0,1,0,java.lang.Object,0.00,0,0,1,0,0,0,0,0,18,0
"org.apache.solr.BaseDistributedSearchTestCase$RandVal_3",2,0.50,2.00,11,0.07,1148.68,4,2,32,4,0,123.04,0,11,0,1,123.04,0.00,0.00,0.25,1,2.00,3,213.09,0,2,0,java.lang.Object,0.00,2,0,4,0,2,0,0,0,56,3
"org.apache.solr.BaseDistributedSearchTestCase$Thread",1,0.00,4.00,13,0.14,4176.98,1,0,32,5,3,100.62,0,16,0,1,100.62,0.00,0.00,0.00,0,0.00,4,420.53,0,0,3,java.lang.Object,0.00,4,0,4,0,4,1,0,0,81,0
"org.apache.solr.BasicFunctionalityTest",26,0.00,1.46,346,6.06,243783.50,26,0,36,123,25,118.70,81,572,0,3,98.08,0.00,0.67,0.00,0,142.00,5,18185.69,13,2,25,org.apache.solr.SolrTestCaseJ4,0.00,97,2,38,0,97,24,0,51,3156,1
"org.apache.solr.BasicFunctionalityTest$RequestHandlerBase",5,0.00,1.00,11,0.08,840.12,5,0,36,6,2,142.25,0,14,0,1,142.25,0.00,0.00,0.00,0,5.00,1,226.16,0,4,2,java.lang.Object,0.00,1,0,5,0,1,1,0,0,66,0
"org.apache.solr.CollectionTester",15,0.02,4.47,191,2.57,192607.03,23,8,3,54,2,98.05,8,228,1,1,98.05,0.00,0.00,0.14,10,71.00,24,7709.50,0,4,2,java.lang.Object,0.00,39,0,67,0,39,11,0,8,1390,0
"org.apache.solr.ConvertedLegacyTest",2,0.00,1.00,515,9.77,554933.83,2,0,5,6,4,52.02,69,1098,0,3,38.24,0.00,0.67,0.00,0,2.00,1,29317.11,7,0,4,org.apache.solr.SolrTestCaseJ4,0.00,4,2,2,0,4,2,0,64,3294,1
"org.apache.solr.DisMaxRequestHandlerTest",5,0.00,1.00,34,0.88,20323.02,5,0,4,14,2,163.55,6,159,0,3,113.55,0.00,0.67,0.00,1,7.00,1,2637.92,5,0,2,org.apache.solr.SolrTestCaseJ4,0.00,9,2,5,0,9,5,0,4,467,1
"org.apache.solr.EchoParamsTest",6,0.40,1.00,30,0.35,4505.02,7,1,3,9,2,122.28,2,45,0,3,122.28,0.00,0.67,0.67,4,0.00,1,1045.21,3,0,2,org.apache.solr.SolrTestCaseJ4,0.00,3,2,6,0,3,6,0,2,236,1
"org.apache.solr.JSONTestUtil",6,0.60,1.83,26,0.43,16198.60,7,1,3,14,5,103.51,35,35,4,1,121.38,0.00,0.00,0.50,2,6.00,4,1299.09,0,6,2,java.lang.Object,0.00,8,0,11,0,8,0,0,7,276,1
"org.apache.solr.MinimalSchemaTest",4,0.00,2.00,26,0.40,9798.15,4,0,4,14,2,97.25,21,69,0,3,115.13,0.00,0.67,0.00,0,4.00,5,1208.75,5,0,2,org.apache.solr.SolrTestCaseJ4,0.00,10,2,8,0,10,4,0,6,239,1
"org.apache.solr.OutputWriterTest",6,1.00,1.00,34,0.44,7509.32,7,1,13,14,9,160.42,16,46,0,3,120.54,0.00,0.67,0.17,0,0.00,1,1316.31,3,0,9,org.apache.solr.SolrTestCaseJ4,0.00,8,2,6,0,8,6,0,10,291,1
"org.apache.solr.OutputWriterTest$UselessOutputWriter",4,0.00,1.00,7,0.06,471.75,4,0,13,5,4,154.69,0,11,0,1,154.69,0.00,0.00,0.00,0,8.00,1,166.32,0,1,4,java.lang.Object,0.00,1,0,4,0,1,3,1,0,49,2
"org.apache.solr.SampleTest",3,0.00,1.00,22,0.36,6075.06,3,0,5,8,3,65.33,26,55,0,3,113.44,0.00,0.67,0.00,0,1.00,1,1079.11,7,0,3,org.apache.solr.SolrTestCaseJ4,0.00,5,2,3,0,5,3,0,9,201,1
"org.apache.solr.SolrInfoMBeanTest",3,0.00,4.33,50,0.88,58358.28,3,0,13,38,8,92.21,14,65,0,3,91.97,0.00,0.67,0.00,1,4.00,7,2648.29,1,1,8,org.apache.solr.SolrTestCaseJ4,0.00,35,2,13,0,35,2,0,9,453,1
"org.apache.solr.SolrJettyTestBase",5,0.19,2.00,39,0.40,11586.69,9,4,6,19,10,152.70,13,53,4,3,112.82,9.00,0.10,0.40,0,1.00,3,1193.92,2,4,6,org.apache.solr.SolrTestCaseJ4,0.00,14,2,10,18,14,1,0,8,249,2
"org.apache.solr.SolrLogFormatter",13,0.04,3.69,193,2.81,175171.12,21,8,12,76,9,95.66,61,223,2,2,95.43,0.00,0.50,0.09,6,52.00,17,8439.07,2,6,7,java.util.logging.Formatter,0.00,63,1,48,0,63,7,0,21,1494,1
"org.apache.solr.SolrLogFormatter$CoreInfo",0,0.00,0.00,5,0.03,260.19,4,4,12,0,1,171.00,2,6,0,1,171.00,0.00,0.00,0.00,0,0.00,0,92.51,0,0,1,java.lang.Object,0.00,0,0,0,0,0,0,0,2,25,2
"org.apache.solr.SolrLogFormatter$Method",4,0.33,1.25,14,0.15,3810.36,6,2,12,6,0,129.69,0,22,0,1,129.69,0.00,0.00,0.75,0,0.00,2,443.23,0,1,0,java.lang.Object,0.00,2,0,5,0,2,3,0,0,114,2
"org.apache.solr.SolrLogFormatter$MyThreadGroup",2,0.00,1.00,5,0.03,195.00,2,0,12,2,0,144.11,0,6,0,2,144.11,0.00,0.50,0.00,0,2.00,1,78.00,0,1,0,java.lang.ThreadGroup,0.00,0,1,2,0,0,1,1,0,26,1
"org.apache.solr.SolrLogFormatter$TG",1,0.00,1.00,2,0.01,40.63,1,0,12,1,0,147.10,0,3,0,1,147.10,0.00,0.00,0.00,0,1.00,1,23.22,0,1,0,,0.00,0,0,1,0,0,0,0,0,10,2
"org.apache.solr.SolrLogFormatter$Thread",1,0.00,2.00,5,0.04,485.39,1,0,12,3,0,123.62,0,9,0,1,123.62,0.00,0.00,0.00,0,1.00,2,105.37,0,0,0,java.lang.Object,0.00,2,0,2,0,2,1,0,0,29,0
"org.apache.solr.SolrLogFormatter$Thread_0",1,0.00,1.00,4,0.03,272.46,1,0,12,2,0,129.36,0,6,0,1,129.36,0.00,0.00,0.00,0,0.00,1,86.14,0,0,0,java.lang.Object,0.00,1,0,1,0,1,1,0,0,24,0
"org.apache.solr.SolrLogFormatter$Thread_1",1,0.00,1.00,4,0.03,272.46,1,0,12,2,0,129.36,0,6,0,1,129.36,0.00,0.00,0.00,0,0.00,1,86.14,0,0,0,java.lang.Object,0.00,1,0,1,0,1,1,0,0,24,0
"org.apache.solr.SolrTestCaseJ4",68,0.01,2.74,574,8.11,390403.95,86,18,48,209,160,147.37,191,745,137,2,107.48,208.00,0.00,0.04,34,1330.00,10,24339.09,2,35,23,org.apache.lucene.util.LuceneTestCase,0.00,141,1,186,208,141,33,0,79,4600,2
"org.apache.solr.SolrTestCaseJ4$Comparator<Doc>",1,0.00,1.00,3,0.04,766.48,1,0,48,1,0,130.49,0,5,0,1,130.49,0.00,0.00,0.00,0,1.00,1,117.75,0,0,0,java.lang.Object,0.00,0,0,1,0,0,1,0,0,31,0
"org.apache.solr.SolrTestCaseJ4$Comparator<Doc>_0",2,0.00,10.00,28,0.40,21753.61,2,0,48,4,0,95.93,1,36,0,1,95.93,0.00,0.00,0.00,0,2.00,10,1210.36,0,1,0,java.lang.Object,0.00,2,0,20,0,2,1,0,1,246,0
"org.apache.solr.SolrTestCaseJ4$Comparator<Doc>_1",1,0.00,3.00,8,0.09,4301.78,1,0,48,2,0,108.45,0,10,0,1,108.45,0.00,0.00,0.00,0,1.00,3,271.66,0,0,0,java.lang.Object,0.00,1,0,3,0,1,1,0,0,60,0
"org.apache.solr.SolrTestCaseJ4$Doc",7,0.17,2.00,34,0.49,16841.97,10,3,48,20,2,121.76,1,47,0,1,121.76,0.00,0.00,0.19,2,18.00,3,1463.44,0,4,2,java.lang.Object,0.00,13,0,14,0,13,3,1,1,317,2
"org.apache.solr.SolrTestCaseJ4$FVal",3,0.25,1.33,11,0.09,1836.28,5,2,48,4,0,131.19,0,16,0,2,131.19,0.00,0.50,0.33,1,4.00,2,276.27,0,1,0,org.apache.solr.Vals,0.00,1,1,4,0,1,2,0,0,75,2
"org.apache.solr.SolrTestCaseJ4$Fld",1,0.00,2.00,5,0.08,1553.12,3,2,48,5,0,119.64,0,8,0,1,119.64,0.00,0.00,1.00,0,0.00,2,231.61,0,1,0,java.lang.Object,0.00,4,0,2,0,4,0,0,0,55,2
"org.apache.solr.SolrTestCaseJ4$FldType",5,0.25,1.60,29,0.25,7093.17,8,3,48,9,0,120.00,0,32,0,1,120.00,0.00,0.00,0.13,1,14.00,3,749.16,0,3,0,java.lang.Object,0.00,4,0,8,0,4,2,0,0,177,1
"org.apache.solr.SolrTestCaseJ4$IRange",3,0.25,1.00,10,0.07,1037.76,5,2,48,4,0,133.21,0,16,0,2,133.21,0.00,0.50,0.33,1,4.00,1,220.19,0,1,0,org.apache.solr.IVals,0.00,1,1,3,0,1,2,0,0,63,2
"org.apache.solr.SolrTestCaseJ4$IVals",1,0.00,1.00,2,0.01,103.02,1,0,48,1,0,143.92,0,3,0,2,143.92,0.00,0.50,0.00,0,1.00,1,39.51,0,0,0,org.apache.solr.Vals,0.00,0,1,1,0,0,1,0,0,14,3
"org.apache.solr.SolrTestCaseJ4$SVal",3,0.12,1.33,20,0.17,4255.35,7,4,48,5,0,117.09,0,23,0,2,117.09,0.00,0.50,0.33,0,4.00,2,519.77,0,1,0,org.apache.solr.Vals,0.00,2,1,4,0,2,2,0,0,124,2
"org.apache.solr.SolrTestCaseJ4$Vals",3,0.00,1.33,6,0.07,1649.28,3,0,48,5,0,138.13,0,9,0,1,138.13,0.00,0.00,0.00,0,3.00,2,196.21,0,2,0,java.lang.Object,0.00,2,0,4,0,2,1,0,0,54,3
"org.apache.solr.SolrTestCaseJ4$XmlDoc",1,0.00,1.00,4,0.02,212.03,2,1,48,1,0,130.22,0,5,0,1,130.22,0.00,0.00,1.00,0,0.00,1,66.54,0,1,0,java.lang.Object,0.00,0,0,1,0,0,0,0,0,21,2
"org.apache.solr.TestDistributedGrouping",2,0.71,3.50,99,3.22,390905.02,9,7,3,8,4,17.89,16,131,0,4,66.00,0.00,0.75,0.50,1,2.00,5,9666.47,6,0,4,org.apache.solr.BaseDistributedSearchTestCase,0.04,6,3,7,0,6,2,0,10,1328,1
"org.apache.solr.TestDistributedSearch",4,0.06,8.00,219,4.92,554340.59,20,16,15,44,10,64.94,65,268,0,4,65.41,0.00,0.75,0.11,3,0.00,16,14749.50,10,1,10,org.apache.solr.BaseDistributedSearchTestCase,0.04,40,3,32,0,40,3,0,50,1959,1
"org.apache.solr.TestDistributedSearch$Thread",1,0.00,4.00,13,0.14,4218.01,1,0,15,8,3,100.58,0,16,0,1,100.58,0.00,0.00,0.00,0,1.00,4,428.60,0,0,3,java.lang.Object,0.00,7,0,4,0,7,1,0,0,82,0
"org.apache.solr.TestGroupingSearch",18,0.13,3.33,335,8.56,856469.79,23,5,10,73,6,87.30,76,606,0,3,87.06,0.00,0.67,0.08,3,62.00,32,25673.87,17,4,6,org.apache.solr.SolrTestCaseJ4,0.00,55,2,60,0,55,14,0,68,3956,1
"org.apache.solr.TestGroupingSearch$Comparator<Grp>",1,0.00,1.00,5,0.05,1099.53,1,0,10,2,0,170.98,1,7,0,1,120.98,0.00,0.00,0.00,0,1.00,1,164.08,0,0,0,java.lang.Object,0.00,1,0,1,0,1,1,0,1,41,0
"org.apache.solr.TestGroupingSearch$Comparator<Grp>_0",1,0.00,1.00,5,0.07,1411.42,1,0,10,4,0,170.12,1,7,0,1,120.12,0.00,0.00,0.00,0,1.00,1,204.13,0,0,0,java.lang.Object,0.00,3,0,1,0,3,1,0,1,49,0
"org.apache.solr.TestGroupingSearch$Grp",2,0.67,1.50,10,0.13,2698.57,5,3,10,5,0,120.18,1,14,0,1,120.18,0.00,0.00,0.67,0,0.00,2,385.28,0,1,0,java.lang.Object,0.00,3,0,3,0,3,1,0,1,89,2
"org.apache.solr.TestJoin",5,0.00,4.60,117,2.88,259318.74,5,0,17,41,13,82.96,21,172,0,3,82.73,0.00,0.67,0.00,1,8.00,11,8649.90,10,2,13,org.apache.solr.SolrTestCaseJ4,0.00,36,2,23,0,36,3,0,21,1307,1
"org.apache.solr.TestPluginEnable",2,0.00,1.00,6,0.07,911.55,2,0,3,6,2,152.88,6,11,0,3,132.27,0.00,0.67,0.00,0,2.00,1,209.87,1,0,2,org.apache.solr.SolrTestCaseJ4,0.00,4,2,2,0,4,2,0,1,54,1
"org.apache.solr.TestSolrCoreProperties",10,0.06,1.10,62,0.72,15196.43,16,6,11,41,7,166.90,10,74,0,2,116.90,0.00,0.50,0.22,5,50.00,2,2160.27,2,5,7,org.apache.lucene.util.LuceneTestCase,0.00,31,1,11,0,31,5,0,2,445,1
"org.apache.solr.TestTrie",13,0.00,2.31,173,3.38,188229.26,13,0,11,25,6,136.38,26,197,0,3,96.49,0.00,0.67,0.00,3,24.00,6,10136.66,8,0,6,org.apache.solr.SolrTestCaseJ4,0.04,12,2,30,0,12,13,0,21,1717,1
"org.apache.lucene.benchmark.utils.ExtractReuters",5,0.04,3.40,72,0.98,52435.45,11,6,8,36,1,116.92,18,86,1,1,96.30,0.00,0.00,0.20,2,11.00,8,2952.11,0,0,0,java.lang.Object,0.00,31,0,17,0,31,5,0,12,536,1
"org.apache.lucene.benchmark.utils.ExtractReuters$FileFilter",1,0.00,1.00,3,0.02,227.68,1,0,8,3,0,134.64,0,4,0,1,134.64,0.00,0.00,0.00,0,1.00,1,70.91,0,0,0,java.lang.Object,0.00,2,0,1,0,2,1,0,0,21,0
"org.apache.lucene.benchmark.utils.ExtractWikipedia",6,0.15,3.00,86,1.17,55182.14,10,4,8,34,5,96.78,4,101,1,1,96.78,0.00,0.00,0.12,3,14.00,6,3522.10,0,1,4,java.lang.Object,0.00,28,0,18,0,28,5,0,2,654,1
"org.apache.lucene.spatial.vector.BaseTwoDoublesStrategyTestCase",3,0.00,1.00,10,0.12,1846.42,3,0,7,8,7,131.24,0,16,1,4,131.24,0.33,0.60,0.00,0,5.00,1,369.59,3,1,6,org.apache.lucene.spatial.StrategyTestCase,0.24,5,3,3,1,5,2,0,0,87,2
"org.apache.lucene.spatial.vector.DistanceValueSource",5,0.19,3.20,32,0.54,25465.31,9,4,12,18,9,133.13,19,42,2,2,112.51,0.00,0.50,0.40,0,0.00,9,1627.59,0,2,7,org.apache.lucene.queries.function.ValueSource,0.31,13,1,16,0,13,3,0,5,347,1
"org.apache.lucene.spatial.vector.DistanceValueSource$FunctionValues",3,0.00,1.33,10,0.13,2704.88,3,0,12,7,0,129.87,1,17,0,1,129.87,0.00,0.00,0.00,1,4.00,2,377.84,0,1,0,java.lang.Object,0.00,4,0,4,0,4,2,0,1,89,0
"org.apache.lucene.spatial.vector.TwoDoublesFieldInfo",4,0.27,1.00,16,0.11,1649.52,9,5,1,4,4,127.95,0,21,3,1,127.95,0.00,0.00,0.40,0,0.00,1,334.17,0,3,1,java.lang.Object,0.00,0,0,4,0,0,1,1,0,88,1
"org.apache.lucene.spatial.vector.TwoDoublesStrategy",9,0.31,2.78,83,1.45,61657.22,11,2,20,46,19,154.96,13,148,1,3,104.96,0.00,0.67,0.22,3,21.00,9,4348.10,0,7,18,org.apache.lucene.spatial.SpatialStrategy,0.16,37,2,25,0,37,2,0,7,803,1
"org.apache.lucene.spatial.vector.TwoDoublesStrategyTestCase",1,0.00,1.00,3,0.02,226.76,1,0,2,1,1,134.65,0,6,0,5,134.65,0.00,0.80,0.00,0,1.00,1,62.11,0,1,1,org.apache.lucene.spatial.vector.BaseTwoDoublesStrategyTestCase,0.28,0,4,1,0,0,0,0,0,19,1
"org.apache.lucene.sandbox.queries.Deprecated",2,0.60,3.00,22,0.32,13620.14,7,5,5,5,3,119.85,37,35,0,3,101.72,0.00,0.67,0.50,0,2.00,4,962.55,1,0,3,org.apache.lucene.index.FilteredTermsEnum,0.00,3,2,6,0,3,2,0,5,199,1
"org.apache.lucene.sandbox.queries.DuplicateFilter",13,0.03,2.46,97,1.08,45874.01,16,3,8,29,14,161.33,20,135,3,2,111.33,0.00,0.50,0.36,2,25.00,10,3254.52,0,6,11,org.apache.lucene.search.Filter,0.00,16,1,32,0,16,7,0,8,652,1
"org.apache.lucene.sandbox.queries.DuplicateFilter$KeepMode",0,0.00,0.00,2,0.01,23.26,0,0,8,0,0,171.00,0,3,0,1,171.00,0.00,0.00,0.00,0,0.00,0,15.51,0,0,0,java.lang.Object,0.00,0,0,0,0,0,0,0,0,6,1
"org.apache.lucene.sandbox.queries.DuplicateFilter$ProcessingMode",0,0.00,0.00,2,0.01,23.26,0,0,8,0,0,171.00,0,3,0,1,171.00,0.00,0.00,0.00,0,0.00,0,15.51,0,0,0,java.lang.Object,0.00,0,0,0,0,0,0,0,0,6,1
"org.apache.lucene.sandbox.queries.DuplicateFilterTest",8,0.43,1.88,95,1.45,41383.26,13,5,15,41,17,102.76,3,118,0,2,102.76,0.00,0.50,0.58,1,0.00,3,4360.13,2,0,17,org.apache.lucene.util.LuceneTestCase,0.00,33,1,15,0,33,8,0,3,797,1
"org.apache.lucene.sandbox.queries.FuzzyLikeThisQuery",9,0.16,4.56,138,2.21,172129.47,17,8,18,63,21,60.84,60,186,3,2,93.06,0.00,0.50,0.26,1,2.00,12,6625.90,1,2,18,org.apache.lucene.search.Query,0.11,54,1,41,0,54,7,0,34,1127,1
"org.apache.lucene.sandbox.queries.FuzzyLikeThisQuery$FieldVals",3,1.00,5.33,32,0.42,20772.02,7,4,18,7,0,103.07,0,52,0,1,103.07,0.00,0.00,0.92,0,0.00,12,1256.70,0,0,0,java.lang.Object,0.00,4,0,16,0,4,3,0,0,266,0
"org.apache.lucene.sandbox.queries.FuzzyLikeThisQuery$ScoreTerm",1,3.00,1.00,8,0.06,948.88,4,3,18,1,1,113.87,0,10,0,1,113.87,0.00,0.00,0.00,0,1.00,1,171.73,0,0,1,java.lang.Object,0.00,0,0,1,0,0,1,0,0,47,2
"org.apache.lucene.sandbox.queries.FuzzyLikeThisQuery$ScoreTermQueue",2,0.00,1.50,5,0.09,2781.31,2,0,18,3,1,184.93,3,13,0,2,134.93,0.00,0.50,0.00,0,2.00,2,259.43,0,0,1,org.apache.lucene.util.PriorityQueue,0.00,1,1,3,0,1,2,0,1,64,2
"org.apache.lucene.sandbox.queries.FuzzyLikeThisQueryTest",7,0.17,1.00,73,1.21,33886.08,11,4,15,32,13,104.68,4,84,0,2,104.68,0.00,0.50,0.39,1,4.00,1,3642.63,2,0,13,org.apache.lucene.util.LuceneTestCase,0.00,25,1,7,0,25,7,0,4,670,1
"org.apache.lucene.sandbox.queries.TestSlowCollationMethods",7,0.39,1.86,86,1.20,45437.69,13,6,15,38,16,121.20,21,90,0,2,100.58,0.00,0.50,0.50,2,0.00,3,3603.10,0,0,16,org.apache.lucene.util.LuceneTestCase,0.00,31,1,13,0,31,7,0,4,680,1
"org.apache.lucene.sandbox.queries.TestSlowCollationMethods$FieldComparatorSource",1,0.00,1.00,3,0.05,920.19,1,0,15,2,1,129.86,0,5,0,1,129.86,0.00,0.00,0.00,0,0.00,1,139.18,0,1,1,java.lang.Object,0.00,1,0,1,0,1,0,0,0,33,0
"org.apache.lucene.facet.taxonomy.CategoryPath",42,0.28,4.05,544,5.92,521919.36,45,3,4,59,83,48.18,403,595,83,1,98.18,0.00,0.00,0.61,7,0.00,9,17766.79,0,7,0,java.lang.Object,0.00,17,0,170,0,17,35,3,94,3560,1
"org.apache.lucene.facet.taxonomy.InconsistentTaxonomyException",2,0.00,1.00,5,0.02,142.21,2,0,0,2,6,115.81,26,8,6,2,145.19,0.00,0.50,0.00,0,2.00,1,63.60,0,0,0,java.lang.Exception,0.00,0,1,2,0,0,2,0,2,23,1
"org.apache.lucene.facet.taxonomy.TaxonomyReader",12,2.00,1.00,16,0.13,1232.50,14,2,3,12,66,173.29,226,17,64,2,155.16,0.00,0.50,0.00,0,12.00,1,395.37,0,2,2,,0.00,0,1,12,0,0,10,0,17,122,1
"org.apache.lucene.facet.taxonomy.TaxonomyReader$ChildrenArrays",2,0.00,1.00,3,0.01,85.26,2,0,3,2,0,115.88,14,4,0,1,158.17,0.00,0.00,0.00,0,2.00,1,42.63,0,0,0,,0.00,0,0,2,0,0,2,0,2,17,2
"org.apache.lucene.facet.taxonomy.TaxonomyWriter",3,0.00,1.00,4,0.03,181.28,3,0,3,3,35,194.01,90,5,33,3,156.97,0.00,0.67,0.00,0,3.00,1,86.79,0,0,2,,0.00,0,2,3,0,0,3,0,5,30,1
"org.apache.lucene.facet.taxonomy.TestCategoryPath",31,0.00,1.65,636,8.91,660565.20,31,0,8,80,1,88.50,127,701,0,2,88.27,0.00,0.50,0.00,0,31.00,7,26741.98,0,0,1,org.apache.lucene.util.LuceneTestCase,0.00,49,1,51,0,49,31,0,112,5175,1
"org.apache.lucene.facet.taxonomy.TestCategoryPath$CS",4,1.00,1.00,11,0.10,1569.64,5,1,8,6,0,139.35,1,16,0,1,139.35,0.00,0.00,0.00,0,4.00,1,308.95,0,1,0,java.lang.Object,0.00,2,0,4,0,2,3,1,1,83,2
"org.apache.lucene.facet.taxonomy.TestTaxonomyCombined",29,0.19,3.21,579,8.14,518580.02,32,3,15,83,9,41.07,307,692,0,2,89.54,0.00,0.50,0.15,5,203.00,14,24406.88,0,3,9,org.apache.lucene.util.LuceneTestCase,0.00,54,1,93,0,54,26,0,166,4396,1
"org.apache.lucene.facet.taxonomy.TestTaxonomyCombined$Thread",2,0.00,2.00,13,0.25,7350.13,2,0,15,9,0,113.74,0,23,0,1,113.74,0.00,0.00,0.00,1,2.00,3,746.72,0,0,0,java.lang.Object,0.00,7,0,4,0,7,2,0,0,147,0
"org.apache.lucene.facet.index.categorypolicy.DefaultOrdinalPolicy",2,0.00,1.00,4,0.03,272.04,2,0,2,2,6,122.83,29,6,3,1,142.97,0.00,0.00,0.00,0,2.00,1,86.97,0,0,3,java.lang.Object,0.00,0,0,2,0,0,2,1,4,27,1
"org.apache.lucene.facet.index.categorypolicy.DefaultPathPolicy",1,0.00,1.00,3,0.02,257.67,1,0,2,2,6,183.70,26,5,3,1,134.22,0.00,0.00,0.00,0,1.00,1,71.02,0,0,3,java.lang.Object,0.00,1,0,1,0,1,1,1,3,21,1
"org.apache.lucene.facet.index.categorypolicy.NonTopLevelOrdinalPolicy",3,1.00,2.00,13,0.11,1807.43,4,1,2,4,6,97.11,39,21,3,1,126.49,0.00,0.00,0.00,0,3.00,4,318.29,0,0,3,java.lang.Object,0.00,1,0,6,0,1,3,1,6,79,1
"org.apache.lucene.facet.index.categorypolicy.NonTopLevelPathPolicy",1,0.00,1.00,4,0.04,402.32,2,1,2,2,6,169.51,29,6,3,1,128.03,0.00,0.00,1.00,0,0.00,1,105.70,0,0,3,java.lang.Object,0.00,1,0,1,0,1,1,1,4,29,1
"org.apache.lucene.facet.index.categorypolicy.OrdinalPolicy",2,0.00,1.00,3,0.02,127.02,2,0,3,2,10,196.10,42,4,8,2,156.80,0.00,0.50,0.00,0,2.00,1,63.51,0,0,2,,0.00,0,1,2,0,0,2,0,4,22,1
"org.apache.lucene.facet.index.categorypolicy.OrdinalPolicyTest",2,0.00,4.00,52,0.70,40346.49,2,0,10,17,8,34.00,19,54,0,2,84.00,0.00,0.50,0.00,0,2.00,6,2114.72,0,0,8,org.apache.lucene.util.LuceneTestCase,0.00,15,1,8,0,15,2,0,4,365,1
"org.apache.lucene.facet.index.categorypolicy.PathPolicy",1,0.00,1.00,2,0.01,79.02,1,0,3,1,10,158.61,34,3,8,2,144.83,0.00,0.50,0.00,0,1.00,1,39.51,0,0,2,,0.00,0,1,1,0,0,1,0,3,14,1
"org.apache.lucene.facet.index.categorypolicy.PathPolicyTest",2,0.00,4.50,60,0.79,46067.74,2,0,9,17,7,31.20,18,59,0,2,81.20,0.00,0.50,0.00,0,2.00,6,2358.54,0,0,7,org.apache.lucene.util.LuceneTestCase,0.00,15,1,9,0,15,2,0,3,413,1
"org.apache.lucene.analysis.wikipedia.WikipediaTokenizer",13,0.04,1.92,157,2.55,107178.48,56,43,10,45,13,67.53,82,199,6,4,99.75,0.00,0.75,0.06,5,20.00,7,7643.02,2,0,8,org.apache.lucene.analysis.Tokenizer,0.44,32,3,25,0,32,13,0,32,1295,2
"org.apache.lucene.analysis.wikipedia.WikipediaTokenizerImpl",28,0.04,4.61,515,7.50,473193.60,93,65,1,38,2,48.24,222,714,1,1,90.53,0.00,0.00,0.06,3,354.00,88,22494.74,0,1,2,java.lang.Object,0.00,10,0,129,0,10,27,0,108,3253,0
"org.apache.lucene.analysis.wikipedia.WikipediaTokenizerTest",9,0.88,1.11,67,1.81,61252.82,10,1,10,24,5,159.27,9,134,0,3,109.27,0.00,0.67,0.22,1,19.00,2,5434.63,2,0,5,org.apache.lucene.analysis.BaseTokenStreamTestCase,0.00,15,2,10,0,15,9,0,7,903,1
"org.apache.lucene.analysis.wikipedia.WikipediaTokenizerTest$Analyzer",1,0.00,1.00,4,0.04,687.53,1,0,10,3,2,126.20,0,6,0,1,126.20,0.00,0.00,0.00,0,1.00,1,120.59,0,1,2,java.lang.Object,0.00,2,0,1,0,2,0,0,0,31,0
"org.apache.lucene.analysis.wikipedia.WikipediaTokenizerTest$Analyzer_0",1,0.00,1.00,4,0.04,687.53,1,0,10,3,2,126.20,0,6,0,1,126.20,0.00,0.00,0.00,0,1.00,1,120.59,0,1,2,java.lang.Object,0.00,2,0,1,0,2,0,0,0,31,0
"org.apache.lucene.analysis.ja.GraphvizFormatter",8,0.02,2.00,104,1.43,107923.52,14,6,6,24,4,146.76,14,112,2,1,96.77,0.00,0.00,0.19,5,28.00,7,4278.88,0,5,3,java.lang.Object,0.00,16,0,16,0,16,3,0,12,778,1
"org.apache.lucene.analysis.ja.JapaneseAnalyzer",5,0.17,1.00,25,0.29,5252.13,8,3,14,13,13,171.13,8,31,1,3,121.13,0.00,0.67,0.20,0,8.00,1,876.17,0,3,12,org.apache.lucene.analysis.util.StopwordAnalyzerBase,0.00,8,2,5,0,8,2,0,2,195,1
"org.apache.lucene.analysis.ja.JapaneseAnalyzer$DefaultSetHolder",0,0.00,0.00,13,0.15,4925.83,2,2,14,1,2,171.00,2,18,0,1,171.00,0.00,0.00,0.00,0,0.00,0,461.98,0,0,2,java.lang.Object,0.00,1,0,0,0,1,0,0,2,93,2
"org.apache.lucene.analysis.ja.JapaneseBaseFormFilter",2,0.33,2.50,15,0.16,3702.06,5,3,7,7,10,95.66,10,22,4,4,113.54,0.00,0.75,0.50,0,2.00,4,487.45,0,0,6,org.apache.lucene.analysis.TokenFilter,0.29,5,3,5,0,5,2,0,1,109,2
"org.apache.lucene.analysis.ja.JapaneseKatakanaStemFilter",5,0.00,2.40,34,0.34,8589.85,10,5,5,11,8,136.91,17,45,4,4,116.30,0.00,0.75,0.20,1,14.00,4,1017.41,0,0,4,org.apache.lucene.analysis.TokenFilter,0.24,6,3,12,0,6,5,0,2,228,2
"org.apache.lucene.analysis.ja.JapanesePartOfSpeechStopFilter",2,0.00,1.00,9,0.12,2553.12,4,2,5,4,5,174.08,3,13,2,5,124.08,0.00,0.80,0.50,0,2.00,1,363.23,0,0,3,org.apache.lucene.analysis.util.FilteringTokenFilter,0.25,2,4,2,0,2,2,0,1,83,2
"org.apache.lucene.analysis.ja.JapaneseReadingFormFilter",3,0.00,2.00,20,0.19,4005.66,6,3,6,8,9,167.20,5,28,4,4,117.20,0.00,0.75,0.33,0,4.00,4,568.44,0,0,5,org.apache.lucene.analysis.TokenFilter,0.27,5,3,6,0,5,3,0,1,129,2
"org.apache.lucene.analysis.ja.JapaneseTokenizer",15,0.13,8.13,515,8.82,1291739.56,56,41,25,88,35,54.39,220,644,13,4,74.53,0.00,0.75,0.14,8,26.00,44,26459.27,2,1,23,org.apache.lucene.analysis.Tokenizer,0.41,73,3,122,0,73,14,0,173,4029,2
"org.apache.lucene.analysis.ja.JapaneseTokenizer$Mode",0,0.00,0.00,2,0.01,48.00,0,0,25,0,0,171.00,3,5,0,1,171.00,0.00,0.00,0.00,0,0.00,0,24.00,0,0,0,java.lang.Object,0.00,0,0,0,0,0,0,0,1,8,2
"org.apache.lucene.analysis.ja.JapaneseTokenizer$Position",5,0.25,1.40,51,0.67,24628.49,18,13,25,7,1,125.16,18,59,0,1,104.54,0.00,0.00,0.28,2,0.00,2,2005.45,0,0,1,java.lang.Object,0.00,2,0,7,0,2,5,0,18,434,2
"org.apache.lucene.analysis.ja.JapaneseTokenizer$Type",0,0.00,0.00,2,0.01,15.51,0,0,25,0,0,171.00,0,5,0,1,171.00,0.00,0.00,0.00,0,0.00,0,15.51,0,0,0,java.lang.Object,0.00,0,0,0,0,0,0,0,0,6,0
"org.apache.lucene.analysis.ja.JapaneseTokenizer$WrappedPositionArray",7,0.50,2.57,68,0.68,50080.66,11,4,25,11,2,154.83,12,78,0,1,104.83,0.00,0.00,0.68,2,0.00,5,2031.19,0,1,2,java.lang.Object,0.00,4,0,18,0,4,6,0,10,420,2
"org.apache.lucene.analysis.ja.TestExtendedMode",4,0.00,1.50,21,0.24,4961.36,4,0,11,13,7,170.47,4,27,0,3,120.47,0.00,0.67,0.00,0,4.00,3,721.60,2,0,7,org.apache.lucene.analysis.BaseTokenStreamTestCase,0.00,9,2,6,0,9,4,0,4,152,1
"org.apache.lucene.analysis.ja.TestExtendedMode$Analyzer",1,0.00,1.00,4,0.05,896.03,1,0,11,3,2,125.29,0,6,0,1,125.29,0.00,0.00,0.00,0,1.00,1,152.75,0,1,2,java.lang.Object,0.00,2,0,1,0,2,0,0,0,36,0
"org.apache.lucene.analysis.ja.TestJapaneseAnalyzer",9,0.00,1.00,52,0.93,25652.74,9,0,5,17,4,117.96,39,110,0,3,117.72,0.00,0.67,0.00,0,9.00,1,2777.37,5,0,4,org.apache.lucene.analysis.BaseTokenStreamTestCase,0.00,8,2,9,0,8,9,0,28,541,1
"org.apache.lucene.analysis.ja.TestJapaneseBaseFormFilter",4,0.00,1.00,12,0.12,1341.04,4,0,6,6,4,133.32,0,21,0,3,133.32,0.00,0.67,0.00,0,4.00,1,356.65,3,0,4,org.apache.lucene.analysis.BaseTokenStreamTestCase,0.00,2,2,4,0,2,4,0,0,90,1
"org.apache.lucene.analysis.ja.TestJapaneseBaseFormFilter$Analyzer",1,0.00,1.00,4,0.06,1029.80,1,0,6,4,3,124.82,0,6,0,1,124.82,0.00,0.00,0.00,0,1.00,1,166.32,0,1,3,java.lang.Object,0.00,3,0,1,0,3,0,0,0,39,0
"org.apache.lucene.analysis.ja.TestJapaneseBaseFormFilter$Analyzer_0",1,0.00,1.00,4,0.05,753.46,1,0,6,4,3,125.89,0,6,0,1,125.89,0.00,0.00,0.00,0,1.00,1,135.44,0,1,3,java.lang.Object,0.00,3,0,1,0,3,0,0,0,34,0
"org.apache.lucene.analysis.ja.TestJapaneseKatakanaStemFilter",4,0.00,1.00,14,0.15,1799.71,4,0,7,6,5,132.55,19,21,0,3,132.31,0.00,0.67,0.00,0,4.00,1,453.95,3,0,5,org.apache.lucene.analysis.BaseTokenStreamTestCase,0.00,2,2,4,0,2,4,0,3,107,1
"org.apache.lucene.analysis.ja.TestJapaneseKatakanaStemFilter$Analyzer",1,0.00,1.00,4,0.05,1009.20,1,0,7,4,3,174.89,1,6,0,1,124.89,0.00,0.00,0.00,0,1.00,1,159.62,0,1,3,java.lang.Object,0.00,3,0,1,0,3,0,0,1,38,0
"org.apache.lucene.analysis.ja.TestJapaneseKatakanaStemFilter$Analyzer_0",1,0.00,1.00,4,0.05,753.46,1,0,7,4,3,125.89,0,6,0,1,125.89,0.00,0.00,0.00,0,1.00,1,135.44,0,1,3,java.lang.Object,0.00,3,0,1,0,3,0,0,0,34,0
"org.apache.lucene.analysis.ja.TestJapaneseReadingFormFilter",4,0.00,1.00,15,0.15,2051.93,4,0,6,6,4,131.86,3,26,0,3,131.86,0.00,0.67,0.00,0,4.00,1,453.80,3,0,4,org.apache.lucene.analysis.BaseTokenStreamTestCase,0.00,2,2,4,0,2,4,0,1,112,1
"org.apache.lucene.analysis.ja.TestJapaneseReadingFormFilter$Analyzer",1,0.00,1.00,4,0.06,1103.89,1,0,6,4,3,124.58,0,6,0,1,124.58,0.00,0.00,0.00,0,1.00,1,184.47,0,1,3,java.lang.Object,0.00,3,0,1,0,3,0,0,0,42,0
"org.apache.lucene.analysis.ja.TestJapaneseReadingFormFilter$Analyzer_0",1,0.00,1.00,4,0.06,1161.91,1,0,6,4,3,124.40,0,6,0,1,124.40,0.00,0.00,0.00,0,1.00,1,182.23,0,1,3,java.lang.Object,0.00,3,0,1,0,3,0,0,0,42,0
"org.apache.lucene.analysis.ja.TestJapaneseReadingFormFilter$Analyzer_1",1,0.00,1.00,4,0.05,753.46,1,0,6,4,3,125.89,0,6,0,1,125.89,0.00,0.00,0.00,0,1.00,1,135.44,0,1,3,java.lang.Object,0.00,3,0,1,0,3,0,0,0,34,0
"org.apache.lucene.analysis.ja.TestJapaneseTokenizer",40,0.00,1.55,237,3.45,90446.89,40,0,18,80,18,158.30,116,397,3,3,118.41,0.00,0.67,0.00,7,40.00,9,10350.32,3,1,15,org.apache.lucene.analysis.BaseTokenStreamTestCase,0.00,40,2,62,0,40,39,0,31,2037,1
"org.apache.lucene.analysis.ja.TestJapaneseTokenizer$Analyzer",1,0.00,1.00,4,0.05,923.66,1,0,18,3,2,125.19,0,6,0,1,125.19,0.00,0.00,0.00,0,1.00,1,157.28,0,1,2,java.lang.Object,0.00,2,0,1,0,2,0,0,0,37,0
"org.apache.lucene.analysis.ja.TestJapaneseTokenizer$Analyzer_0",1,0.00,1.00,4,0.05,923.66,1,0,18,3,2,125.19,0,6,0,1,125.19,0.00,0.00,0.00,0,1.00,1,157.28,0,1,2,java.lang.Object,0.00,2,0,1,0,2,0,0,0,37,0
"org.apache.lucene.analysis.ja.TestJapaneseTokenizer$Analyzer_1",1,0.00,1.00,4,0.05,923.66,1,0,18,3,2,125.19,0,6,0,1,125.19,0.00,0.00,0.00,0,1.00,1,157.28,0,1,2,java.lang.Object,0.00,2,0,1,0,2,0,0,0,37,0
"org.apache.lucene.analysis.ja.TestJapaneseTokenizer$Analyzer_2",1,0.00,1.00,4,0.05,923.66,1,0,18,3,2,125.19,0,6,0,1,125.19,0.00,0.00,0.00,0,1.00,1,157.28,0,1,2,java.lang.Object,0.00,2,0,1,0,2,0,0,0,37,0
"org.apache.lucene.analysis.ja.TestJapaneseTokenizer$Analyzer_3",1,0.00,1.00,5,0.06,1192.17,1,0,18,4,1,120.70,0,7,0,1,120.70,0.00,0.00,0.00,0,1.00,1,186.81,0,1,1,java.lang.Object,0.00,3,0,1,0,3,0,0,0,43,0
"org.apache.lucene.analysis.ja.TestSearchMode",1,0.00,7.00,34,0.53,37399.11,2,1,11,15,5,98.03,3,42,1,3,77.41,0.00,0.67,1.00,0,0.00,7,1595.42,1,0,4,org.apache.lucene.analysis.BaseTokenStreamTestCase,0.00,14,2,7,0,14,1,0,3,264,1
"org.apache.lucene.analysis.ja.TestSearchMode$Analyzer",1,0.00,1.00,4,0.05,896.03,1,0,11,3,2,125.29,0,6,0,1,125.29,0.00,0.00,0.00,0,1.00,1,152.75,0,1,2,java.lang.Object,0.00,2,0,1,0,2,0,0,0,36,0
"org.apache.lucene.analysis.ja.Token",18,0.16,1.00,52,0.45,7040.75,26,8,2,26,10,159.97,58,72,9,1,139.36,0.00,0.00,0.28,0,98.00,1,1336.69,0,8,1,java.lang.Object,0.00,8,0,18,0,8,10,0,17,343,1
"org.apache.lucene.facet.taxonomy.writercache.cl.CharBlockArray",16,0.13,1.69,100,1.04,48461.07,22,6,8,37,4,164.44,23,126,4,1,114.44,0.00,0.00,0.04,3,60.00,4,3122.67,0,8,0,java.lang.Object,0.00,21,0,27,0,21,8,3,3,682,0
"org.apache.lucene.facet.taxonomy.writercache.cl.CharBlockArray$Block",1,3.00,1.00,7,0.06,838.86,4,3,8,1,0,116.45,0,9,0,1,116.45,0.00,0.00,0.00,0,1.00,1,188.58,0,0,0,java.lang.Object,0.00,0,0,1,0,0,1,2,0,46,2
"org.apache.lucene.facet.taxonomy.writercache.cl.Cl2oTaxonomyWriterCache",8,0.43,1.25,23,0.22,4397.08,9,1,2,12,4,138.38,33,33,1,1,138.14,0.00,0.00,0.62,1,0.00,2,662.25,0,0,3,java.lang.Object,0.00,4,0,10,0,4,8,1,8,170,1
"org.apache.lucene.facet.taxonomy.writercache.cl.CollisionMap",15,0.13,2.13,112,1.34,60148.80,21,6,4,21,4,150.81,38,134,1,1,110.93,0.00,0.00,0.04,3,50.00,5,4009.41,0,1,4,java.lang.Object,0.00,6,0,32,0,6,14,0,9,830,1
"org.apache.lucene.facet.taxonomy.writercache.cl.CollisionMap$Entry",1,4.00,1.00,10,0.07,986.62,5,4,4,1,0,110.12,0,12,0,1,110.12,0.00,0.00,0.00,0,1.00,1,203.02,0,0,0,java.lang.Object,0.00,0,0,1,0,0,1,0,0,56,1
"org.apache.lucene.facet.taxonomy.writercache.cl.CollisionMap$EntryIterator",4,0.33,2.00,28,0.28,12629.14,7,3,4,6,0,161.76,4,36,0,1,111.76,0.00,0.00,0.08,0,6.00,3,841.35,0,1,0,java.lang.Object,0.00,2,0,8,0,2,3,1,4,185,1
"org.apache.lucene.facet.taxonomy.writercache.cl.CompactLabelToOrdinal",23,0.08,3.13,272,3.76,252706.31,32,9,10,60,7,82.20,128,330,4,2,100.07,0.00,0.50,0.03,10,96.00,9,11281.06,0,1,4,org.apache.lucene.facet.taxonomy.writercache.cl2o.LabelToOrdinal,0.00,37,1,72,0,37,22,0,76,2130,1
"org.apache.lucene.facet.taxonomy.writercache.cl.CompactLabelToOrdinal$HashArray",1,3.00,1.00,8,0.07,1374.03,4,3,10,1,0,112.60,0,10,0,1,112.60,0.00,0.00,0.00,0,1.00,1,200.93,0,0,0,java.lang.Object,0.00,0,0,1,0,0,1,0,0,54,3
"org.apache.lucene.facet.taxonomy.writercache.cl.LabelToOrdinal",6,2.00,1.00,11,0.09,987.08,8,2,1,6,5,111.26,46,14,4,1,153.55,0.00,0.00,0.00,0,6.00,1,279.84,0,0,1,java.lang.Object,0.00,0,0,6,2,0,6,0,8,81,2
"org.apache.lucene.facet.taxonomy.writercache.cl.TestCharBlockArray",2,0.00,3.50,55,0.68,48984.80,2,0,8,26,1,34.65,16,48,0,2,82.76,0.00,0.50,0.00,1,2.00,5,2040.97,0,0,1,org.apache.lucene.util.LuceneTestCase,0.00,24,1,7,0,24,2,0,1,360,1
"org.apache.lucene.facet.taxonomy.writercache.cl.TestCompactLabelToOrdinal",1,0.00,8.00,48,0.69,73685.08,1,0,8,21,3,78.61,17,49,0,2,69.48,0.00,0.50,0.00,0,1.00,8,2073.62,0,0,3,org.apache.lucene.util.LuceneTestCase,0.00,20,1,8,0,20,1,0,2,337,1
"org.apache.lucene.facet.taxonomy.writercache.cl.TestCompactLabelToOrdinal$LabelToOrdinalMap",5,0.25,1.40,13,0.21,4542.94,6,1,8,10,2,136.40,0,22,0,2,136.40,0.00,0.50,0.80,0,0.00,2,638.93,0,0,2,org.apache.lucene.facet.taxonomy.writercache.cl2o.LabelToOrdinal,0.00,5,1,7,0,5,5,0,0,148,2
"org.apache.lucene.analysis.standard.ClassicAnalyzer",6,0.13,1.00,21,0.21,3686.48,9,3,11,12,11,88.95,47,29,2,3,131.24,0.00,0.67,0.22,0,10.00,1,626.17,0,1,9,org.apache.lucene.analysis.util.StopwordAnalyzerBase,0.00,6,2,6,0,6,5,0,8,152,2
"org.apache.lucene.analysis.standard.ClassicAnalyzer$TokenStreamComponents",1,0.00,1.00,4,0.05,649.94,1,0,11,2,1,126.39,0,6,0,1,126.39,0.00,0.00,0.00,0,1.00,1,140.85,1,0,1,java.lang.Object,0.00,1,0,1,0,1,1,0,0,35,0
"org.apache.lucene.analysis.standard.ClassicFilter",2,0.50,3.50,25,0.39,24010.30,6,4,4,7,7,80.46,10,33,2,4,98.33,0.00,0.75,0.50,0,2.00,6,1181.01,0,0,5,org.apache.lucene.analysis.TokenFilter,0.29,5,3,7,0,5,2,0,7,221,1
"org.apache.lucene.analysis.standard.ClassicTokenizer",9,0.01,1.44,57,0.79,24525.75,25,16,9,21,14,96.96,50,84,5,4,114.84,0.00,0.75,0.07,1,28.00,5,2361.33,2,0,9,org.apache.lucene.analysis.Tokenizer,0.35,12,3,13,0,12,9,0,15,456,2
"org.apache.lucene.analysis.standard.ClassicTokenizerImpl",24,0.05,2.50,255,3.83,189527.85,66,42,2,33,4,60.50,180,440,2,1,102.80,0.00,0.00,0.07,2,234.00,23,11482.09,0,1,3,java.lang.Object,0.00,9,0,60,0,9,23,1,69,1926,0
"org.apache.lucene.analysis.standard.GenerateJflexTLDMacros",6,0.11,2.50,91,1.48,69620.48,13,7,17,50,1,62.69,36,130,1,1,94.91,0.00,0.00,0.24,3,10.00,4,4437.09,0,2,0,java.lang.Object,0.00,44,0,15,0,44,4,0,5,793,1
"org.apache.lucene.analysis.standard.StandardAnalyzer",6,0.13,1.00,21,0.21,3802.66,9,3,11,12,35,83.03,48,29,27,3,131.14,0.00,0.67,0.22,0,10.00,1,630.98,0,1,9,org.apache.lucene.analysis.util.StopwordAnalyzerBase,0.00,6,2,6,0,6,5,0,8,153,2
"org.apache.lucene.analysis.standard.StandardAnalyzer$TokenStreamComponents",1,0.00,1.00,4,0.05,649.94,1,0,11,2,1,126.39,0,6,0,1,126.39,0.00,0.00,0.00,0,1.00,1,140.85,1,0,1,java.lang.Object,0.00,1,0,1,0,1,1,0,0,35,0
"org.apache.lucene.analysis.standard.StandardFilter",3,0.20,3.00,29,0.45,23249.27,8,5,6,9,39,144.41,8,41,34,4,104.52,0.00,0.75,0.33,0,1.00,6,1336.88,0,0,5,org.apache.lucene.analysis.TokenFilter,0.27,6,3,9,0,6,3,0,6,259,1
"org.apache.lucene.analysis.standard.StandardTokenizer",9,0.01,1.67,67,1.02,33804.84,30,21,10,24,68,78.99,61,106,61,4,111.21,0.00,0.75,0.05,1,28.00,5,3048.87,2,0,10,org.apache.lucene.analysis.Tokenizer,0.35,15,3,15,0,15,9,0,24,566,2
"org.apache.lucene.analysis.standard.StandardTokenizerImpl",24,0.05,2.42,246,6.19,240767.74,63,39,1,33,3,53.88,199,798,1,1,101.98,0.00,0.00,0.07,2,234.00,21,18560.07,0,1,3,java.lang.Object,0.00,9,0,58,0,9,23,1,72,2605,2
"org.apache.lucene.analysis.standard.StandardTokenizerInterface",5,1.00,1.00,7,0.04,333.84,6,1,3,5,9,124.41,31,8,8,1,156.63,0.00,0.00,0.00,0,5.00,1,132.36,0,0,1,,0.00,0,0,5,0,0,5,0,7,45,1
"org.apache.lucene.analysis.standard.UAX29URLEmailAnalyzer",6,0.13,1.00,21,0.21,3932.32,9,3,9,12,11,98.80,39,29,2,3,131.02,0.00,0.67,0.22,0,10.00,1,639.62,0,1,9,org.apache.lucene.analysis.util.StopwordAnalyzerBase,0.00,6,2,6,0,6,5,0,8,155,2
"org.apache.lucene.analysis.standard.UAX29URLEmailAnalyzer$TokenStreamComponents",1,0.00,1.00,4,0.05,649.94,1,0,9,2,1,126.39,0,6,0,1,126.39,0.00,0.00,0.00,0,1.00,1,140.85,1,0,1,java.lang.Object,0.00,1,0,1,0,1,1,0,0,35,0
"org.apache.lucene.analysis.standard.UAX29URLEmailTokenizer",9,0.02,1.56,58,0.87,29132.57,25,16,14,23,19,96.36,48,85,10,4,114.23,0.00,0.75,0.08,0,21.00,4,2613.01,2,1,10,org.apache.lucene.analysis.Tokenizer,0.35,14,3,14,0,14,8,0,13,514,2
"org.apache.lucene.analysis.standard.UAX29URLEmailTokenizerImpl",24,0.05,2.54,259,30.92,994258.78,66,42,1,33,3,49.02,203,3890,1,1,97.12,0.00,0.00,0.07,2,234.00,24,92760.62,0,1,3,java.lang.Object,0.00,9,0,61,0,9,23,1,73,8834,2
"org.apache.lucene.analysis.it.ItalianAnalyzer",5,0.25,1.60,27,0.43,11681.25,8,3,19,21,17,69.82,51,44,1,3,118.29,0.00,0.67,0.13,0,8.00,4,1293.21,0,2,16,org.apache.lucene.analysis.util.StopwordAnalyzerBase,0.00,16,2,8,0,16,3,0,8,259,2
"org.apache.lucene.analysis.it.ItalianAnalyzer$DefaultSetHolder",0,0.00,0.00,6,0.07,1089.77,1,1,19,0,4,171.00,2,11,0,1,171.00,0.00,0.00,0.00,0,0.00,0,202.05,0,0,4,java.lang.Object,0.00,0,0,0,0,0,0,0,2,47,2
"org.apache.lucene.analysis.it.ItalianLightStemFilter",2,0.33,2.00,14,0.16,3794.18,5,3,6,9,10,113.74,9,20,4,4,113.50,0.00,0.75,0.50,0,2.00,3,481.98,0,0,6,org.apache.lucene.analysis.TokenFilter,0.29,7,3,4,0,7,2,0,1,107,2
"org.apache.lucene.analysis.it.ItalianLightStemmer",1,0.00,14.00,23,0.50,39068.30,1,0,0,1,1,46.57,56,52,1,1,83.44,0.00,0.00,0.00,0,1.00,14,1488.03,0,0,0,java.lang.Object,0.00,0,0,14,0,0,1,0,4,260,1
"org.apache.lucene.analysis.it.TestItalianAnalyzer",6,0.00,1.00,23,0.27,4267.13,6,0,7,9,4,180.74,9,31,0,3,130.74,0.00,0.67,0.00,0,6.00,1,802.59,3,0,4,org.apache.lucene.analysis.BaseTokenStreamTestCase,0.00,3,2,6,0,3,6,0,8,186,1
"org.apache.lucene.analysis.it.TestItalianLightStemFilter",3,0.00,1.00,10,0.08,885.78,3,0,8,6,5,183.75,5,15,0,3,133.75,0.00,0.67,0.00,0,3.00,1,234.73,2,0,5,org.apache.lucene.analysis.BaseTokenStreamTestCase,0.00,3,2,3,0,3,3,0,3,63,1
"org.apache.lucene.analysis.it.TestItalianLightStemFilter$Analyzer",1,0.00,1.00,4,0.05,1009.20,1,0,8,4,3,124.89,0,7,0,1,124.89,0.00,0.00,0.00,0,1.00,1,159.62,0,1,3,java.lang.Object,0.00,3,0,1,0,3,0,0,0,38,0
"org.apache.lucene.analysis.it.TestItalianLightStemFilter$Analyzer_0",1,0.00,1.00,4,0.05,753.46,1,0,8,4,3,125.89,0,6,0,1,125.89,0.00,0.00,0.00,0,1.00,1,135.44,0,1,3,java.lang.Object,0.00,3,0,1,0,3,0,0,0,34,0
"org.apache.lucene.util.junitcompat.SorePoint",0,0.00,0.00,2,0.01,57.08,0,0,0,0,3,171.00,21,9,3,1,171.00,0.00,0.00,0.00,0,0.00,0,38.05,0,0,0,java.lang.Object,0.00,0,0,0,0,0,0,0,3,11,1
"org.apache.lucene.util.junitcompat.SoreType",0,0.00,0.00,2,0.01,29.48,0,0,0,0,2,171.00,16,5,2,1,171.00,0.00,0.00,0.00,0,0.00,0,19.65,0,0,0,java.lang.Object,0.00,0,0,0,0,0,0,0,1,7,1
"org.apache.lucene.util.junitcompat.TestExceptionInBeforeClassHooks",4,0.00,1.50,28,0.44,10660.23,4,0,11,22,1,112.41,0,39,0,2,112.41,0.00,0.50,0.00,0,4.00,3,1334.93,0,0,1,org.apache.lucene.util.junitcompat.WithNestedTests,0.00,18,1,6,0,18,4,0,0,271,1
"org.apache.lucene.util.junitcompat.TestExceptionInBeforeClassHooks$Nested1",2,0.00,1.00,6,0.05,735.28,2,0,11,5,0,133.00,0,9,0,2,133.00,0.00,0.50,0.00,0,2.00,1,142.33,0,0,0,WithNestedTests.AbstractNestedTest,0.00,3,1,2,0,3,2,0,0,39,2
"org.apache.lucene.util.junitcompat.TestExceptionInBeforeClassHooks$Nested1$Thread",1,0.00,1.00,3,0.01,121.62,1,0,11,2,0,136.78,0,4,0,1,136.78,0.00,0.00,0.00,0,1.00,1,44.54,0,0,0,java.lang.Object,0.00,1,0,1,0,1,1,0,0,15,0
"org.apache.lucene.util.junitcompat.TestExceptionInBeforeClassHooks$Nested2",3,0.00,1.00,13,0.09,1128.51,3,0,11,6,0,128.26,0,17,0,2,128.26,0.00,0.50,0.00,0,3.00,1,259.51,0,0,0,org.apache.lucene.util.LuceneTestCase,0.00,3,1,3,0,3,3,0,0,70,2
"org.apache.lucene.util.junitcompat.TestExceptionInBeforeClassHooks$Nested2$Thread_0",1,0.00,1.00,3,0.01,121.62,1,0,11,2,0,136.78,0,4,0,1,136.78,0.00,0.00,0.00,0,1.00,1,44.54,0,0,0,java.lang.Object,0.00,1,0,1,0,1,1,0,0,15,0
"org.apache.lucene.util.junitcompat.TestExceptionInBeforeClassHooks$Nested2$Thread_1",1,0.00,1.00,3,0.01,121.62,1,0,11,2,0,136.78,0,4,0,1,136.78,0.00,0.00,0.00,0,1.00,1,44.54,0,0,0,java.lang.Object,0.00,1,0,1,0,1,1,0,0,15,0
"org.apache.lucene.util.junitcompat.TestExceptionInBeforeClassHooks$Nested2$Thread_2",1,0.00,1.00,3,0.01,121.62,1,0,11,2,0,136.78,0,4,0,1,136.78,0.00,0.00,0.00,0,1.00,1,44.54,0,0,0,java.lang.Object,0.00,1,0,1,0,1,1,0,0,15,0
"org.apache.lucene.util.junitcompat.TestExceptionInBeforeClassHooks$Nested3",2,0.00,1.00,6,0.05,652.89,2,0,11,5,0,133.41,0,11,0,2,133.41,0.00,0.50,0.00,0,2.00,1,144.18,0,0,0,WithNestedTests.AbstractNestedTest,0.00,3,1,2,0,3,2,0,0,40,2
"org.apache.lucene.util.junitcompat.TestExceptionInBeforeClassHooks$Nested3$Thread_3",1,0.00,1.00,3,0.01,121.62,1,0,11,2,0,136.78,0,4,0,1,136.78,0.00,0.00,0.00,0,1.00,1,44.54,0,0,0,java.lang.Object,0.00,1,0,1,0,1,1,0,0,15,0
"org.apache.lucene.util.junitcompat.TestJUnitRuleOrder",1,1.00,1.00,5,0.04,518.06,2,1,13,1,1,105.68,5,7,0,2,123.55,0.00,0.50,0.00,0,1.00,1,114.46,0,0,1,org.apache.lucene.util.junitcompat.WithNestedTests,0.00,0,1,1,0,0,1,0,1,31,1
"org.apache.lucene.util.junitcompat.TestJUnitRuleOrder$Nested",6,0.00,1.00,15,0.16,2206.02,6,0,13,11,0,139.57,1,31,0,2,139.57,0.00,0.50,0.00,0,0.00,1,469.93,0,0,0,WithNestedTests.AbstractNestedTest,0.00,5,1,6,0,5,6,0,1,121,2
"org.apache.lucene.util.junitcompat.TestJUnitRuleOrder$Nested$TestRule",1,0.00,1.00,3,0.02,271.03,1,0,13,2,0,134.04,0,5,0,1,134.04,0.00,0.00,0.00,0,1.00,1,63.51,0,1,0,java.lang.Object,0.00,1,0,1,0,1,0,0,0,19,0
"org.apache.lucene.util.junitcompat.TestJUnitRuleOrder$Nested$TestRule$Statement",1,0.00,1.00,5,0.03,388.93,1,0,13,2,0,124.53,0,6,0,1,124.53,0.00,0.00,0.00,0,0.00,1,99.38,0,0,0,java.lang.Object,0.00,1,0,1,0,1,1,0,0,28,0
"org.apache.lucene.util.junitcompat.TestReproduceMessage",0,0.00,0.00,4,0.03,285.55,2,2,14,0,3,171.00,3,5,0,2,171.00,0.00,0.50,0.00,0,0.00,0,95.18,0,0,3,org.apache.lucene.util.junitcompat.WithNestedTests,0.00,0,1,0,0,0,0,0,1,25,1
"org.apache.lucene.util.junitcompat.TestReproduceMessage$Nested",30,0.00,1.20,125,1.67,25368.20,30,0,14,41,2,125.45,13,194,0,2,125.45,0.00,0.50,0.00,2,0.00,3,4997.71,0,1,2,org.apache.lucene.util.junitcompat.AbstractNestedTest,0.00,11,1,36,0,11,29,0,7,1094,2
"org.apache.lucene.util.junitcompat.TestReproduceMessage$Nested$TestRule",1,0.00,1.00,3,0.02,271.03,1,0,14,2,0,134.04,0,5,0,1,134.04,0.00,0.00,0.00,0,1.00,1,63.51,0,1,0,java.lang.Object,0.00,1,0,1,0,1,0,0,0,19,0
"org.apache.lucene.util.junitcompat.TestReproduceMessage$Nested$TestRule$Statement",1,0.00,2.00,5,0.03,365.82,1,0,14,4,1,124.58,0,7,0,1,124.58,0.00,0.00,0.00,0,1.00,2,97.86,0,0,1,java.lang.Object,0.00,3,0,2,0,3,1,0,0,27,0
"org.apache.lucene.util.junitcompat.TestSeedFromUncaught",2,0.00,1.00,11,0.14,2754.03,2,0,5,7,1,120.44,8,16,0,2,120.21,0.00,0.50,0.00,0,2.00,1,433.67,2,0,1,org.apache.lucene.util.junitcompat.WithNestedTests,0.00,5,1,2,0,5,2,0,3,95,1
"org.apache.lucene.util.junitcompat.TestSeedFromUncaught$ThrowInUncaught",1,0.00,1.00,5,0.04,577.13,1,0,5,4,0,123.18,0,8,0,2,123.18,0.00,0.50,0.00,0,1.00,1,115.65,0,0,0,org.apache.lucene.util.junitcompat.AbstractNestedTest,0.00,3,1,1,0,3,1,0,0,31,2
"org.apache.lucene.util.junitcompat.TestSeedFromUncaught$ThrowInUncaught$Thread",1,0.00,1.00,3,0.02,222.80,1,0,5,2,0,134.71,0,5,0,1,134.71,0.00,0.00,0.00,0,1.00,1,58.19,0,0,0,java.lang.Object,0.00,1,0,1,0,1,1,0,0,18,0
"org.apache.lucene.util.junitcompat.TestSetupTeardownChaining",3,0.00,1.00,15,0.20,2842.56,3,0,6,11,1,142.10,10,25,0,2,121.49,0.00,0.50,0.00,0,3.00,1,613.56,0,0,1,org.apache.lucene.util.junitcompat.WithNestedTests,0.00,8,1,3,0,8,3,0,3,136,1
"org.apache.lucene.util.junitcompat.TestSetupTeardownChaining$NestedSetupChain",2,0.00,1.00,3,0.02,208.08,2,0,6,2,0,155.11,1,8,0,2,155.11,0.00,0.50,0.00,0,2.00,1,73.81,0,0,0,org.apache.lucene.util.junitcompat.AbstractNestedTest,0.00,0,1,2,0,0,2,0,1,25,2
"org.apache.lucene.util.junitcompat.TestSetupTeardownChaining$NestedTeardownChain",2,0.00,1.00,3,0.02,208.08,2,0,6,2,0,155.11,1,8,0,2,155.11,0.00,0.50,0.00,0,2.00,1,73.81,0,0,0,org.apache.lucene.util.junitcompat.AbstractNestedTest,0.00,0,1,2,0,0,2,0,1,25,2
"org.apache.lucene.util.junitcompat.TestSystemPropertiesInvariantRule",6,0.10,1.17,40,0.58,10499.46,8,2,9,19,3,116.40,4,58,0,2,116.40,0.00,0.50,0.42,0,0.00,2,1735.12,0,0,3,org.apache.lucene.util.junitcompat.WithNestedTests,0.00,13,1,7,0,13,6,0,1,367,1
"org.apache.lucene.util.junitcompat.TestSystemPropertiesInvariantRule$Base",1,0.00,1.00,2,0.01,66.54,1,0,9,1,0,145.41,0,3,0,2,145.41,0.00,0.50,0.00,0,1.00,1,31.26,0,0,0,org.apache.lucene.util.LuceneTestCase,0.00,0,1,1,0,0,1,0,0,12,2
"org.apache.lucene.util.junitcompat.TestSystemPropertiesInvariantRule$IgnoredProperty",1,1.00,1.00,4,0.04,559.51,2,1,9,3,1,126.90,0,9,0,1,126.90,0.00,0.00,0.00,0,0.00,1,125.83,0,0,1,java.lang.Object,0.00,2,0,1,0,2,1,0,0,33,2
"org.apache.lucene.util.junitcompat.TestSystemPropertiesInvariantRule$InAfterClass",1,0.00,1.00,3,0.03,292.80,1,0,9,2,0,133.78,0,6,0,2,133.78,0.00,0.50,0.00,0,0.00,1,80.57,0,0,0,org.apache.lucene.util.junitcompat.Base,0.00,1,1,1,0,1,1,0,0,23,2
"org.apache.lucene.util.junitcompat.TestSystemPropertiesInvariantRule$InBeforeClass",1,0.00,1.00,3,0.03,292.80,1,0,9,2,0,133.78,0,6,0,2,133.78,0.00,0.50,0.00,0,0.00,1,80.57,0,0,0,org.apache.lucene.util.junitcompat.Base,0.00,1,1,1,0,1,1,0,0,23,2
"org.apache.lucene.util.junitcompat.TestSystemPropertiesInvariantRule$InTestMethod",2,0.00,1.50,7,0.05,736.33,2,0,9,5,0,132.90,0,11,0,2,132.90,0.00,0.50,0.00,1,2.00,2,161.05,0,0,0,org.apache.lucene.util.junitcompat.Base,0.00,3,1,3,0,3,2,0,0,43,2
"org.apache.lucene.util.junitcompat.TestSystemPropertiesInvariantRule$NonStringProperties",3,0.00,1.33,11,0.12,2448.62,3,0,9,10,0,130.21,0,17,0,2,130.21,0.00,0.50,0.00,1,1.00,2,370.70,0,0,0,org.apache.lucene.util.junitcompat.Base,0.00,7,1,4,0,7,3,0,0,89,2
"org.apache.lucene.util.junitcompat.WithNestedTests",5,0.35,2.00,41,0.43,9812.09,10,5,8,17,6,151.11,12,59,6,1,111.22,0.00,0.00,0.48,0,0.00,3,1283.88,0,2,0,java.lang.Object,0.00,12,0,10,6,12,3,0,1,272,2
"org.apache.lucene.util.junitcompat.WithNestedTests$AbstractNestedTest",2,0.00,1.00,5,0.05,715.95,2,0,8,4,0,139.66,0,9,0,2,139.66,0.00,0.50,0.00,1,2.00,1,150.11,0,0,0,org.apache.lucene.util.LuceneTestCase,0.00,2,1,2,0,2,2,0,0,42,3
"org.apache.lucene.util.junitcompat.WithNestedTests$ThreadLocal<Boolean>",1,0.00,1.00,3,0.02,186.16,1,0,8,1,0,135.33,0,5,0,1,135.33,0.00,0.00,0.00,0,1.00,1,56.19,0,1,0,java.lang.Object,0.00,0,0,1,0,0,0,0,0,18,0
"org.apache.lucene.index.AtomicReader",16,1.00,2.12,94,1.08,33954.21,17,1,5,27,141,100.68,87,127,128,2,118.56,9.00,0.09,0.06,1,30.00,4,3230.78,1,2,15,org.apache.lucene.index.IndexReader,0.04,11,1,34,9,11,14,0,16,680,2
"org.apache.lucene.index.AtomicReaderContext",5,0.19,1.20,20,0.18,3672.28,9,4,0,5,395,108.06,25,28,395,2,125.93,0.00,0.50,0.10,0,14.00,2,531.63,0,3,3,org.apache.lucene.index.IndexReaderContext,0.67,0,1,6,0,0,2,0,5,134,2
"org.apache.lucene.index.AutomatonTermsEnum",7,0.33,5.14,127,1.84,148261.66,18,11,8,25,9,98.86,122,155,1,3,89.73,0.00,0.67,0.38,2,0.00,9,5508.27,0,2,8,org.apache.lucene.index.FilteredTermsEnum,0.00,18,2,36,0,18,5,0,49,1008,0
"org.apache.lucene.index.BalancedSegmentMergePolicy",16,0.01,4.00,227,2.84,287875.36,21,5,3,31,5,134.31,34,253,0,4,94.42,0.00,0.75,0.21,8,64.00,13,8522.41,5,0,5,org.apache.lucene.index.LogByteSizeMergePolicy,0.28,15,3,64,0,15,16,0,24,1551,1
"org.apache.lucene.index.BalancedSegmentMergePolicy$MergePolicyParams",13,0.07,1.00,39,0.23,2680.55,19,6,3,13,1,134.98,0,53,0,1,134.98,0.00,0.00,0.23,0,84.00,1,687.28,0,0,1,java.lang.Object,0.00,0,0,13,0,0,13,0,0,191,2
"org.apache.lucene.index.BaseCompositeReader",9,0.05,1.44,55,0.61,27100.43,14,5,3,18,10,96.62,45,70,3,3,114.49,3.00,0.22,0.24,1,36.00,3,1826.95,1,0,7,org.apache.lucene.index.CompositeReader,0.32,9,2,13,6,9,9,0,15,391,2
"org.apache.lucene.index.BinaryTokenStream",3,0.00,1.33,14,0.13,2655.13,5,2,5,4,5,175.27,3,21,1,3,125.27,0.00,0.67,0.50,0,2.00,2,380.24,0,0,4,org.apache.lucene.analysis.TokenStream,0.55,1,2,4,0,1,3,0,1,92,2
"org.apache.lucene.index.BinaryTokenStream$ByteTermAttribute",1,0.00,1.00,2,0.01,60.50,1,0,5,1,1,145.74,0,3,0,2,145.74,0.00,0.50,0.00,0,1.00,1,35.16,0,0,1,,0.00,0,1,1,0,0,1,0,0,13,1
"org.apache.lucene.index.BinaryTokenStream$ByteTermAttributeImpl",5,0.50,1.00,12,0.09,1115.43,6,1,5,6,3,141.28,0,18,0,2,141.28,0.00,0.50,0.60,0,2.00,1,264.09,0,1,3,org.apache.lucene.util.AttributeImpl,0.20,1,1,5,0,1,4,2,0,75,2
"org.apache.lucene.index.BufferedDeletes",9,0.22,1.89,57,0.90,30099.89,20,11,8,30,17,134.69,34,77,14,1,114.07,0.00,0.00,0.28,0,0.00,6,2687.01,0,1,3,java.lang.Object,0.00,21,0,17,0,21,8,0,15,538,0
"org.apache.lucene.index.BufferedDeletesStream",14,0.14,4.79,232,3.59,428139.09,20,6,14,84,21,72.53,78,288,2,1,90.40,0.00,0.00,0.30,3,30.00,25,10757.45,0,1,19,java.lang.Object,0.00,70,0,67,0,70,13,0,45,1784,0
"org.apache.lucene.index.BufferedDeletesStream$ApplyDeletesResult",1,3.00,1.00,8,0.07,1209.33,4,3,14,1,1,133.65,3,10,0,1,113.04,0.00,0.00,0.00,0,1.00,1,224.00,0,0,1,java.lang.Object,0.00,0,0,1,0,0,1,0,3,56,2
"org.apache.lucene.index.BufferedDeletesStream$Comparator<SegmentInfo>",1,0.00,3.00,9,0.09,3214.13,1,0,14,2,1,107.53,0,12,0,1,107.53,0.00,0.00,0.00,0,1.00,3,256.49,0,0,1,java.lang.Object,0.00,1,0,3,0,1,1,0,0,58,0
"org.apache.lucene.index.BufferedDeletesStream$QueryAndLimit",1,2.00,1.00,6,0.04,570.78,3,2,14,1,1,120.27,0,8,0,1,120.27,0.00,0.00,0.00,0,1.00,1,130.51,0,0,1,java.lang.Object,0.00,0,0,1,0,0,1,0,0,37,2
"org.apache.lucene.index.BugReproTokenStream",2,0.78,1.50,22,0.33,9684.58,11,9,9,6,8,103.04,0,28,1,3,103.04,0.00,0.67,0.50,0,2.00,2,989.64,1,0,7,org.apache.lucene.analysis.TokenStream,0.60,4,2,3,0,4,2,0,0,199,1
"org.apache.lucene.index.ByteSliceReader",6,0.55,2.17,70,0.82,47002.71,14,8,4,8,8,141.20,12,86,5,2,101.31,0.00,0.50,0.58,1,0.00,3,2474.82,0,0,3,org.apache.lucene.store.DataInput,0.24,2,1,13,0,2,6,0,8,487,1
"org.apache.lucene.index.ByteSliceWriter",5,0.56,1.60,33,0.37,12725.75,9,4,2,6,4,97.17,26,44,1,2,115.05,0.00,0.50,0.70,0,0.00,3,1103.09,0,0,3,org.apache.lucene.store.DataOutput,0.25,1,1,8,0,1,5,0,5,238,1
"org.apache.lucene.index.CheckIndex",0,0.00,0.00,4,0.02,204.34,2,2,27,0,21,171.00,16,4,5,1,171.00,0.00,0.00,0.00,0,0.00,0,68.11,0,0,16,java.lang.Object,0.00,0,0,0,0,0,0,0,2,19,1
"org.apache.lucene.index.CheckIndex$Status",19,0.03,13.74,920,17.33,2912728.98,40,21,27,182,30,29.29,236,1166,0,1,66.85,0.00,0.00,0.02,6,61.00,85,52004.32,0,8,30,java.lang.Object,0.00,163,0,261,0,163,11,0,129,7086,2
"org.apache.lucene.index.CheckIndex$Status$DocValuesStatus",0,0.00,0.00,4,0.03,314.50,3,3,27,0,0,171.00,3,5,0,1,171.00,0.00,0.00,0.00,0,0.00,0,89.86,0,0,0,java.lang.Object,0.00,0,0,0,0,0,0,0,3,23,3
"org.apache.lucene.index.CheckIndex$Status$FieldNormStatus",0,0.00,0.00,3,0.03,266.51,2,2,27,0,0,171.00,2,4,0,1,171.00,0.00,0.00,0.00,0,0.00,0,76.15,0,0,0,java.lang.Object,0.00,0,0,0,0,0,0,0,2,20,3
"org.apache.lucene.index.CheckIndex$Status$SegmentInfoStatus",0,0.00,0.00,22,0.21,3745.48,21,21,27,0,1,171.00,31,23,0,1,171.00,0.00,0.00,0.00,0,0.00,0,633.29,0,0,1,java.lang.Object,0.00,0,0,0,0,0,0,0,21,116,2
"org.apache.lucene.index.CheckIndex$Status$StoredFieldStatus",0,0.00,0.00,4,0.04,420.00,3,3,27,0,0,171.00,3,5,0,1,171.00,0.00,0.00,0.00,0,0.00,0,108.00,0,0,0,java.lang.Object,0.00,0,0,0,0,0,0,0,3,27,3
"org.apache.lucene.index.CheckIndex$Status$TermIndexStatus",0,0.00,0.00,6,0.07,1462.28,5,5,27,0,1,171.00,4,7,0,1,171.00,0.00,0.00,0.00,0,0.00,0,215.49,0,0,1,java.lang.Object,0.00,0,0,0,0,0,0,0,4,47,3
"org.apache.lucene.index.CheckIndex$Status$TermVectorStatus",0,0.00,0.00,4,0.04,420.00,3,3,27,0,0,171.00,3,5,0,1,171.00,0.00,0.00,0.00,0,0.00,0,108.00,0,0,0,java.lang.Object,0.00,0,0,0,0,0,0,0,3,27,3
"org.apache.lucene.index.CoalescedDeletes",5,0.12,1.20,21,0.25,5160.01,7,2,8,15,7,124.77,2,26,2,1,124.77,0.00,0.00,0.40,0,7.00,2,749.41,0,2,5,java.lang.Object,0.00,10,0,6,0,10,3,0,2,172,0
"org.apache.lucene.index.CoalescedDeletes$Iterable<QueryAndLimit>",1,0.00,1.00,3,0.02,282.15,1,0,8,2,0,133.91,0,5,0,1,133.91,0.00,0.00,0.00,0,1.00,1,66.26,0,1,0,java.lang.Object,0.00,1,0,1,0,1,0,0,0,20,0
"org.apache.lucene.index.CoalescedDeletes$Iterable<QueryAndLimit>$Iterator<QueryAndLimit>",3,0.50,1.00,9,0.13,2585.36,4,1,8,10,1,130.09,0,15,0,1,130.09,0.00,0.00,0.67,0,1.00,1,385.91,0,1,1,java.lang.Object,0.00,7,0,3,0,7,2,0,0,93,0
"org.apache.lucene.index.CoalescedDeletes$Iterable<Term>",1,0.00,2.00,7,0.10,3550.60,1,0,8,5,1,111.36,0,9,0,1,111.36,0.00,0.00,0.00,0,0.00,2,289.00,0,1,1,java.lang.Object,0.00,4,0,2,0,4,0,0,0,65,0
"org.apache.lucene.index.CoalescedDeletes$Iterator<Term>",5,0.44,2.60,51,0.49,18551.23,9,4,8,16,1,155.37,5,62,0,1,105.37,0.00,0.00,0.60,2,0.00,4,1465.22,0,0,1,java.lang.Object,0.00,11,0,13,0,11,5,0,5,313,0
"org.apache.lucene.index.CoalescedDeletes$SubIterator",0,0.00,0.00,4,0.03,319.82,3,3,8,0,1,171.00,0,5,0,1,171.00,0.00,0.00,0.00,0,0.00,0,79.95,0,0,1,java.lang.Object,0.00,0,0,0,0,0,0,0,0,21,2
"org.apache.lucene.index.CoalescedDeletes$TermMergeQueue",2,0.00,1.50,9,0.09,2952.29,2,0,8,3,1,123.49,0,14,0,2,123.49,0.00,0.50,0.00,0,2.00,2,284.71,0,0,1,org.apache.lucene.util.PriorityQueue,0.00,1,1,3,0,1,2,0,0,68,2
"org.apache.lucene.index.CompositeReader",4,1.00,1.75,26,0.26,12415.26,5,1,2,11,16,65.87,42,32,14,2,114.35,7.00,0.11,0.25,1,6.00,3,780.98,1,3,3,org.apache.lucene.index.IndexReader,0.05,7,1,7,7,7,1,0,4,165,2
"org.apache.lucene.index.CompositeReaderContext",7,0.22,1.00,22,0.22,3341.98,10,3,2,9,9,182.11,11,34,8,2,132.11,0.00,0.50,0.14,0,22.00,1,656.22,0,2,4,org.apache.lucene.index.IndexReaderContext,0.55,2,1,7,0,2,5,0,3,169,2
"org.apache.lucene.index.CompositeReaderContext$Builder",4,0.08,2.00,40,0.46,28102.55,8,4,2,11,6,103.25,1,47,0,1,103.25,0.00,0.00,0.31,1,6.00,4,1371.14,0,1,6,java.lang.Object,0.00,7,0,8,0,7,3,0,1,276,3
"org.apache.lucene.index.CompositeReaderContext$Builder$ReaderUtil.Gather",1,0.00,1.00,3,0.03,303.75,1,0,2,1,1,133.65,0,5,0,1,133.65,0.00,0.00,0.00,0,1.00,1,87.65,0,0,1,java.lang.Object,0.00,0,0,1,0,0,1,0,0,24,0
"org.apache.lucene.index.CompoundFileExtractor",1,0.00,15.00,60,0.95,97814.20,1,0,10,24,7,46.88,5,77,0,1,64.75,0.00,0.00,0.00,0,1.00,15,2857.71,0,0,7,java.lang.Object,0.00,23,0,15,0,23,1,0,3,432,1
"org.apache.lucene.index.ConcurrentMergeScheduler",19,0.02,3.00,161,1.88,97355.54,27,8,7,63,26,89.97,111,224,21,2,107.85,1.00,0.33,0.14,6,195.00,13,5648.06,0,0,5,org.apache.lucene.index.MergeScheduler,0.10,44,1,57,1,44,19,0,59,1058,1
"org.apache.lucene.index.ConcurrentMergeScheduler$Comparator<MergeThread>",1,0.00,3.00,7,0.12,4217.11,1,0,7,2,0,110.68,0,8,0,1,110.68,0.00,0.00,0.00,0,1.00,3,346.55,0,0,0,java.lang.Object,0.00,1,0,3,0,1,1,0,0,75,0
"org.apache.lucene.index.ConcurrentMergeScheduler$MergeThread",6,0.05,3.00,47,0.43,14909.73,10,4,7,16,3,152.37,13,70,0,2,112.49,0.00,0.50,0.29,1,6.00,9,1298.12,0,2,3,org.apache.lucene.index.Thread,0.00,10,1,18,0,10,4,0,13,269,1
"org.apache.lucene.index.CorruptIndexException",1,0.00,1.00,3,0.02,106.02,1,0,1,1,92,137.49,4,5,92,2,137.25,2.00,0.25,0.00,0,1.00,1,45.51,0,0,0,java.io.IOException,0.00,0,1,1,2,0,1,0,1,16,1
"org.apache.lucene.index.DirectoryReader",18,0.44,1.28,61,0.81,33034.85,20,2,8,34,132,117.09,284,80,125,4,127.44,0.33,0.60,0.08,0,62.00,5,2437.94,0,13,10,org.apache.lucene.index.BaseCompositeReader,0.00,16,3,23,1,16,5,0,32,522,2
"org.apache.lucene.index.DocConsumer",6,0.00,1.00,7,0.04,243.65,6,0,1,6,7,158.33,0,8,5,1,158.33,0.00,0.00,0.00,0,6.00,1,124.23,0,0,2,java.lang.Object,0.00,0,0,6,1,0,6,0,0,45,1
"org.apache.lucene.index.DocFieldConsumer",6,0.00,1.00,7,0.05,330.72,6,0,2,6,5,207.29,6,8,2,1,157.29,0.00,0.00,0.00,0,6.00,1,148.78,0,1,3,java.lang.Object,0.00,0,0,6,1,0,5,0,3,50,1
"org.apache.lucene.index.DocFieldConsumerPerField",3,0.00,1.00,4,0.02,154.38,3,0,1,3,7,157.52,1,5,5,1,157.52,0.00,0.00,0.00,0,3.00,1,74.24,0,0,2,java.lang.Object,0.00,0,0,3,1,0,3,0,1,26,1
"org.apache.lucene.index.DocFieldProcessor",10,0.18,4.40,173,2.38,172064.47,23,13,14,63,18,112.02,37,216,2,2,91.41,0.00,0.50,0.24,2,0.00,15,7147.17,0,2,17,org.apache.lucene.index.DocConsumer,0.75,53,1,44,0,53,8,0,30,1258,1
"org.apache.lucene.index.DocFieldProcessor$Comparator<DocFieldProcessorPerField>",1,0.00,1.00,3,0.04,494.59,1,0,14,2,1,131.99,0,4,0,1,131.99,0.00,0.00,0.00,0,1.00,1,111.03,0,0,1,java.lang.Object,0.00,1,0,1,0,1,1,0,0,31,0
"org.apache.lucene.index.DocFieldProcessor$DocValuesConsumerAndDocID",1,2.00,1.00,5,0.03,367.59,3,2,14,1,1,164.61,2,7,0,1,124.73,0.00,0.00,0.00,0,1.00,1,93.64,0,0,1,java.lang.Object,0.00,0,0,1,0,0,1,0,2,27,2
"org.apache.lucene.index.DocFieldProcessorPerField",3,0.00,1.33,19,0.20,4660.56,9,6,2,7,7,166.78,3,24,2,1,116.78,0.00,0.00,0.17,0,5.00,2,597.45,0,0,6,java.lang.Object,0.00,4,0,4,0,4,3,0,1,136,1
"org.apache.lucene.index.DocHelper",6,0.02,1.33,182,3.06,136214.21,69,63,18,30,28,63.66,33,214,13,1,81.53,0.00,0.00,0.00,2,10.00,2,9166.12,0,1,15,java.lang.Object,0.00,24,0,8,0,24,5,0,14,1564,0
"org.apache.lucene.index.DocInverter",7,0.11,1.14,32,0.37,10588.41,10,3,3,22,10,123.47,5,48,2,2,123.47,0.00,0.50,0.43,0,0.00,2,1121.77,0,1,9,org.apache.lucene.index.DocFieldConsumer,0.62,15,1,8,0,15,6,0,3,256,1
"org.apache.lucene.index.DocInverterPerField",4,0.40,4.00,70,0.99,104878.09,9,5,4,32,17,47.70,30,87,7,2,89.99,0.00,0.50,0.50,0,0.00,13,2981.42,0,1,11,org.apache.lucene.index.DocFieldConsumerPerField,0.86,28,1,16,0,28,3,0,23,499,1
"org.apache.lucene.index.DocTermOrds",15,0.03,4.53,258,3.73,594999.18,34,19,10,44,22,68.40,213,298,12,1,88.54,0.00,0.00,0.08,5,77.00,36,11176.00,0,2,10,java.lang.Object,0.00,29,0,68,1,29,13,0,109,1783,1
"org.apache.lucene.index.DocTermOrds$OrdWrappedTermsEnum",12,0.21,2.00,85,1.07,90003.24,15,3,10,27,7,158.80,15,119,0,2,108.80,0.00,0.50,0.53,2,0.00,8,3205.49,0,6,7,org.apache.lucene.index.TermsEnum,0.40,15,1,24,0,15,6,0,15,630,2
"org.apache.lucene.index.DocTermOrds$TermOrdsIterator",2,1.33,6.00,50,0.43,33789.30,5,3,10,2,0,42.86,14,51,0,1,85.15,0.00,0.00,1.00,0,0.00,10,1298.34,0,1,0,java.lang.Object,0.00,0,0,12,0,0,1,0,12,254,1
"org.apache.lucene.index.DocValues",9,0.25,1.11,28,0.27,6993.96,12,3,7,17,104,171.90,264,36,102,1,130.42,0.00,0.00,0.11,0,26.00,2,822.76,0,3,4,java.lang.Object,0.00,8,0,10,8,8,6,1,28,198,2
"org.apache.lucene.index.DocValues$PackedInts.Reader",5,0.00,1.00,11,0.07,779.57,5,0,7,5,0,142.50,0,21,0,1,142.50,0.00,0.00,0.00,0,5.00,1,206.61,0,1,0,java.lang.Object,0.00,0,0,5,0,0,4,0,0,63,0
"org.apache.lucene.index.DocValues$SortedSource",11,0.90,1.36,38,0.37,18555.69,12,1,7,12,1,167.60,31,52,0,2,127.72,0.00,0.50,0.18,2,25.00,4,1099.70,0,5,1,org.apache.lucene.index.Source,0.00,1,1,15,0,1,6,0,8,260,3
"org.apache.lucene.index.DocValues$SortedSource_1",7,0.00,1.14,21,0.17,3161.07,7,0,7,7,1,132.27,0,36,0,1,132.27,0.00,0.00,0.00,0,7.00,2,509.41,0,3,1,java.lang.Object,0.00,0,0,8,0,0,4,0,0,133,0
"org.apache.lucene.index.DocValues$Source",8,1.00,1.00,18,0.12,1154.62,9,1,7,9,1,124.89,45,27,0,1,142.77,0.00,0.00,0.12,0,14.00,1,351.17,0,3,1,java.lang.Object,0.00,1,0,8,0,1,5,0,7,103,3
"org.apache.lucene.index.DocValues$SourceCache",3,0.00,1.00,6,0.05,483.63,3,0,7,3,1,100.10,21,9,0,1,142.39,0.00,0.00,0.00,1,3.00,1,141.46,0,1,1,java.lang.Object,0.00,0,0,3,0,0,2,0,4,44,3
"org.apache.lucene.index.DocValues$SourceCache$DirectSourceCache",2,0.00,1.50,8,0.07,1252.52,3,1,7,3,1,126.42,0,12,0,2,126.42,0.00,0.50,1.00,0,0.00,2,198.04,0,1,1,org.apache.lucene.index.SourceCache,0.00,1,1,3,0,1,1,0,0,51,3
"org.apache.lucene.index.DocValues$Source_0",3,0.00,1.00,8,0.06,847.65,3,0,7,3,1,140.47,0,14,0,1,140.47,0.00,0.00,0.00,0,3.00,1,188.82,0,1,1,java.lang.Object,0.00,0,0,3,0,0,2,0,0,52,0
"org.apache.lucene.index.DocValues$Type",0,0.00,0.00,2,0.03,150.12,0,0,7,0,0,171.00,14,15,0,1,171.00,0.00,0.00,0.00,0,0.00,0,75.06,0,0,0,java.lang.Object,0.00,0,0,0,0,0,0,0,1,18,2
"org.apache.lucene.index.DocsAndPositionsEnum",5,0.00,1.00,6,0.04,320.15,5,0,2,5,102,196.66,14,7,100,3,156.78,8.00,0.11,0.00,0,5.00,1,131.16,0,1,2,org.apache.lucene.index.DocsEnum,0.00,0,2,5,16,0,4,0,5,45,2
"org.apache.lucene.index.DocsEnum",2,1.00,1.50,6,0.05,791.92,3,1,2,3,136,153.27,7,8,134,2,132.65,31.00,0.03,0.50,0,2.00,2,137.62,0,1,2,org.apache.lucene.search.DocIdSetIterator,0.00,1,1,3,31,1,1,0,3,39,2
"org.apache.lucene.index.DocumentsWriter",25,0.08,2.72,250,3.10,133712.32,42,17,16,95,28,86.24,146,350,13,1,104.11,0.00,0.00,0.13,6,44.00,7,9304.91,0,1,21,java.lang.Object,0.00,70,0,68,0,70,24,0,43,1748,1
"org.apache.lucene.index.DocumentsWriterDeleteQueue",18,0.12,1.89,103,1.04,30534.68,24,6,4,39,11,101.48,105,147,6,1,119.35,0.00,0.00,0.28,4,22.00,8,3118.86,0,2,5,java.lang.Object,0.00,21,0,34,0,21,16,0,24,685,1
"org.apache.lucene.index.DocumentsWriterDeleteQueue$DeleteSlice",5,0.50,1.60,22,0.17,4742.36,7,2,4,6,2,125.23,20,29,0,1,124.99,0.00,0.00,0.90,1,0.00,3,507.34,0,0,2,java.lang.Object,0.00,1,0,8,0,1,5,0,8,123,1
"org.apache.lucene.index.DocumentsWriterDeleteQueue$Node<T>",3,0.33,1.67,10,0.13,3321.39,6,3,4,5,2,129.11,0,16,0,1,129.11,0.00,0.00,0.11,0,4.00,3,390.47,0,0,2,java.lang.Object,0.00,2,0,5,0,2,3,0,0,94,2
"org.apache.lucene.index.DocumentsWriterDeleteQueue$QueryArrayNode",2,0.00,1.50,7,0.06,782.27,2,0,4,3,3,132.70,0,11,0,2,132.70,0.00,0.50,0.00,0,2.00,2,180.85,0,0,3,Node,0.00,1,1,3,0,1,2,0,0,48,3
"org.apache.lucene.index.DocumentsWriterDeleteQueue$TermArrayNode",3,0.00,1.33,9,0.08,1127.47,3,0,4,5,3,132.86,0,15,0,2,132.86,0.00,0.50,0.00,0,3.00,2,245.58,0,1,3,Node,0.09,2,1,4,0,2,2,0,0,65,3
"org.apache.lucene.index.DocumentsWriterDeleteQueue$TermNode",3,0.00,1.00,7,0.06,637.61,3,0,4,4,3,141.44,0,13,0,2,141.44,0.00,0.50,0.00,0,3.00,1,181.92,0,1,3,Node,0.09,1,1,3,0,1,2,0,0,52,3
"org.apache.lucene.index.DocumentsWriterFlushControl",41,0.06,1.95,319,3.57,131404.37,62,21,10,110,11,151.60,98,436,6,1,111.71,0.00,0.00,0.11,13,678.00,6,10717.52,0,8,8,java.lang.Object,0.00,69,0,80,0,69,33,0,48,2117,2
"org.apache.lucene.index.DocumentsWriterFlushControl$BlockedFlush",1,2.00,1.00,7,0.04,493.69,3,2,10,1,1,118.27,0,9,0,1,118.27,0.00,0.00,0.00,0,1.00,1,130.76,0,0,1,java.lang.Object,0.00,0,0,1,0,0,1,0,0,37,2
"org.apache.lucene.index.DocumentsWriterFlushControl$Iterator<ThreadState>",3,1.00,1.00,8,0.06,548.06,4,1,10,4,0,141.96,0,11,0,1,141.96,0.00,0.00,0.33,0,4.00,1,166.55,0,1,0,java.lang.Object,0.00,1,0,3,0,1,2,0,0,48,0
"org.apache.lucene.index.DocumentsWriterFlushQueue",11,0.03,1.45,72,0.66,18844.45,14,3,6,35,3,156.31,23,104,1,1,116.42,0.00,0.00,0.36,4,20.00,3,1979.44,0,0,3,java.lang.Object,0.00,24,0,16,0,24,11,0,16,432,1
"org.apache.lucene.index.DocumentsWriterFlushQueue$FlushTicket",3,2.00,1.00,8,0.06,736.85,5,2,6,3,2,140.95,0,10,0,1,140.95,0.00,0.00,0.00,0,3.00,1,174.54,0,0,2,java.lang.Object,0.00,0,0,3,0,0,3,0,0,50,2
"org.apache.lucene.index.DocumentsWriterFlushQueue$GlobalDeletesTicket",3,0.00,1.00,9,0.06,858.95,3,0,6,4,2,133.86,1,13,0,2,133.86,0.00,0.50,0.00,0,3.00,1,187.85,0,0,2,org.apache.lucene.index.FlushTicket,0.00,1,1,3,0,1,3,0,1,51,2
"org.apache.lucene.index.DocumentsWriterFlushQueue$SegmentFlushTicket",5,0.12,1.00,17,0.13,1723.83,7,2,6,6,2,133.22,0,23,0,2,133.22,0.00,0.50,0.60,0,0.00,1,377.98,0,0,2,org.apache.lucene.index.FlushTicket,0.00,1,1,5,0,1,5,0,0,98,2
"org.apache.lucene.index.DocumentsWriterPerThread",22,0.12,2.77,248,3.39,223686.28,48,26,17,80,41,120.98,76,329,22,1,100.36,0.00,0.00,0.16,5,10.00,13,10161.80,0,4,21,java.lang.Object,0.00,58,0,61,0,58,18,0,50,1761,1
"org.apache.lucene.index.DocumentsWriterPerThread$DocState",3,0.00,1.00,16,0.11,1454.35,10,7,17,4,5,173.78,3,20,0,1,123.78,0.00,0.00,0.14,0,5.00,1,342.74,0,0,5,java.lang.Object,0.00,1,0,3,0,1,3,0,3,86,1
"org.apache.lucene.index.DocumentsWriterPerThread$FlushedSegment",1,4.00,1.00,10,0.08,1135.64,5,4,17,1,3,109.64,0,13,0,1,109.64,0.00,0.00,0.00,0,1.00,1,235.38,0,0,3,java.lang.Object,0.00,0,0,1,0,0,1,0,0,60,1
"org.apache.lucene.index.DocumentsWriterPerThread$IndexingChain",1,0.00,1.00,2,0.01,52.70,1,0,17,1,2,146.21,0,3,0,1,146.21,0.00,0.00,0.00,0,1.00,1,31.26,0,0,2,java.lang.Object,0.00,0,0,1,0,0,1,0,0,12,2
"org.apache.lucene.index.DocumentsWriterPerThread$IndexingChain_0",1,0.00,1.00,8,0.12,2823.06,1,0,17,7,10,128.27,18,11,0,1,110.14,0.00,0.00,0.00,0,1.00,1,369.66,0,0,10,java.lang.Object,0.00,6,0,1,0,6,1,0,2,77,0
"org.apache.lucene.index.DocumentsWriterPerThreadPool",15,0.02,1.80,109,1.02,38713.03,19,4,3,32,10,94.60,89,130,6,1,112.47,0.00,0.00,0.23,1,2.00,4,3060.91,0,1,6,java.lang.Object,0.00,17,0,27,2,17,14,0,19,655,2
"org.apache.lucene.index.DocumentsWriterPerThreadPool$SuppressWarnings",6,0.05,1.17,25,0.19,3084.03,10,4,3,7,1,127.39,29,34,0,2,127.16,0.00,0.50,0.21,0,22.00,2,558.11,0,1,1,java.util.concurrent.locks.ReentrantLock,0.00,1,1,7,0,1,5,0,12,138,3
"org.apache.lucene.index.DocumentsWriterStallControl",4,0.17,1.50,17,0.14,2758.12,6,2,2,9,1,93.87,27,25,1,1,126.10,0.00,0.00,0.62,0,0.00,3,431.71,0,0,1,java.lang.Object,0.00,5,0,6,0,5,4,0,6,105,1
"org.apache.lucene.index.DocumentsWriterStallControl$SuppressWarnings",7,1.00,1.43,24,0.20,3137.35,8,1,2,11,0,132.24,2,37,0,2,132.24,0.00,0.50,0.14,1,12.00,3,591.58,0,0,0,java.util.concurrent.locks.AbstractQueuedSynchronizer,0.00,4,1,10,0,4,7,0,2,151,3
"org.apache.lucene.index.FieldFilterAtomicReader",9,0.12,1.89,38,0.49,13381.30,12,3,3,20,7,123.41,1,57,0,4,123.41,0.00,0.75,0.22,1,29.00,3,1467.69,5,1,7,org.apache.lucene.index.FilterAtomicReader,0.27,11,3,17,0,11,8,0,1,329,2
"org.apache.lucene.index.FieldFilterAtomicReader$FieldFilterFields",4,0.00,1.50,13,0.12,2658.53,4,0,3,6,3,130.88,1,22,0,2,130.88,0.00,0.50,0.00,1,4.00,2,362.86,1,0,3,org.apache.lucene.index.FilterFields,0.00,2,1,6,0,2,4,0,1,90,1
"org.apache.lucene.index.FieldFilterAtomicReader$FieldFilterFields$FilterFieldsEnum",1,0.00,3.00,6,0.06,1795.30,1,0,3,2,0,116.10,0,9,0,1,116.10,0.00,0.00,0.00,0,1.00,3,178.05,0,1,0,java.lang.Object,0.00,1,0,3,0,1,0,0,0,44,0
"org.apache.lucene.index.FieldFilterAtomicReader$StoredFieldVisitor",7,0.00,1.14,15,0.22,3841.77,7,0,3,15,1,138.17,0,29,0,1,138.17,0.00,0.00,0.00,0,7.00,2,674.35,0,0,1,java.lang.Object,0.00,8,0,8,0,8,7,0,0,166,0
"org.apache.lucene.index.FieldInfo",11,0.09,2.27,68,0.78,43020.24,20,9,1,14,130,95.62,59,93,130,1,113.50,0.00,0.00,0.19,0,32.00,9,2338.44,0,3,0,java.lang.Object,0.00,3,0,25,0,3,8,0,23,499,2
"org.apache.lucene.index.FieldInfo$IndexOptions",0,0.00,0.00,2,0.01,83.05,0,0,1,0,0,171.00,5,6,0,1,171.00,0.00,0.00,0.00,0,0.00,0,33.22,0,0,0,java.lang.Object,0.00,0,0,0,0,0,0,0,5,10,2
"org.apache.lucene.index.FieldInfos",32,0.05,1.88,155,1.75,51177.36,39,7,7,65,94,123.40,144,214,92,1,123.17,0.00,0.00,0.10,7,332.00,5,5260.06,0,5,2,java.lang.Object,0.00,33,0,60,0,33,27,1,43,1161,2
"org.apache.lucene.index.FieldInfos$FieldNumberBiMap",4,0.33,2.00,28,0.36,13928.52,7,3,7,12,0,132.04,13,39,0,1,111.43,0.00,0.00,0.58,1,0.00,4,1082.46,0,0,0,java.lang.Object,0.00,8,0,8,0,8,4,0,6,234,2
"org.apache.lucene.index.FieldInvertState",15,0.02,1.00,52,0.31,4095.85,24,9,1,15,38,173.90,44,68,37,1,134.02,0.00,0.00,0.13,0,113.00,1,928.89,0,2,1,java.lang.Object,0.00,0,0,15,0,0,13,0,10,253,2
"org.apache.lucene.index.Fields",4,1.00,2.00,19,0.18,6683.20,5,1,1,6,70,143.62,15,25,68,1,123.00,0.00,0.00,0.00,1,4.00,5,541.29,0,1,2,java.lang.Object,0.00,2,0,8,14,2,3,0,6,122,2
"org.apache.lucene.index.FieldsEnum",3,0.50,1.33,11,0.09,2184.74,5,2,2,5,53,88.31,22,15,51,1,130.60,0.00,0.00,0.17,0,4.00,2,279.18,0,3,2,java.lang.Object,0.00,2,0,4,9,2,0,0,13,73,2
"org.apache.lucene.index.FieldsEnum$FieldsEnum",2,0.00,1.00,5,0.03,359.83,2,0,2,3,1,142.01,0,9,0,1,142.01,0.00,0.00,0.00,0,2.00,1,94.73,0,2,1,java.lang.Object,0.00,1,0,2,0,1,0,0,0,29,0
"org.apache.lucene.index.FilterAtomicReader",15,0.07,1.00,50,0.44,7170.83,16,1,6,32,13,171.99,32,81,3,3,132.10,2.00,0.29,0.93,0,0.00,1,1328.38,1,4,10,org.apache.lucene.index.AtomicReader,0.46,17,2,15,4,17,11,0,12,339,1
"org.apache.lucene.index.FilterAtomicReader$FilterDocsAndPositionsEnum",11,0.10,1.00,24,0.22,3576.37,12,1,6,21,3,139.99,0,46,0,4,139.99,0.00,0.75,0.91,0,0.00,1,646.94,0,2,3,org.apache.lucene.index.DocsAndPositionsEnum,1.90,10,3,11,0,10,9,0,0,180,2
"org.apache.lucene.index.FilterAtomicReader$FilterDocsEnum",6,0.20,1.00,14,0.12,1995.87,7,1,6,11,2,139.91,0,26,0,3,139.91,0.00,0.67,0.83,0,0.00,1,361.68,0,1,2,org.apache.lucene.index.DocsEnum,1.36,5,2,6,0,5,5,0,0,102,2
"org.apache.lucene.index.FilterAtomicReader$FilterFields",5,0.25,1.00,12,0.11,1838.09,6,1,6,9,3,139.57,0,22,0,2,139.57,0.00,0.50,0.80,0,0.00,1,336.69,0,1,3,org.apache.lucene.index.Fields,0.67,4,1,5,0,4,4,0,0,92,2
"org.apache.lucene.index.FilterAtomicReader$FilterFieldsEnum",4,0.33,1.00,10,0.08,1336.63,5,1,6,7,3,139.90,0,18,0,2,139.90,0.00,0.50,0.75,0,0.00,1,251.68,0,3,3,org.apache.lucene.index.FieldsEnum,0.86,3,1,4,0,3,1,0,0,71,2
"org.apache.lucene.index.FilterAtomicReader$FilterTerms",8,0.14,1.00,18,0.19,3336.84,9,1,6,15,4,139.14,0,34,0,2,139.14,0.00,0.50,0.88,0,0.00,1,580.45,0,1,4,org.apache.lucene.index.Terms,0.80,7,1,8,0,7,7,0,0,153,2
"org.apache.lucene.index.FilterAtomicReader$FilterTermsEnum",15,0.07,1.00,32,0.36,6263.90,16,1,6,27,7,139.13,0,60,0,2,139.13,0.00,0.50,0.93,0,0.00,1,1092.19,0,4,7,org.apache.lucene.index.TermsEnum,0.50,12,1,15,0,12,11,0,0,285,2
"org.apache.lucene.index.FilteredTermsEnum",19,0.07,1.32,68,0.79,27868.44,23,4,5,34,24,128.44,84,107,17,2,128.20,12.00,0.07,0.18,2,39.00,7,2376.61,0,7,7,org.apache.lucene.index.TermsEnum,0.44,15,1,25,12,15,12,0,27,532,2
"org.apache.lucene.index.FilteredTermsEnum$AcceptStatus",0,0.00,0.00,2,0.01,95.13,0,0,5,0,0,171.00,0,1,0,1,171.00,0.00,0.00,0.00,0,0.00,0,38.05,0,0,0,java.lang.Object,0.00,0,0,0,0,0,0,0,0,11,2
"org.apache.lucene.index.FlushByRamOrCountsPolicy",6,0.00,2.33,30,0.53,17069.06,6,0,1,18,7,69.43,50,52,4,2,117.53,1.00,0.33,0.00,4,0.00,5,1591.90,1,0,4,org.apache.lucene.index.FlushPolicy,0.00,12,1,14,1,12,6,0,8,314,1
"org.apache.lucene.index.FlushPolicy",6,0.30,1.67,30,0.35,12932.40,8,2,4,16,7,70.08,62,42,5,1,118.56,0.00,0.00,0.25,3,10.00,4,1063.44,0,1,5,java.lang.Object,0.00,10,0,10,2,10,5,0,7,234,2
"org.apache.lucene.index.FreqProxTermsWriter",5,1.00,2.20,43,0.62,46220.53,6,1,9,23,12,106.14,22,57,2,2,105.90,0.00,0.50,0.00,0,5.00,7,1867.06,0,1,11,org.apache.lucene.index.TermsHashConsumer,0.40,18,1,11,0,18,4,0,12,321,1
"org.apache.lucene.index.FreqProxTermsWriterPerField",16,0.13,3.56,258,3.77,432024.04,29,13,13,60,23,111.51,60,310,3,2,90.90,0.00,0.50,0.20,3,24.00,24,11310.18,0,1,21,org.apache.lucene.index.TermsHashConsumerPerField,0.50,44,1,57,0,44,15,1,58,1868,1
"org.apache.lucene.index.FreqProxTermsWriterPerField$FreqProxPostingsArray",4,0.80,3.25,44,0.48,20605.56,9,5,13,6,2,152.65,6,61,0,2,102.65,0.00,0.50,0.80,0,0.00,4,1440.15,1,1,2,org.apache.lucene.index.ParallelPostingsArray,0.44,2,1,13,0,2,3,0,6,313,2
"org.apache.lucene.index.FrozenBufferedDeletes",7,0.13,1.71,52,0.66,28572.18,16,9,6,21,16,160.92,13,64,10,1,110.92,0.00,0.00,0.22,0,15.00,4,1978.55,0,1,6,java.lang.Object,0.00,14,0,12,0,14,6,0,10,384,0
"org.apache.lucene.index.FrozenBufferedDeletes$Iterable<QueryAndLimit>",1,0.00,1.00,3,0.02,282.15,1,0,6,2,0,133.91,0,5,0,1,133.91,0.00,0.00,0.00,0,1.00,1,66.26,0,1,0,java.lang.Object,0.00,1,0,1,0,1,0,0,0,20,0
"org.apache.lucene.index.FrozenBufferedDeletes$Iterable<QueryAndLimit>$Iterator<QueryAndLimit>",3,0.50,1.00,10,0.08,1633.35,4,1,6,5,0,131.66,0,16,0,1,131.66,0.00,0.00,0.67,0,1.00,1,253.96,0,1,0,java.lang.Object,0.00,2,0,3,0,2,2,0,0,67,0
"org.apache.lucene.index.FrozenBufferedDeletes$Iterable<Term>",1,0.00,1.00,3,0.03,456.90,1,0,6,1,0,132.26,0,5,0,1,132.26,0.00,0.00,0.00,0,0.00,1,84.38,0,1,0,java.lang.Object,0.00,0,0,1,0,0,0,0,0,24,0
"org.apache.lucene.index.IndexCommit",11,0.00,1.36,28,0.27,7694.42,11,0,4,16,39,137.53,46,37,38,1,137.30,0.00,0.00,0.00,2,11.00,4,803.61,0,4,1,java.lang.Object,0.00,5,0,15,4,5,7,1,9,201,2
"org.apache.lucene.index.IndexDeletionPolicy",2,0.00,1.00,3,0.04,438.42,2,0,2,2,25,166.35,69,4,25,1,152.57,0.00,0.00,0.00,0,2.00,1,114.61,0,0,0,,0.00,0,0,2,0,0,2,0,3,32,1
"org.apache.lucene.index.IndexFileDeleter",21,0.07,4.19,267,3.48,235357.14,33,12,12,70,9,50.42,183,342,1,1,98.53,0.00,0.00,0.15,9,121.00,26,10438.70,0,0,9,java.lang.Object,0.00,49,0,88,0,49,21,0,78,1849,1
"org.apache.lucene.index.IndexFileDeleter$CommitPoint",10,0.07,1.10,37,0.35,5988.79,18,8,12,17,3,131.31,4,58,0,2,131.31,0.00,0.50,0.19,0,58.00,2,1037.73,0,5,3,org.apache.lucene.index.IndexCommit,0.76,7,1,11,0,7,5,0,1,246,3
"org.apache.lucene.index.IndexFileDeleter$RefCount",3,0.33,1.33,15,0.14,2708.35,6,3,12,5,0,121.59,1,20,0,1,121.59,0.00,0.00,0.56,0,1.00,2,413.60,0,0,0,java.lang.Object,0.00,2,0,4,0,2,3,0,1,97,3
"org.apache.lucene.index.IndexFileNameFilter",2,0.50,1.50,9,0.11,2210.30,4,2,3,8,1,76.01,20,13,0,1,124.48,0.00,0.00,0.25,0,2.00,2,321.59,0,0,1,java.lang.Object,0.00,6,0,3,0,6,2,1,7,74,1
"org.apache.lucene.index.IndexFileNames",5,6.00,2.80,43,0.63,29137.13,11,6,1,15,77,97.07,75,62,77,1,107.42,0.00,0.00,0.00,1,5.00,4,1877.92,0,4,2,java.lang.Object,0.00,10,0,14,0,10,1,0,19,391,2
"org.apache.lucene.index.IndexFormatTooNewException",2,0.00,1.00,6,0.09,1233.23,2,0,1,3,8,151.85,6,10,6,3,131.23,0.00,0.67,0.00,0,2.00,1,261.79,0,0,2,org.apache.lucene.index.CorruptIndexException,0.00,1,2,2,0,1,2,0,3,65,1
"org.apache.lucene.index.IndexFormatTooOldException",4,0.00,1.00,11,0.14,1923.16,4,0,1,5,8,178.54,8,19,6,3,138.65,0.00,0.67,0.00,0,4.00,1,419.15,0,0,2,org.apache.lucene.index.CorruptIndexException,0.00,1,2,4,0,1,4,0,5,106,1
"org.apache.lucene.index.IndexNotFoundException",1,0.00,1.00,3,0.02,124.13,1,0,1,1,3,136.95,4,5,3,2,136.71,0.00,0.50,0.00,0,1.00,1,49.65,0,0,0,java.io.FileNotFoundException,0.00,0,1,1,0,0,1,0,1,17,2
"org.apache.lucene.index.IndexReader",34,0.13,1.38,108,1.11,26695.33,39,5,14,58,505,82.23,292,160,494,1,130.33,0.00,0.00,0.07,9,330.00,5,3340.88,0,5,17,java.lang.Object,0.00,24,0,47,18,24,29,1,50,786,2
"org.apache.lucene.index.IndexReader$ReaderClosedListener",1,0.00,1.00,2,0.01,52.70,1,0,14,1,1,146.21,0,3,0,1,146.21,0.00,0.00,0.00,0,1.00,1,31.26,0,0,1,,0.00,0,0,1,0,0,1,0,0,12,2
"org.apache.lucene.index.IndexReaderContext",4,4.00,1.25,14,0.13,3601.36,8,4,0,5,34,81.41,43,17,34,1,129.89,0.00,0.00,0.00,0,4.00,2,403.64,0,2,3,java.lang.Object,0.00,1,0,5,2,1,2,0,9,101,2
"org.apache.lucene.index.IndexSplitter",8,0.07,2.88,94,1.17,55749.00,12,4,11,42,6,122.26,27,102,2,1,101.65,0.00,0.00,0.31,3,0.00,7,3495.13,0,0,4,java.lang.Object,0.00,34,0,23,0,34,8,0,4,672,1
"org.apache.lucene.index.IndexUpgrader",6,0.20,3.17,73,1.05,44111.68,9,3,10,38,14,100.27,29,95,2,1,100.03,0.00,0.00,0.17,1,10.00,9,3155.78,0,0,12,java.lang.Object,0.00,32,0,19,0,32,6,0,4,584,2
"org.apache.lucene.index.IndexWriter",114,0.04,3.83,1382,18.96,1248121.81,154,40,35,362,278,61.06,1384,1869,246,1,98.63,0.00,0.00,0.06,54,5030.00,21,56877.11,0,13,41,java.lang.Object,0.00,248,0,437,11,248,101,2,432,9797,1
"org.apache.lucene.index.IndexWriter$IndexReaderWarmer",1,0.00,1.00,2,0.02,121.82,1,0,35,1,1,143.35,0,3,0,1,143.35,0.00,0.00,0.00,0,1.00,1,48.73,0,0,1,java.lang.Object,0.00,0,0,1,0,0,1,0,0,16,3
"org.apache.lucene.index.IndexWriter$ReaderPool",6,0.20,2.83,54,0.73,26692.61,7,1,35,22,4,74.21,38,71,0,1,106.44,0.00,0.00,0.83,1,0.00,4,2197.26,0,0,4,java.lang.Object,0.00,16,0,17,0,16,6,0,27,435,0
"org.apache.lucene.index.IndexWriterConfig",47,0.02,1.40,210,2.48,82005.67,79,32,10,70,152,74.83,382,279,136,1,122.94,0.00,0.00,0.05,1,1083.00,3,7427.21,1,32,20,java.lang.Object,0.00,23,0,66,0,23,15,1,66,1484,2
"org.apache.lucene.index.IndexWriterConfig$OpenMode",0,0.00,0.00,2,0.01,48.00,0,0,10,0,0,171.00,0,1,0,1,171.00,0.00,0.00,0.00,0,0.00,0,24.00,0,0,0,java.lang.Object,0.00,0,0,0,0,0,0,1,0,8,2
"org.apache.lucene.index.IndexableField",8,0.00,1.00,9,0.04,190.96,8,0,5,8,133,200.04,23,10,130,1,160.15,0.00,0.00,0.00,0,8.00,1,117.80,0,7,4,,0.00,0,0,8,0,0,1,0,11,48,1
"org.apache.lucene.index.IndexableFieldType",9,0.00,1.00,10,0.04,190.62,9,0,1,9,10,210.56,12,11,10,1,160.56,0.00,0.00,0.00,0,9.00,1,120.53,0,2,0,,0.00,0,0,9,0,0,7,0,10,51,1
"org.apache.lucene.index.IntBlockPool",3,0.75,2.00,27,0.31,10047.67,9,6,1,7,3,65.20,21,34,2,1,107.49,0.00,0.00,0.67,0,1.00,3,922.40,0,0,1,java.lang.Object,0.00,4,0,6,0,4,3,0,6,197,1
"org.apache.lucene.index.InvertedDocConsumer",6,0.00,1.00,7,0.05,344.04,6,0,2,6,7,157.15,4,8,3,1,157.15,0.00,0.00,0.00,0,6.00,1,157.65,0,0,4,java.lang.Object,0.00,0,0,6,1,0,6,0,3,52,1
"org.apache.lucene.index.InvertedDocConsumerPerField",5,0.00,1.00,6,0.04,245.05,5,0,1,5,6,207.69,9,7,5,1,157.69,0.00,0.00,0.00,0,5.00,1,121.58,0,0,1,java.lang.Object,0.00,0,0,5,1,0,5,0,9,42,1
"org.apache.lucene.index.InvertedDocEndConsumer",5,0.00,1.00,6,0.05,326.62,5,0,2,5,6,156.71,0,7,2,1,156.71,0.00,0.00,0.00,0,5.00,1,146.05,0,1,4,java.lang.Object,0.00,0,0,5,1,0,4,0,0,47,1
"org.apache.lucene.index.InvertedDocEndConsumerPerField",2,0.00,1.00,3,0.01,68.72,2,0,1,2,5,110.80,16,4,5,1,158.90,0.00,0.00,0.00,0,2.00,1,39.26,0,0,0,java.lang.Object,0.00,0,0,2,1,0,2,0,1,16,1
"org.apache.lucene.index.KeepOnlyLastCommitDeletionPolicy",2,0.00,2.50,10,0.10,2597.29,2,0,1,5,7,77.91,15,11,6,1,120.20,0.00,0.00,0.00,1,2.00,3,289.54,0,0,1,java.lang.Object,0.00,3,0,5,0,3,2,1,6,68,2
"org.apache.lucene.index.LogByteSizeMergePolicy",8,0.24,1.00,22,0.24,3308.52,11,3,1,8,18,121.29,43,32,16,3,139.17,1.00,0.40,0.12,0,14.00,1,707.27,1,0,2,org.apache.lucene.index.LogMergePolicy,0.07,0,2,8,2,0,8,0,10,188,1
"org.apache.lucene.index.LogDocMergePolicy",4,1.00,1.00,12,0.09,1008.38,5,1,1,4,17,86.19,34,18,15,3,134.29,0.50,0.50,0.25,0,0.00,1,260.78,1,0,2,org.apache.lucene.index.LogMergePolicy,0.08,0,2,4,1,0,4,0,7,73,1
"org.apache.lucene.index.LogMergePolicy",26,0.02,3.88,304,4.71,525051.50,38,12,5,63,44,65.72,165,381,39,2,97.94,5.00,0.14,0.10,7,210.00,25,14123.83,0,6,5,org.apache.lucene.index.MergePolicy,0.06,37,1,101,5,37,20,0,75,2432,2
"org.apache.lucene.index.LogMergePolicy$SegmentInfoAndLevel",2,0.33,2.00,10,0.11,2459.20,5,3,5,2,1,120.44,1,19,0,1,120.44,0.00,0.00,0.17,0,2.00,3,336.21,0,0,1,java.lang.Object,0.00,0,0,4,0,0,2,1,1,84,2
"org.apache.lucene.index.MergePolicy",7,1.00,1.00,15,0.17,2315.04,8,1,9,9,30,110.55,95,22,23,1,139.93,0.00,0.00,0.14,0,12.00,1,520.66,0,3,8,java.lang.Object,0.00,2,0,7,11,2,4,1,11,131,2
"org.apache.lucene.index.MergePolicy$MergeAbortedException",2,0.00,1.00,5,0.02,169.05,2,0,9,2,0,144.60,0,8,0,2,144.60,0.00,0.50,0.00,0,2.00,1,72.11,0,0,0,java.io.IOException,0.00,0,1,2,0,0,2,0,0,25,2
"org.apache.lucene.index.MergePolicy$MergeException",3,1.00,1.00,10,0.07,776.22,4,1,9,3,1,134.20,2,14,0,2,134.20,0.00,0.50,0.33,0,4.00,1,198.73,0,1,1,java.lang.RuntimeException,0.00,0,1,3,0,0,2,0,1,56,2
"org.apache.lucene.index.MergePolicy$MergeSpecification",2,0.00,1.50,14,0.17,5385.55,3,1,9,8,1,162.37,3,14,0,1,112.37,0.00,0.00,1.00,0,0.00,2,507.19,0,1,1,java.lang.Object,0.00,6,0,3,0,6,1,0,1,110,2
"org.apache.lucene.index.MergePolicy$OneMerge",12,0.03,2.17,74,0.70,22251.27,25,13,9,26,5,155.94,28,95,0,1,116.06,0.00,0.00,0.11,0,56.00,6,2090.16,0,3,5,java.lang.Object,0.00,14,0,26,0,14,9,0,18,446,2
"org.apache.lucene.index.MergeScheduler",2,0.00,1.00,3,0.03,189.68,2,0,1,2,15,155.67,9,6,14,1,155.43,0.00,0.00,0.00,0,2.00,1,78.19,0,0,2,java.lang.Object,0.00,0,0,2,7,0,2,0,3,25,2
"org.apache.lucene.index.MergeState",0,0.00,0.00,16,0.15,2130.75,13,13,6,0,29,171.00,13,16,22,1,171.00,0.00,0.00,0.00,0,0.00,0,443.91,0,0,7,java.lang.Object,0.00,0,0,0,0,0,0,0,11,88,1
"org.apache.lucene.index.MergeState$CheckAbort",2,0.33,1.50,14,0.13,2587.08,5,3,6,4,2,97.01,10,20,0,1,114.88,0.00,0.00,0.50,0,2.00,2,393.57,0,0,2,java.lang.Object,0.00,2,0,3,0,2,2,0,2,92,2
"org.apache.lucene.index.MergeState$CheckAbort$MergeState.CheckAbort",1,0.00,1.00,2,0.02,237.51,1,0,6,1,0,191.06,1,4,0,1,141.06,0.00,0.00,0.00,0,1.00,1,74.26,0,0,0,java.lang.Object,0.00,0,0,1,0,0,1,0,1,22,0
"org.apache.lucene.index.MergeState$IndexReaderAndLiveDocs",1,2.00,1.00,6,0.04,570.78,3,2,6,1,2,120.27,0,8,0,1,120.27,0.00,0.00,0.00,0,1.00,1,130.51,0,0,2,java.lang.Object,0.00,0,0,1,0,0,1,0,0,37,2
"org.apache.lucene.index.MockIndexInput",5,0.08,1.40,25,0.25,11049.40,8,3,1,6,2,168.51,7,36,1,4,118.51,0.00,0.75,0.40,0,5.00,3,755.25,0,0,1,org.apache.lucene.store.BufferedIndexInput,0.34,1,3,7,0,1,5,0,5,169,1
"org.apache.lucene.index.MockRandomMergePolicy",6,0.60,2.50,41,0.68,44264.57,7,1,7,24,5,161.30,11,62,0,2,111.30,0.00,0.50,0.50,1,6.00,9,2032.58,0,0,5,org.apache.lucene.index.MergePolicy,0.62,18,1,15,0,18,6,0,9,373,1
"org.apache.lucene.index.MultiDocValues",8,0.03,1.88,65,0.94,64458.41,13,5,14,24,20,127.02,30,84,11,2,106.41,0.00,0.50,0.22,1,26.00,8,2826.69,0,1,9,org.apache.lucene.index.DocValues,0.47,16,1,15,0,16,7,0,10,527,1
"org.apache.lucene.index.MultiDocValues$DocValuesPuller",2,0.00,1.00,7,0.08,1531.41,2,0,14,5,4,130.49,1,9,0,1,130.49,0.00,0.00,0.00,0,2.00,1,247.97,0,0,4,java.lang.Object,0.00,3,0,2,0,3,2,0,1,59,0
"org.apache.lucene.index.MultiDocValues$DocValuesPuller_0",2,0.00,1.00,5,0.05,490.80,2,0,14,3,2,140.95,0,8,0,1,140.95,0.00,0.00,0.00,0,2.00,1,135.24,0,0,2,java.lang.Object,0.00,1,0,2,0,1,2,0,0,37,2
"org.apache.lucene.index.MultiDocValues$DocValuesSlice",1,4.00,1.00,9,0.08,1519.80,5,4,14,1,1,110.35,0,11,0,1,110.35,0.00,0.00,0.00,0,1.00,1,234.41,0,0,1,java.lang.Object,0.00,0,0,1,0,0,1,0,0,60,2
"org.apache.lucene.index.MultiDocValues$EmptyDocValues",4,0.17,1.00,12,0.10,1337.68,6,2,14,6,1,133.32,0,20,0,2,133.32,0.00,0.50,0.38,0,0.00,1,294.41,0,1,1,org.apache.lucene.index.DocValues,0.46,2,1,4,0,2,3,0,0,80,2
"org.apache.lucene.index.MultiDocValues$EmptyFixedDocValues",5,0.08,1.00,16,0.13,2013.82,8,3,14,7,1,132.69,0,26,0,2,132.69,0.00,0.50,0.27,0,5.00,1,389.94,0,1,1,org.apache.lucene.index.DocValues,0.57,2,1,5,0,2,4,0,0,105,2
"org.apache.lucene.index.MultiDocValues$EmptyFixedSource",5,0.12,1.00,21,0.21,3722.06,7,2,14,7,1,125.93,0,32,0,2,125.93,0.00,0.50,0.40,0,6.00,1,625.07,0,2,1,org.apache.lucene.index.EmptySource,0.00,2,1,5,0,2,3,0,0,150,2
"org.apache.lucene.index.MultiDocValues$EmptySource",9,0.00,1.11,23,0.20,3157.54,9,0,14,11,1,139.70,0,42,0,2,139.70,0.00,0.50,0.00,0,9.00,2,598.81,1,3,1,org.apache.lucene.index.SortedSource,0.00,2,1,10,0,2,6,0,0,160,2
"org.apache.lucene.index.MultiDocValues$MultiSortedSource",5,0.00,1.20,27,0.31,9399.98,10,5,14,7,2,119.10,0,38,0,2,119.10,0.00,0.50,0.20,0,13.00,2,921.21,0,2,2,org.apache.lucene.index.SortedSource,0.00,2,1,6,0,2,3,0,0,203,3
"org.apache.lucene.index.MultiDocValues$MultiSource",10,0.06,3.40,132,1.70,136473.80,17,7,14,34,4,96.60,7,164,0,2,96.60,0.00,0.50,0.20,2,26.00,11,5098.84,1,2,4,org.apache.lucene.index.Source,0.00,24,1,34,0,24,8,0,5,931,2
"org.apache.lucene.index.MultiDocValues$ReaderUtil.Gather",1,0.00,4.00,13,0.20,7207.35,2,1,14,10,3,148.75,1,17,0,1,98.75,0.00,0.00,1.00,0,0.00,4,607.05,0,0,3,java.lang.Object,0.00,9,0,4,0,9,1,0,1,116,0
"org.apache.lucene.index.MultiDocValues$RecordingBytesRefConsumer",2,0.33,2.50,12,0.18,4629.96,5,3,14,5,3,115.27,0,18,0,1,115.27,0.00,0.00,0.50,0,0.00,3,525.83,0,0,3,java.lang.Object,0.00,3,0,5,0,3,2,1,0,112,3
"org.apache.lucene.index.MultiDocsAndPositionsEnum",14,0.08,1.64,74,0.75,33000.63,22,8,3,23,7,118.26,6,103,4,4,118.26,0.00,0.75,0.20,0,10.00,5,2244.46,0,2,4,org.apache.lucene.index.DocsAndPositionsEnum,1.50,9,3,23,0,9,12,0,2,488,2
"org.apache.lucene.index.MultiDocsAndPositionsEnum$EnumWithSlice",0,0.00,0.00,3,0.02,233.13,2,2,3,0,1,171.00,0,4,0,1,171.00,0.00,0.00,0.00,0,0.00,0,66.61,0,0,1,java.lang.Object,0.00,0,0,0,0,0,0,0,0,18,3
"org.apache.lucene.index.MultiDocsEnum",10,0.10,1.90,66,0.68,31005.94,18,8,3,15,9,114.33,6,86,7,3,114.33,0.00,0.67,0.21,1,34.00,5,2027.94,0,3,3,org.apache.lucene.index.DocsEnum,0.80,5,2,19,0,5,7,0,2,429,2
"org.apache.lucene.index.MultiDocsEnum$EnumWithSlice",1,0.00,1.00,5,0.05,598.63,3,2,3,2,1,123.06,0,9,0,1,123.06,0.00,0.00,1.00,0,0.00,1,135.14,0,1,1,java.lang.Object,0.00,1,0,1,0,1,0,0,0,36,3
"org.apache.lucene.index.MultiFields",12,0.24,2.92,120,1.64,80664.87,15,3,12,54,106,123.93,41,154,91,2,103.31,0.00,0.50,0.11,2,28.00,5,4919.62,0,9,16,org.apache.lucene.index.Fields,0.25,42,1,35,0,42,3,0,15,949,2
"org.apache.lucene.index.MultiFields$ReaderUtil.Gather",1,0.00,2.00,6,0.10,2844.48,1,0,12,7,2,114.61,0,9,0,1,114.61,0.00,0.00,0.00,0,1.00,2,297.09,0,0,2,java.lang.Object,0.00,6,0,2,0,6,1,0,0,63,0
"org.apache.lucene.index.MultiFields$ReaderUtil.Gather_0",1,0.00,1.00,4,0.05,654.94,1,0,12,4,1,176.36,1,6,0,1,126.36,0.00,0.00,0.00,0,1.00,1,140.58,0,0,1,java.lang.Object,0.00,3,0,1,0,3,1,0,1,36,0
"org.apache.lucene.index.MultiFieldsEnum",3,0.60,3.33,45,0.57,35919.27,8,5,5,15,6,76.86,17,52,1,2,94.74,0.00,0.50,0.60,0,0.00,6,1701.54,0,2,6,org.apache.lucene.index.FieldsEnum,0.67,12,1,10,0,12,1,0,10,327,2
"org.apache.lucene.index.MultiFieldsEnum$FieldMergeQueue",2,0.00,1.00,5,0.06,972.35,2,0,5,3,1,138.61,1,9,0,2,138.61,0.00,0.50,0.00,0,2.00,1,175.20,0,0,1,org.apache.lucene.util.PriorityQueue,0.00,1,1,2,0,1,2,0,1,47,3
"org.apache.lucene.index.MultiFieldsEnum$FieldsEnumWithSlice",1,5.00,1.00,11,0.13,3135.51,6,5,5,1,1,104.62,0,13,0,1,104.62,0.00,0.00,0.00,0,1.00,1,384.70,0,0,1,java.lang.Object,0.00,0,0,1,0,0,1,0,0,85,3
"org.apache.lucene.index.MultiPassIndexSplitter",2,0.00,12.50,100,1.50,143571.01,2,0,10,34,12,95.09,38,111,2,1,68.80,0.00,0.00,0.00,0,2.00,15,4503.99,0,0,10,java.lang.Object,0.00,32,0,25,0,32,2,0,12,711,1
"org.apache.lucene.index.MultiPassIndexSplitter$FakeDeleteAtomicIndexReader",6,0.40,1.50,26,0.23,7488.06,7,1,10,14,4,124.07,3,35,0,4,124.07,0.00,0.75,0.67,2,0.00,4,697.31,0,1,4,org.apache.lucene.index.FilterAtomicReader,0.17,8,3,9,0,8,5,0,3,165,3
"org.apache.lucene.index.MultiPassIndexSplitter$FakeDeleteIndexReader",4,0.00,1.25,14,0.15,3653.63,4,0,10,11,3,129.84,2,19,0,5,129.84,0.00,0.80,0.00,1,6.00,2,464.11,1,0,3,org.apache.lucene.index.MultiReader,0.00,7,4,5,0,7,4,0,2,114,3
"org.apache.lucene.index.MultiPassIndexSplitter$FakeDeleteIndexReader$ReaderUtil.Gather",1,0.00,1.00,3,0.03,431.30,1,0,10,3,1,132.45,0,5,0,1,132.45,0.00,0.00,0.00,0,1.00,1,103.65,0,0,1,java.lang.Object,0.00,2,0,1,0,2,1,0,0,28,0
"org.apache.lucene.index.MultiReader",3,1.00,3.33,26,0.25,11129.37,4,1,1,5,16,60.45,30,31,14,4,108.93,0.67,0.50,0.33,0,4.00,6,744.38,0,0,2,org.apache.lucene.index.BaseCompositeReader,0.08,2,3,10,2,2,3,0,4,157,1
"org.apache.lucene.index.MultiTerms",8,0.10,2.88,76,0.91,46679.12,11,3,7,23,7,155.51,8,95,1,2,105.51,0.00,0.50,0.25,0,24.00,4,2726.27,0,1,6,org.apache.lucene.index.Terms,0.80,15,1,23,0,15,7,0,3,534,2
"org.apache.lucene.index.MultiTermsEnum",18,0.17,3.83,289,3.62,329432.36,31,13,9,55,12,112.82,70,338,3,2,92.21,0.00,0.50,0.24,3,0.00,11,10850.97,0,6,11,org.apache.lucene.index.TermsEnum,0.32,37,1,69,0,37,12,0,64,1942,2
"org.apache.lucene.index.MultiTermsEnum$TermMergeQueue",2,1.00,1.50,10,0.12,3423.52,3,1,9,3,2,119.37,0,16,0,2,119.37,0.00,0.50,0.50,0,2.00,2,351.51,0,0,2,org.apache.lucene.util.PriorityQueue,0.00,1,1,3,0,1,2,0,0,81,3
"org.apache.lucene.index.MultiTermsEnum$TermsEnumIndex",1,3.00,1.00,7,0.06,1042.35,4,3,9,1,1,115.71,0,9,0,1,115.71,0.00,0.00,0.00,0,1.00,1,183.70,0,0,1,java.lang.Object,0.00,0,0,1,0,0,1,0,0,48,2
"org.apache.lucene.index.MultiTermsEnum$TermsEnumWithSlice",3,0.00,1.00,14,0.14,2509.03,7,4,9,4,2,125.53,0,19,0,1,125.53,0.00,0.00,0.25,0,5.00,1,413.07,0,1,2,java.lang.Object,0.00,1,0,3,0,1,2,0,0,101,3
"org.apache.lucene.index.NoDeletionPolicy",3,1.00,1.67,5,0.06,993.49,4,1,2,4,6,190.92,7,7,5,1,151.04,0.00,0.00,0.00,0,3.00,2,181.21,0,0,1,java.lang.Object,0.00,1,0,5,0,1,3,1,3,50,2
"org.apache.lucene.index.NoMergePolicy",8,0.33,1.00,18,0.19,2978.87,11,3,2,9,25,179.41,18,28,20,2,139.53,0.00,0.50,0.04,0,14.00,1,576.83,0,4,5,org.apache.lucene.index.MergePolicy,0.13,1,1,8,0,1,4,0,4,149,2
"org.apache.lucene.index.NoMergeScheduler",3,1.00,1.00,5,0.05,760.11,4,1,1,4,6,152.31,12,9,3,2,152.07,0.00,0.50,0.00,0,3.00,1,143.67,0,0,3,org.apache.lucene.index.MergeScheduler,0.40,1,1,3,0,1,3,0,3,43,2
"org.apache.lucene.index.Norm",11,0.35,1.64,45,0.52,13157.28,13,2,4,21,38,144.81,41,75,35,1,124.19,0.00,0.00,0.18,1,35.00,6,1567.34,0,2,4,java.lang.Object,0.00,10,0,18,0,10,9,0,11,348,2
"org.apache.lucene.index.NormsConsumer",8,0.21,2.12,42,0.49,24508.04,10,2,8,21,13,167.30,10,64,2,2,117.30,0.00,0.50,0.31,0,16.00,8,1483.05,0,1,12,org.apache.lucene.index.InvertedDocEndConsumer,0.62,13,1,17,0,13,7,0,6,302,1
"org.apache.lucene.index.NormsConsumerPerField",7,0.23,1.71,41,0.48,10657.26,15,8,4,18,10,119.74,3,57,2,2,119.74,0.00,0.50,0.32,1,5.00,3,1430.61,0,2,9,org.apache.lucene.index.InvertedDocEndConsumerPerField,0.44,11,1,12,0,11,5,1,3,306,1
"org.apache.lucene.index.OrdTermState",2,0.00,1.00,7,0.08,1647.50,3,1,0,4,6,81.76,21,12,5,2,130.24,4.00,0.17,1.00,0,0.00,1,242.01,0,1,1,org.apache.lucene.index.TermState,0.80,2,1,2,4,2,1,0,2,60,1
"org.apache.lucene.index.PKIndexSplitter",7,0.03,1.43,51,0.63,18184.17,13,6,11,19,15,162.50,13,67,1,1,112.50,0.00,0.00,0.14,1,12.00,3,1904.28,0,0,14,java.lang.Object,0.00,12,0,10,0,12,7,0,4,401,1
"org.apache.lucene.index.PKIndexSplitter$DocumentFilteredAtomicIndexReader",4,0.17,2.50,32,0.38,15306.17,6,2,11,17,7,108.89,2,43,0,4,108.89,0.00,0.75,0.38,0,4.00,7,1151.02,0,1,7,org.apache.lucene.index.FilterAtomicReader,0.17,13,3,10,0,13,3,0,2,223,2
"org.apache.lucene.index.ParallelAtomicReader",15,0.01,2.87,119,1.57,92032.78,26,11,9,52,15,149.29,35,159,6,3,109.41,0.00,0.67,0.10,0,117.00,15,4708.78,1,3,9,org.apache.lucene.index.AtomicReader,0.37,37,2,43,0,37,12,0,14,891,2
"org.apache.lucene.index.ParallelAtomicReader$ParallelFields",5,0.50,1.00,11,0.12,1858.79,6,1,9,10,3,139.53,0,21,0,2,139.53,0.00,0.50,0.60,0,2.00,1,367.39,0,1,3,org.apache.lucene.index.Fields,0.44,5,1,5,0,5,4,0,0,95,2
"org.apache.lucene.index.ParallelAtomicReader$ParallelFieldsEnum",3,0.33,1.33,15,0.13,2408.00,6,3,9,8,2,121.99,0,22,0,2,121.99,0.00,0.50,0.56,0,0.00,2,395.36,0,2,2,org.apache.lucene.index.FieldsEnum,0.67,5,1,4,0,5,1,0,0,100,2
"org.apache.lucene.index.ParallelCompositeReader",7,0.42,4.57,107,1.41,184060.88,9,2,5,25,8,74.10,39,111,3,4,91.97,0.00,0.75,0.14,2,17.00,10,4227.36,0,2,5,org.apache.lucene.index.BaseCompositeReader,0.15,18,3,32,0,18,5,0,13,796,2
"org.apache.lucene.index.ParallelPostingsArray",5,0.15,1.00,24,0.22,3992.20,10,5,2,8,10,125.69,0,30,8,1,125.69,0.00,0.00,0.32,2,13.00,1,666.66,0,2,2,java.lang.Object,0.00,3,0,5,2,3,3,0,0,167,0
"org.apache.lucene.index.Payload",14,0.13,1.71,58,0.67,25889.69,17,3,2,20,48,104.82,74,88,46,1,122.69,0.00,0.00,0.21,2,38.00,6,2005.13,1,1,2,java.lang.Object,0.00,6,0,24,0,6,13,1,22,455,1
"org.apache.lucene.index.PayloadProcessorProvider",1,0.00,1.00,4,0.03,210.55,1,0,3,1,9,118.18,38,5,6,1,130.25,0.00,0.00,0.00,0,1.00,1,84.22,0,1,3,java.lang.Object,0.00,0,0,1,2,0,0,0,4,27,2
"org.apache.lucene.index.PayloadProcessorProvider$PayloadProcessor",1,0.00,1.00,2,0.02,121.82,1,0,3,1,1,193.35,1,3,0,1,143.35,0.00,0.00,0.00,0,1.00,1,48.73,0,0,1,java.lang.Object,0.00,0,0,1,0,0,1,0,1,16,3
"org.apache.lucene.index.PayloadProcessorProvider$ReaderPayloadProcessor",1,0.00,1.00,2,0.02,146.32,1,0,3,1,1,192.72,1,3,0,1,142.72,0.00,0.00,0.00,0,1.00,1,58.53,0,0,1,java.lang.Object,0.00,0,0,1,0,0,1,0,1,18,3
"org.apache.lucene.index.PerDocWriteState",3,0.29,1.00,32,0.31,5858.53,10,7,5,4,27,147.67,6,38,20,1,107.78,0.00,0.00,0.33,0,4.00,1,916.69,0,0,7,java.lang.Object,0.00,1,0,3,0,1,3,0,1,217,1
"org.apache.lucene.index.PersistentSnapshotDeletionPolicy",7,0.08,2.71,60,0.85,36387.90,9,2,12,36,14,59.34,74,85,1,2,107.82,0.00,0.50,0.43,1,8.00,5,2547.69,5,1,13,org.apache.lucene.index.SnapshotDeletionPolicy,0.00,29,1,19,0,29,6,0,24,485,1
"org.apache.lucene.index.PrefixCodedTerms",3,1.00,1.00,10,0.08,1043.29,4,1,7,5,8,173.08,7,14,3,1,133.19,0.00,0.00,0.33,0,4.00,1,227.61,0,1,5,java.lang.Object,0.00,2,0,3,0,2,2,1,4,62,0
"org.apache.lucene.index.PrefixCodedTerms$Builder",3,0.17,2.67,34,0.47,28163.58,6,3,7,17,5,100.65,2,45,0,1,100.65,0.00,0.00,0.44,1,1.00,3,1405.79,0,0,5,java.lang.Object,0.00,14,0,8,0,14,3,0,2,281,2
"org.apache.lucene.index.PrefixCodedTerms$PrefixCodedTermsIterator",4,0.17,1.75,27,0.29,10845.27,8,4,7,16,4,114.81,1,37,0,1,114.81,0.00,0.00,0.38,1,0.00,3,870.83,0,0,4,java.lang.Object,0.00,12,0,7,0,12,4,1,1,186,0
"org.apache.lucene.index.RandomCodec",3,0.33,2.00,33,0.66,31454.43,6,3,20,32,14,68.11,20,42,1,3,100.33,0.00,0.67,0.56,0,0.00,3,1983.46,1,2,13,org.apache.lucene.codecs.lucene40.Lucene40Codec,0.10,29,2,6,0,29,1,0,12,375,1
"org.apache.lucene.index.RandomDocumentsWriterPerThreadPool",2,0.33,4.00,39,0.41,25974.92,5,3,1,8,2,42.48,16,51,0,2,90.59,0.00,0.50,0.50,0,0.00,7,1225.49,2,0,2,org.apache.lucene.index.DocumentsWriterPerThreadPool,0.00,6,1,8,0,6,2,0,4,237,1
"org.apache.lucene.index.RandomIndexWriter",29,0.06,2.10,163,2.22,90304.62,41,12,18,73,173,167.25,50,226,156,1,117.25,0.00,0.00,0.14,6,0.00,12,6645.37,0,0,17,java.lang.Object,0.00,44,0,61,0,44,29,1,26,1304,1
"org.apache.lucene.index.RandomIndexWriter$Iterable<Iterable<T>>",1,0.00,1.00,3,0.03,389.47,1,0,18,2,0,132.80,0,5,0,1,132.80,0.00,0.00,0.00,0,1.00,1,87.28,0,1,0,java.lang.Object,0.00,1,0,1,0,1,0,0,0,26,0
"org.apache.lucene.index.RandomIndexWriter$Iterable<Iterable<T>>$Iterator<Iterable<T>>",3,0.50,1.33,11,0.09,1409.24,4,1,18,5,0,132.10,0,18,0,1,132.10,0.00,0.00,0.67,0,1.00,2,255.07,0,0,0,java.lang.Object,0.00,2,0,4,0,2,3,0,0,67,0
"org.apache.lucene.index.RandomIndexWriter$Iterable<Iterable<T>>_0",1,0.00,1.00,3,0.03,389.47,1,0,18,2,0,132.80,0,5,0,1,132.80,0.00,0.00,0.00,0,1.00,1,87.28,0,1,0,java.lang.Object,0.00,1,0,1,0,1,0,0,0,26,0
"org.apache.lucene.index.RandomIndexWriter$Iterable<Iterable<T>>_0$Iterator<Iterable<T>>_1",3,0.50,1.33,11,0.09,1409.24,4,1,18,5,0,132.10,0,18,0,1,132.10,0.00,0.00,0.67,0,1.00,2,255.07,0,0,0,java.lang.Object,0.00,2,0,4,0,2,3,0,0,67,0
"org.apache.lucene.index.RandomIndexWriter$MockIndexWriter",2,1.00,1.50,8,0.09,1373.19,3,1,18,5,3,176.11,3,13,0,2,126.11,0.00,0.50,0.50,0,2.00,2,283.99,0,0,3,org.apache.lucene.index.IndexWriter,0.00,3,1,3,0,3,2,0,3,69,3
"org.apache.lucene.index.ReadersAndLiveDocs",18,0.20,1.94,128,1.34,50772.50,26,8,7,43,11,112.39,77,164,4,1,112.15,0.00,0.00,0.31,2,10.00,4,4011.31,0,6,8,java.lang.Object,0.00,25,0,35,0,25,12,0,73,835,0
"org.apache.lucene.index.RepeatingTokenizer",3,0.33,1.67,27,0.24,4361.91,9,6,14,7,10,110.38,0,35,1,4,110.38,0.00,0.75,0.39,0,1.00,2,730.90,1,0,9,org.apache.lucene.analysis.Tokenizer,0.47,4,3,5,0,4,3,0,0,162,0
"org.apache.lucene.index.SegmentCoreReaders",7,0.20,1.86,63,0.81,29922.18,18,11,17,36,16,146.56,20,84,1,1,106.67,0.00,0.00,0.26,2,18.00,5,2425.43,0,1,16,java.lang.Object,0.00,29,0,13,0,29,6,0,19,445,1
"org.apache.lucene.index.SegmentCoreReaders$CloseableThreadLocal<StoredFieldsReader>",1,0.00,1.00,3,0.02,259.92,1,0,17,1,1,134.19,0,5,0,1,134.19,0.00,0.00,0.00,0,0.00,1,69.84,0,1,1,java.lang.Object,0.00,0,0,1,0,0,0,0,0,21,0
"org.apache.lucene.index.SegmentCoreReaders$CloseableThreadLocal<TermVectorsReader>",1,0.00,2.00,3,0.03,679.13,1,0,17,1,1,130.74,0,6,0,1,130.74,0.00,0.00,0.00,0,0.00,2,103.65,0,1,1,java.lang.Object,0.00,0,0,2,0,0,0,0,0,28,0
"org.apache.lucene.index.SegmentInfo",42,0.05,1.69,240,2.61,94101.29,66,24,14,70,113,139.04,155,320,107,1,118.42,0.00,0.00,0.09,6,974.00,9,7842.33,0,10,8,java.lang.Object,0.00,28,0,71,0,28,32,1,80,1605,2
"org.apache.lucene.index.SegmentInfos",51,0.01,2.12,338,3.94,158873.44,73,22,25,136,54,114.53,227,460,39,1,114.29,0.00,0.00,0.05,18,1367.00,8,11811.40,1,15,17,java.lang.Object,0.00,85,0,108,0,85,36,2,103,2349,2
"org.apache.lucene.index.SegmentInfos$FindSegmentsFile",1,0.00,1.00,4,0.03,377.93,1,0,25,2,1,128.25,0,6,0,1,128.25,0.00,0.00,0.00,0,1.00,1,97.45,0,1,1,java.lang.Object,0.00,1,0,1,0,1,0,0,0,26,0
"org.apache.lucene.index.SegmentInfos$FindSegmentsFile_0",4,1.00,9.25,93,1.37,167720.95,5,1,25,19,8,45.73,51,137,0,1,83.29,0.00,0.00,0.25,2,6.00,34,4109.28,0,3,8,java.lang.Object,0.00,15,0,37,0,15,1,0,46,624,3
"org.apache.lucene.index.SegmentMerger",15,0.23,3.27,208,2.77,153196.59,21,6,17,83,30,97.84,63,261,4,1,97.60,0.00,0.00,0.38,8,0.00,8,8307.19,0,1,26,java.lang.Object,0.00,68,0,49,0,68,14,0,40,1540,1
"org.apache.lucene.index.SegmentMerger$ReaderUtil.Gather",1,0.00,1.00,3,0.05,614.19,1,0,17,4,1,131.25,0,5,0,1,131.25,0.00,0.00,0.00,0,1.00,1,142.84,0,0,1,java.lang.Object,0.00,3,0,1,0,3,1,0,0,36,0
"org.apache.lucene.index.SegmentReadState",3,6.00,1.00,23,0.24,3768.51,9,6,2,3,41,154.96,8,34,37,1,115.07,0.00,0.00,0.00,0,3.00,1,705.76,0,0,4,java.lang.Object,0.00,0,0,3,0,0,3,0,6,168,1
"org.apache.lucene.index.SegmentReader",25,0.02,1.24,93,0.92,21704.40,29,4,8,43,46,169.90,69,139,32,3,130.01,0.00,0.67,0.23,3,157.00,3,2767.49,1,8,15,org.apache.lucene.index.AtomicReader,0.40,18,2,31,0,18,17,0,39,641,2
"org.apache.lucene.index.SegmentReader$CoreClosedListener",1,0.00,1.00,2,0.01,52.70,1,0,8,1,1,146.21,0,3,0,1,146.21,0.00,0.00,0.00,0,1.00,1,31.26,0,0,1,,0.00,0,0,1,0,0,1,0,0,12,2
"org.apache.lucene.index.SegmentWriteState",2,0.75,1.00,36,0.35,6064.73,14,12,5,2,53,46.76,19,40,46,1,96.76,0.00,0.00,0.46,0,2.00,1,1052.53,0,0,7,java.lang.Object,0.00,0,0,2,0,0,2,0,10,227,1
"org.apache.lucene.index.SerialMergeScheduler",2,0.00,2.00,7,0.08,2050.42,2,0,1,4,18,169.22,5,14,15,2,129.33,1.00,0.33,0.00,0,2.00,3,228.37,0,0,3,org.apache.lucene.index.MergeScheduler,0.50,2,1,4,1,2,2,0,2,55,1
"org.apache.lucene.index.SingleTermsEnum",2,0.00,1.50,8,0.08,1178.82,3,1,3,3,7,84.34,14,12,4,3,126.63,0.00,0.67,1.00,0,0.00,2,235.17,1,1,4,org.apache.lucene.index.FilteredTermsEnum,0.00,1,2,3,0,1,1,0,2,60,2
"org.apache.lucene.index.SlowCompositeReaderWrapper",16,0.03,1.12,57,0.53,10253.54,20,4,7,33,46,181.07,23,91,32,3,131.07,0.00,0.67,0.28,0,0.00,2,1576.70,1,8,14,org.apache.lucene.index.AtomicReader,0.45,17,2,18,0,17,8,0,6,386,2
"org.apache.lucene.index.SnapshotDeletionPolicy",12,0.02,2.83,84,1.13,47019.45,16,4,10,37,9,60.94,115,113,6,1,110.94,0.00,0.00,0.27,4,30.00,10,3387.35,0,2,3,java.lang.Object,0.00,25,0,34,1,25,10,1,21,689,1
"org.apache.lucene.index.SnapshotDeletionPolicy$SnapshotCommitPoint",11,0.20,1.09,26,0.23,3640.70,12,1,10,19,3,139.91,6,49,0,2,139.91,0.00,0.50,0.82,2,0.00,2,686.04,0,5,3,org.apache.lucene.index.IndexCommit,0.73,8,1,12,0,8,6,0,3,188,1
"org.apache.lucene.index.SnapshotDeletionPolicy$SnapshotInfo",2,0.00,1.00,10,0.07,1118.76,5,3,10,2,1,123.29,0,14,0,1,123.29,0.00,0.00,0.33,0,2.00,1,221.39,0,1,1,java.lang.Object,0.00,0,0,2,0,0,1,0,0,61,2
"org.apache.lucene.index.SortedBytesMergeUtils",5,0.00,3.40,80,1.20,98690.75,5,0,13,24,11,74.10,27,98,5,1,91.98,0.00,0.00,0.00,1,5.00,5,3597.01,0,1,6,java.lang.Object,0.00,19,0,17,0,19,4,0,12,652,2
"org.apache.lucene.index.SortedBytesMergeUtils$BytesRefConsumer",1,0.00,1.00,2,0.02,119.43,1,0,13,1,1,143.41,0,3,0,1,143.41,0.00,0.00,0.00,0,1.00,1,59.72,0,0,1,,0.00,0,0,1,0,0,1,0,0,18,2
"org.apache.lucene.index.SortedBytesMergeUtils$IndexOutputBytesRefConsumer",2,1.00,1.00,6,0.07,1006.05,3,1,13,3,2,131.93,0,11,0,1,131.93,0.00,0.00,0.50,0,2.00,1,221.82,0,0,2,java.lang.Object,0.00,1,0,2,0,1,2,1,0,56,3
"org.apache.lucene.index.SortedBytesMergeUtils$MergeContext",2,0.17,1.50,18,0.21,6918.49,8,6,13,4,1,157.44,2,23,0,1,107.44,0.00,0.00,0.25,0,0.00,2,615.77,0,0,1,java.lang.Object,0.00,2,0,3,0,2,2,0,2,130,3
"org.apache.lucene.index.SortedBytesMergeUtils$MergeQueue",2,1.00,1.50,11,0.13,3265.14,3,1,13,3,2,119.53,1,17,0,2,119.53,0.00,0.50,0.50,0,2.00,2,381.14,0,0,2,org.apache.lucene.util.PriorityQueue,0.00,1,1,3,0,1,2,0,1,88,3
"org.apache.lucene.index.SortedBytesMergeUtils$MissingValueSource",5,1.00,1.00,14,0.11,1503.85,6,1,13,6,1,140.26,0,24,0,2,140.26,0.00,0.50,0.20,0,8.00,1,342.70,0,2,1,org.apache.lucene.index.DocValues.SortedSource,0.00,1,1,5,0,1,3,0,0,94,3
"org.apache.lucene.index.SortedBytesMergeUtils$RecordMerger",3,0.70,2.33,30,0.32,12033.56,8,5,13,9,1,155.13,4,36,0,1,105.13,0.00,0.00,0.67,0,1.00,3,968.39,0,0,1,java.lang.Object,0.00,6,0,7,0,6,3,0,4,206,3
"org.apache.lucene.index.SortedBytesMergeUtils$SortedSourceSlice",5,0.09,2.00,50,0.52,18849.23,13,8,13,9,1,145.26,11,53,0,1,105.38,0.00,0.00,0.20,0,2.00,3,1546.09,0,1,1,java.lang.Object,0.00,4,0,10,0,4,4,0,6,329,2
"org.apache.lucene.index.StandardDirectoryReader",15,0.04,3.40,177,2.42,211496.22,19,4,10,73,14,139.08,39,225,4,5,99.20,0.00,0.80,0.22,4,24.00,15,7256.73,1,11,12,org.apache.lucene.index.DirectoryReader,0.38,58,4,51,0,58,4,0,39,1306,1
"org.apache.lucene.index.StandardDirectoryReader$ReaderCommit",10,0.04,1.00,32,0.28,3869.98,16,6,10,17,3,132.82,0,52,0,2,132.82,0.00,0.50,0.20,0,46.00,1,845.76,0,5,3,org.apache.lucene.index.IndexCommit,0.76,7,1,10,0,7,5,0,0,211,2
"org.apache.lucene.index.StandardDirectoryReader$SegmentInfos.FindSegmentsFile",1,0.00,4.00,17,0.25,14370.29,1,0,10,8,6,92.04,0,21,0,1,92.04,0.00,0.00,0.00,0,0.00,4,735.64,0,1,6,java.lang.Object,0.00,7,0,4,0,7,0,0,0,132,0
"org.apache.lucene.index.StandardDirectoryReader$SegmentInfos.FindSegmentsFile_0",1,0.00,1.00,5,0.06,1226.46,1,0,10,4,2,120.60,0,7,0,1,120.60,0.00,0.00,0.00,0,1.00,1,175.54,0,1,2,java.lang.Object,0.00,3,0,1,0,3,0,0,0,41,0
"org.apache.lucene.index.StoredFieldVisitor",7,0.00,1.00,9,0.11,725.49,7,0,3,7,25,195.01,19,16,23,1,155.13,0.00,0.00,0.00,0,7.00,1,316.00,0,1,3,java.lang.Object,0.00,0,0,7,3,0,6,0,9,91,2
"org.apache.lucene.index.StoredFieldVisitor$Status",0,0.00,0.00,2,0.01,48.00,0,0,3,0,0,171.00,1,5,0,1,171.00,0.00,0.00,0.00,0,0.00,0,24.00,0,0,0,java.lang.Object,0.00,0,0,0,0,0,0,0,1,8,2
"org.apache.lucene.index.StoredFieldsConsumer",9,0.19,1.89,72,0.70,19978.08,19,10,6,21,10,110.82,7,89,1,1,110.82,0.00,0.00,0.27,3,6.00,3,2104.97,0,0,9,java.lang.Object,0.00,12,0,17,0,12,9,0,7,445,1
"org.apache.lucene.index.Term",12,0.14,2.00,46,0.49,18921.82,14,2,1,23,437,148.48,43,62,436,1,127.86,0.00,0.00,0.62,0,0.00,10,1482.86,0,5,1,java.lang.Object,0.00,11,0,24,0,11,7,1,9,356,2
"org.apache.lucene.index.TermState",3,0.00,1.33,8,0.06,1118.78,3,0,0,4,40,90.98,31,15,40,1,139.45,0.00,0.00,0.00,0,3.00,2,192.78,1,2,0,java.lang.Object,0.00,1,0,4,5,1,1,1,4,53,2
"org.apache.lucene.index.TermVectorsConsumer",12,0.10,1.75,86,0.91,26864.18,24,12,9,34,18,112.97,7,115,3,2,112.97,0.00,0.50,0.17,4,52.00,3,2716.33,0,1,16,org.apache.lucene.index.TermsHashConsumer,0.24,22,1,21,0,22,11,0,6,561,1
"org.apache.lucene.index.TermVectorsConsumerPerField",12,0.20,2.42,109,1.37,59391.06,22,10,6,36,13,156.11,14,45,1,2,106.11,0.00,0.50,0.28,0,0.00,8,4102.35,0,1,13,org.apache.lucene.index.TermsHashConsumerPerField,0.80,24,1,29,0,24,11,0,11,784,1
"org.apache.lucene.index.TermVectorsConsumerPerField$TermVectorsPostingsArray",4,0.22,1.00,20,0.21,4831.85,7,3,6,6,2,120.66,3,0,0,2,120.66,0.00,0.50,0.50,0,4.00,1,633.94,2,1,2,org.apache.lucene.index.ParallelPostingsArray,0.44,2,1,4,0,2,3,0,3,153,2
"org.apache.lucene.index.Terms",7,1.00,1.29,15,0.16,3249.03,8,1,4,9,167,106.49,48,19,164,1,138.71,0.00,0.00,0.00,1,7.00,3,470.40,0,1,4,java.lang.Object,0.00,2,0,9,11,2,6,0,11,120,2
"org.apache.lucene.index.Terms$AutomatonTermsEnum",1,0.00,2.00,5,0.05,1219.39,1,0,4,1,1,120.46,0,8,0,1,120.46,0.00,0.00,0.00,0,1.00,2,145.65,1,1,1,java.lang.Object,0.00,0,0,2,0,0,0,0,0,37,0
"org.apache.lucene.index.TermsEnum",13,1.00,1.15,25,0.26,4025.64,14,1,6,17,209,103.25,113,32,202,1,151.35,0.00,0.00,0.08,1,24.00,2,781.09,0,7,7,java.lang.Object,0.00,4,0,15,29,4,6,1,16,207,2
"org.apache.lucene.index.TermsEnum$SeekStatus",0,0.00,0.00,2,0.01,71.32,0,0,6,0,1,171.00,0,1,0,1,171.00,0.00,0.00,0.00,0,0.00,0,28.53,0,0,1,java.lang.Object,0.00,0,0,0,0,0,0,1,0,9,2
"org.apache.lucene.index.TermsEnum$TermState",1,0.00,1.00,2,0.01,88.08,1,0,6,1,1,144.46,0,4,0,1,144.46,0.00,0.00,0.00,0,1.00,1,39.70,0,0,1,java.lang.Object,0.00,0,0,1,0,0,1,0,0,14,0
"org.apache.lucene.index.TermsEnum$TermsEnum",13,0.00,1.00,26,0.25,3268.11,13,0,6,14,6,140.87,1,49,0,1,140.87,0.00,0.00,0.00,0,13.00,1,756.81,1,8,6,java.lang.Object,0.00,1,0,13,0,1,5,0,1,203,0
"org.apache.lucene.index.TermsHash",8,0.10,2.12,66,0.71,26350.64,20,12,5,25,16,159.44,12,91,6,2,109.44,0.00,0.50,0.17,1,6.00,5,2133.77,0,0,12,org.apache.lucene.index.InvertedDocConsumer,0.71,17,1,17,0,17,8,0,5,450,1
"org.apache.lucene.index.TermsHashConsumer",5,0.00,1.00,6,0.06,416.21,5,0,2,5,8,155.88,0,7,4,1,155.88,0.00,0.00,0.00,0,5.00,1,165.01,0,1,5,java.lang.Object,0.00,0,0,5,2,0,4,0,0,51,1
"org.apache.lucene.index.TermsHashConsumerPerField",8,0.00,1.00,9,0.07,388.64,8,0,1,8,9,157.72,0,10,7,1,157.72,0.00,0.00,0.00,0,8.00,1,198.29,0,1,2,java.lang.Object,0.00,0,0,8,2,0,7,0,0,67,1
"org.apache.lucene.index.TermsHashPerField",14,0.17,2.50,154,2.15,114551.86,35,21,9,46,23,151.13,25,192,8,2,101.13,0.00,0.50,0.20,2,0.00,8,6459.93,0,0,16,org.apache.lucene.index.InvertedDocConsumerPerField,0.53,32,1,35,0,32,14,0,25,1179,1
"org.apache.lucene.index.TermsHashPerField$PostingsBytesStartArray",5,0.25,1.40,24,0.30,9556.03,7,2,9,10,3,122.62,0,37,0,2,122.62,0.00,0.50,0.70,0,0.00,2,903.77,0,1,3,org.apache.lucene.util.BytesRefHash.BytesStartArray,0.00,5,1,7,0,5,4,0,0,208,3
"org.apache.lucene.index.TestAddIndexes",30,0.00,2.00,615,9.12,370484.38,30,0,39,140,47,110.70,93,729,0,2,90.09,0.00,0.50,0.00,7,30.00,4,27353.87,0,1,47,org.apache.lucene.util.LuceneTestCase,0.00,110,1,60,0,110,29,0,91,4775,1
"org.apache.lucene.index.TestAddIndexes$CommitAndAddIndexes",3,0.00,4.33,30,0.39,17187.84,3,0,39,12,1,103.77,0,48,0,2,103.77,0.00,0.50,0.00,0,3.00,11,1174.18,0,0,1,org.apache.lucene.index.RunAddIndexesThreads,0.00,9,1,13,0,9,3,0,0,228,1
"org.apache.lucene.index.TestAddIndexes$CommitAndAddIndexes2",2,0.00,1.50,8,0.08,1521.88,2,0,39,4,0,125.76,0,14,0,2,125.76,0.00,0.50,0.00,0,2.00,2,238.21,0,0,0,org.apache.lucene.index.CommitAndAddIndexes,0.00,2,1,3,0,2,2,0,0,59,1
"org.apache.lucene.index.TestAddIndexes$CommitAndAddIndexes3",3,0.00,6.00,39,0.53,23521.45,3,0,39,12,2,98.37,0,60,0,2,98.37,0.00,0.50,0.00,0,3.00,11,1587.29,0,0,2,org.apache.lucene.index.RunAddIndexesThreads,0.00,9,1,18,0,9,3,0,0,303,1
"org.apache.lucene.index.TestAddIndexes$CustomPerFieldCodec",1,0.00,3.00,11,0.12,2624.20,4,3,39,3,2,104.98,0,15,0,3,104.98,0.00,0.67,1.00,0,0.00,3,354.40,0,1,2,org.apache.lucene.codecs.lucene40.Lucene40Codec,0.00,2,2,3,0,2,0,0,0,82,3
"org.apache.lucene.index.TestAddIndexes$RunAddIndexesThreads",7,0.03,1.86,58,0.53,15054.16,17,10,39,18,7,110.93,0,49,0,1,110.93,0.00,0.00,0.13,0,19.00,3,1581.75,0,0,7,java.lang.Object,0.00,11,0,13,0,11,7,0,0,332,2
"org.apache.lucene.index.TestAddIndexes$RunAddIndexesThreads$Thread",1,0.00,5.00,14,0.15,7941.18,1,0,39,3,1,147.17,1,17,0,1,97.17,0.00,0.00,0.00,0,0.00,5,458.03,0,0,1,java.lang.Object,0.00,2,0,5,0,2,1,0,1,88,0
"org.apache.lucene.index.TestAddIndexes$UnRegisteredCodec",9,0.00,1.00,19,0.14,1734.83,9,0,39,17,16,141.78,0,37,0,2,141.78,0.00,0.50,0.00,0,9.00,1,410.69,0,8,16,org.apache.lucene.codecs.Codec,0.64,8,1,9,0,8,1,0,0,121,2
"org.apache.lucene.index.TestAtomicUpdate",2,0.00,2.00,56,0.77,37889.36,2,0,7,32,12,40.88,14,60,0,2,83.17,0.00,0.50,0.00,1,2.00,3,2316.98,0,0,12,org.apache.lucene.util.LuceneTestCase,0.00,30,1,4,0,30,2,0,8,395,1
"org.apache.lucene.index.TestAtomicUpdate$IndexerThread",2,1.00,1.50,14,0.18,5123.65,3,1,7,10,7,112.54,1,16,0,2,112.54,0.00,0.50,0.50,0,2.00,2,543.28,0,0,7,org.apache.lucene.index.TimedThread,0.00,8,1,3,0,8,2,0,1,112,2
"org.apache.lucene.index.TestAtomicUpdate$MockIndexWriter",2,1.00,1.50,7,0.07,817.19,3,1,7,4,3,132.55,1,12,0,2,132.55,0.00,0.50,0.50,0,2.00,2,211.12,0,0,3,org.apache.lucene.index.IndexWriter,0.00,2,1,3,0,2,2,0,1,54,3
"org.apache.lucene.index.TestAtomicUpdate$SearcherThread",2,1.00,1.00,9,0.08,1218.90,3,1,7,6,2,126.61,0,13,0,2,126.61,0.00,0.50,0.50,0,2.00,1,250.50,0,0,2,org.apache.lucene.index.TimedThread,0.00,4,1,2,0,4,2,0,0,63,2
"org.apache.lucene.index.TestAtomicUpdate$TimedThread",4,0.08,2.00,23,0.28,8474.76,8,4,7,9,0,118.58,0,31,0,2,118.58,0.00,0.50,0.31,2,4.00,3,833.97,0,0,0,org.apache.lucene.analysis.Thread,0.00,5,1,8,0,5,4,0,0,175,3
"org.apache.lucene.index.TestBackwardsCompatibility",27,0.07,2.74,427,6.93,324153.92,32,5,36,147,40,115.39,82,520,1,2,94.77,0.00,0.50,0.13,9,113.00,8,20776.16,0,2,39,org.apache.lucene.util.LuceneTestCase,0.00,120,1,74,0,120,25,0,57,3549,1
"org.apache.lucene.index.TestBinaryTerms",1,0.00,3.00,35,0.55,24753.39,1,0,12,27,14,99.17,3,34,0,2,78.55,0.00,0.50,0.00,0,1.00,3,1643.43,0,0,14,org.apache.lucene.util.LuceneTestCase,0.00,26,1,3,0,26,1,0,1,269,1
"org.apache.lucene.index.TestByteSlices",1,0.00,14.00,56,0.83,88529.10,1,0,3,16,4,116.22,1,53,0,2,66.22,0.00,0.50,0.00,0,1.00,14,2489.65,0,0,4,org.apache.lucene.util.LuceneTestCase,0.00,15,1,14,0,15,1,0,1,407,1
"org.apache.lucene.index.TestCheckIndex",2,0.00,2.50,57,1.01,52121.28,2,0,12,39,9,82.03,1,62,0,2,82.03,0.00,0.50,0.00,0,2.00,4,3024.74,0,0,9,org.apache.lucene.util.LuceneTestCase,0.00,37,1,5,0,37,2,0,1,473,1
"org.apache.lucene.index.TestCodecs",7,0.06,3.86,195,3.06,183708.62,15,8,29,76,34,82.73,28,199,0,2,82.50,0.00,0.50,0.18,3,20.00,10,9193.46,0,2,34,org.apache.lucene.util.LuceneTestCase,0.00,69,1,27,0,69,5,0,28,1515,1
"org.apache.lucene.index.TestCodecs$FieldData",3,0.12,2.33,37,0.44,16843.70,7,4,29,13,5,101.02,1,36,0,1,101.02,0.00,0.00,0.33,0,0.00,3,1313.90,0,0,5,java.lang.Object,0.00,10,0,7,0,10,3,1,1,260,0
"org.apache.lucene.index.TestCodecs$PositionData",1,2.00,1.00,6,0.04,468.06,3,2,29,1,1,120.95,0,8,0,1,120.95,0.00,0.00,0.00,0,1.00,1,111.28,0,0,1,java.lang.Object,0.00,0,0,1,0,0,1,0,0,33,0
"org.apache.lucene.index.TestCodecs$TermData",3,0.20,2.33,37,0.41,22757.67,8,5,29,11,4,100.00,0,39,0,1,100.00,0.00,0.00,0.33,0,1.00,5,1240.73,0,0,4,java.lang.Object,0.00,8,0,7,0,8,3,1,0,246,0
"org.apache.lucene.index.TestCodecs$Verify",5,0.05,7.00,158,2.91,629657.29,10,5,29,37,7,95.37,16,181,0,2,74.76,0.00,0.50,0.16,3,11.00,25,8737.33,0,0,7,org.apache.lucene.analysis.Thread,0.00,32,1,35,0,32,5,0,16,1336,1
"org.apache.lucene.index.TestCompoundFile",27,0.46,1.93,509,6.81,347531.07,28,1,11,65,8,112.28,95,551,0,2,91.66,0.00,0.50,0.56,7,0.00,6,20441.24,2,0,8,org.apache.lucene.util.LuceneTestCase,0.00,38,1,52,0,38,27,0,73,3779,1
"org.apache.lucene.index.TestConcurrentMergeScheduler",4,0.00,5.50,127,1.75,75126.49,4,0,9,41,11,101.94,15,140,0,2,81.32,0.00,0.50,0.00,0,4.00,8,5247.95,0,0,11,org.apache.lucene.util.LuceneTestCase,0.00,37,1,22,0,37,4,0,15,861,1
"org.apache.lucene.index.TestConcurrentMergeScheduler$FailOnlyOnFlush",3,0.00,2.67,24,0.29,10416.24,5,2,9,11,1,109.21,0,33,0,2,109.21,0.00,0.50,0.50,0,1.00,6,860.34,0,0,1,MockDirectoryWrapper.Failure,0.00,8,1,8,0,8,3,0,0,169,1
"org.apache.lucene.index.TestConsistentFieldNumbers",5,0.00,3.40,279,4.99,437631.70,5,0,12,47,15,66.88,4,299,0,2,66.88,0.00,0.50,0.00,1,5.00,7,14966.01,0,1,15,org.apache.lucene.util.LuceneTestCase,0.00,42,1,17,0,42,4,0,4,2429,1
"org.apache.lucene.index.TestCrash",8,0.00,1.25,73,0.88,19322.00,8,0,8,35,8,129.33,26,81,0,2,108.71,0.00,0.50,0.00,2,8.00,3,2644.15,0,2,8,org.apache.lucene.util.LuceneTestCase,0.00,27,1,10,0,27,6,0,9,539,1
"org.apache.lucene.index.TestCrashCausesCorruptIndex",5,0.12,1.20,45,0.51,9567.75,7,2,16,31,15,59.52,45,55,0,2,109.52,0.00,0.50,0.60,4,0.00,2,1518.62,0,1,15,org.apache.lucene.util.LuceneTestCase,0.00,26,1,6,0,26,4,0,18,313,1
"org.apache.lucene.index.TestCrashCausesCorruptIndex$CrashAfterCreateOutput",10,0.06,1.20,31,0.36,8119.78,12,2,16,25,4,170.13,25,52,0,2,130.25,0.00,0.50,0.45,0,0.00,3,1084.97,1,3,4,org.apache.lucene.store.Directory,0.15,15,1,12,0,15,7,0,9,256,2
"org.apache.lucene.index.TestCrashCausesCorruptIndex$CrashingException",1,1.00,1.00,4,0.03,311.83,2,1,16,1,0,149.52,3,6,0,2,128.90,0.00,0.50,0.00,0,1.00,1,89.21,0,0,0,java.lang.RuntimeException,0.00,0,1,1,0,0,1,0,1,26,2
"org.apache.lucene.index.TestCustomNorms",3,0.25,3.00,77,1.07,40661.05,5,2,17,42,17,125.95,6,86,0,2,86.06,0.00,0.50,0.33,0,5.00,4,3200.91,1,0,17,org.apache.lucene.util.LuceneTestCase,0.00,39,1,9,0,39,3,0,4,535,1
"org.apache.lucene.index.TestCustomNorms$FloatEncodingBoostSimilarity",1,0.00,1.00,4,0.04,566.58,1,0,17,3,3,126.86,0,7,0,4,126.86,0.00,0.75,0.00,0,1.00,1,128.07,0,0,3,org.apache.lucene.search.similarities.DefaultSimilarity,0.00,2,3,1,0,2,1,0,0,33,2
"org.apache.lucene.index.TestCustomNorms$MySimProvider",3,0.00,1.67,13,0.13,2341.23,4,1,17,8,3,125.65,0,21,0,3,125.65,0.00,0.67,1.00,0,0.00,3,384.35,0,1,3,org.apache.lucene.search.similarities.PerFieldSimilarityWrapper,0.43,5,2,5,0,5,2,0,0,95,1
"org.apache.lucene.index.TestCustomNorms$RandomTypeSimilarity",2,1.00,4.00,21,0.25,7267.91,3,1,17,12,4,105.34,0,33,0,4,105.34,0.00,0.75,0.50,0,2.00,7,760.34,0,0,4,org.apache.lucene.search.similarities.DefaultSimilarity,0.00,10,3,8,0,10,2,0,0,147,2
"org.apache.lucene.index.TestDeletionPolicy",10,0.00,6.30,355,5.82,591816.93,10,0,18,78,21,27.29,86,409,0,2,75.40,0.00,0.50,0.00,2,10.00,14,17465.14,0,0,21,org.apache.lucene.util.LuceneTestCase,0.00,68,1,63,0,68,10,0,63,2735,1
"org.apache.lucene.index.TestDeletionPolicy$ExpirationTimeDeletionPolicy",3,0.17,2.33,20,0.22,8761.78,6,3,18,8,3,114.49,1,25,0,1,114.49,0.00,0.00,0.22,1,4.00,4,648.89,0,0,3,java.lang.Object,0.00,5,0,7,0,5,3,1,1,139,0
"org.apache.lucene.index.TestDeletionPolicy$KeepAllDeletionPolicy",2,0.33,2.00,14,0.18,5029.87,5,3,18,10,4,112.54,0,17,0,1,112.54,0.00,0.00,0.50,0,2.00,2,550.97,0,0,4,java.lang.Object,0.00,8,0,4,0,8,2,1,0,116,0
"org.apache.lucene.index.TestDeletionPolicy$KeepLastNDeletionPolicy",4,0.00,3.00,33,0.36,11612.69,9,5,18,14,2,109.79,3,40,0,1,109.79,0.00,0.00,0.20,1,8.00,5,1088.69,0,0,2,java.lang.Object,0.00,10,0,12,0,10,4,1,3,223,0
"org.apache.lucene.index.TestDeletionPolicy$KeepNoneOnInitDeletionPolicy",2,0.00,3.00,19,0.17,5248.19,4,2,18,9,2,158.23,2,20,0,1,108.23,0.00,0.00,0.50,0,2.00,3,514.00,0,0,2,java.lang.Object,0.00,7,0,6,0,7,2,1,2,112,0
"org.apache.lucene.index.TestDirectoryReader",31,0.00,2.42,733,11.78,802350.20,31,0,28,176,44,125.14,86,820,2,2,85.25,0.00,0.50,0.00,5,31.00,14,35326.56,0,1,42,org.apache.lucene.util.LuceneTestCase,0.00,145,1,75,0,145,30,0,70,5913,1
"org.apache.lucene.index.TestDirectoryReader$IncThread",2,0.00,2.00,14,0.11,2146.87,5,3,28,6,1,115.45,0,21,0,2,115.45,0.00,0.50,0.33,0,2.00,3,339.53,0,0,1,org.apache.lucene.analysis.Thread,0.00,4,1,4,0,4,2,0,0,84,1
"org.apache.lucene.index.TestDirectoryReader$IndexReader.ReaderClosedListener",1,0.00,1.00,3,0.02,160.08,1,0,28,1,1,135.84,0,4,0,1,135.84,0.00,0.00,0.00,0,1.00,1,58.53,0,0,1,java.lang.Object,0.00,0,0,1,0,0,1,0,0,18,0
"org.apache.lucene.index.TestDirectoryReaderReopen",15,1.00,3.93,318,4.23,271644.55,16,1,27,91,27,127.72,30,357,2,2,87.83,0.00,0.50,0.07,6,28.00,13,12682.83,0,3,25,org.apache.lucene.util.LuceneTestCase,0.00,76,1,59,0,76,12,0,19,2179,1
"org.apache.lucene.index.TestDirectoryReaderReopen$KeepAllCommits",2,0.00,2.00,3,0.04,350.27,2,0,27,2,1,153.17,0,6,0,1,153.17,0.00,0.00,0.00,0,2.00,2,105.69,0,0,1,java.lang.Object,0.00,0,0,4,0,0,2,1,0,31,2
"org.apache.lucene.index.TestDirectoryReaderReopen$ReaderCouple",1,0.00,1.00,6,0.03,288.17,3,2,27,1,1,122.60,0,8,0,1,122.60,0.00,0.00,1.00,0,0.00,1,94.21,0,0,1,java.lang.Object,0.00,0,0,1,0,0,1,0,0,29,2
"org.apache.lucene.index.TestDirectoryReaderReopen$ReaderThread",3,2.00,1.33,12,0.10,1431.65,5,2,27,5,0,127.38,0,19,0,2,127.38,0.00,0.50,0.00,1,3.00,2,291.27,0,0,0,org.apache.lucene.analysis.Thread,0.00,2,1,4,0,2,3,0,0,76,2
"org.apache.lucene.index.TestDirectoryReaderReopen$ReaderThreadTask",1,0.00,6.00,21,0.33,16013.35,1,0,27,15,5,108.77,3,31,0,1,88.16,0.00,0.00,0.00,0,1.00,6,975.91,0,0,5,java.lang.Object,0.00,14,0,6,0,14,1,0,3,163,0
"org.apache.lucene.index.TestDirectoryReaderReopen$ReaderThreadTask_2",1,0.00,3.00,9,0.12,2937.40,1,0,27,7,1,107.84,0,14,0,1,107.84,0.00,0.00,0.00,0,1.00,3,359.61,0,0,1,java.lang.Object,0.00,6,0,3,0,6,1,0,0,71,0
"org.apache.lucene.index.TestDirectoryReaderReopen$ReaderThreadTask_3",2,1.00,1.00,5,0.03,340.21,3,1,27,2,0,142.20,0,7,0,1,142.20,0.00,0.00,0.00,0,2.00,1,103.57,0,0,0,java.lang.Object,0.00,0,0,2,0,0,2,0,0,31,3
"org.apache.lucene.index.TestDirectoryReaderReopen$TestReopen",2,0.00,1.00,5,0.05,714.44,2,0,27,4,2,139.67,0,9,0,1,139.67,0.00,0.00,0.00,0,2.00,1,146.96,0,1,2,java.lang.Object,0.00,2,0,2,0,2,1,0,0,40,0
"org.apache.lucene.index.TestDirectoryReaderReopen$TestReopen_0",2,0.00,1.00,5,0.05,714.44,2,0,27,4,2,139.67,0,9,0,1,139.67,0.00,0.00,0.00,0,2.00,1,146.96,0,1,2,java.lang.Object,0.00,2,0,2,0,2,1,0,0,40,0
"org.apache.lucene.index.TestDirectoryReaderReopen$TestReopen_1",2,0.00,1.00,7,0.09,1708.60,2,0,27,9,4,130.12,0,12,0,1,130.12,0.00,0.00,0.00,0,2.00,1,284.25,0,1,4,java.lang.Object,0.00,7,0,2,0,7,1,0,0,65,0
"org.apache.lucene.index.TestDirectoryReaderReopen$TestReopen_4",2,0.00,1.00,3,0.02,181.82,2,0,27,2,1,155.58,0,4,0,1,155.58,0.00,0.00,0.00,0,2.00,1,72.73,0,1,1,java.lang.Object,0.00,0,0,2,0,0,1,0,0,24,3
"org.apache.lucene.index.TestDoc",6,0.00,2.83,126,1.97,86655.05,9,3,19,67,21,128.57,13,155,0,2,88.68,0.00,0.50,0.33,4,6.00,6,5896.33,1,3,21,org.apache.lucene.util.LuceneTestCase,0.00,61,1,17,0,61,3,0,4,1028,1
"org.apache.lucene.index.TestDocCount",3,0.00,3.33,47,0.60,19734.43,3,0,8,32,15,146.79,3,53,0,2,96.79,0.00,0.50,0.00,2,3.00,6,1788.72,0,1,15,org.apache.lucene.util.LuceneTestCase,0.00,29,1,10,0,29,2,0,1,332,1
"org.apache.lucene.index.TestDocTermOrds",4,0.00,13.00,232,4.32,340925.30,4,0,21,67,24,47.93,23,265,0,2,65.80,0.00,0.50,0.00,1,4.00,21,12954.60,0,0,24,org.apache.lucene.util.LuceneTestCase,0.00,63,1,52,0,63,4,0,19,1918,1
"org.apache.lucene.index.TestDocValuesIndexing",21,0.42,5.81,643,10.85,954839.67,23,2,31,157,32,118.70,42,771,0,2,78.82,0.00,0.50,0.10,6,85.00,27,32544.63,1,4,32,org.apache.lucene.util.LuceneTestCase,0.00,136,1,122,0,136,17,0,33,5059,1
"org.apache.lucene.index.TestDocValuesIndexing$Thread",1,0.00,5.00,26,0.32,15480.58,1,0,31,14,1,84.85,0,30,0,1,84.85,0.00,0.00,0.00,0,1.00,5,962.85,0,0,1,java.lang.Object,0.00,13,0,5,0,13,1,0,0,167,0
"org.apache.lucene.index.TestDocsAndPositions",9,0.38,4.78,281,4.57,335322.14,10,1,14,66,19,118.90,26,294,0,2,79.01,0.00,0.50,0.67,2,0.00,12,13718.65,1,1,19,org.apache.lucene.util.LuceneTestCase,0.00,57,1,43,0,57,8,0,15,2124,1
"org.apache.lucene.index.TestDocumentWriter",9,0.00,1.22,153,2.64,93801.40,10,1,18,64,26,133.30,22,170,0,2,93.41,0.00,0.50,1.00,0,0.00,3,7927.41,2,0,26,org.apache.lucene.util.LuceneTestCase,0.00,55,1,11,0,55,9,0,15,1358,1
"org.apache.lucene.index.TestDocumentWriter$Analyzer",2,0.00,1.00,5,0.05,758.91,2,0,18,4,1,139.46,0,9,0,1,139.46,0.00,0.00,0.00,0,2.00,1,158.85,0,1,1,java.lang.Object,0.00,2,0,2,0,2,1,0,0,42,0
"org.apache.lucene.index.TestDocumentWriter$Analyzer_0",1,0.00,1.00,4,0.05,852.03,1,0,18,4,3,125.47,0,6,0,1,125.47,0.00,0.00,0.00,0,1.00,1,139.77,0,1,3,java.lang.Object,0.00,3,0,1,0,3,0,0,0,34,0
"org.apache.lucene.index.TestDocumentWriter$Analyzer_0$TokenFilter",2,1.00,3.00,27,0.32,10020.36,7,5,18,11,4,150.06,2,34,0,1,100.06,0.00,0.00,0.70,0,0.00,5,968.93,1,0,4,java.lang.Object,0.00,9,0,6,0,9,2,0,2,192,0
"org.apache.lucene.index.TestDocumentWriter$TokenStream",1,0.00,2.00,11,0.12,2455.90,4,3,18,4,1,105.30,0,14,0,1,105.30,0.00,0.00,1.00,0,0.00,2,355.23,0,0,1,java.lang.Object,0.00,3,0,2,0,3,1,0,0,78,0
"org.apache.lucene.index.TestDocumentsWriterDeleteQueue",6,0.00,3.83,164,2.32,150296.19,6,0,11,52,7,82.66,4,169,0,2,82.66,0.00,0.50,0.00,1,6.00,6,6965.59,0,0,7,org.apache.lucene.util.LuceneTestCase,0.00,46,1,23,0,46,6,0,2,1176,1
"org.apache.lucene.index.TestDocumentsWriterDeleteQueue$Thread",1,0.00,1.00,3,0.02,178.52,1,0,11,3,1,135.47,0,4,0,1,135.47,0.00,0.00,0.00,0,1.00,1,63.51,0,0,1,java.lang.Object,0.00,2,0,1,0,2,1,0,0,19,0
"org.apache.lucene.index.TestDocumentsWriterDeleteQueue$UpdateThread",2,0.67,2.00,24,0.28,6718.55,8,6,11,12,4,102.82,0,32,0,2,102.82,0.00,0.50,0.50,0,0.00,3,848.91,0,0,4,org.apache.lucene.index.Thread,0.00,10,1,4,0,10,2,0,0,173,2
"org.apache.lucene.index.TestDuelingCodecs",25,0.06,3.20,350,5.31,305265.34,32,7,22,126,28,96.03,101,434,0,2,95.80,0.00,0.50,0.20,21,0.00,8,15939.13,2,1,28,org.apache.lucene.util.LuceneTestCase,0.00,101,1,80,0,101,24,0,60,3023,1
"org.apache.lucene.index.TestDuelingCodecs$Comparator<IndexableField>",1,0.00,1.00,3,0.04,604.64,1,0,22,3,1,131.30,0,5,0,1,131.30,0.00,0.00,0.00,0,1.00,1,117.32,0,0,1,java.lang.Object,0.00,2,0,1,0,2,1,0,0,32,0
"org.apache.lucene.index.TestDuelingCodecs$RandomBits",3,0.00,1.67,14,0.12,2624.52,4,1,22,8,1,125.26,0,19,0,1,125.26,0.00,0.00,1.00,0,0.00,3,357.53,0,0,1,java.lang.Object,0.00,5,0,5,0,5,3,1,0,88,2
"org.apache.lucene.index.TestFieldInfos",6,0.80,2.33,76,1.08,37736.11,7,1,12,36,11,140.52,13,99,0,2,100.64,0.00,0.50,0.33,3,10.00,9,3242.33,1,2,11,org.apache.lucene.util.LuceneTestCase,0.00,30,1,14,0,30,4,0,13,625,1
"org.apache.lucene.index.TestFieldsReader",6,0.13,2.67,159,2.35,121365.11,9,3,27,76,28,84.08,5,169,0,2,84.08,0.00,0.50,0.44,0,6.00,7,7044.08,0,0,28,org.apache.lucene.util.LuceneTestCase,0.00,70,1,16,0,70,6,0,5,1183,1
"org.apache.lucene.index.TestFieldsReader$FaultyFSDirectory",9,0.00,1.00,21,0.25,4093.10,10,1,27,19,4,138.84,0,39,0,2,138.84,0.00,0.50,1.00,0,0.00,1,737.54,0,3,4,org.apache.lucene.store.Directory,0.15,10,1,9,0,10,6,0,0,189,2
"org.apache.lucene.index.TestFieldsReader$FaultyIndexInput",7,0.00,1.14,21,0.21,3266.34,10,3,27,14,2,132.15,1,35,0,4,132.15,0.00,0.75,0.33,1,0.00,2,641.56,0,1,2,org.apache.lucene.store.BufferedIndexInput,0.41,7,3,8,0,7,6,0,1,162,2
"org.apache.lucene.index.TestFilterAtomicReader",0,0.00,0.00,2,0.01,129.56,0,0,12,0,8,171.00,0,2,0,2,171.00,0.00,0.50,0.00,0,0.00,0,43.19,0,0,8,org.apache.lucene.util.LuceneTestCase,0.00,0,1,0,0,0,0,0,0,13,1
"org.apache.lucene.index.TestFilterAtomicReader$TestReader",5,0.00,2.40,61,0.99,37042.99,5,0,12,42,14,150.07,7,74,0,4,100.07,0.00,0.75,0.00,1,5.00,6,2959.15,1,1,14,org.apache.lucene.index.FilterAtomicReader,0.06,37,3,12,0,37,4,0,4,533,2
"org.apache.lucene.index.TestFilterAtomicReader$TestReader$TestFields",3,0.00,1.00,7,0.07,1105.31,3,0,12,5,3,139.56,0,13,0,2,139.56,0.00,0.50,0.00,0,3.00,1,211.88,2,2,3,org.apache.lucene.index.FilterFields,0.00,2,1,3,0,2,1,0,0,58,2
"org.apache.lucene.index.TestFilterAtomicReader$TestReader$TestFieldsEnum",2,0.00,1.00,5,0.04,548.91,2,0,12,3,2,140.57,0,9,0,2,140.57,0.00,0.50,0.00,0,2.00,1,121.96,1,1,2,org.apache.lucene.index.FilterFieldsEnum,0.00,1,1,2,0,1,1,0,0,36,2
"org.apache.lucene.index.TestFilterAtomicReader$TestReader$TestPositions",2,0.00,2.00,8,0.08,2319.56,2,0,12,2,1,124.25,1,14,0,2,124.25,0.00,0.50,0.00,0,2.00,3,226.07,0,0,1,org.apache.lucene.index.FilterDocsAndPositionsEnum,0.00,0,1,4,0,0,2,0,1,56,2
"org.apache.lucene.index.TestFilterAtomicReader$TestReader$TestTerms",2,0.00,1.00,5,0.05,725.81,2,0,12,3,2,139.61,0,9,0,2,139.61,0.00,0.50,0.00,0,2.00,1,135.73,1,1,2,org.apache.lucene.index.FilterTerms,0.00,1,1,2,0,1,1,0,0,39,2
"org.apache.lucene.index.TestFilterAtomicReader$TestReader$TestTermsEnum",3,0.00,2.00,10,0.14,3998.31,3,0,12,6,3,128.44,1,18,0,2,128.44,0.00,0.50,0.00,0,3.00,3,434.71,1,2,3,org.apache.lucene.index.FilterTermsEnum,0.00,3,1,6,0,3,1,0,1,100,2
"org.apache.lucene.index.TestFlex",2,0.00,3.00,43,0.67,22103.32,2,0,5,30,12,139.58,2,50,0,2,89.58,0.00,0.50,0.00,0,2.00,4,1997.68,0,0,12,org.apache.lucene.util.LuceneTestCase,0.00,28,1,6,0,28,2,0,2,337,1
"org.apache.lucene.index.TestFlushByRamOrCountsPolicy",10,0.44,3.40,210,3.42,185287.99,11,1,14,59,16,87.79,3,242,0,2,87.79,0.00,0.50,0.60,2,0.00,7,10251.21,0,0,16,org.apache.lucene.util.LuceneTestCase,0.00,49,1,34,0,49,10,0,3,1636,1
"org.apache.lucene.index.TestFlushByRamOrCountsPolicy$IndexThread",2,0.40,3.50,28,0.29,7670.85,7,5,14,11,4,99.74,0,38,0,2,99.74,0.00,0.50,0.40,0,2.00,6,861.16,0,0,4,org.apache.lucene.analysis.Thread,0.00,9,1,7,0,9,2,0,0,175,1
"org.apache.lucene.index.TestFlushByRamOrCountsPolicy$MockDefaultFlushPolicy",2,0.67,6.50,57,0.78,51627.27,5,3,14,14,2,81.85,0,74,0,3,81.85,0.00,0.67,0.67,0,0.00,7,2346.87,5,0,2,org.apache.lucene.index.FlushByRamOrCountsPolicy,0.00,12,2,13,0,12,2,0,0,416,2
"org.apache.lucene.index.TestForTooMuchCloning",1,0.00,3.00,32,0.51,21037.88,1,0,10,26,12,32.08,10,35,0,2,80.56,0.00,0.50,0.00,0,1.00,3,1527.51,0,0,12,org.apache.lucene.util.LuceneTestCase,0.00,25,1,3,0,25,1,0,10,248,1
"org.apache.lucene.index.TestForceMergeForever",1,0.00,4.00,33,0.48,23575.27,1,0,8,25,7,100.22,3,34,0,2,79.61,0.00,0.50,0.00,0,1.00,4,1449.93,0,0,7,org.apache.lucene.util.LuceneTestCase,0.00,24,1,4,0,24,1,0,3,241,1
"org.apache.lucene.index.TestForceMergeForever$MyIndexWriter",2,0.00,2.00,12,0.15,3727.31,4,2,8,6,4,116.06,0,18,0,2,116.06,0.00,0.50,0.50,0,2.00,3,458.96,1,0,4,org.apache.lucene.index.IndexWriter,0.00,4,1,4,0,4,2,0,0,99,2
"org.apache.lucene.index.TestForceMergeForever$Thread",1,0.00,3.00,7,0.10,2161.29,1,0,8,8,1,162.96,1,13,0,1,112.96,0.00,0.00,0.00,0,1.00,3,295.53,0,0,1,java.lang.Object,0.00,7,0,3,0,7,1,0,1,61,0
"org.apache.lucene.index.TestIndexCommit",1,0.00,1.00,8,0.08,1602.80,1,0,6,7,2,162.08,1,11,0,2,112.08,0.00,0.50,0.00,0,1.00,1,228.12,0,0,2,org.apache.lucene.util.LuceneTestCase,0.00,6,1,1,0,6,1,0,1,53,1
"org.apache.lucene.index.TestIndexCommit$IndexCommit",8,0.00,1.00,16,0.11,1483.72,8,0,6,8,1,141.91,0,9,0,1,141.91,0.00,0.00,0.00,0,8.00,1,342.09,0,4,1,java.lang.Object,0.00,0,0,8,0,0,4,0,0,100,0
"org.apache.lucene.index.TestIndexCommit$IndexCommit_0",8,0.00,1.00,16,0.11,1483.72,8,0,6,8,1,141.91,0,9,0,1,141.91,0.00,0.00,0.00,0,8.00,1,342.09,0,4,1,java.lang.Object,0.00,0,0,8,0,0,4,0,0,100,0
"org.apache.lucene.index.TestIndexFileDeleter",5,0.00,3.60,98,1.51,97793.41,5,0,17,46,17,71.34,27,111,0,2,89.21,0.00,0.50,0.00,3,5.00,7,4542.01,0,2,17,org.apache.lucene.util.LuceneTestCase,0.00,41,1,18,0,41,3,0,20,771,1
"org.apache.lucene.index.TestIndexInput",4,0.33,1.75,49,1.27,92773.96,5,1,7,23,6,116.85,13,90,0,2,96.24,0.00,0.50,0.75,1,0.00,4,3814.39,0,0,6,org.apache.lucene.util.LuceneTestCase,0.00,19,1,7,0,19,4,0,13,696,1
"org.apache.lucene.index.TestIndexSplitter",1,0.00,4.00,60,0.91,43833.62,1,0,7,29,11,88.41,3,61,0,2,67.80,0.00,0.50,0.00,0,1.00,4,2722.01,0,0,11,org.apache.lucene.util.LuceneTestCase,0.00,28,1,4,0,28,1,0,3,425,1
"org.apache.lucene.index.TestIndexWriterCommit",12,0.00,3.33,389,5.37,278552.47,12,0,17,88,20,47.98,75,400,0,2,80.20,0.00,0.50,0.00,0,12.00,5,16110.96,0,0,20,org.apache.lucene.util.LuceneTestCase,0.00,76,1,40,0,76,12,0,54,2760,1
"org.apache.lucene.index.TestIndexWriterCommit$Analyzer",1,0.00,1.00,3,0.04,595.79,1,0,17,3,1,131.35,0,5,0,1,131.35,0.00,0.00,0.00,0,1.00,1,112.25,0,1,1,java.lang.Object,0.00,2,0,1,0,2,0,0,0,29,0
"org.apache.lucene.index.TestIndexWriterCommit$Analyzer_0",1,0.00,1.00,4,0.06,1051.87,1,0,17,4,3,124.74,0,6,0,1,124.74,0.00,0.00,0.00,0,1.00,1,173.06,0,1,3,java.lang.Object,0.00,3,0,1,0,3,0,0,0,40,0
"org.apache.lucene.index.TestIndexWriterCommit$Thread",1,0.00,4.00,28,0.38,19251.93,1,0,17,20,6,82.96,0,30,0,1,82.96,0.00,0.00,0.00,0,1.00,4,1150.54,0,0,6,java.lang.Object,0.00,19,0,4,0,19,1,0,0,188,0
"org.apache.lucene.index.TestIndexWriterConfig",6,0.00,3.50,142,2.57,145287.13,6,0,14,69,17,85.63,26,177,0,2,85.39,0.00,0.50,0.00,0,6.00,9,7708.03,0,0,17,org.apache.lucene.util.LuceneTestCase,0.00,63,1,21,0,63,6,0,26,1255,1
"org.apache.lucene.index.TestIndexWriterConfig$MyIndexingChain",1,0.00,1.00,3,0.02,193.08,1,0,14,1,2,185.20,1,7,0,2,135.20,0.00,0.50,0.00,0,1.00,1,65.51,0,1,2,org.apache.lucene.index.DocumentsWriterPerThread.IndexingChain,0.00,0,1,1,0,0,0,0,1,20,3
"org.apache.lucene.index.TestIndexWriterConfig$MySimilarity",0,0.00,0.00,1,0.01,72.00,0,0,14,0,1,171.00,1,2,0,4,171.00,0.00,0.75,0.00,0,0.00,0,24.00,0,0,1,org.apache.lucene.search.similarities.DefaultSimilarity,0.00,0,3,0,0,0,0,0,1,8,3
"org.apache.lucene.index.TestIndexWriterDelete",23,0.00,4.43,610,9.25,566071.75,23,0,21,127,22,83.53,109,703,0,2,83.30,0.00,0.50,0.00,4,23.00,29,27738.11,0,0,22,org.apache.lucene.util.LuceneTestCase,0.00,104,1,102,0,104,23,0,106,4468,1
"org.apache.lucene.index.TestIndexWriterDelete$Analyzer",1,0.00,1.00,3,0.04,595.79,1,0,21,3,1,131.35,0,5,0,1,131.35,0.00,0.00,0.00,0,1.00,1,112.25,0,1,1,java.lang.Object,0.00,2,0,1,0,2,0,0,0,29,0
"org.apache.lucene.index.TestIndexWriterDelete$MockAnalyzer",1,0.00,1.00,5,0.10,1461.36,1,0,21,6,0,120.01,0,8,0,1,120.01,0.00,0.00,0.00,0,1.00,1,285.99,0,0,0,java.lang.Object,0.00,5,0,1,0,5,1,0,0,66,0
"org.apache.lucene.index.TestIndexWriterDelete$MockDirectoryWrapper.Failure",2,1.33,6.00,40,0.44,24552.93,5,3,21,11,1,139.86,2,48,0,1,89.86,0.00,0.00,1.00,0,0.00,11,1310.75,0,1,1,java.lang.Object,0.00,9,0,12,0,9,1,0,2,242,0
"org.apache.lucene.index.TestIndexWriterDelete$MockDirectoryWrapper.Failure_0",2,0.00,1.50,9,0.08,1294.28,3,1,21,3,1,126.31,0,14,0,1,126.31,0.00,0.00,1.00,0,0.00,2,228.08,0,1,1,java.lang.Object,0.00,1,0,3,0,1,1,0,0,57,0
"org.apache.lucene.index.TestIndexWriterExceptions",25,0.48,4.64,765,11.33,704725.43,27,2,29,185,36,120.39,73,836,0,2,80.50,0.00,0.50,0.04,1,67.00,12,33990.33,0,0,36,org.apache.lucene.util.LuceneTestCase,0.00,160,1,116,0,160,25,0,73,5521,1
"org.apache.lucene.index.TestIndexWriterExceptions$Analyzer",1,0.00,1.00,5,0.06,1123.43,1,0,29,5,2,170.90,1,7,0,1,120.90,0.00,0.00,0.00,0,1.00,1,168.54,0,1,2,java.lang.Object,0.00,4,0,1,0,4,0,0,1,40,0
"org.apache.lucene.index.TestIndexWriterExceptions$Analyzer$TokenFilter",2,1.00,1.50,9,0.08,1668.24,3,1,29,4,0,125.44,0,14,0,1,125.44,0.00,0.00,0.50,0,2.00,2,246.53,1,0,0,java.lang.Object,0.00,2,0,3,0,2,2,0,0,61,0
"org.apache.lucene.index.TestIndexWriterExceptions$Analyzer.PerFieldReuseStrategy",1,0.00,1.00,5,0.07,1486.68,1,0,29,5,1,169.95,1,7,0,1,119.95,0.00,0.00,0.00,0,1.00,1,198.35,0,1,1,java.lang.Object,0.00,4,0,1,0,4,0,0,1,47,0
"org.apache.lucene.index.TestIndexWriterExceptions$Analyzer.PerFieldReuseStrategy_0",1,0.00,1.00,5,0.07,1486.68,1,0,29,5,1,169.95,1,7,0,1,119.95,0.00,0.00,0.00,0,1.00,1,198.35,0,1,1,java.lang.Object,0.00,4,0,1,0,4,0,0,1,47,0
"org.apache.lucene.index.TestIndexWriterExceptions$Analyzer.PerFieldReuseStrategy_1",1,0.00,1.00,5,0.07,1486.68,1,0,29,5,1,169.95,1,7,0,1,119.95,0.00,0.00,0.00,0,1.00,1,198.35,0,1,1,java.lang.Object,0.00,4,0,1,0,4,0,0,1,47,0
"org.apache.lucene.index.TestIndexWriterExceptions$CrashingFilter",3,0.25,1.33,12,0.12,2277.59,5,2,29,6,1,125.79,0,19,0,4,125.79,0.00,0.75,0.33,0,1.00,2,361.95,1,0,1,org.apache.lucene.analysis.TokenFilter,0.53,3,3,4,0,3,3,0,0,88,1
"org.apache.lucene.index.TestIndexWriterExceptions$DocCopyIterator",2,7.00,1.00,26,0.28,7801.51,9,7,29,4,4,151.17,2,31,0,1,101.17,0.00,0.00,0.00,0,2.00,1,832.09,0,1,4,java.lang.Object,0.00,2,0,2,0,2,1,1,2,193,2
"org.apache.lucene.index.TestIndexWriterExceptions$DocCopyIterator$Iterator<Document>",3,0.50,1.00,9,0.06,722.88,4,1,29,4,1,134.45,0,15,0,1,134.45,0.00,0.00,0.67,0,1.00,1,181.63,0,1,1,java.lang.Object,0.00,1,0,3,0,1,2,0,0,52,0
"org.apache.lucene.index.TestIndexWriterExceptions$FailOnTermVectors",2,0.00,2.50,18,0.23,6929.42,6,4,29,10,2,107.32,0,22,0,2,107.32,0.00,0.50,0.25,0,2.00,4,693.47,0,0,2,MockDirectoryWrapper.Failure,0.00,8,1,5,0,8,2,0,0,141,2
"org.apache.lucene.index.TestIndexWriterExceptions$FailOnlyInCommit",2,0.33,4.50,30,0.46,25960.62,8,6,29,12,2,94.39,0,38,0,2,94.39,0.00,0.50,0.33,0,2.00,8,1366.41,0,0,2,MockDirectoryWrapper.Failure,0.00,10,1,9,0,10,2,0,0,256,2
"org.apache.lucene.index.TestIndexWriterExceptions$FailOnlyInSync",1,0.00,4.00,12,0.17,5958.05,2,1,29,8,1,100.70,0,15,0,2,100.70,0.00,0.50,1.00,0,0.00,4,497.23,0,0,1,MockDirectoryWrapper.Failure,0.00,7,1,4,0,7,1,0,0,98,2
"org.apache.lucene.index.TestIndexWriterExceptions$FailOnlyOnFlush",3,0.25,2.67,21,0.29,11889.42,5,2,29,11,2,110.92,0,30,0,2,110.92,0.00,0.50,0.33,0,4.00,6,861.27,0,0,2,MockDirectoryWrapper.Failure,0.00,8,1,8,0,8,3,0,0,170,2
"org.apache.lucene.index.TestIndexWriterExceptions$IndexerThread",2,0.33,4.50,52,0.94,63086.61,5,3,29,25,6,132.44,3,66,0,2,82.44,0.00,0.50,0.50,0,2.00,8,2808.63,0,0,6,org.apache.lucene.analysis.Thread,0.00,23,1,9,0,23,2,0,3,449,1
"org.apache.lucene.index.TestIndexWriterExceptions$InfoStream",3,0.00,1.33,7,0.08,1663.05,3,0,29,6,0,138.10,0,13,0,1,138.10,0.00,0.00,0.00,0,3.00,2,253.48,0,0,0,java.lang.Object,0.00,3,0,4,0,3,3,0,0,63,0
"org.apache.lucene.index.TestIndexWriterExceptions$MockIndexWriter",2,1.00,2.00,11,0.19,4762.88,3,1,29,12,3,118.18,0,17,0,2,118.18,0.00,0.50,0.50,0,2.00,3,578.04,0,0,3,org.apache.lucene.index.IndexWriter,0.00,10,1,4,0,10,2,0,0,118,1
"org.apache.lucene.index.TestIndexWriterExceptions$MockIndexWriter2",2,1.00,1.50,7,0.07,1018.92,3,1,29,4,3,131.79,0,12,0,2,131.79,0.00,0.50,0.50,0,2.00,2,213.88,0,0,3,org.apache.lucene.index.IndexWriter,0.00,2,1,3,0,2,2,0,0,54,3
"org.apache.lucene.index.TestIndexWriterExceptions$MockIndexWriter3",2,0.00,1.50,10,0.09,1408.94,4,2,29,4,3,122.41,0,15,0,2,122.41,0.00,0.50,0.50,0,2.00,2,255.89,0,0,3,org.apache.lucene.index.IndexWriter,0.00,2,1,3,0,2,2,0,0,63,3
"org.apache.lucene.index.TestIndexWriterExceptions$MockIndexWriter4",2,1.00,1.50,7,0.07,1018.92,3,1,29,4,3,131.79,0,12,0,2,131.79,0.00,0.50,0.50,0,2.00,2,213.88,0,0,3,org.apache.lucene.index.IndexWriter,0.00,2,1,3,0,2,2,0,0,54,3
"org.apache.lucene.index.TestIndexWriterExceptions$Thread",1,0.00,5.00,25,0.32,17558.50,1,0,29,10,1,85.06,0,31,0,1,85.06,0.00,0.00,0.00,0,1.00,5,974.82,0,0,1,java.lang.Object,0.00,9,0,5,0,9,1,0,0,172,0
"org.apache.lucene.index.TestIndexWriterExceptions$UOEDirectory",1,0.00,4.00,12,0.16,5140.07,2,1,29,7,3,101.20,0,15,0,3,101.20,0.00,0.67,1.00,0,0.00,4,465.57,1,1,3,org.apache.lucene.store.RAMDirectory,0.00,6,2,4,0,6,0,0,0,91,1
"org.apache.lucene.index.TestIndexWriterForceMerge",4,0.00,4.75,129,1.91,96824.80,4,0,9,44,12,100.59,15,138,0,2,79.97,0.00,0.50,0.00,0,4.00,6,5735.79,0,0,12,org.apache.lucene.util.LuceneTestCase,0.00,40,1,19,0,40,4,0,11,939,1
"org.apache.lucene.index.TestIndexWriterLockRelease",3,1.00,4.00,29,0.47,18756.81,4,1,9,17,5,155.19,5,47,0,2,105.19,0.00,0.50,0.00,0,3.00,5,1417.25,2,0,5,org.apache.lucene.util.LuceneTestCase,0.00,14,1,12,0,14,3,0,1,280,1
"org.apache.lucene.index.TestIndexWriterMergePolicy",8,0.00,3.00,163,2.15,107901.17,8,0,7,44,11,139.69,14,182,0,2,89.69,0.00,0.50,0.00,2,8.00,5,6450.31,0,0,11,org.apache.lucene.util.LuceneTestCase,0.00,36,1,24,0,36,8,0,14,1160,1
"org.apache.lucene.index.TestIndexWriterMerging",8,0.00,3.38,259,3.96,189162.80,8,0,13,67,15,120.02,18,300,0,2,80.13,0.00,0.50,0.00,2,8.00,9,11874.68,0,0,15,org.apache.lucene.util.LuceneTestCase,0.00,59,1,27,0,59,8,0,15,1931,1
"org.apache.lucene.index.TestIndexWriterMerging$MyMergeScheduler",2,0.00,2.50,13,0.14,5497.54,2,0,13,5,3,114.68,0,18,0,2,114.68,0.00,0.50,0.00,0,2.00,4,423.47,0,0,3,org.apache.lucene.index.MergeScheduler,0.50,3,1,5,0,3,2,0,0,88,1
"org.apache.lucene.index.TestIndexWriterMerging$Thread",1,0.00,6.00,19,0.17,5593.64,1,0,13,5,1,93.38,0,24,0,1,93.38,0.00,0.00,0.00,0,1.00,6,497.62,0,0,1,java.lang.Object,0.00,4,0,6,0,4,1,0,0,96,0
"org.apache.lucene.index.TestIndexWriterNRTIsCurrent",1,0.00,5.00,33,0.42,20017.44,1,0,11,17,10,80.11,0,36,0,2,80.11,0.00,0.50,0.00,0,1.00,5,1253.95,0,0,10,org.apache.lucene.util.LuceneTestCase,0.00,16,1,5,0,16,1,0,0,225,1
"org.apache.lucene.index.TestIndexWriterNRTIsCurrent$ReaderHolder",0,0.00,0.00,3,0.02,220.18,2,2,11,0,1,171.00,0,4,0,1,171.00,0.00,0.00,0.00,0,0.00,0,62.91,0,0,1,java.lang.Object,0.00,0,0,0,0,0,0,0,0,17,2
"org.apache.lucene.index.TestIndexWriterNRTIsCurrent$ReaderThread",2,0.33,5.00,31,0.33,11972.66,5,3,11,9,1,97.01,0,46,0,2,97.01,0.00,0.50,0.50,0,2.00,9,1002.50,0,0,1,org.apache.lucene.analysis.Thread,0.00,7,1,10,0,7,2,0,0,195,3
"org.apache.lucene.index.TestIndexWriterNRTIsCurrent$WriterThread",2,0.57,7.50,58,0.72,41471.02,9,7,11,20,7,81.99,0,75,0,2,81.99,0.00,0.50,0.43,0,2.00,14,2154.36,0,0,7,org.apache.lucene.analysis.Thread,0.00,18,1,15,0,18,2,0,0,372,2
"org.apache.lucene.index.TestIndexWriterOnDiskFull",6,0.00,12.67,294,4.80,698150.38,6,0,16,75,18,47.33,86,357,0,2,67.48,0.00,0.50,0.00,2,6.00,50,14392.21,0,0,18,org.apache.lucene.util.LuceneTestCase,0.00,69,1,76,0,69,6,0,73,2059,1
"org.apache.lucene.index.TestIndexWriterOnDiskFull$FailTwiceDuringMerge",1,0.00,5.00,17,0.26,12832.43,3,2,16,9,3,92.38,0,21,0,2,92.38,0.00,0.50,1.00,0,0.00,5,794.44,0,0,3,MockDirectoryWrapper.Failure,0.00,8,1,5,0,8,1,0,0,149,2
"org.apache.lucene.index.TestIndexWriterOnJRECrash",5,0.50,4.00,77,1.11,42753.73,6,1,12,45,5,96.08,20,95,0,2,95.85,0.00,0.50,0.60,2,2.00,6,3315.45,2,0,5,TestNRTThreads,0.00,40,1,20,0,40,5,0,12,584,1
"org.apache.lucene.index.TestIndexWriterOnJRECrash$Thread",1,0.00,2.00,5,0.04,448.00,1,0,12,3,0,123.89,0,8,0,1,123.89,0.00,0.00,0.00,0,1.00,2,106.10,0,0,0,java.lang.Object,0.00,2,0,2,0,2,1,0,0,28,0
"org.apache.lucene.index.TestIndexWriterReader",24,0.96,2.46,558,8.42,393404.24,25,1,27,138,32,107.42,84,623,2,2,86.81,0.00,0.50,0.08,2,64.00,7,25253.88,0,0,30,org.apache.lucene.util.LuceneTestCase,0.00,114,1,59,0,114,24,0,66,4288,1
"org.apache.lucene.index.TestIndexWriterReader$AddDirectoriesThreads",7,0.10,2.71,75,0.71,19130.70,17,10,27,27,7,106.41,0,77,0,1,106.41,0.00,0.00,0.19,0,26.00,5,2124.31,0,0,7,java.lang.Object,0.00,20,0,19,0,20,7,0,0,436,1
"org.apache.lucene.index.TestIndexWriterReader$AddDirectoriesThreads$Thread",1,0.00,4.00,15,0.13,4810.75,1,0,27,3,1,49.34,10,14,0,1,97.81,0.00,0.00,0.00,0,0.00,4,399.73,0,0,1,java.lang.Object,0.00,2,0,4,0,2,1,0,10,81,0
"org.apache.lucene.index.TestIndexWriterReader$IndexWriter.IndexReaderWarmer",1,0.00,1.00,6,0.09,1325.26,1,0,27,7,5,117.39,0,8,0,1,117.39,0.00,0.00,0.00,0,1.00,1,260.51,0,0,5,java.lang.Object,0.00,6,0,1,0,6,1,0,0,55,0
"org.apache.lucene.index.TestIndexWriterReader$MyWarmer",1,0.00,1.00,4,0.04,404.10,2,1,27,1,1,128.02,0,7,0,2,128.02,0.00,0.50,1.00,0,0.00,1,107.30,0,0,1,IndexWriter.IndexReaderWarmer,0.00,0,1,1,0,0,1,0,0,29,2
"org.apache.lucene.index.TestIndexWriterReader$Thread_0",1,0.00,2.00,9,0.08,1951.45,1,0,27,6,0,109.33,0,13,0,1,109.33,0.00,0.00,0.00,0,1.00,2,243.56,0,0,0,java.lang.Object,0.00,5,0,2,0,5,1,0,0,53,0
"org.apache.lucene.index.TestIndexWriterReader$Thread_1",1,0.00,4.00,22,0.25,11077.36,2,1,27,11,2,88.76,0,22,0,1,88.76,0.00,0.00,1.00,0,0.00,4,735.96,0,0,2,java.lang.Object,0.00,10,0,4,0,10,1,0,0,136,0
"org.apache.lucene.index.TestIndexWriterUnicode",12,1.00,3.42,191,3.25,252591.02,13,1,16,70,16,132.69,24,228,0,2,92.80,0.00,0.50,0.08,4,22.00,11,9763.90,0,2,16,org.apache.lucene.util.LuceneTestCase,0.00,58,1,41,0,58,10,0,24,1706,1
"org.apache.lucene.index.TestIndexWriterUnicode$ReaderUtil.Gather",1,0.00,1.00,3,0.03,329.14,1,0,16,2,1,133.38,0,5,0,1,133.38,0.00,0.00,0.00,0,1.00,1,101.40,0,0,1,java.lang.Object,0.00,1,0,1,0,1,1,0,0,27,0
"org.apache.lucene.index.TestIndexWriterWithThreads",13,0.00,3.15,190,2.48,128860.55,13,0,16,65,18,117.13,43,209,0,2,96.51,0.00,0.50,0.00,2,13.00,12,7426.94,0,0,18,org.apache.lucene.util.LuceneTestCase,0.00,52,1,41,0,52,13,0,41,1263,1
"org.apache.lucene.index.TestIndexWriterWithThreads$DelayedIndexAndCloseRunnable",3,0.20,1.33,25,0.27,5196.49,8,5,16,14,6,111.74,0,34,0,2,111.74,0.00,0.50,0.33,0,4.00,2,803.88,0,0,6,org.apache.lucene.analysis.Thread,0.00,11,1,4,0,11,3,0,0,165,1
"org.apache.lucene.index.TestIndexWriterWithThreads$FailOnlyInWriteSegment",2,1.00,3.00,14,0.17,5355.50,3,1,16,9,1,112.23,0,19,0,2,112.23,0.00,0.50,0.50,0,2.00,5,512.88,0,0,1,MockDirectoryWrapper.Failure,0.00,7,1,6,0,7,2,0,0,106,2
"org.apache.lucene.index.TestIndexWriterWithThreads$FailOnlyOnAbortOrFlush",2,1.00,4.00,20,0.25,11371.70,3,1,16,8,1,153.81,2,28,0,2,103.81,0.00,0.50,0.50,0,2.00,7,738.09,0,0,1,MockDirectoryWrapper.Failure,0.00,6,1,8,0,6,2,0,2,144,2
"org.apache.lucene.index.TestIndexWriterWithThreads$IndexerThread",2,0.50,5.00,45,0.61,33484.10,8,6,16,22,7,137.29,3,60,0,2,87.29,0.00,0.50,0.42,0,2.00,9,1841.52,0,0,7,org.apache.lucene.analysis.Thread,0.00,20,1,10,0,20,2,0,3,309,1
"org.apache.lucene.index.TestIndexableField",0,0.00,0.00,2,0.01,119.59,0,0,18,0,13,171.00,0,2,0,2,171.00,0.00,0.50,0.00,0,0.00,0,39.86,0,0,13,org.apache.lucene.util.LuceneTestCase,0.00,0,1,0,0,0,0,0,0,12,1
"org.apache.lucene.index.TestIndexableField$MyField",10,0.67,2.70,137,2.30,260041.93,11,1,18,50,19,94.45,4,163,0,1,94.45,0.00,0.00,0.40,3,18.00,13,6903.59,0,7,19,java.lang.Object,0.00,40,0,27,0,40,3,1,4,1065,1
"org.apache.lucene.index.TestIndexableField$MyField$IndexableFieldType",9,0.00,1.00,19,0.20,3348.70,9,0,18,9,0,139.53,0,37,0,1,139.53,0.00,0.00,0.00,0,4.00,1,608.16,0,2,0,java.lang.Object,0.00,0,0,9,0,0,7,0,0,158,0
"org.apache.lucene.index.TestIndexableField$MyField$Iterable<IndexableField>",1,0.00,1.00,3,0.02,282.15,1,0,18,2,1,133.91,0,5,0,1,133.91,0.00,0.00,0.00,0,1.00,1,66.26,0,1,1,java.lang.Object,0.00,1,0,1,0,1,0,0,0,20,0
"org.apache.lucene.index.TestIndexableField$MyField$Iterable<IndexableField>$Iterator<IndexableField>",3,0.50,1.33,13,0.12,3232.08,4,1,18,6,2,124.60,0,20,0,1,124.60,0.00,0.00,0.67,0,1.00,2,371.44,0,1,2,java.lang.Object,0.00,3,0,4,0,3,2,0,0,86,0
"org.apache.lucene.index.TestIsCurrent",4,0.33,1.00,34,0.39,7055.75,6,2,6,22,6,93.87,20,43,0,2,111.75,0.00,0.50,0.75,0,0.00,1,1160.51,2,0,6,org.apache.lucene.util.LuceneTestCase,0.00,18,1,4,0,18,4,0,12,243,1
"org.apache.lucene.index.TestLazyProxSkipping",5,6.00,2.20,80,1.11,40104.04,11,6,16,38,21,115.77,16,92,1,2,95.16,0.00,0.50,0.00,3,5.00,4,3339.05,0,1,20,org.apache.lucene.util.LuceneTestCase,0.00,33,1,11,0,33,4,0,13,607,1
"org.apache.lucene.index.TestLazyProxSkipping$Analyzer",1,0.00,1.00,3,0.04,595.79,1,0,16,3,1,131.35,0,5,0,1,131.35,0.00,0.00,0.00,0,1.00,1,112.25,0,1,1,java.lang.Object,0.00,2,0,1,0,2,0,0,0,29,0
"org.apache.lucene.index.TestLazyProxSkipping$SeekCountingDirectory",2,0.00,1.50,8,0.09,2532.07,2,0,16,4,4,124.02,1,13,0,3,124.02,0.00,0.67,0.00,0,2.00,2,276.00,1,1,4,org.apache.lucene.store.MockDirectoryWrapper,0.00,2,2,3,0,2,1,0,1,65,1
"org.apache.lucene.index.TestLazyProxSkipping$SeeksCountingStream",8,1.00,1.00,20,0.22,3383.97,9,1,16,9,2,139.09,0,36,0,3,139.09,0.00,0.67,0.00,7,8.00,1,655.79,0,1,2,org.apache.lucene.store.IndexInput,0.81,1,2,8,0,1,7,0,0,171,0
"org.apache.lucene.index.TestMaxTermFrequency",4,0.22,2.00,51,0.63,19120.23,7,3,13,31,12,122.23,13,50,0,2,101.61,0.00,0.50,0.50,1,0.00,3,1894.93,2,1,12,org.apache.lucene.util.LuceneTestCase,0.00,27,1,8,0,27,3,0,4,360,1
"org.apache.lucene.index.TestMaxTermFrequency$TestSimilarity",3,0.00,1.00,7,0.07,905.74,3,0,13,5,3,140.24,0,14,0,4,140.24,0.00,0.75,0.00,1,3.00,1,217.58,0,0,3,org.apache.lucene.search.similarities.DefaultSimilarity,0.24,2,3,3,0,2,3,0,0,60,0
"org.apache.lucene.index.TestMixedCodecs",1,0.00,8.00,34,0.58,34293.84,1,0,11,30,11,77.92,4,43,0,2,77.68,0.00,0.50,0.00,0,1.00,8,1728.65,0,0,11,org.apache.lucene.util.LuceneTestCase,0.00,29,1,8,0,29,1,0,4,274,1
"org.apache.lucene.index.TestMultiFields",2,0.00,10.50,105,1.95,150814.05,2,0,6,51,14,25.75,15,114,0,2,68.04,0.00,0.50,0.00,0,2.00,20,5846.87,0,0,14,org.apache.lucene.util.LuceneTestCase,0.00,49,1,21,0,49,2,0,2,859,1
"org.apache.lucene.index.TestMultiLevelSkipList",3,0.00,2.00,44,0.68,17899.93,4,1,17,34,17,80.48,16,49,1,2,98.35,0.00,0.50,1.00,1,0.00,3,2051.11,1,0,16,org.apache.lucene.util.LuceneTestCase,0.00,31,1,6,0,31,3,0,9,366,1
"org.apache.lucene.index.TestMultiLevelSkipList$CountingRAMDirectory",2,0.00,1.50,7,0.08,1850.79,2,0,17,4,4,129.75,0,13,0,3,129.75,0.00,0.67,0.00,0,2.00,2,234.46,1,1,4,org.apache.lucene.store.MockDirectoryWrapper,0.00,2,2,3,0,2,1,0,0,57,0
"org.apache.lucene.index.TestMultiLevelSkipList$CountingStream",8,1.00,1.00,21,0.23,3821.86,9,1,17,9,2,138.67,0,37,0,3,138.67,0.00,0.67,0.00,7,8.00,1,696.38,0,1,2,org.apache.lucene.store.IndexInput,0.81,1,2,8,0,1,7,0,0,179,0
"org.apache.lucene.index.TestMultiLevelSkipList$PayloadAnalyzer",1,0.00,1.00,5,0.08,1519.40,2,1,17,5,3,119.87,0,8,0,2,119.87,0.00,0.50,1.00,0,0.00,1,234.32,0,1,3,org.apache.lucene.analysis.Analyzer,0.00,4,1,1,0,4,0,0,0,54,2
"org.apache.lucene.index.TestMultiLevelSkipList$PayloadFilter",2,0.50,1.50,12,0.12,2440.76,4,2,17,6,3,117.57,0,17,0,4,117.57,0.00,0.75,0.75,0,0.00,2,364.37,0,0,3,org.apache.lucene.analysis.TokenFilter,0.29,4,3,3,0,4,2,0,0,86,2
"org.apache.lucene.index.TestMultiPassIndexSplitter",4,0.56,2.00,89,1.54,96384.67,7,3,7,33,13,126.14,8,100,0,2,86.26,0.00,0.50,0.75,0,0.00,3,4616.02,2,0,13,org.apache.lucene.util.LuceneTestCase,0.00,29,1,8,0,29,4,0,4,792,1
"org.apache.lucene.index.TestNRTReaderWithThreads",1,1.00,6.00,42,0.56,36420.11,2,1,6,19,5,94.73,3,42,0,2,74.12,0.00,0.50,0.00,0,1.00,6,1687.90,0,0,5,org.apache.lucene.util.LuceneTestCase,0.00,18,1,6,0,18,1,0,3,288,1
"org.apache.lucene.index.TestNRTReaderWithThreads$RunThread",2,0.71,3.00,30,0.38,11988.45,9,7,6,14,6,147.13,3,38,0,2,97.13,0.00,0.50,0.50,0,2.00,5,1130.24,0,0,6,org.apache.lucene.analysis.Thread,0.00,12,1,6,0,12,2,0,3,209,1
"org.apache.lucene.index.TestNeverDelete",1,0.00,7.00,39,0.64,32053.68,1,0,10,31,11,43.50,6,46,0,2,75.72,0.00,0.50,0.00,0,1.00,7,1916.34,0,0,11,org.apache.lucene.util.LuceneTestCase,0.00,30,1,7,0,30,1,0,6,296,1
"org.apache.lucene.index.TestNeverDelete$Thread",1,0.00,4.00,13,0.17,7263.11,1,0,10,7,3,98.72,0,19,0,1,98.72,0.00,0.00,0.00,0,1.00,4,510.64,0,0,3,java.lang.Object,0.00,6,0,4,0,6,1,0,0,95,0
"org.apache.lucene.index.TestNewestSegment",1,0.00,1.00,7,0.07,1170.96,1,0,3,8,3,115.31,0,9,0,2,115.31,0.00,0.50,0.00,0,1.00,1,219.07,0,0,3,org.apache.lucene.util.LuceneTestCase,0.00,7,1,1,0,7,1,0,0,51,1
"org.apache.lucene.index.TestNoDeletionPolicy",4,0.00,2.00,29,0.44,12355.09,4,0,10,28,8,151.72,11,39,0,2,111.84,0.00,0.50,0.00,0,4.00,3,1323.08,0,0,8,org.apache.lucene.util.LuceneTestCase,0.00,24,1,8,0,24,4,0,11,259,1
"org.apache.lucene.index.TestNoMergePolicy",4,0.00,1.75,21,0.33,8598.11,4,0,6,22,2,158.44,8,31,0,2,118.56,0.00,0.50,0.00,0,4.00,3,988.49,0,0,2,org.apache.lucene.util.LuceneTestCase,0.00,18,1,7,0,18,4,0,8,211,1
"org.apache.lucene.index.TestNoMergeScheduler",3,0.00,2.00,15,0.24,6613.39,3,0,6,14,2,158.33,8,23,0,2,118.44,0.00,0.50,0.00,0,3.00,3,709.29,0,0,2,org.apache.lucene.util.LuceneTestCase,0.00,11,1,6,0,11,3,0,8,150,1
"org.apache.lucene.index.TestNorms",4,0.33,3.50,128,1.81,83274.05,5,1,13,54,19,120.45,11,127,0,2,80.56,0.00,0.50,0.75,1,0.00,4,5430.98,0,0,19,org.apache.lucene.util.LuceneTestCase,0.00,50,1,14,0,50,4,0,3,902,1
"org.apache.lucene.index.TestNorms$ByteEncodingBoostSimilarity",2,1.00,1.50,8,0.08,1346.84,3,1,13,4,3,126.18,0,13,0,4,126.18,0.00,0.75,0.50,0,2.00,2,248.75,0,0,3,org.apache.lucene.search.similarities.DefaultSimilarity,0.00,2,3,3,0,2,2,0,0,61,2
"org.apache.lucene.index.TestNorms$CustomNormEncodingSimilarity",3,0.00,1.00,7,0.07,905.74,3,0,13,5,3,140.24,0,14,0,4,140.24,0.00,0.75,0.00,1,3.00,1,217.58,0,0,3,org.apache.lucene.search.similarities.DefaultSimilarity,0.24,2,3,3,0,2,3,0,0,60,0
"org.apache.lucene.index.TestNorms$MySimProvider",4,0.00,1.25,14,0.13,2132.23,6,2,13,8,3,131.68,0,23,0,3,131.68,0.00,0.67,0.50,0,0.00,2,382.29,0,1,3,org.apache.lucene.search.similarities.PerFieldSimilarityWrapper,0.40,4,2,5,0,4,3,0,0,98,1
"org.apache.lucene.index.TestOmitNorms",7,0.00,2.43,177,2.54,101247.30,7,0,10,55,18,43.60,49,182,0,2,85.89,0.00,0.50,0.00,2,7.00,5,7627.75,0,0,18,org.apache.lucene.util.LuceneTestCase,0.00,48,1,17,0,48,7,0,41,1319,1
"org.apache.lucene.index.TestOmitPositions",4,0.00,2.25,127,1.91,83211.33,4,0,12,43,18,38.89,29,124,0,2,81.18,0.00,0.50,0.00,1,4.00,3,5721.73,0,0,18,org.apache.lucene.util.LuceneTestCase,0.00,39,1,9,0,39,4,0,26,950,1
"org.apache.lucene.index.TestOmitTf",7,0.17,2.57,193,2.79,106370.86,9,2,15,64,23,52.24,42,205,0,2,84.46,0.00,0.50,0.64,1,0.00,5,8366.47,0,0,23,org.apache.lucene.util.LuceneTestCase,0.00,57,1,18,0,57,7,0,40,1397,1
"org.apache.lucene.index.TestOmitTf$CountingHitCollector",2,1.00,1.00,8,0.08,1498.24,3,1,15,4,1,125.91,1,12,0,1,125.91,0.00,0.00,0.50,0,2.00,1,238.89,1,0,1,java.lang.Object,0.00,2,0,2,0,2,2,0,1,59,0
"org.apache.lucene.index.TestOmitTf$CountingHitCollector_0",2,1.00,1.00,8,0.08,1612.84,3,1,15,4,1,125.65,1,12,0,1,125.65,0.00,0.00,0.50,0,2.00,1,250.05,1,0,1,java.lang.Object,0.00,2,0,2,0,2,2,0,1,61,0
"org.apache.lucene.index.TestOmitTf$CountingHitCollector_1",2,1.00,1.00,9,0.09,1939.78,3,1,15,5,1,125.02,1,13,0,1,125.02,0.00,0.00,0.50,0,2.00,1,284.44,1,0,1,java.lang.Object,0.00,3,0,2,0,3,2,0,1,67,0
"org.apache.lucene.index.TestOmitTf$CountingHitCollector_2",2,1.00,1.00,9,0.09,2026.63,3,1,15,4,1,124.87,1,13,0,1,124.87,0.00,0.00,0.50,0,2.00,1,282.12,1,0,1,java.lang.Object,0.00,2,0,2,0,2,2,0,1,67,0
"org.apache.lucene.index.TestOmitTf$CountingHitCollector_3",1,0.00,1.00,3,0.03,436.18,1,0,15,1,0,182.42,1,5,0,1,132.42,0.00,0.00,0.00,0,1.00,1,82.23,1,0,0,java.lang.Object,0.00,0,0,1,0,0,1,0,1,23,0
"org.apache.lucene.index.TestOmitTf$CountingHitCollector_4",7,0.06,1.00,19,0.14,2037.69,10,3,15,7,3,140.37,1,23,0,2,140.37,0.00,0.50,0.38,0,8.00,1,433.42,0,0,3,org.apache.lucene.search.Collector,0.36,0,1,7,0,0,7,0,1,118,2
"org.apache.lucene.index.TestOmitTf$SimpleSimilarity",8,0.00,1.00,17,0.16,1928.07,8,0,15,11,7,141.01,0,12,0,3,141.01,0.00,0.67,0.00,0,8.00,1,487.91,1,1,7,org.apache.lucene.search.similarities.TFIDFSimilarity,0.52,3,2,8,0,3,7,0,0,132,2
"org.apache.lucene.index.TestPKIndexSplitter",4,0.00,2.75,68,1.02,45079.60,4,0,11,33,13,92.96,1,73,0,2,92.96,0.00,0.50,0.00,3,4.00,5,3068.80,0,1,13,org.apache.lucene.util.LuceneTestCase,0.00,29,1,11,0,29,3,0,1,555,1
"org.apache.lucene.index.TestParallelAtomicReader",11,0.02,1.36,200,3.04,142523.48,16,5,9,48,16,141.72,19,221,0,2,91.72,0.00,0.50,0.18,3,35.00,3,9115.16,0,4,16,org.apache.lucene.util.LuceneTestCase,0.00,37,1,15,0,37,7,0,19,1727,1
"org.apache.lucene.index.TestParallelCompositeReader",15,0.00,1.67,314,4.62,242834.10,20,5,9,57,18,139.20,25,346,0,2,89.20,0.00,0.50,0.20,5,52.00,3,13848.70,0,5,18,org.apache.lucene.util.LuceneTestCase,0.00,42,1,25,0,42,10,0,25,2612,1
"org.apache.lucene.index.TestParallelReaderEmptyIndex",2,0.00,1.00,66,1.07,40839.61,2,0,9,32,15,42.85,24,80,0,2,80.42,0.00,0.50,0.00,0,2.00,1,3216.84,0,0,15,org.apache.lucene.util.LuceneTestCase,0.00,30,1,2,0,30,2,0,11,552,1
"org.apache.lucene.index.TestParallelTermEnum",4,0.33,1.25,57,0.79,22161.30,8,4,10,31,17,98.72,0,64,0,2,98.72,0.00,0.50,0.50,1,2.00,2,2363.70,2,0,17,org.apache.lucene.util.LuceneTestCase,0.00,27,1,5,0,27,4,0,0,452,1
"org.apache.lucene.index.TestPayloadProcessorProvider",7,0.50,2.57,101,1.51,72458.24,8,1,19,39,15,146.41,10,124,0,2,96.41,0.00,0.50,0.57,4,3.00,7,4536.37,0,0,15,org.apache.lucene.util.LuceneTestCase,0.00,32,1,18,0,32,7,0,10,807,1
"org.apache.lucene.index.TestPayloadProcessorProvider$DeletePayloadProcessor",1,0.00,1.00,3,0.03,432.00,1,0,19,1,1,132.45,0,6,0,2,132.45,0.00,0.50,0.00,0,1.00,1,96.00,0,0,1,org.apache.lucene.index.PayloadProcessorProvider.PayloadProcessor,0.00,0,1,1,0,0,1,0,0,26,3
"org.apache.lucene.index.TestPayloadProcessorProvider$PayloadTokenStream",3,0.38,1.33,19,0.19,3740.36,7,4,19,7,4,117.53,0,26,0,3,117.53,0.00,0.67,0.50,0,1.00,2,569.74,1,0,4,org.apache.lucene.analysis.TokenStream,0.55,4,2,4,0,4,3,0,0,129,3
"org.apache.lucene.index.TestPayloadProcessorProvider$PerDirPayloadProcessor",2,1.00,1.50,9,0.10,2210.98,3,1,19,5,4,124.48,0,14,0,2,124.48,0.00,0.50,0.50,0,2.00,2,312.35,0,1,4,org.apache.lucene.index.PayloadProcessorProvider,0.00,3,1,3,0,3,1,0,0,73,3
"org.apache.lucene.index.TestPayloadProcessorProvider$PerTermPayloadProcessor",1,0.00,2.00,5,0.07,1558.68,1,0,19,5,1,159.51,2,9,0,2,119.63,0.00,0.50,0.00,0,1.00,2,216.72,0,1,1,org.apache.lucene.index.PayloadProcessorProvider.ReaderPayloadProcessor,0.00,4,1,2,0,4,0,0,2,49,3
"org.apache.lucene.index.TestPayloads",9,1.00,3.56,244,3.88,422185.14,10,1,20,63,18,48.31,59,257,0,2,80.53,0.00,0.50,0.11,4,16.00,11,11650.47,0,1,18,org.apache.lucene.util.LuceneTestCase,0.00,54,1,32,0,54,8,0,48,1920,1
"org.apache.lucene.index.TestPayloads$PayloadAnalyzer",6,0.80,2.00,72,1.02,36730.70,7,1,20,45,15,100.76,3,81,0,2,100.76,0.00,0.50,0.33,1,10.00,6,3050.43,0,1,15,org.apache.lucene.analysis.Analyzer,0.00,39,1,12,0,39,5,0,1,559,2
"org.apache.lucene.index.TestPayloads$PayloadAnalyzer$ByteArrayPool",4,0.00,1.25,15,0.12,2418.37,5,1,20,7,0,131.25,0,18,0,1,131.25,0.00,0.00,1.00,0,0.00,2,357.55,0,0,0,java.lang.Object,0.00,3,0,5,0,3,4,0,0,92,2
"org.apache.lucene.index.TestPayloads$PayloadAnalyzer$PayloadData",1,3.00,1.00,8,0.06,948.88,4,3,20,1,0,113.87,0,10,0,1,113.87,0.00,0.00,0.00,0,1.00,1,171.73,0,0,0,java.lang.Object,0.00,0,0,1,0,0,1,0,0,47,2
"org.apache.lucene.index.TestPayloads$PayloadAnalyzer$PayloadFilter",3,0.42,1.67,30,0.31,9209.70,9,6,20,9,4,106.12,1,38,0,4,106.12,0.00,0.75,0.44,0,2.00,3,928.60,1,0,4,org.apache.lucene.analysis.TokenFilter,0.53,6,3,5,0,6,3,0,1,196,2
"org.apache.lucene.index.TestPayloads$PayloadAnalyzer$PoolingPayloadTokenStream",3,0.75,1.33,24,0.22,3351.03,9,6,20,11,3,113.24,0,30,0,2,113.24,0.00,0.50,0.67,0,0.00,2,665.71,0,0,3,org.apache.lucene.document.TokenStream,0.00,8,1,4,0,8,3,0,0,147,1
"org.apache.lucene.index.TestPayloads$PayloadAnalyzer$Thread",1,0.00,3.00,12,0.12,3071.62,1,0,20,9,2,103.03,0,14,0,1,103.03,0.00,0.00,0.00,0,1.00,3,348.86,0,0,2,java.lang.Object,0.00,8,0,3,0,8,1,0,0,71,0
"org.apache.lucene.index.TestPerSegmentDeletes",6,0.00,2.83,95,1.28,50500.45,6,0,15,49,22,85.62,95,94,0,2,95.98,0.00,0.50,0.00,2,6.00,4,3851.60,0,0,22,org.apache.lucene.util.LuceneTestCase,0.00,43,1,17,0,43,6,0,30,680,1
"org.apache.lucene.index.TestPerSegmentDeletes$RangeMergePolicy",6,0.10,1.17,22,0.23,4418.75,10,4,15,11,4,130.59,0,38,0,2,130.59,0.00,0.50,0.17,0,14.00,2,683.87,0,3,4,org.apache.lucene.index.MergePolicy,0.15,5,1,7,0,5,3,0,0,160,1
"org.apache.lucene.index.TestPersistentSnapshotDeletionPolicy",11,0.00,1.55,81,1.15,30025.99,13,2,10,32,8,162.32,12,127,0,3,112.32,0.00,0.67,0.50,1,0.00,3,3460.25,4,2,8,org.apache.lucene.index.TestSnapshotDeletionPolicy,0.20,21,2,17,0,21,9,0,12,688,1
"org.apache.lucene.index.TestPostingsOffsets",7,0.50,6.00,243,4.53,448754.09,8,1,25,93,29,75.84,34,259,0,2,75.61,0.00,0.50,0.57,2,3.00,20,13582.12,1,1,29,org.apache.lucene.util.LuceneTestCase,0.00,86,1,42,0,86,6,0,34,2011,1
"org.apache.lucene.index.TestPrefixCodedTerms",6,0.00,2.33,91,1.31,51715.44,6,0,8,30,4,95.94,0,91,0,2,95.94,0.00,0.50,0.00,0,6.00,6,3920.08,0,0,4,org.apache.lucene.util.LuceneTestCase,0.00,24,1,14,0,24,6,0,0,737,1
"org.apache.lucene.index.TestRandomStoredFields",1,0.00,17.00,82,1.43,113997.08,1,0,18,41,13,99.02,2,84,0,2,59.14,0.00,0.50,0.00,0,1.00,17,4296.98,0,0,13,org.apache.lucene.util.LuceneTestCase,0.00,40,1,17,0,40,1,0,2,611,1
"org.apache.lucene.index.TestReaderClosed",4,0.17,1.75,41,0.54,12830.45,6,2,11,28,15,155.96,5,54,0,2,105.96,0.00,0.50,0.62,0,0.00,2,1619.72,2,0,15,org.apache.lucene.util.LuceneTestCase,0.00,24,1,7,0,24,4,0,5,307,1
"org.apache.lucene.index.TestRollback",1,0.00,3.00,27,0.39,12701.30,1,0,5,21,8,124.92,2,25,0,2,85.04,0.00,0.50,0.00,0,1.00,3,1167.35,0,0,8,org.apache.lucene.util.LuceneTestCase,0.00,20,1,3,0,20,1,0,2,201,1
"org.apache.lucene.index.TestRollingUpdates",2,0.00,6.50,69,1.09,69278.94,2,0,7,41,11,117.58,4,72,0,2,77.69,0.00,0.50,0.00,0,2.00,9,3257.32,0,0,11,org.apache.lucene.util.LuceneTestCase,0.00,39,1,13,0,39,2,0,4,520,1
"org.apache.lucene.index.TestRollingUpdates$IndexingThread",2,0.33,4.00,30,0.38,15115.85,5,3,7,16,7,96.27,1,37,0,2,96.27,0.00,0.50,0.17,0,2.00,7,1128.50,0,0,7,org.apache.lucene.analysis.Thread,0.00,14,1,8,0,14,2,0,1,211,1
"org.apache.lucene.index.TestSameTokenSamePosition",2,0.00,1.50,21,0.21,4625.60,2,0,9,11,9,127.73,7,22,0,2,107.11,0.00,0.50,0.00,0,2.00,2,635.21,0,0,9,org.apache.lucene.util.LuceneTestCase,0.00,9,1,3,0,9,2,0,2,134,1
"org.apache.lucene.index.TestSegmentMerger",4,0.79,1.75,73,1.20,55430.64,12,8,11,38,22,141.43,7,89,0,2,91.43,0.00,0.50,0.72,0,0.00,4,3607.76,2,0,22,org.apache.lucene.util.LuceneTestCase,0.00,34,1,7,0,34,4,0,7,604,1
"org.apache.lucene.index.TestSegmentReader",9,0.17,2.44,106,1.77,88670.06,12,3,11,68,22,140.39,18,137,1,2,100.50,0.00,0.50,0.48,1,0.00,7,5304.25,2,0,21,org.apache.lucene.util.LuceneTestCase,0.00,59,1,22,0,59,9,0,9,979,1
"org.apache.lucene.index.TestSegmentTermDocs",11,0.07,1.36,159,2.89,284775.35,14,3,9,48,16,143.42,13,210,0,2,93.42,0.00,0.50,0.27,3,29.00,4,8670.27,2,0,16,org.apache.lucene.util.LuceneTestCase,0.00,37,1,15,0,37,11,0,13,1453,1
"org.apache.lucene.index.TestSegmentTermEnum",6,0.20,1.33,62,0.81,21599.72,7,1,10,37,12,145.51,17,75,0,2,105.63,0.00,0.50,0.83,2,0.00,2,2419.45,2,0,12,org.apache.lucene.util.LuceneTestCase,0.00,31,1,8,0,31,6,0,17,472,1
"org.apache.lucene.index.TestSizeBoundedForceMerge",14,0.00,1.29,237,2.64,75319.95,14,0,7,43,13,146.65,14,249,0,2,96.65,0.00,0.50,0.00,2,14.00,3,7927.28,0,1,13,org.apache.lucene.util.LuceneTestCase,0.00,29,1,18,0,29,13,0,14,1516,1
"org.apache.lucene.index.TestSnapshotDeletionPolicy",19,0.50,1.74,211,2.67,84777.12,21,2,13,75,16,123.90,64,252,1,2,103.29,1.00,0.33,0.03,9,36.00,5,8022.69,0,3,15,org.apache.lucene.util.LuceneTestCase,0.00,56,1,33,1,56,16,0,59,1508,1
"org.apache.lucene.index.TestSnapshotDeletionPolicy$Thread",1,0.00,6.00,25,0.30,12277.37,1,0,13,16,4,86.24,0,32,0,1,86.24,0.00,0.00,0.00,0,1.00,6,889.22,0,0,4,java.lang.Object,0.00,15,0,6,0,15,1,0,0,152,0
"org.apache.lucene.index.TestSnapshotDeletionPolicy$Thread_0",1,0.00,2.00,7,0.06,1153.33,1,0,13,7,1,115.20,0,11,0,1,115.20,0.00,0.00,0.00,0,1.00,2,193.47,0,0,1,java.lang.Object,0.00,6,0,2,0,6,1,0,0,45,0
"org.apache.lucene.index.TestStressAdvance",2,0.00,9.50,87,1.40,99769.93,2,0,8,41,10,122.55,2,95,0,2,72.55,0.00,0.50,0.00,1,2.00,10,4212.83,0,0,10,org.apache.lucene.util.LuceneTestCase,0.00,39,1,19,0,39,2,0,2,665,1
"org.apache.lucene.index.TestStressIndexing",2,0.00,2.00,36,0.43,17926.39,2,0,6,16,5,50.60,15,36,0,2,92.89,0.00,0.50,0.00,1,2.00,3,1279.86,0,0,5,org.apache.lucene.util.LuceneTestCase,0.00,14,1,4,0,14,2,0,9,242,1
"org.apache.lucene.index.TestStressIndexing$IndexerThread",2,0.00,2.00,23,0.26,8419.03,4,2,6,11,6,153.45,2,23,0,2,103.45,0.00,0.50,0.50,0,2.00,3,773.27,0,0,6,org.apache.lucene.index.TimedThread,0.00,9,1,4,0,9,2,0,2,149,1
"org.apache.lucene.index.TestStressIndexing$SearcherThread",2,1.00,1.50,14,0.12,2849.55,3,1,6,5,3,114.55,0,16,0,2,114.55,0.00,0.50,0.50,0,2.00,2,355.10,0,0,3,org.apache.lucene.index.TimedThread,0.00,3,1,3,0,3,2,0,0,81,2
"org.apache.lucene.index.TestStressIndexing$TimedThread",4,0.08,2.00,23,0.27,8101.38,8,4,6,8,0,118.73,0,31,0,2,118.73,0.00,0.50,0.31,2,4.00,3,802.23,0,0,0,org.apache.lucene.analysis.Thread,0.00,4,1,8,0,4,4,0,0,170,3
"org.apache.lucene.index.TestStressIndexing2",12,0.02,6.83,468,7.91,1393311.73,20,8,22,110,26,71.56,52,505,0,2,71.32,0.00,0.50,0.10,5,30.00,42,23729.02,0,2,26,org.apache.lucene.util.LuceneTestCase,0.00,98,1,82,0,98,10,0,47,3611,1
"org.apache.lucene.index.TestStressIndexing2$Comparator<IndexableField>",1,0.00,1.00,3,0.03,432.92,1,0,22,3,1,132.44,0,4,0,1,132.44,0.00,0.00,0.00,0,1.00,1,101.06,0,0,1,java.lang.Object,0.00,2,0,1,0,2,1,0,0,29,0
"org.apache.lucene.index.TestStressIndexing2$DocsAndWriter",0,0.00,0.00,3,0.02,239.86,2,2,22,0,2,171.00,0,4,0,1,171.00,0.00,0.00,0.00,0,0.00,0,68.53,0,0,2,java.lang.Object,0.00,0,0,0,0,0,0,0,0,18,2
"org.apache.lucene.index.TestStressIndexing2$IndexingThread",10,0.11,4.10,140,1.95,136087.36,17,7,22,48,7,95.37,8,166,0,2,95.37,0.00,0.50,0.24,5,34.00,15,5858.16,0,3,7,org.apache.lucene.analysis.Thread,0.00,38,1,41,0,38,7,0,8,1045,1
"org.apache.lucene.index.TestStressIndexing2$MockIndexWriter",2,0.00,1.50,6,0.06,690.80,2,0,22,4,3,133.12,1,11,0,2,133.12,0.00,0.50,0.00,0,2.00,2,181.65,0,0,3,org.apache.lucene.index.IndexWriter,0.00,2,1,3,0,2,2,0,1,47,1
"org.apache.lucene.index.TestStressNRT",2,0.62,6.00,78,1.15,68160.54,10,8,20,31,16,115.43,5,77,2,2,75.55,0.00,0.50,0.44,1,2.00,10,3441.28,0,0,14,org.apache.lucene.util.LuceneTestCase,0.00,29,1,12,0,29,2,0,5,556,1
"org.apache.lucene.index.TestStressNRT$Thread",1,0.00,28.00,103,2.11,304447.77,2,1,20,31,6,99.24,23,135,0,1,51.97,0.00,0.00,1.00,0,0.00,28,6338.61,0,0,6,java.lang.Object,0.00,30,0,28,0,30,1,0,23,909,0
"org.apache.lucene.index.TestStressNRT$Thread_0",1,0.00,12.00,43,0.96,90848.06,2,1,20,24,8,22.35,8,56,0,1,70.45,0.00,0.00,1.00,0,0.00,12,2884.46,0,0,8,java.lang.Object,0.00,23,0,12,0,23,1,0,8,431,0
"org.apache.lucene.index.TestSumDocFreq",2,0.00,4.00,55,0.79,38381.53,2,0,7,28,14,123.45,5,58,0,2,83.56,0.00,0.50,0.00,1,2.00,5,2357.47,0,0,14,org.apache.lucene.util.LuceneTestCase,0.00,26,1,8,0,26,2,0,2,403,1
"org.apache.lucene.index.TestTerm",1,0.00,1.00,12,0.13,4439.98,1,0,1,5,1,102.02,0,14,0,2,102.02,0.00,0.50,0.00,0,1.00,1,400.01,0,0,1,org.apache.lucene.util.LuceneTestCase,0.00,4,1,1,0,4,1,0,0,91,1
"org.apache.lucene.index.TestTermVectorsReader",8,0.41,3.62,233,3.54,228567.00,18,10,20,67,23,120.95,23,227,0,2,81.06,0.00,0.50,0.46,0,0.00,8,10607.87,2,0,23,org.apache.lucene.util.LuceneTestCase,0.00,59,1,29,0,59,8,0,17,1764,1
"org.apache.lucene.index.TestTermVectorsReader$MyAnalyzer",1,0.00,1.00,3,0.03,425.86,1,0,20,3,1,132.50,0,6,0,2,132.50,0.00,0.50,0.00,0,1.00,1,97.55,0,1,1,org.apache.lucene.analysis.Analyzer,0.00,2,1,1,0,2,0,0,0,27,1
"org.apache.lucene.index.TestTermVectorsReader$MyTokenizer",3,0.50,1.67,26,0.27,8226.32,7,4,20,7,4,110.12,0,34,0,4,110.12,0.00,0.75,0.58,0,1.00,3,815.43,1,0,4,org.apache.lucene.analysis.Tokenizer,0.47,4,3,5,0,4,3,0,0,173,1
"org.apache.lucene.index.TestTermVectorsReader$TestToken",1,3.00,1.00,7,0.05,734.78,5,4,20,1,0,116.91,0,9,0,1,116.91,0.00,0.00,0.25,0,0.00,1,151.77,0,0,0,java.lang.Object,0.00,0,0,1,0,0,1,1,0,40,1
"org.apache.lucene.index.TestTermVectorsWriter",13,0.00,1.46,413,6.42,203856.92,13,0,19,64,24,132.24,21,442,0,2,82.24,0.00,0.50,0.00,0,13.00,4,19271.37,0,0,24,org.apache.lucene.util.LuceneTestCase,0.00,51,1,19,0,51,13,0,21,3192,1
"org.apache.lucene.index.TestTermdocPerf",3,0.00,2.67,36,0.61,26037.76,3,0,14,26,14,99.50,2,43,0,2,99.50,0.00,0.50,0.00,1,3.00,5,1829.75,0,0,14,org.apache.lucene.util.LuceneTestCase,0.00,23,1,8,0,23,3,0,2,315,1
"org.apache.lucene.index.TestTermdocPerf$Analyzer",1,0.00,1.00,3,0.04,476.62,1,0,14,3,1,132.11,0,5,0,1,132.11,0.00,0.00,0.00,0,1.00,1,114.20,0,1,1,java.lang.Object,0.00,2,0,1,0,2,0,0,0,29,0
"org.apache.lucene.index.TestTermsEnum2",6,0.27,3.50,98,1.47,48444.02,12,6,26,58,24,134.91,14,103,0,2,95.03,0.00,0.50,0.39,0,0.00,5,4415.09,2,0,24,org.apache.lucene.util.LuceneTestCase,0.00,52,1,21,0,52,6,0,14,766,1
"org.apache.lucene.index.TestThreadedForceMerge",3,0.20,2.67,60,1.03,58017.84,8,5,11,33,12,138.49,5,60,0,2,88.49,0.00,0.50,0.33,1,1.00,6,3096.37,0,0,12,org.apache.lucene.util.LuceneTestCase,0.00,30,1,8,0,30,3,0,2,497,1
"org.apache.lucene.index.TestThreadedForceMerge$Thread",1,0.00,5.00,25,0.35,16505.14,1,0,11,12,2,85.27,0,22,0,1,85.27,0.00,0.00,0.00,0,1.00,5,1042.86,0,0,2,java.lang.Object,0.00,11,0,5,0,11,1,0,0,183,0
"org.apache.lucene.index.TestTieredMergePolicy",3,0.00,4.00,109,1.60,73668.32,3,0,7,48,13,78.06,0,110,0,2,78.06,0.00,0.50,0.00,0,3.00,5,4785.57,0,0,13,org.apache.lucene.util.LuceneTestCase,0.00,45,1,12,0,45,3,0,0,767,1
"org.apache.lucene.index.TestTransactionRollback",6,0.10,2.83,75,1.07,38690.44,8,2,13,44,11,82.63,30,86,0,2,100.51,0.00,0.50,0.58,2,0.00,5,3206.38,2,0,11,org.apache.lucene.util.LuceneTestCase,0.00,38,1,17,0,38,6,0,11,584,1
"org.apache.lucene.index.TestTransactionRollback$DeleteLastCommitPolicy",2,0.00,2.00,4,0.06,1042.33,2,0,13,5,1,138.22,0,6,0,1,138.22,0.00,0.00,0.00,0,2.00,2,187.90,0,0,1,java.lang.Object,0.00,3,0,4,0,3,2,1,0,47,0
"org.apache.lucene.index.TestTransactionRollback$KeepAllDeletionPolicy",2,0.00,2.00,3,0.04,443.84,2,0,13,2,1,152.36,0,4,0,1,152.36,0.00,0.00,0.00,0,2.00,2,118.22,0,0,1,java.lang.Object,0.00,0,0,4,0,0,2,1,0,33,0
"org.apache.lucene.index.TestTransactionRollback$RollbackDeletionPolicy",3,1.00,2.67,15,0.20,6066.93,4,1,13,10,1,118.90,12,21,0,1,118.67,0.00,0.00,0.33,0,4.00,5,596.95,0,0,1,java.lang.Object,0.00,7,0,8,0,7,3,1,4,123,0
"org.apache.lucene.index.TestTransactions",2,1.00,2.50,51,0.59,28298.13,3,1,11,22,12,85.96,1,47,2,2,85.96,0.00,0.50,0.00,1,2.00,3,1771.58,0,0,10,org.apache.lucene.util.LuceneTestCase,0.00,20,1,5,0,20,2,0,1,334,1
"org.apache.lucene.index.TestTransactions$IndexerThread",3,0.12,2.33,54,0.68,27876.51,7,4,11,28,11,142.73,4,74,0,2,92.73,0.00,0.50,0.33,1,5.00,3,2054.94,0,0,11,org.apache.lucene.index.TimedThread,0.00,25,1,7,0,25,3,0,4,382,1
"org.apache.lucene.index.TestTransactions$RandomFailure",1,0.00,2.00,4,0.06,1223.36,1,0,11,3,2,124.07,0,8,0,2,124.07,0.00,0.50,0.00,0,1.00,2,179.11,0,0,2,MockDirectoryWrapper.Failure,0.00,2,1,2,0,2,1,0,0,41,1
"org.apache.lucene.index.TestTransactions$SearcherThread",2,0.33,1.50,17,0.19,6270.02,5,3,11,6,2,109.69,0,23,0,2,109.69,0.00,0.50,0.50,0,2.00,2,575.27,0,0,2,org.apache.lucene.index.TimedThread,0.00,4,1,3,0,4,2,0,0,128,2
"org.apache.lucene.index.TestTransactions$TimedThread",4,0.00,2.00,20,0.25,7408.19,7,3,11,8,0,119.04,0,28,0,2,119.04,0.00,0.50,0.33,2,4.00,3,752.86,0,0,0,org.apache.lucene.analysis.Thread,0.00,4,1,8,0,4,4,0,0,162,3
"org.apache.lucene.index.TestTypePromotion",10,0.08,4.60,206,3.94,324535.35,14,4,16,71,18,86.59,7,287,0,2,86.59,0.00,0.50,0.18,3,38.00,21,11816.60,1,1,18,org.apache.lucene.util.LuceneTestCase,0.00,61,1,46,0,61,9,0,7,1900,1
"org.apache.lucene.index.TestTypePromotion$TestType",0,0.00,0.00,2,0.01,48.00,0,0,16,0,0,171.00,0,3,0,1,171.00,0.00,0.00,0.00,0,0.00,0,24.00,0,0,0,java.lang.Object,0.00,0,0,0,0,0,0,0,0,8,2
"org.apache.lucene.index.TestUniqueTermCount",4,0.22,1.75,47,0.58,15895.88,7,3,12,32,13,143.57,11,49,0,2,103.68,0.00,0.50,0.50,1,0.00,2,1752.65,2,1,13,org.apache.lucene.util.LuceneTestCase,0.00,28,1,7,0,28,3,0,4,337,1
"org.apache.lucene.index.TestUniqueTermCount$TestSimilarity",1,0.00,1.00,3,0.03,376.21,1,0,12,3,3,132.92,0,6,0,4,132.92,0.00,0.75,0.00,0,1.00,1,103.61,0,0,3,org.apache.lucene.search.similarities.DefaultSimilarity,0.00,2,3,1,0,2,1,0,0,28,0
"org.apache.lucene.index.ThreadAffinityDocumentsWriterThreadPool",2,1.00,3.00,22,0.25,12536.36,3,1,3,9,6,57.87,23,29,4,2,102.00,0.00,0.50,0.50,0,2.00,5,741.04,2,1,2,org.apache.lucene.index.DocumentsWriterPerThreadPool,0.00,7,1,6,0,7,1,0,7,151,1
"org.apache.lucene.index.ThreadedIndexingAndSearchingTestCase",18,0.07,3.17,193,3.62,308697.43,24,6,34,93,29,150.09,26,224,1,2,100.09,1.00,0.33,0.10,7,54.00,29,10866.13,0,4,28,org.apache.lucene.util.LuceneTestCase,0.00,75,1,57,1,75,14,0,25,1666,2
"org.apache.lucene.index.ThreadedIndexingAndSearchingTestCase$IndexWriter.IndexReaderWarmer",1,0.00,5.00,19,0.30,13437.24,1,0,34,13,6,90.42,0,22,0,1,90.42,0.00,0.00,0.00,0,1.00,5,905.12,0,0,6,java.lang.Object,0.00,12,0,5,0,12,1,0,0,156,0
"org.apache.lucene.index.ThreadedIndexingAndSearchingTestCase$SubDocs",1,3.00,1.00,7,0.06,1214.84,4,3,34,1,0,115.19,0,9,0,1,115.19,0.00,0.00,0.00,0,1.00,1,187.57,0,0,0,java.lang.Object,0.00,0,0,1,0,0,1,0,0,48,2
"org.apache.lucene.index.ThreadedIndexingAndSearchingTestCase$Thread",1,0.00,34.00,121,2.53,394286.58,1,0,34,40,5,10.87,12,155,0,1,48.43,0.00,0.00,0.00,0,0.00,34,7590.20,0,0,5,java.lang.Object,0.00,39,0,34,0,39,1,0,12,1066,0
"org.apache.lucene.index.ThreadedIndexingAndSearchingTestCase$Thread_0",1,0.00,10.00,37,0.52,35723.19,1,0,34,22,8,33.83,7,51,0,1,76.12,0.00,0.00,0.00,0,0.00,10,1561.26,0,0,8,java.lang.Object,0.00,21,0,10,0,21,1,0,7,249,0
"org.apache.lucene.index.TieredMergePolicy",30,0.04,3.03,310,4.81,547595.80,40,10,8,75,20,100.12,136,391,15,2,99.89,0.00,0.50,0.14,4,482.00,28,14433.05,0,14,5,org.apache.lucene.index.MergePolicy,0.05,45,1,91,0,45,16,0,68,2420,1
"org.apache.lucene.index.TieredMergePolicy$MergeScore",2,0.00,1.00,3,0.01,73.60,2,0,8,2,0,158.67,0,5,0,1,158.67,0.00,0.00,0.00,0,2.00,1,38.73,0,1,0,java.lang.Object,0.00,0,0,2,0,0,1,0,0,16,3
"org.apache.lucene.index.TieredMergePolicy$MergeScore_0",2,0.00,1.00,5,0.05,835.72,2,0,8,3,0,139.13,0,9,0,1,139.13,0.00,0.00,0.00,0,2.00,1,154.90,0,1,0,java.lang.Object,0.00,1,0,2,0,1,1,0,0,42,0
"org.apache.lucene.index.TieredMergePolicy$SegmentByteSizeDescending",1,0.00,4.00,12,0.13,5525.96,1,0,8,4,1,100.95,0,17,0,1,100.95,0.00,0.00,0.00,0,1.00,4,380.28,0,0,1,java.lang.Object,0.00,3,0,4,0,3,1,1,0,80,1
"org.apache.lucene.index.TypePromoter",7,0.15,1.57,66,1.18,65760.84,26,19,3,12,5,55.91,57,102,5,1,104.02,0.00,0.00,0.18,1,17.00,4,3542.57,0,5,0,java.lang.Object,0.00,5,0,11,1,5,2,0,11,671,0
"org.apache.lucene.index.TypePromoter$IdentityTypePromoter",2,0.00,1.00,5,0.03,367.20,2,0,3,2,1,141.94,0,9,0,2,141.94,0.00,0.50,0.00,0,2.00,1,99.38,0,0,1,org.apache.lucene.index.TypePromoter,0.22,0,1,2,0,0,2,0,0,31,2
"org.apache.lucene.index.UpgradeIndexMergePolicy",11,0.40,2.00,51,0.71,35136.23,12,1,6,36,7,141.40,35,79,1,2,120.79,0.00,0.50,0.64,2,4.00,12,2120.23,1,4,6,org.apache.lucene.index.MergePolicy,0.11,25,1,22,0,25,7,0,8,429,1
"org.apache.lucene.index.UseNoMemoryExpensiveCodec",0,0.00,0.00,4,0.06,1646.58,2,2,14,1,2,171.00,12,4,0,2,171.00,0.00,0.50,0.00,0,0.00,0,180.94,0,0,2,org.apache.lucene.util.LuceneTestCase,0.00,1,1,0,0,1,0,0,12,40,1
"org.apache.lucene.index.UseNoMemoryExpensiveCodec$MyTokenStream",6,0.16,3.17,120,2.28,128717.39,11,5,14,68,21,88.09,4,144,0,3,88.09,0.00,0.67,0.33,1,0.00,6,6830.36,0,1,21,org.apache.lucene.analysis.TokenStream,0.43,62,2,19,0,62,5,0,4,1065,3
"org.apache.lucene.index.UseNoMemoryExpensiveCodec$MyTokenStream$MyAttributeFactory",2,1.00,2.50,8,0.11,3033.18,3,1,14,6,3,123.28,0,14,0,2,123.28,0.00,0.50,0.50,0,2.00,4,324.41,0,1,3,org.apache.lucene.util.AttributeFactory,0.00,4,1,5,0,4,1,0,0,75,3
"org.apache.lucene.index.UseNoMemoryExpensiveCodec$MyTokenStream$MyTermAttributeImpl",7,0.00,1.00,13,0.10,1104.30,7,0,14,9,3,153.69,0,26,0,2,153.69,0.00,0.50,0.00,0,13.00,1,303.90,0,2,3,org.apache.lucene.util.AttributeImpl,0.33,2,1,7,0,2,5,1,0,90,3
"org.apache.lucene.index.UseNoMemoryExpensiveCodec$TermAndState",1,2.00,1.00,6,0.04,607.65,3,2,29,1,2,120.05,0,8,0,1,120.05,0.00,0.00,0.00,0,1.00,1,132.64,0,0,2,java.lang.Object,0.00,0,0,1,0,0,1,0,0,37,2
"org.apache.solr.core.AbstractSolrEventListener",7,0.50,1.14,23,0.20,4266.35,9,2,3,13,7,181.24,12,34,2,1,131.24,0.00,0.00,0.07,0,12.00,2,589.75,0,2,5,java.lang.Object,0.00,6,0,8,2,6,5,1,2,151,1
"org.apache.solr.core.AlternateDirectoryTest",2,0.00,1.00,9,0.09,965.00,2,0,7,3,3,167.30,5,14,0,3,127.41,0.00,0.67,0.00,0,2.00,1,268.35,3,0,3,org.apache.solr.SolrTestCaseJ4,0.00,1,2,2,0,1,2,0,1,67,1
"org.apache.solr.core.AlternateDirectoryTest$TestFSDirectoryFactory",1,0.00,1.00,6,0.07,957.04,3,2,7,2,2,118.50,0,9,0,3,118.50,0.00,0.67,1.00,0,0.00,1,202.23,0,1,2,org.apache.solr.core.CachingDirectoryFactory,0.00,1,2,1,0,1,0,0,0,49,2
"org.apache.solr.core.AlternateDirectoryTest$TestIndexReaderFactory",1,1.00,1.00,5,0.05,843.29,2,1,7,2,3,121.89,0,8,0,2,121.89,0.00,0.50,0.00,0,1.00,1,161.70,0,1,3,org.apache.solr.core.IndexReaderFactory,0.00,1,1,1,0,1,0,0,0,40,2
"org.apache.solr.core.CachingDirectoryFactory",10,0.07,2.50,78,1.04,47138.30,13,3,14,37,15,110.57,48,113,7,2,110.34,9.00,0.09,0.27,3,26.00,7,3131.08,0,4,8,org.apache.solr.core.DirectoryFactory,0.12,27,1,25,9,27,6,0,11,614,2
"org.apache.solr.core.CachingDirectoryFactory$CacheValue",0,0.00,0.00,5,0.03,260.00,4,4,14,0,1,171.00,0,6,0,1,171.00,0.00,0.00,0.00,0,0.00,0,104.00,0,0,1,java.lang.Object,0.00,0,0,0,0,0,0,0,0,26,0
"org.apache.solr.core.CloseHook",2,0.00,1.00,3,0.02,119.22,2,0,0,2,5,204.29,47,4,4,1,157.02,0.00,0.00,0.00,0,2.00,1,59.61,0,0,1,java.lang.Object,0.00,0,0,2,0,0,2,0,4,21,2
"org.apache.solr.core.ClosingRequestHandler",1,1.00,1.00,4,0.03,270.16,2,1,11,3,12,129.39,0,6,1,3,129.39,0.00,0.67,0.00,0,1.00,1,90.05,0,0,11,org.apache.solr.core.EmptyRequestHandler,0.00,2,2,1,0,2,1,1,0,26,0
"org.apache.solr.core.ClosingRequestHandler$CloseHook",2,0.00,1.00,4,0.03,265.70,2,0,11,2,1,143.05,0,7,0,1,143.05,0.00,0.00,0.00,0,2.00,1,91.51,0,0,1,java.lang.Object,0.00,0,0,2,0,0,2,0,0,28,0
"org.apache.solr.core.CodecFactory",2,0.00,1.00,3,0.02,126.61,2,0,4,2,7,206.81,3,5,3,1,156.81,0.00,0.00,0.00,0,2.00,1,63.30,0,1,4,java.lang.Object,0.00,0,0,2,1,0,1,1,1,22,2
"org.apache.solr.core.Config",27,0.02,1.93,136,1.95,79510.35,35,8,26,71,14,167.46,47,200,9,1,117.46,0.00,0.00,0.10,4,223.00,10,5863.92,0,14,5,java.lang.Object,0.00,44,0,52,1,44,13,0,10,1163,1
"org.apache.solr.core.CoreContainer",50,0.03,3.44,614,9.89,619974.11,84,34,56,208,48,118.84,158,842,29,1,98.23,0.00,0.00,0.06,16,1082.00,20,29683.48,1,19,24,java.lang.Object,0.00,158,0,172,0,158,31,0,73,4933,1
"org.apache.solr.core.CoreContainer$CurrentCoreDescriptorProvider",1,0.00,2.00,7,0.08,2315.22,1,0,56,6,1,112.82,0,9,0,1,112.82,0.00,0.00,0.00,0,1.00,2,238.32,0,1,1,java.lang.Object,0.00,5,0,2,0,5,0,0,0,53,0
"org.apache.solr.core.CoreContainer$Initializer",1,1.00,3.00,17,0.23,8329.90,3,2,56,11,2,114.59,3,22,0,1,93.97,0.00,0.00,0.50,0,0.00,3,683.20,0,0,2,java.lang.Object,0.00,10,0,3,0,10,1,0,3,131,2
"org.apache.solr.core.CoreDescriptor",22,0.04,1.55,91,0.88,24466.62,31,9,3,39,19,174.45,24,124,17,1,124.45,0.00,0.00,0.08,1,186.00,5,2640.00,0,13,3,java.lang.Object,0.00,17,0,34,0,17,9,0,13,615,1
"org.apache.solr.core.DefaultCodecFactory",1,0.00,1.00,3,0.02,226.76,1,0,5,2,7,105.27,13,6,1,2,134.65,0.00,0.50,0.00,0,1.00,1,62.11,0,1,6,org.apache.solr.core.CodecFactory,0.00,1,1,1,0,1,0,0,8,19,1
"org.apache.solr.core.DefaultCodecFactory$Lucene40Codec",1,0.00,3.00,9,0.11,4170.09,1,0,5,6,2,106.64,0,13,0,1,106.64,0.00,0.00,0.00,0,1.00,3,333.00,1,1,2,java.lang.Object,0.00,5,0,3,0,5,0,0,0,69,0
"org.apache.solr.core.DirectoryFactory",7,0.00,1.00,8,0.09,648.88,7,0,4,7,12,123.29,42,12,10,1,155.51,0.00,0.00,0.00,0,7.00,1,255.76,0,3,2,java.lang.Object,0.00,0,0,7,10,0,4,2,8,78,2
"org.apache.solr.core.DummyValueSourceParser",2,1.00,1.00,8,0.07,1208.58,3,1,7,4,8,166.53,4,13,1,2,126.64,0.00,0.50,0.00,0,2.00,1,208.34,0,1,7,org.apache.solr.search.ValueSourceParser,0.00,2,1,2,0,2,1,0,1,54,1
"org.apache.solr.core.DummyValueSourceParser$SimpleFloatFunction",2,0.00,1.00,6,0.04,527.78,2,0,7,2,1,134.13,0,10,0,1,134.13,0.00,0.00,0.00,0,2.00,1,128.15,0,1,1,java.lang.Object,0.00,0,0,2,0,0,1,0,0,36,0
"org.apache.solr.core.EmptyRequestHandler",5,0.00,1.00,10,0.07,711.24,5,0,11,5,10,142.82,1,10,2,2,142.82,1.00,0.33,0.00,0,5.00,1,209.58,0,4,8,org.apache.solr.RequestHandlerBase,0.00,0,1,5,1,0,1,0,1,63,0
"org.apache.solr.core.FakeDeletionPolicy",5,0.12,1.00,14,0.11,1161.97,7,2,5,7,4,191.14,6,20,1,1,141.14,0.00,0.00,0.40,0,6.00,1,341.96,0,2,3,java.lang.Object,0.00,2,0,5,0,2,3,2,4,92,1
"org.apache.solr.core.IndexDeletionPolicyWrapper",14,0.03,1.79,72,0.82,24822.76,19,5,8,38,12,139.83,52,87,8,1,119.21,0.00,0.00,0.17,3,110.00,3,2461.64,0,5,4,java.lang.Object,0.00,24,0,25,0,24,9,1,16,541,1
"org.apache.solr.core.IndexDeletionPolicyWrapper$IndexCommitWrapper",11,0.10,1.18,28,0.26,5078.23,12,1,8,22,2,138.75,0,50,0,2,138.75,0.00,0.50,0.91,0,0.00,3,791.79,0,4,2,org.apache.lucene.index.IndexCommit,0.82,11,1,13,0,11,7,0,0,208,1
"org.apache.solr.core.IndexReaderFactory",3,0.50,1.33,9,0.08,1068.56,4,1,6,5,11,84.94,25,14,6,1,133.04,0.00,0.00,0.67,0,1.00,2,240.71,0,1,5,java.lang.Object,0.00,2,0,4,2,2,2,1,5,63,2
"org.apache.solr.core.IndexReaderFactoryTest",3,0.00,1.00,10,0.10,1807.27,3,0,1,8,2,181.31,5,16,0,3,131.31,0.00,0.67,0.00,0,4.00,1,312.06,0,2,2,org.apache.solr.util.AbstractSolrTestCase,0.17,5,2,3,0,5,1,0,1,74,1
"org.apache.solr.core.JmxMonitoredMap",6,0.25,4.17,64,1.06,52637.14,10,4,12,32,5,60.03,42,104,2,2,102.32,0.00,0.50,0.46,2,0.00,9,3185.18,3,3,3,java.util.concurrent.ConcurrentHashMap,0.00,26,1,25,0,26,3,0,10,588,1
"org.apache.solr.core.JmxMonitoredMap$SolrDynamicMBean",7,0.06,2.57,60,0.91,48804.69,10,3,12,37,2,106.83,2,90,0,1,106.83,0.00,0.00,0.29,0,11.00,6,2716.95,0,5,2,java.lang.Object,0.00,30,0,18,0,30,2,1,2,517,1
"org.apache.solr.core.MMapDirectoryFactory",2,1.00,2.00,17,0.21,4730.07,5,3,8,12,5,92.71,10,25,0,3,110.59,0.00,0.67,0.83,0,0.00,2,639.59,0,1,5,org.apache.solr.core.CachingDirectoryFactory,0.00,10,2,4,0,10,1,0,1,133,1
"org.apache.solr.core.MockDirectoryFactory",2,0.00,2.00,16,0.16,4831.37,2,0,5,7,4,131.13,7,24,0,3,110.51,0.00,0.67,0.00,0,2.00,3,480.86,0,1,4,org.apache.solr.core.CachingDirectoryFactory,0.00,5,2,4,0,5,1,0,5,102,1
"org.apache.solr.core.MockEventListener",6,0.80,1.00,10,0.07,816.05,7,1,3,9,5,154.20,4,19,2,1,154.20,0.00,0.00,0.33,0,10.00,1,219.01,0,0,3,java.lang.Object,0.00,3,0,6,0,3,6,1,4,68,1
"org.apache.solr.core.MockFSDirectoryFactory",1,0.00,1.00,5,0.05,1007.07,1,0,5,4,3,78.99,7,8,0,3,121.28,0.00,0.67,0.00,0,1.00,1,164.79,0,1,3,org.apache.solr.core.CachingDirectoryFactory,0.00,3,2,1,0,3,0,0,5,39,1
"org.apache.solr.core.MockQuerySenderListenerReqHandler",7,0.28,1.00,26,0.22,3987.46,10,3,5,11,6,131.50,4,41,2,2,131.50,0.00,0.50,0.10,0,13.00,1,669.12,2,5,4,org.apache.solr.handler.RequestHandlerBase,0.53,4,1,7,0,4,2,0,1,171,1
"org.apache.solr.core.NIOFSDirectoryFactory",1,0.00,1.00,3,0.03,451.02,1,0,4,3,3,132.54,4,6,0,3,132.30,0.00,0.67,0.00,0,1.00,1,99.51,0,1,3,org.apache.solr.core.CachingDirectoryFactory,0.00,2,2,1,0,2,0,0,1,27,1
"org.apache.solr.core.NRTCachingDirectoryFactory",1,0.00,1.00,3,0.04,653.63,1,0,5,4,4,151.65,3,6,0,4,131.03,0.00,0.75,0.00,0,1.00,1,134.10,0,1,4,org.apache.solr.core.StandardDirectoryFactory,0.00,3,3,1,0,3,0,0,1,33,1
"org.apache.solr.core.PluginInfo",8,0.12,3.00,55,0.99,32704.46,16,8,7,34,19,163.28,9,68,17,1,113.28,0.00,0.00,0.23,1,18.00,6,2962.92,0,4,2,java.lang.Object,0.00,26,0,24,0,26,4,0,3,586,1
"org.apache.solr.core.PluginInfoTest",9,0.19,1.33,73,1.17,31010.70,11,2,5,32,3,109.39,6,125,0,3,109.39,0.00,0.67,0.33,0,20.00,2,3506.80,1,0,3,org.apache.solr.util.DOMUtilTestBase,0.00,23,2,12,0,23,9,0,2,684,1
"org.apache.solr.core.QuerySenderListener",2,0.00,5.00,35,0.50,31964.31,2,0,10,19,13,73.76,10,40,2,2,91.63,0.00,0.50,0.00,0,2.00,9,1495.38,1,0,11,org.apache.solr.core.AbstractSolrEventListener,0.00,17,1,10,0,17,2,0,8,246,1
"org.apache.solr.core.QuerySenderListener$LocalSolrQueryRequest",2,0.00,1.00,4,0.02,220.18,2,0,10,2,1,143.69,0,3,0,1,143.69,0.00,0.00,0.00,0,2.00,1,74.51,0,1,1,java.lang.Object,0.00,0,0,2,0,0,1,0,0,25,0
"org.apache.solr.core.RAMDirectoryFactory",2,0.00,2.00,14,0.14,4418.50,2,0,4,6,5,162.98,3,22,1,4,112.98,0.00,0.75,0.00,0,2.00,3,419.90,0,1,4,org.apache.solr.core.StandardDirectoryFactory,0.00,4,3,4,0,4,1,0,1,90,1
"org.apache.solr.core.RAMDirectoryFactoryTest",3,0.00,1.00,18,0.18,3942.98,3,0,4,11,3,167.41,3,24,0,2,117.41,0.00,0.50,0.00,2,3.00,1,536.98,0,0,3,org.apache.lucene.util.LuceneTestCase,0.00,8,1,3,0,8,3,0,1,120,1
"org.apache.solr.core.RAMDirectoryFactoryTest$RAMDirectoryFactory",1,0.00,1.00,3,0.02,240.44,1,0,4,1,1,134.45,0,5,0,1,134.45,0.00,0.00,0.00,0,1.00,1,65.11,0,1,1,java.lang.Object,0.00,0,0,1,0,0,0,0,0,19,0
"org.apache.solr.core.RequestHandlers",7,0.00,3.29,63,1.06,58170.56,11,4,17,40,11,55.79,70,87,1,1,104.27,0.00,0.00,0.25,3,11.00,11,3191.87,0,5,11,java.lang.Object,0.00,33,0,23,0,33,2,0,12,583,2
"org.apache.solr.core.RequestHandlers$LazyRequestHandlerWrapper",13,0.06,1.77,61,0.51,12405.54,17,4,17,26,9,124.95,9,93,0,1,124.95,0.00,0.00,0.31,1,0.00,4,1521.74,0,9,9,java.lang.Object,0.00,13,0,23,0,13,4,2,5,361,3
"org.apache.solr.core.RequestHandlersTest",4,0.00,1.00,29,0.40,7179.85,4,0,5,12,4,113.85,3,54,0,3,113.85,0.00,0.67,0.00,0,0.00,1,1195.91,5,0,4,org.apache.solr.SolrTestCaseJ4,0.00,8,2,4,0,8,4,0,3,236,1
"org.apache.solr.core.ResourceLoaderTest",4,0.00,2.50,50,0.75,33663.43,4,0,15,25,9,139.51,11,75,0,2,99.62,0.00,0.50,0.00,0,4.00,5,2262.70,0,0,9,org.apache.lucene.util.LuceneTestCase,0.00,21,1,10,0,21,4,0,11,428,1
"org.apache.solr.core.RunExecutableListener",5,0.20,2.80,45,0.65,25989.70,10,5,7,21,5,126.52,15,63,0,2,105.91,0.00,0.50,0.36,1,7.00,6,1947.20,1,0,5,org.apache.solr.core.AbstractSolrEventListener,0.17,16,1,14,0,16,5,0,7,374,0
"org.apache.solr.core.SOLR749Test",2,0.00,1.00,12,0.16,3942.13,2,0,5,6,6,155.91,4,16,0,3,116.03,0.00,0.67,0.00,0,2.00,1,476.51,1,0,6,org.apache.solr.SolrTestCaseJ4,0.00,4,2,2,0,4,2,0,1,100,1
"org.apache.solr.core.SimpleFSDirectoryFactory",1,0.00,1.00,3,0.03,451.02,1,0,4,3,3,132.54,4,6,0,3,132.30,0.00,0.67,0.00,0,1.00,1,99.51,0,1,3,org.apache.solr.core.CachingDirectoryFactory,0.00,2,2,1,0,2,0,0,1,27,1
"org.apache.solr.core.SolrConfig",9,0.09,1.67,116,2.08,83237.18,38,29,31,35,45,99.63,42,138,23,2,99.39,0.00,0.50,0.11,2,33.00,4,6244.15,3,1,25,org.apache.solr.core.Config,0.00,26,1,15,0,26,8,0,17,983,1
"org.apache.solr.core.SolrConfig$HttpCachingConfig",0,0.00,0.00,4,0.05,845.18,2,2,31,1,0,171.00,2,6,0,1,171.00,0.00,0.00,0.00,0,0.00,0,138.30,0,0,0,java.lang.Object,0.00,1,0,0,0,1,0,0,2,32,2
"org.apache.solr.core.SolrConfig$HttpCachingConfig$LastModFrom",1,0.00,13.00,64,1.13,102618.52,6,5,31,19,3,26.01,12,78,0,1,63.57,0.00,0.00,1.00,0,0.00,13,3388.53,0,1,3,java.lang.Object,0.00,18,0,13,0,18,0,0,7,489,2
"org.apache.solr.core.SolrConfig$HttpCachingConfig$LastModFrom$UpdateHandlerInfo",1,7.00,1.00,12,0.12,2582.84,8,7,31,1,0,61.58,7,16,0,1,103.87,0.00,0.00,0.00,0,1.00,1,360.56,0,0,0,java.lang.Object,0.00,0,0,1,0,0,1,0,2,87,2
"org.apache.solr.core.SolrConfig$JmxConfiguration",1,4.00,2.00,12,0.13,4069.97,5,4,31,2,1,102.16,0,21,0,1,102.16,0.00,0.00,0.00,0,1.00,2,380.12,0,0,1,java.lang.Object,0.00,1,0,2,0,1,1,0,0,86,2
"org.apache.solr.core.SolrCore",93,0.01,2.91,841,12.72,772605.63,138,45,46,317,229,104.53,431,1143,174,1,104.29,0.00,0.00,0.03,36,5123.00,27,38161.75,1,52,68,java.lang.Object,0.00,224,0,271,0,224,41,1,201,6750,2
"org.apache.solr.core.SolrCore$Callable",1,0.00,1.00,4,0.02,206.27,1,0,46,2,0,130.32,0,5,0,1,130.32,0.00,0.00,0.00,0,1.00,1,63.51,0,1,0,java.lang.Object,0.00,1,0,1,0,1,0,0,0,19,0
"org.apache.solr.core.SolrCore$Callable_0",1,0.00,2.00,6,0.05,701.54,1,0,46,3,1,119.40,0,9,0,1,119.40,0.00,0.00,0.00,0,0.00,2,137.66,0,1,1,java.lang.Object,0.00,2,0,2,0,2,0,0,0,34,0
"org.apache.solr.core.SolrCore$Callable_1",1,0.00,3.00,8,0.06,1467.46,1,0,46,3,1,112.12,0,11,0,1,112.12,0.00,0.00,0.00,0,0.00,3,184.42,0,1,1,java.lang.Object,0.00,2,0,3,0,2,0,0,0,43,0
"org.apache.solr.core.SolrCore$Callable_2",1,0.00,3.00,8,0.06,1373.73,1,0,46,3,1,112.35,0,11,0,1,112.35,0.00,0.00,0.00,0,0.00,3,186.81,0,1,1,java.lang.Object,0.00,2,0,3,0,2,0,0,0,43,0
"org.apache.solr.core.SolrCore$Callable_3",1,0.00,3.00,7,0.06,1479.19,1,0,46,4,1,114.50,4,11,0,1,114.26,0.00,0.00,0.00,0,0.00,3,191.40,0,1,1,java.lang.Object,0.00,3,0,3,0,3,0,0,4,44,0
"org.apache.solr.core.SolrCore$LazyQueryResponseWriterWrapper",5,0.12,1.40,23,0.23,4333.28,9,4,46,10,6,125.33,1,37,0,1,125.33,0.00,0.00,0.35,1,7.00,3,680.02,0,2,6,java.lang.Object,0.00,5,0,7,0,5,3,1,1,160,2
"org.apache.solr.core.SolrCore$RefCounted<SolrIndexSearcher>",1,0.00,3.00,8,0.08,1790.65,1,0,46,5,1,69.15,7,13,0,1,111.44,0.00,0.00,0.00,0,0.00,3,254.75,0,0,1,java.lang.Object,0.00,4,0,3,0,4,1,0,7,56,0
"org.apache.solr.core.SolrCoreCheckLockOnStartupTest",3,0.00,1.67,37,0.57,18811.32,3,0,11,20,7,140.61,6,53,0,3,100.72,0.00,0.67,0.00,0,0.00,2,1713.64,4,0,7,org.apache.solr.SolrTestCaseJ4,0.04,17,2,5,0,17,3,0,6,317,1
"org.apache.solr.core.SolrCoreTest",7,0.00,1.29,95,1.46,60957.85,7,0,11,37,13,148.36,9,108,0,3,98.36,0.00,0.67,0.00,0,0.00,3,4391.59,4,0,13,org.apache.solr.SolrTestCaseJ4,0.08,30,2,9,0,30,7,0,9,779,1
"org.apache.solr.core.SolrCoreTest$Callable<Integer>",2,0.00,2.50,26,0.26,12870.73,2,0,11,7,1,99.25,1,31,0,1,99.25,0.00,0.00,0.00,1,2.00,3,770.50,0,1,1,java.lang.Object,0.00,5,0,5,0,5,1,0,1,151,0
"org.apache.solr.core.SolrDeletionPolicy",12,0.00,2.42,101,1.34,62187.36,16,4,14,39,12,147.74,24,131,3,1,107.86,0.00,0.00,0.25,2,42.00,9,4013.94,0,4,10,java.lang.Object,0.00,27,0,29,0,27,8,2,13,779,1
"org.apache.solr.core.SolrEventListener",3,1.00,1.00,5,0.04,550.37,4,1,4,4,14,103.18,29,6,12,2,153.18,0.00,0.50,0.00,0,3.00,1,131.88,0,0,3,,0.00,1,1,3,0,1,3,0,2,39,1
"org.apache.solr.core.SolrInfoMBean",8,0.00,1.00,10,0.04,194.28,8,0,2,8,18,160.33,33,10,17,1,160.09,0.00,0.00,0.00,0,8.00,1,117.46,0,8,1,,0.00,0,0,8,0,0,0,0,9,49,1
"org.apache.solr.core.SolrInfoMBean$Category",0,0.00,0.00,2,0.01,76.11,0,0,2,0,0,171.00,0,1,0,1,171.00,0.00,0.00,0.00,0,0.00,0,38.05,0,0,0,java.lang.Object,0.00,0,0,0,0,0,0,0,0,11,1
"org.apache.solr.core.SolrResourceLoader",29,0.02,3.10,261,4.15,215954.65,44,15,37,108,58,86.78,166,396,41,1,104.65,0.00,0.00,0.09,9,377.00,9,12439.84,0,20,18,java.lang.Object,0.00,79,0,90,1,79,9,1,48,2300,1
"org.apache.solr.core.SolrResourceLoader$FileFilter",1,0.00,1.00,3,0.02,187.66,1,0,37,2,0,135.30,0,4,0,1,135.30,0.00,0.00,0.00,0,1.00,1,58.19,0,0,0,java.lang.Object,0.00,1,0,1,0,1,1,0,0,18,0
"org.apache.solr.core.SolrXMLSerializer",6,0.30,5.17,104,1.50,92764.16,8,2,16,38,4,91.97,24,135,2,1,91.73,0.00,0.00,0.25,3,14.00,12,4494.68,0,0,2,java.lang.Object,0.00,32,0,31,0,32,6,0,7,821,1
"org.apache.solr.core.SolrXMLSerializer$SolrCoreXMLDef",0,0.00,0.00,3,0.02,271.98,2,2,16,0,0,171.00,0,4,0,1,171.00,0.00,0.00,0.00,0,0.00,0,66.61,0,0,0,java.lang.Object,0.00,0,0,0,0,0,0,0,0,18,2
"org.apache.solr.core.SolrXMLSerializer$SolrXMLDef",0,0.00,0.00,5,0.04,660.94,4,4,16,0,0,171.00,0,6,0,1,171.00,0.00,0.00,0.00,0,0.00,0,134.89,0,0,0,java.lang.Object,0.00,0,0,0,0,0,0,0,0,33,2
"org.apache.solr.core.StandardDirectoryFactory",1,0.00,1.00,3,0.04,535.58,1,0,4,3,6,113.84,5,6,3,3,131.71,1.00,0.40,0.00,0,1.00,1,107.25,0,1,3,org.apache.solr.core.CachingDirectoryFactory,0.00,2,2,1,2,2,0,0,1,28,1
"org.apache.solr.core.StandardIndexReaderFactory",1,0.00,1.00,3,0.03,471.02,1,0,3,2,5,99.93,6,6,2,2,132.15,0.00,0.50,0.00,0,0.00,1,95.51,0,1,3,org.apache.solr.core.IndexReaderFactory,0.00,1,1,1,0,1,0,0,1,26,1
"org.apache.solr.core.TestArbitraryIndexDir",7,0.83,1.43,48,0.80,26450.58,8,1,22,40,12,163.72,10,80,0,3,113.72,0.00,0.67,0.29,0,19.00,3,2389.12,6,2,12,org.apache.solr.util.AbstractSolrTestCase,0.30,33,2,10,0,33,5,0,8,430,1
"org.apache.solr.core.TestBadConfig",4,0.00,1.25,14,0.11,1790.24,4,0,1,8,1,132.28,1,21,0,3,132.28,0.00,0.67,0.00,0,4.00,2,326.50,3,2,1,org.apache.solr.util.AbstractSolrTestCase,0.24,4,2,5,0,4,2,0,1,83,1
"org.apache.solr.core.TestCodecSupport",4,0.00,1.25,30,0.48,10871.75,4,0,6,15,4,112.38,1,39,0,3,112.38,0.00,0.67,0.00,0,0.00,2,1452.98,1,0,4,org.apache.solr.SolrTestCaseJ4,0.00,11,2,5,0,11,4,0,1,300,1
"org.apache.solr.core.TestConfig",7,0.00,1.43,53,0.79,19738.80,7,0,15,36,10,112.22,6,75,0,3,112.22,0.00,0.67,0.00,0,9.00,4,2369.09,1,0,10,org.apache.solr.SolrTestCaseJ4,0.00,29,2,10,0,29,7,0,6,469,1
"org.apache.solr.core.TestCoreContainer",3,0.00,3.00,60,1.13,60354.94,3,0,8,35,4,128.21,8,96,0,3,88.33,0.00,0.67,0.00,1,1.00,5,3379.25,1,0,4,org.apache.solr.SolrTestCaseJ4,0.00,32,2,9,0,32,3,0,8,528,1
"org.apache.solr.core.TestJmxIntegration",8,0.00,2.75,82,1.50,81178.46,8,0,9,54,3,151.92,10,112,0,3,101.92,0.00,0.67,0.00,1,12.00,9,4492.21,4,3,3,org.apache.solr.util.AbstractSolrTestCase,0.29,46,2,22,0,46,5,0,5,773,1
"org.apache.solr.core.TestJmxMonitoredMap",3,0.50,2.67,49,0.71,34179.16,7,4,17,24,3,133.80,7,74,0,2,93.91,0.00,0.50,0.58,0,0.00,5,2133.35,2,0,3,org.apache.lucene.util.LuceneTestCase,0.00,21,1,8,0,21,3,0,2,395,1
"org.apache.solr.core.TestJmxMonitoredMap$MockInfoMBean",8,0.00,1.00,17,0.08,667.94,8,0,17,8,2,144.64,1,27,0,1,144.64,0.00,0.00,0.00,0,8.00,1,237.25,0,8,2,java.lang.Object,0.00,0,0,8,0,0,0,1,1,77,1
"org.apache.solr.core.TestLegacyMergeSchedulerPolicyConfig",2,0.00,1.00,7,0.16,3189.38,2,0,7,13,5,127.98,0,12,0,3,127.98,0.00,0.67,0.00,0,2.00,1,488.61,1,0,5,org.apache.solr.SolrTestCaseJ4,0.00,11,2,2,0,11,2,0,0,106,1
"org.apache.solr.core.TestMergePolicyConfig",2,0.00,1.00,13,0.18,3025.28,2,0,5,13,4,156.82,5,17,0,3,116.93,0.00,0.67,0.00,0,2.00,1,529.65,1,0,4,org.apache.solr.SolrTestCaseJ4,0.00,11,2,2,0,11,2,0,5,109,1
"org.apache.solr.core.TestPropInject",4,0.00,1.00,13,0.19,2486.42,4,0,6,14,5,131.20,0,20,0,3,131.20,0.00,0.67,0.00,0,4.00,1,579.20,0,2,5,org.apache.solr.util.AbstractSolrTestCase,0.16,10,2,4,0,10,2,0,0,133,1
"org.apache.solr.core.TestPropInjectDefaults",3,0.00,1.00,11,0.20,3051.01,3,0,7,13,5,129.52,0,18,0,3,129.52,0.00,0.67,0.00,0,1.00,1,607.16,1,0,5,org.apache.solr.SolrTestCaseJ4,0.00,10,2,3,0,10,3,0,0,133,1
"org.apache.solr.core.TestQuerySenderListener",4,0.17,1.00,33,0.57,20947.22,6,2,6,26,9,158.03,7,43,0,3,108.03,0.00,0.67,0.38,0,0.00,1,1703.25,1,0,9,org.apache.solr.SolrTestCaseJ4,0.00,22,2,4,0,22,4,0,7,315,1
"org.apache.solr.core.TestQuerySenderNoQuery",4,0.17,1.00,30,0.44,11438.05,6,2,5,24,8,152.14,10,40,0,3,112.26,0.00,0.67,0.38,0,0.00,1,1309.87,1,0,8,org.apache.solr.SolrTestCaseJ4,0.00,20,2,4,0,20,4,0,10,255,1
"org.apache.solr.core.TestSolrDeletionPolicy1",6,0.00,1.33,49,0.81,21613.08,6,0,6,24,4,109.24,3,87,0,3,109.24,0.00,0.67,0.00,1,6.00,3,2431.86,8,0,4,org.apache.solr.SolrTestCaseJ4,0.04,18,2,8,0,18,6,0,1,471,1
"org.apache.solr.core.TestSolrDeletionPolicy2",2,0.00,1.00,16,0.26,5777.95,2,0,3,12,3,160.06,3,25,0,3,110.06,0.00,0.67,0.00,0,2.00,1,783.44,5,0,3,org.apache.solr.SolrTestCaseJ4,0.00,10,2,2,0,10,2,0,1,150,1
"org.apache.solr.core.TestSolrXMLSerializer",4,0.49,1.00,62,1.08,36175.56,17,13,27,31,1,145.97,7,82,0,2,95.97,0.00,0.50,0.44,3,6.00,1,3226.86,0,1,1,org.apache.lucene.util.LuceneTestCase,0.00,27,1,4,0,27,3,0,7,593,1
"org.apache.solr.core.TestXIncludeConfig",4,0.67,1.50,21,0.20,3476.41,5,1,3,11,3,161.57,8,32,0,3,121.69,0.00,0.67,0.50,0,4.00,2,585.55,1,2,3,org.apache.solr.util.AbstractSolrTestCase,0.24,7,2,6,0,7,2,0,5,132,1
"org.apache.lucene.spatial.SimpleSpatialFieldInfo",2,1.00,1.00,6,0.04,384.68,3,1,0,2,6,135.22,0,9,5,1,135.22,0.00,0.00,0.50,0,2.00,1,105.38,0,1,1,java.lang.Object,0.00,0,0,2,0,0,1,1,0,32,1
"org.apache.lucene.spatial.SpatialFieldInfo",0,0.00,0.00,1,0.00,12.00,0,0,0,0,1,171.00,3,2,1,1,171.00,0.00,0.00,0.00,0,0.00,0,8.00,0,0,0,,0.00,0,0,0,0,0,0,0,1,4,1
"org.apache.lucene.spatial.SpatialMatchConcern",1,5.00,1.00,9,0.10,2642.36,6,5,0,2,3,158.46,1,11,3,1,108.46,0.00,0.00,0.00,0,1.00,1,303.35,0,0,0,java.lang.Object,0.00,1,0,1,0,1,1,0,1,75,1
"org.apache.lucene.spatial.SpatialStrategy",10,0.44,1.00,19,0.17,1995.21,12,2,7,10,7,202.89,18,26,3,2,152.89,4.00,0.17,0.10,0,26.00,1,512.28,0,6,4,SpatialFieldInfo>,0.00,0,1,10,4,0,4,0,6,142,2
"org.apache.lucene.spatial.SpatialTestCase",8,0.21,1.88,47,0.49,11695.20,12,4,16,28,11,119.86,2,66,1,2,119.86,6.00,0.12,0.44,1,0.00,4,1472.86,2,0,10,org.apache.lucene.util.LuceneTestCase,0.00,20,1,15,6,20,8,0,2,325,2
"org.apache.lucene.spatial.SpatialTestCase$SearchResult",1,2.00,1.00,6,0.04,550.02,3,2,16,1,1,120.39,0,8,0,1,120.39,0.00,0.00,0.00,0,1.00,1,123.59,0,0,1,java.lang.Object,0.00,0,0,1,0,0,1,0,0,35,2
"org.apache.lucene.spatial.SpatialTestCase$SearchResults",1,2.00,1.00,6,0.05,890.30,3,2,16,1,0,118.75,0,8,0,1,118.75,0.00,0.00,0.00,0,1.00,1,158.39,0,0,0,java.lang.Object,0.00,0,0,1,0,0,1,0,0,41,2
"org.apache.lucene.spatial.SpatialTestQuery",2,0.20,1.00,10,0.12,2149.50,7,5,11,5,4,141.67,6,18,4,1,121.06,0.00,0.00,0.10,0,2.00,1,365.97,0,2,0,java.lang.Object,0.00,3,0,2,0,3,0,0,2,84,1
"org.apache.lucene.spatial.SpatialTestQuery$InputStreamReader",1,0.00,5.00,17,0.28,13629.24,1,0,11,11,1,142.17,1,25,0,1,92.17,0.00,0.00,0.00,0,1.00,5,840.87,0,0,1,java.lang.Object,0.00,10,0,5,0,10,1,0,1,153,0
"org.apache.lucene.spatial.StrategyTestCase",6,0.01,3.17,76,1.24,53039.33,20,14,14,38,10,99.40,4,95,2,3,99.40,2.00,0.29,0.08,4,14.00,10,3726.82,3,3,8,org.apache.lucene.spatial.SpatialTestCase,0.00,32,2,19,4,32,3,0,4,664,2
"org.apache.lucene.spatial.TestTestFramework",1,0.00,2.00,15,0.31,9949.41,1,0,13,18,2,95.72,4,20,0,2,95.49,0.00,0.50,0.00,0,1.00,2,939.08,0,0,2,org.apache.lucene.util.LuceneTestCase,0.00,17,1,2,0,17,1,0,2,163,1
"org.apache.lucene.codecs.memory.MemoryPostingsFormat",3,1.00,1.00,10,0.08,886.61,4,1,38,3,34,91.46,21,14,3,2,133.75,0.00,0.50,0.33,0,4.00,1,234.10,0,1,31,org.apache.lucene.codecs.PostingsFormat,0.18,0,1,3,0,0,2,0,9,64,1
"org.apache.lucene.codecs.memory.MemoryPostingsFormat$TermsWriter",8,0.13,1.88,76,1.26,44172.44,20,12,38,46,20,105.79,7,101,0,2,105.79,0.00,0.50,0.20,0,22.00,4,3773.78,0,4,20,org.apache.lucene.codecs.TermsConsumer,0.31,38,1,15,0,38,4,0,7,694,3
"org.apache.lucene.codecs.memory.MemoryPostingsFormat$TermsWriter$FSTDocsAndPositionsEnum",12,0.19,2.67,113,1.25,74625.86,29,17,38,21,5,145.19,25,150,0,4,105.30,0.00,0.75,0.23,1,28.00,13,3744.99,0,2,5,org.apache.lucene.index.DocsAndPositionsEnum,1.64,9,3,32,0,9,10,0,25,726,3
"org.apache.lucene.codecs.memory.MemoryPostingsFormat$TermsWriter$FSTDocsEnum",7,0.20,3.29,79,0.91,71251.85,18,11,38,14,5,150.32,12,100,0,3,100.32,0.00,0.67,0.26,0,4.00,15,2722.22,0,1,5,org.apache.lucene.index.DocsEnum,1.00,7,2,23,0,7,6,0,12,529,3
"org.apache.lucene.codecs.memory.MemoryPostingsFormat$TermsWriter$FSTTermsEnum",13,0.14,1.92,82,0.99,38645.05,20,7,38,32,9,164.47,18,118,0,2,114.47,0.00,0.50,0.27,1,11.00,5,2978.86,0,6,9,org.apache.lucene.index.TermsEnum,0.38,19,1,25,0,19,7,0,18,612,3
"org.apache.lucene.codecs.memory.MemoryPostingsFormat$TermsWriter$FieldsConsumer",2,0.00,1.00,7,0.06,962.52,2,0,38,3,2,182.08,2,13,0,1,132.08,0.00,0.00,0.00,0,0.00,1,178.32,0,1,2,java.lang.Object,0.00,1,0,2,0,1,1,0,2,47,0
"org.apache.lucene.codecs.memory.MemoryPostingsFormat$TermsWriter$FieldsProducer",4,0.00,1.25,12,0.11,1794.60,4,0,38,9,2,132.27,1,20,0,1,132.27,0.00,0.00,0.00,0,4.00,2,329.19,0,2,2,java.lang.Object,0.00,5,0,5,0,5,2,0,1,84,0
"org.apache.lucene.codecs.memory.MemoryPostingsFormat$TermsWriter$FieldsProducer$FieldsEnum",2,0.00,1.00,7,0.05,695.68,3,1,38,3,1,133.19,0,11,0,1,133.19,0.00,0.00,1.00,0,0.00,1,149.49,0,2,1,java.lang.Object,0.00,1,0,2,0,1,0,0,0,42,0
"org.apache.lucene.codecs.memory.MemoryPostingsFormat$TermsWriter$PostingsWriter",4,0.52,3.00,59,0.67,50607.29,11,7,38,9,3,145.69,6,73,0,2,95.69,0.00,0.50,0.54,0,0.00,7,2020.11,0,1,3,org.apache.lucene.codecs.PostingsConsumer,0.50,5,1,12,0,5,3,0,6,381,1
"org.apache.lucene.codecs.memory.MemoryPostingsFormat$TermsWriter$TermsReader",7,0.12,1.14,31,0.34,8606.05,14,7,38,14,8,124.18,0,47,0,2,124.18,0.00,0.50,0.24,0,21.00,2,1026.87,0,2,8,org.apache.lucene.index.Terms,0.71,7,1,8,0,7,5,0,0,225,3
"org.apache.lucene.analysis.in.Deprecated",4,0.00,1.00,9,0.13,2551.81,4,0,5,6,3,187.68,4,18,0,5,137.68,0.00,0.80,0.00,0,4.00,1,392.73,0,0,3,org.apache.lucene.analysis.util.CharTokenizer,0.19,2,4,4,0,2,4,0,1,102,2
"org.apache.lucene.analysis.in.IndicNormalizationFilter",2,0.00,1.50,11,0.11,2172.37,4,2,4,8,8,160.81,4,16,4,4,120.93,0.00,0.75,0.50,0,2.00,2,340.92,0,0,4,org.apache.lucene.analysis.TokenFilter,0.29,6,3,3,0,6,2,0,1,81,2
"org.apache.lucene.analysis.in.IndicNormalizer",3,0.00,5.00,55,2.83,340296.91,5,2,4,7,1,91.26,107,145,1,1,84.00,0.00,0.00,0.50,0,2.00,10,8496.41,0,0,0,java.lang.Object,0.00,4,0,15,0,4,3,0,80,1372,1
"org.apache.lucene.analysis.in.IndicNormalizer$ScriptData",1,3.00,1.00,7,0.04,585.54,4,3,4,1,0,117.68,0,9,0,1,117.68,0.00,0.00,0.00,0,1.00,1,131.23,0,0,0,java.lang.Object,0.00,0,0,1,0,0,1,0,0,38,2
"org.apache.lucene.analysis.in.TestIndicNormalizer",3,0.00,1.00,16,0.16,2228.72,3,0,9,7,7,162.20,7,20,0,3,122.32,0.00,0.67,0.00,1,3.00,1,472.74,2,0,7,org.apache.lucene.analysis.BaseTokenStreamTestCase,0.00,4,2,3,0,4,3,0,3,109,1
"org.apache.lucene.analysis.in.TestIndicNormalizer$Analyzer",1,0.00,1.00,4,0.05,753.46,1,0,9,4,3,125.89,0,6,0,1,125.89,0.00,0.00,0.00,0,1.00,1,135.44,0,1,3,java.lang.Object,0.00,3,0,1,0,3,0,0,0,34,0
"org.apache.lucene.queryparser.flexible.standard.QueryParserUtil",4,0.00,3.75,51,0.95,62552.95,4,0,5,15,8,146.90,105,65,2,1,97.41,0.00,0.00,0.00,0,4.00,4,2837.52,0,4,6,java.lang.Object,0.00,11,0,15,0,11,0,0,9,511,2
"org.apache.lucene.queryparser.flexible.standard.StandardQueryParser",36,0.00,1.25,110,1.13,16324.02,36,0,20,49,19,100.01,249,164,6,2,132.23,2.00,0.25,0.00,2,36.00,2,3382.77,2,10,14,org.apache.lucene.queryparser.flexible.core.QueryParserHelper,0.00,13,1,45,2,13,26,0,32,833,1
"org.apache.lucene.queryparser.flexible.standard.TestMultiAnalyzerQPHelper",2,1.00,1.00,41,0.83,28245.80,3,1,11,11,7,129.09,43,64,0,2,89.79,0.00,0.50,0.00,0,2.00,1,2500.42,0,0,7,org.apache.lucene.util.LuceneTestCase,0.00,9,1,2,0,9,2,0,31,443,1
"org.apache.lucene.queryparser.flexible.standard.TestMultiAnalyzerQPHelper$MultiAnalyzer",1,0.00,1.00,4,0.06,1028.22,1,0,11,4,3,124.82,0,7,0,2,124.82,0.00,0.50,0.00,0,1.00,1,167.13,0,1,3,org.apache.lucene.analysis.Analyzer,0.00,3,1,1,0,3,0,0,0,40,1
"org.apache.lucene.queryparser.flexible.standard.TestMultiAnalyzerQPHelper$PosIncrementAnalyzer",1,0.00,1.00,4,0.06,1028.22,1,0,11,4,3,124.82,0,7,0,2,124.82,0.00,0.50,0.00,0,1.00,1,167.13,0,1,3,org.apache.lucene.analysis.Analyzer,0.00,3,1,1,0,3,0,0,0,40,1
"org.apache.lucene.queryparser.flexible.standard.TestMultiAnalyzerQPHelper$TestFilter",3,0.29,2.33,39,0.44,14023.85,10,7,11,14,6,100.35,0,48,0,4,100.35,0.00,0.75,0.33,0,4.00,5,1306.41,1,0,6,org.apache.lucene.analysis.TokenFilter,0.53,11,3,7,0,11,3,0,0,256,2
"org.apache.lucene.queryparser.flexible.standard.TestMultiAnalyzerQPHelper$TestPosIncrementFilter",2,0.00,2.50,15,0.16,3738.22,4,2,11,5,4,113.50,1,21,0,4,113.50,0.00,0.75,0.50,0,2.00,4,483.67,0,0,4,org.apache.lucene.analysis.TokenFilter,0.29,3,3,5,0,3,2,0,1,108,1
"org.apache.lucene.queryparser.flexible.standard.TestMultiFieldQPHelper",11,0.00,1.45,182,2.97,103394.91,11,0,19,39,13,134.60,32,221,0,2,94.71,0.00,0.50,0.00,1,11.00,2,8909.04,0,0,13,org.apache.lucene.util.LuceneTestCase,0.00,28,1,16,0,28,11,0,22,1606,1
"org.apache.lucene.queryparser.flexible.standard.TestMultiFieldQPHelper$AnalyzerReturningNull",2,1.00,1.50,9,0.09,1898.49,3,1,19,8,1,125.00,0,14,0,2,125.00,0.00,0.50,0.50,0,2.00,2,271.62,0,1,1,org.apache.lucene.index.Analyzer,0.00,6,1,3,0,6,1,0,0,67,3
"org.apache.lucene.queryparser.flexible.standard.TestNumericQueryParser",18,0.08,2.56,256,4.97,366612.54,35,17,38,100,22,94.10,12,345,0,2,94.10,0.00,0.50,0.13,7,98.00,13,14902.90,0,3,22,org.apache.lucene.util.LuceneTestCase,0.00,82,1,46,0,82,15,0,12,2530,1
"org.apache.lucene.queryparser.flexible.standard.TestNumericQueryParser$NumberType",0,0.00,0.00,2,0.01,71.32,0,0,38,0,0,171.00,0,3,0,1,171.00,0.00,0.00,0.00,0,0.00,0,28.53,0,0,0,java.lang.Object,0.00,0,0,0,0,0,0,0,0,9,2
"org.apache.lucene.queryparser.flexible.standard.TestQPHelper",0,0.00,0.00,5,0.06,1012.42,1,1,52,1,37,171.00,6,6,0,2,171.00,0.00,0.50,0.00,0,0.00,0,165.67,0,0,37,org.apache.lucene.util.LuceneTestCase,0.00,1,1,0,0,1,0,0,1,39,1
"org.apache.lucene.queryparser.flexible.standard.TestQPHelper$QPTestAnalyzer",1,0.00,1.00,4,0.06,1228.99,1,0,52,4,1,174.21,1,7,0,2,124.21,0.00,0.50,0.00,0,1.00,1,182.32,0,1,1,org.apache.lucene.index.Analyzer,0.00,3,1,1,0,3,0,0,1,43,3
"org.apache.lucene.queryparser.flexible.standard.TestQPHelper$QPTestFilter",3,0.20,2.33,30,0.34,10287.31,8,5,52,11,2,155.66,4,39,0,2,105.66,0.00,0.50,0.33,0,4.00,5,1010.18,1,0,2,org.apache.lucene.index.TokenFilter,0.00,8,1,7,0,8,3,0,1,210,3
"org.apache.lucene.queryparser.flexible.standard.TestQPHelper$QPTestParser",55,0.98,1.33,569,8.22,238568.16,56,1,52,136,28,125.61,180,701,0,3,104.99,0.00,0.67,0.04,13,210.00,3,24657.97,4,8,28,org.apache.lucene.queryparser.flexible.standard.StandardQueryParser,0.00,81,2,73,0,81,47,0,156,4623,2
"org.apache.lucene.queryparser.flexible.standard.TestQPHelper$QPTestParser$CannedAnalyzer",1,0.00,1.00,3,0.03,425.86,1,0,52,3,0,132.50,0,6,0,2,132.50,0.00,0.50,0.00,0,1.00,1,97.55,0,1,0,org.apache.lucene.index.Analyzer,0.00,2,1,1,0,2,0,0,0,27,1
"org.apache.lucene.queryparser.flexible.standard.TestQPHelper$QPTestParser$CannedTokenizer",3,0.00,2.33,27,0.27,7888.61,6,3,52,7,2,108.28,0,35,0,2,108.28,0.00,0.50,0.33,0,4.00,5,806.23,1,0,2,org.apache.lucene.search.Tokenizer,0.00,4,1,7,0,4,3,0,0,176,1
"org.apache.lucene.queryparser.flexible.standard.TestQPHelper$QPTestParser$QPTestParserQueryNodeProcessor",3,0.00,1.33,9,0.11,2659.22,3,0,52,5,5,129.92,0,22,0,2,129.92,0.00,0.50,0.00,0,3.00,2,318.32,0,3,5,org.apache.lucene.queryparser.flexible.core.processors.QueryNodeProcessorImpl,0.00,2,1,4,0,2,0,0,0,79,2
"org.apache.lucene.queryparser.flexible.standard.TestQPHelper$QPTestParser$SimpleCJKAnalyzer",1,0.00,1.00,3,0.03,425.86,1,0,52,3,0,132.50,0,6,0,2,132.50,0.00,0.50,0.00,0,1.00,1,97.55,0,1,0,org.apache.lucene.index.Analyzer,0.00,2,1,1,0,2,0,0,0,27,1
"org.apache.lucene.queryparser.flexible.standard.TestQPHelper$QPTestParser$SimpleCJKTokenizer",2,1.00,1.50,10,0.10,1712.34,3,1,52,6,1,121.74,0,15,0,2,121.74,0.00,0.50,0.50,0,2.00,2,297.37,0,0,1,org.apache.lucene.search.Tokenizer,0.00,4,1,3,0,4,2,0,0,70,1
"org.apache.lucene.analysis.path.PathHierarchyTokenizer",9,0.17,2.44,101,1.09,96801.62,23,14,6,21,9,140.09,18,133,5,4,100.20,0.00,0.75,0.22,0,20.00,14,3257.63,2,0,4,org.apache.lucene.analysis.Tokenizer,0.35,12,3,22,0,12,9,0,2,629,1
"org.apache.lucene.analysis.path.ReversePathHierarchyTokenizer",11,0.15,1.64,84,1.05,50628.03,27,16,8,28,8,160.52,20,108,4,4,110.52,0.00,0.75,0.20,0,30.00,8,3153.62,2,0,4,org.apache.lucene.analysis.Tokenizer,0.32,17,3,18,0,17,11,0,2,616,1
"org.apache.lucene.analysis.path.TestPathHierarchyTokenizer",17,0.00,1.00,130,1.50,31918.47,17,0,8,25,7,113.70,2,163,0,3,113.70,0.00,0.67,0.00,0,17.00,1,4491.35,2,0,7,org.apache.lucene.analysis.BaseTokenStreamTestCase,0.00,8,2,17,0,8,17,0,2,939,1
"org.apache.lucene.analysis.path.TestPathHierarchyTokenizer$Analyzer",1,0.00,1.00,4,0.04,687.53,1,0,8,3,2,126.20,0,6,0,1,126.20,0.00,0.00,0.00,0,1.00,1,120.59,0,1,2,java.lang.Object,0.00,2,0,1,0,2,0,0,0,31,0
"org.apache.lucene.analysis.path.TestPathHierarchyTokenizer$Analyzer_0",1,0.00,1.00,4,0.04,687.53,1,0,8,3,2,126.20,0,6,0,1,126.20,0.00,0.00,0.00,0,1.00,1,120.59,0,1,2,java.lang.Object,0.00,2,0,1,0,2,0,0,0,31,0
"org.apache.lucene.analysis.path.TestReversePathHierarchyTokenizer",14,0.00,1.00,103,1.13,24248.00,14,0,6,19,4,113.97,2,130,0,3,113.97,0.00,0.67,0.00,0,14.00,1,3378.48,2,0,4,org.apache.lucene.analysis.BaseTokenStreamTestCase,0.00,5,2,14,0,5,14,0,2,723,1
"org.apache.lucene.analysis.path.TestReversePathHierarchyTokenizer$Analyzer",1,0.00,1.00,4,0.04,687.53,1,0,6,3,2,126.20,0,6,0,1,126.20,0.00,0.00,0.00,0,1.00,1,120.59,0,1,2,java.lang.Object,0.00,2,0,1,0,2,0,0,0,31,0
"org.apache.lucene.analysis.path.TestReversePathHierarchyTokenizer$Analyzer_0",1,0.00,1.00,4,0.04,687.53,1,0,6,3,2,126.20,0,6,0,1,126.20,0.00,0.00,0.00,0,1.00,1,120.59,0,1,2,java.lang.Object,0.00,2,0,1,0,2,0,0,0,31,0
"org.apache.lucene.analysis.pattern.PatternReplaceCharFilter",5,0.12,2.20,50,0.61,34331.58,9,4,7,18,5,61.01,37,60,3,5,103.30,0.00,0.80,0.15,1,11.00,5,1816.98,2,1,2,org.apache.lucene.analysis.charfilter.BaseCharFilter,0.56,13,4,11,0,13,4,0,14,362,1
"org.apache.lucene.analysis.pattern.PatternReplaceFilter",2,0.60,3.00,19,0.25,5625.36,7,5,6,10,9,70.43,24,27,6,4,107.99,0.00,0.75,0.50,0,0.00,4,736.35,0,0,3,org.apache.lucene.analysis.TokenFilter,0.29,8,3,6,0,8,2,0,3,155,2
"org.apache.lucene.analysis.pattern.PatternTokenizer",5,0.31,2.60,57,0.74,46102.16,13,8,7,17,7,58.42,36,72,4,4,100.71,0.00,0.75,0.38,1,0.00,8,2211.50,2,0,3,org.apache.lucene.analysis.Tokenizer,0.42,12,3,13,0,12,5,0,10,440,2
"org.apache.lucene.analysis.pattern.TestPatternReplaceCharFilter",17,0.00,1.53,145,2.37,73566.62,17,0,15,40,9,148.47,47,209,0,3,108.58,0.00,0.67,0.00,3,17.00,5,7096.88,2,2,9,org.apache.lucene.analysis.BaseTokenStreamTestCase,0.00,23,2,26,0,23,15,0,39,1302,1
"org.apache.lucene.analysis.pattern.TestPatternReplaceCharFilter$Analyzer",2,0.00,1.00,6,0.08,1410.69,2,0,15,6,4,130.77,0,10,0,1,130.77,0.00,0.00,0.00,0,2.00,1,234.09,0,2,4,java.lang.Object,0.00,4,0,2,0,4,0,0,0,57,0
"org.apache.lucene.analysis.pattern.TestPatternReplaceFilter",7,0.00,1.00,29,0.46,7545.54,7,0,10,13,7,124.66,3,57,0,3,124.66,0.00,0.67,0.00,0,7.00,1,1384.98,3,0,7,org.apache.lucene.analysis.BaseTokenStreamTestCase,0.00,6,2,7,0,6,7,0,2,294,1
"org.apache.lucene.analysis.pattern.TestPatternReplaceFilter$Analyzer",1,0.00,1.00,5,0.08,1426.12,1,0,10,5,4,120.09,0,7,0,1,120.09,0.00,0.00,0.00,0,1.00,1,229.14,0,1,4,java.lang.Object,0.00,4,0,1,0,4,0,0,0,50,0
"org.apache.lucene.analysis.pattern.TestPatternReplaceFilter$Analyzer_0",1,0.00,1.00,5,0.08,1369.56,1,0,10,5,4,120.23,0,7,0,1,120.23,0.00,0.00,0.00,0,1.00,1,231.47,0,1,4,java.lang.Object,0.00,4,0,1,0,4,0,0,0,50,0
"org.apache.lucene.analysis.pattern.TestPatternReplaceFilter$Analyzer_1",1,0.00,1.00,4,0.06,1026.83,1,0,10,5,3,124.83,0,6,0,1,124.83,0.00,0.00,0.00,0,1.00,1,179.82,0,1,3,java.lang.Object,0.00,4,0,1,0,4,0,0,0,41,0
"org.apache.lucene.analysis.pattern.TestPatternTokenizer",4,0.00,1.75,44,0.76,26787.13,4,0,17,28,11,84.02,22,64,0,3,101.90,0.00,0.67,0.00,1,4.00,3,2266.05,2,1,11,org.apache.lucene.analysis.BaseTokenStreamTestCase,0.00,24,2,7,0,24,3,0,12,416,1
"org.apache.lucene.analysis.pattern.TestPatternTokenizer$Analyzer",1,0.00,2.00,7,0.09,2292.99,1,0,17,5,2,112.85,0,11,0,1,112.85,0.00,0.00,0.00,0,1.00,2,260.66,0,1,2,java.lang.Object,0.00,4,0,2,0,4,0,0,0,55,0
"org.apache.lucene.analysis.pattern.TestPatternTokenizer$Analyzer_0",1,0.00,2.00,7,0.08,2056.54,1,0,17,5,2,113.23,0,11,0,1,113.23,0.00,0.00,0.00,0,1.00,2,253.34,0,1,2,java.lang.Object,0.00,4,0,2,0,4,0,0,0,54,0
"org.apache.lucene.analysis.id.IndonesianAnalyzer",5,0.50,1.20,21,0.25,5560.00,7,2,12,15,11,74.51,46,31,1,3,124.51,0.00,0.67,0.10,0,8.00,2,744.03,0,2,10,org.apache.lucene.analysis.util.StopwordAnalyzerBase,0.00,10,2,6,0,10,3,0,8,171,2
"org.apache.lucene.analysis.id.IndonesianAnalyzer$DefaultSetHolder",0,0.00,0.00,6,0.05,732.71,1,1,12,0,2,171.00,2,10,0,1,171.00,0.00,0.00,0.00,0,0.00,0,149.07,0,0,2,java.lang.Object,0.00,0,0,0,0,0,0,0,2,37,2
"org.apache.lucene.analysis.id.IndonesianStemFilter",3,0.12,1.67,18,0.20,4286.50,7,4,5,10,10,117.25,12,26,5,4,117.01,0.00,0.75,0.33,0,4.00,3,593.46,0,0,5,org.apache.lucene.analysis.TokenFilter,0.27,7,3,5,0,7,3,0,3,133,2
"org.apache.lucene.analysis.id.IndonesianStemmer",8,0.27,5.75,142,1.80,131467.05,17,9,1,11,1,131.39,17,202,1,1,91.50,0.00,0.00,0.35,1,0.00,15,5407.45,0,0,0,java.lang.Object,0.00,3,0,46,0,3,8,0,5,1065,1
"org.apache.lucene.analysis.id.TestIndonesianAnalyzer",4,0.00,1.00,15,0.16,2448.23,4,0,4,7,4,181.26,7,21,0,3,131.26,0.00,0.67,0.00,0,4.00,1,483.80,3,0,4,org.apache.lucene.analysis.BaseTokenStreamTestCase,0.00,3,2,4,0,3,4,0,6,114,1
"org.apache.lucene.analysis.id.TestIndonesianStemmer",5,0.00,1.00,78,0.85,14218.27,5,0,6,7,4,149.93,8,86,0,3,99.93,0.00,0.67,0.00,0,5.00,1,2537.09,2,0,4,org.apache.lucene.analysis.BaseTokenStreamTestCase,0.00,2,2,5,0,2,5,0,6,466,1
"org.apache.lucene.analysis.id.TestIndonesianStemmer$Analyzer",1,0.00,1.00,4,0.05,753.46,1,0,6,4,3,125.89,0,6,0,1,125.89,0.00,0.00,0.00,0,1.00,1,135.44,0,1,3,java.lang.Object,0.00,3,0,1,0,3,0,0,0,34,0
"org.apache.lucene.analysis.id.TestIndonesianStemmer$Analyzer_0",1,0.00,1.00,4,0.05,771.22,1,0,6,4,3,125.81,0,6,0,1,125.81,0.00,0.00,0.00,0,1.00,1,141.98,0,1,3,java.lang.Object,0.00,3,0,1,0,3,0,0,0,35,0
"org.apache.lucene.analysis.id.TestIndonesianStemmer$Analyzer_1",1,0.00,1.00,4,0.05,753.46,1,0,6,4,3,125.89,0,6,0,1,125.89,0.00,0.00,0.00,0,1.00,1,135.44,0,1,3,java.lang.Object,0.00,3,0,1,0,3,0,0,0,34,0
"org.apache.lucene.facet.example.multiCL.MultiCLIndexer",4,0.00,2.25,71,1.17,47284.50,10,6,20,30,18,92.37,67,94,2,1,92.84,0.00,0.00,0.17,1,6.00,5,3497.86,0,0,16,java.lang.Object,0.00,26,0,9,0,26,4,0,30,648,1
"org.apache.lucene.facet.example.multiCL.MultiCLMain",2,0.00,1.00,14,0.16,3770.78,2,0,6,10,9,93.54,28,18,2,1,113.68,0.00,0.00,0.00,0,2.00,1,469.95,0,1,7,java.lang.Object,0.00,8,0,2,0,8,1,0,5,100,1
"org.apache.lucene.facet.example.multiCL.MultiCLSearcher",2,0.00,1.50,25,0.43,17595.97,2,0,19,19,21,147.42,54,35,3,1,99.59,0.00,0.00,0.00,1,2.00,2,1302.62,0,2,18,java.lang.Object,0.00,17,0,3,0,17,0,0,23,231,1
"org.apache.lucene.index.memory.MemoryIndex",13,0.03,3.00,139,2.04,127613.39,19,6,42,62,35,135.39,267,172,2,1,102.01,0.00,0.00,0.14,4,44.00,14,6118.17,0,4,33,java.lang.Object,0.00,49,0,39,0,49,9,0,45,1097,1
"org.apache.lucene.index.memory.MemoryIndex$ArrayIntList",8,0.21,1.75,40,0.47,16736.56,10,2,42,15,0,118.65,3,48,0,1,118.65,0.00,0.00,0.69,4,0.00,4,1412.64,0,1,0,java.lang.Object,0.00,7,0,14,0,7,7,0,3,309,3
"org.apache.lucene.index.memory.MemoryIndex$Collector",4,1.00,1.00,9,0.08,1124.03,5,1,42,5,2,140.49,0,16,0,1,140.49,0.00,0.00,0.25,0,6.00,1,254.77,0,0,2,java.lang.Object,0.00,1,0,4,0,1,4,0,0,69,0
"org.apache.lucene.index.memory.MemoryIndex$Comparator<Object>",1,0.00,12.00,8,0.14,6881.06,1,0,42,3,0,106.52,0,8,0,1,106.52,0.00,0.00,0.00,0,1.00,12,425.52,0,0,0,java.lang.Object,0.00,2,0,12,0,2,1,0,0,96,0
"org.apache.lucene.index.memory.MemoryIndex$Info",4,0.06,1.50,23,0.24,5836.33,10,6,42,6,1,120.15,16,28,0,1,119.92,0.00,0.00,0.21,0,8.00,2,731.33,0,0,1,java.lang.Object,0.00,2,0,6,0,2,4,0,6,160,3
"org.apache.lucene.index.memory.MemoryIndex$MemoryIndexReader",16,0.20,1.81,65,0.74,22019.00,20,4,42,28,11,123.69,6,95,0,3,123.69,0.00,0.67,0.06,3,92.00,6,2207.20,0,9,11,org.apache.lucene.index.AtomicReader,0.36,12,2,29,0,12,7,0,6,478,2
"org.apache.lucene.index.memory.MemoryIndex$MemoryIndexReader$MemoryDocsAndPositionsEnum",10,0.09,1.30,35,0.34,7017.02,15,5,42,13,3,130.73,0,57,0,4,130.73,0.00,0.75,0.28,1,18.00,2,1033.43,0,2,3,org.apache.lucene.index.DocsAndPositionsEnum,1.80,3,3,13,0,3,8,0,0,249,1
"org.apache.lucene.index.memory.MemoryIndex$MemoryIndexReader$MemoryDocsEnum",5,0.12,1.20,23,0.19,3531.67,9,4,42,7,2,126.06,0,34,0,3,126.06,0.00,0.67,0.35,1,5.00,2,575.09,0,1,2,org.apache.lucene.index.DocsEnum,1.20,2,2,6,0,2,4,0,0,140,1
"org.apache.lucene.index.memory.MemoryIndex$MemoryIndexReader$MemoryFields",3,0.00,1.33,13,0.11,2164.15,3,0,42,8,3,125.97,0,22,0,2,125.97,0.00,0.50,0.00,0,4.00,2,327.00,0,2,3,org.apache.lucene.index.Fields,0.57,5,1,4,0,5,1,0,0,77,1
"org.apache.lucene.index.memory.MemoryIndex$MemoryIndexReader$MemoryFields$FieldsEnum",2,0.00,1.50,9,0.09,1610.95,3,1,42,3,1,125.56,0,14,0,1,125.56,0.00,0.00,1.00,0,0.00,2,255.30,0,2,1,java.lang.Object,0.00,1,0,3,0,1,0,0,0,64,0
"org.apache.lucene.index.memory.MemoryIndex$MemoryIndexReader$MemoryFields$Terms",6,0.00,1.17,13,0.13,2148.83,6,0,42,9,2,139.62,1,25,0,1,139.62,0.00,0.00,0.00,0,6.00,2,401.69,0,2,2,java.lang.Object,0.00,3,0,7,0,3,4,0,1,106,0
"org.apache.lucene.index.memory.MemoryIndex$MemoryIndexReader$MemoryTermsEnum",14,0.15,1.50,63,0.74,21172.02,17,3,42,26,7,123.41,1,98,0,2,123.41,0.00,0.50,0.48,1,0.00,3,2227.65,0,6,7,org.apache.lucene.index.TermsEnum,0.44,12,1,21,0,12,8,0,1,490,1
"org.apache.lucene.index.memory.MemoryIndex$TokenStream",1,0.00,3.00,15,0.22,6014.99,5,4,42,12,2,147.12,1,18,0,1,97.12,0.00,0.00,1.00,0,0.00,3,653.98,0,0,2,java.lang.Object,0.00,11,0,3,0,11,1,0,1,129,0
"org.apache.lucene.index.memory.MemoryIndexNormDocValues",5,0.50,1.00,13,0.09,1233.25,6,1,4,6,4,140.93,4,23,1,2,140.93,0.00,0.50,0.60,0,2.00,1,279.66,0,1,3,org.apache.lucene.index.DocValues,0.57,1,1,5,0,1,4,0,1,80,0
"org.apache.lucene.index.memory.MemoryIndexNormDocValues$SingleValueSource",6,0.10,1.50,36,0.56,13520.12,8,2,4,18,2,115.48,0,79,0,2,115.48,0.00,0.50,0.42,0,6.00,2,1677.16,3,2,2,org.apache.lucene.index.Source,0.00,12,1,9,0,12,4,0,0,343,2
"org.apache.lucene.index.memory.MemoryIndexTest",11,0.30,1.73,130,2.18,83338.37,14,3,38,80,32,122.09,38,146,0,3,101.48,0.00,0.67,0.06,4,29.00,4,6530.54,1,3,32,org.apache.lucene.analysis.BaseTokenStreamTestCase,0.00,69,2,19,0,69,8,0,18,1174,1
"org.apache.solr.handler.extraction.ExtractingDocumentLoader",4,0.33,4.75,104,1.97,126079.87,16,12,39,61,18,32.44,36,132,2,2,82.43,0.00,0.50,0.33,2,4.00,16,5916.14,0,0,16,org.apache.solr.handler.ContentStreamLoader,0.00,57,1,19,0,57,4,0,18,883,1
"org.apache.solr.handler.extraction.ExtractingMetadataConstants",0,0.00,0.00,5,0.04,368.22,4,4,0,0,1,171.00,4,6,1,1,171.00,0.00,0.00,0.00,0,0.00,0,113.30,0,0,0,,0.00,0,0,0,0,0,0,0,1,29,1
"org.apache.solr.handler.extraction.ExtractingParams",0,0.00,0.00,15,0.23,3397.43,14,14,0,0,3,171.00,92,16,3,1,171.00,0.00,0.00,0.00,0,0.00,0,677.23,0,0,0,,0.00,0,0,0,0,0,0,0,15,130,1
"org.apache.solr.handler.extraction.ExtractingRequestHandler",9,0.00,2.00,47,0.68,27027.97,15,6,20,28,12,117.38,7,74,1,3,117.38,0.00,0.67,0.17,0,22.00,10,2048.38,1,7,11,org.apache.solr.handler.ContentStreamHandlerBase,0.52,19,2,18,0,19,2,1,3,391,1
"org.apache.solr.handler.extraction.ExtractingRequestHandlerTest",14,0.00,1.43,156,2.90,90593.12,14,0,18,37,13,141.95,40,338,0,3,102.06,0.00,0.67,0.00,1,0.00,3,8689.06,10,1,13,org.apache.solr.SolrTestCaseJ4,0.04,23,2,20,0,23,13,0,37,1517,1
"org.apache.solr.handler.extraction.SolrContentHandler",15,0.06,2.93,152,2.08,108079.87,29,14,15,62,9,85.20,81,184,2,2,103.07,0.00,0.50,0.13,7,104.00,14,6225.02,0,3,7,org.xml.sax.helpers.DefaultHandler,0.00,47,1,44,0,47,12,1,32,1158,1
"org.apache.solr.handler.extraction.SolrContentHandlerFactory",2,1.00,1.00,6,0.06,794.73,3,1,4,3,5,172.62,4,10,2,1,132.73,0.00,0.00,0.50,0,2.00,1,175.16,0,1,3,java.lang.Object,0.00,1,0,2,0,1,1,0,1,47,1
"org.apache.lucene.search.grouping.term.TermAllGroupHeadsCollector",4,0.20,2.25,32,0.42,16369.35,9,5,7,11,14,60.58,33,38,8,3,108.68,2.00,0.29,0.05,2,6.00,6,1258.49,0,2,6,org.apache.lucene.search.grouping.AbstractAllGroupHeadsCollector,0.00,7,2,9,4,7,2,0,6,256,2
"org.apache.lucene.search.grouping.term.TermAllGroupHeadsCollector$GeneralAllGroupHeadsCollector",5,0.08,3.00,46,0.59,19796.87,8,3,7,19,6,106.82,1,49,0,4,106.82,0.00,0.75,0.27,0,1.00,4,1776.00,0,1,6,org.apache.lucene.search.grouping.term.TermAllGroupHeadsCollector,0.38,14,3,15,0,14,4,0,1,357,1
"org.apache.lucene.search.grouping.term.TermAllGroupHeadsCollector$GeneralAllGroupHeadsCollector$GroupHead",3,0.50,2.00,24,0.30,10095.73,4,1,7,12,4,109.38,0,25,0,2,109.38,0.00,0.50,0.67,0,1.00,3,907.44,0,0,4,AbstractAllGroupHeadsCollector.GroupHead,0.00,9,1,6,0,9,3,0,0,185,0
"org.apache.lucene.search.grouping.term.TermAllGroupHeadsCollector$GeneralAllGroupHeadsCollector$OrdScoreAllGroupHeadsCollector",5,0.29,3.00,65,0.88,40100.53,11,6,7,23,8,98.45,2,69,0,4,98.45,0.00,0.75,0.40,0,0.00,7,2640.12,0,1,8,org.apache.lucene.search.grouping.term.TermAllGroupHeadsCollector,0.38,18,3,15,0,18,4,0,2,494,1
"org.apache.lucene.search.grouping.term.TermAllGroupHeadsCollector$GeneralAllGroupHeadsCollector$OrdScoreAllGroupHeadsCollector$GroupHead_0",3,1.00,3.67,42,0.57,24097.64,6,3,7,5,1,97.20,1,47,0,2,97.20,0.00,0.50,1.00,0,0.00,5,1724.52,0,0,1,AbstractAllGroupHeadsCollector.GroupHead,0.00,2,1,11,0,2,3,0,1,331,0
"org.apache.lucene.search.grouping.term.TermAllGroupHeadsCollector$GeneralAllGroupHeadsCollector$OrdScoreAllGroupHeadsCollector$OrdAllGroupHeadsCollector",5,0.35,2.60,59,0.79,33026.54,10,5,7,22,8,101.85,2,61,0,4,101.85,0.00,0.75,0.48,0,0.00,5,2359.77,0,1,8,org.apache.lucene.search.grouping.term.TermAllGroupHeadsCollector,0.38,17,3,13,0,17,4,0,2,449,1
"org.apache.lucene.search.grouping.term.TermAllGroupHeadsCollector$GeneralAllGroupHeadsCollector$OrdScoreAllGroupHeadsCollector$OrdAllGroupHeadsCollector$GroupHead_1",3,0.75,2.00,26,0.33,12316.94,5,2,7,5,1,108.70,1,27,0,2,108.70,0.00,0.50,1.00,0,0.00,2,1002.75,0,0,1,AbstractAllGroupHeadsCollector.GroupHead,0.00,2,1,6,0,2,3,0,1,213,0
"org.apache.lucene.search.grouping.term.TermAllGroupHeadsCollector$GeneralAllGroupHeadsCollector$OrdScoreAllGroupHeadsCollector$OrdAllGroupHeadsCollector$ScoreAllGroupHeadsCollector",5,0.20,2.20,48,0.61,21770.32,10,5,7,21,7,106.57,1,55,0,4,106.57,0.00,0.75,0.36,0,0.00,3,1816.65,0,1,7,org.apache.lucene.search.grouping.term.TermAllGroupHeadsCollector,0.38,16,3,11,0,16,4,0,1,358,1
"org.apache.lucene.search.grouping.term.TermAllGroupHeadsCollector$GeneralAllGroupHeadsCollector$OrdScoreAllGroupHeadsCollector$OrdAllGroupHeadsCollector$ScoreAllGroupHeadsCollector$GroupHead_2",3,0.00,2.33,26,0.26,8395.37,4,1,7,3,1,109.97,0,27,0,2,109.97,0.00,0.50,1.00,0,0.00,3,790.41,0,0,1,AbstractAllGroupHeadsCollector.GroupHead,0.00,0,1,7,0,0,3,0,0,169,0
"org.apache.lucene.search.grouping.term.TermAllGroupsCollector",5,0.25,1.80,29,0.35,8350.09,11,6,10,17,11,77.12,36,37,5,3,119.41,0.00,0.67,0.37,0,0.00,3,1064.79,0,1,6,org.apache.lucene.search.grouping.AbstractAllGroupsCollector,0.46,12,2,9,0,12,4,0,5,225,1
"org.apache.lucene.search.grouping.term.TermDistinctValuesCollector",5,0.28,3.60,60,0.92,45771.15,13,8,9,24,7,139.14,13,73,1,3,99.25,0.00,0.67,0.35,1,5.00,7,2773.39,0,1,6,org.apache.lucene.search.grouping.AbstractDistinctValuesCollector,0.50,19,2,18,0,19,4,0,2,522,1
"org.apache.lucene.search.grouping.term.TermDistinctValuesCollector$GroupCount",1,1.00,1.00,4,0.03,396.89,2,1,9,1,0,128.08,0,6,0,2,128.08,0.00,0.50,0.00,0,1.00,1,89.99,0,0,0,AbstractDistinctValuesCollector.GroupCount,0.00,0,1,1,0,0,1,0,0,26,1
"org.apache.lucene.search.grouping.term.TermFirstPassGroupingCollector",4,0.00,1.75,21,0.24,6383.94,7,3,6,11,10,101.70,23,30,5,3,119.58,0.00,0.67,0.33,0,4.00,3,724.10,1,2,5,org.apache.lucene.search.grouping.AbstractFirstPassGroupingCollector,0.18,7,2,7,0,7,2,0,2,166,1
"org.apache.lucene.search.grouping.term.TermGroupFacetCollector",2,0.00,1.50,15,0.18,3906.71,6,4,9,7,12,64.99,20,21,6,3,113.47,1.00,0.40,0.25,0,2.00,2,536.18,0,1,6,org.apache.lucene.search.grouping.AbstractGroupFacetCollector,0.00,5,2,3,2,5,1,0,3,117,2
"org.apache.lucene.search.grouping.term.TermGroupFacetCollector$SV",4,0.33,3.50,50,0.71,38593.58,5,1,9,20,3,99.08,3,67,0,4,99.08,0.00,0.75,0.75,1,0.00,7,2142.92,0,1,3,org.apache.lucene.search.grouping.term.TermGroupFacetCollector,0.53,16,3,14,0,16,3,0,3,390,1
"org.apache.lucene.search.grouping.term.TermGroupFacetCollector$SV$GroupedFacetHit",1,2.00,1.00,6,0.03,444.64,3,2,9,1,0,121.12,0,8,0,1,121.12,0.00,0.00,0.00,0,1.00,1,102.12,0,0,0,java.lang.Object,0.00,0,0,1,0,0,1,0,0,32,0
"org.apache.lucene.search.grouping.term.TermGroupFacetCollector$SV$MV",4,0.44,5.25,83,1.19,93318.81,7,3,9,27,5,137.69,4,104,0,4,87.69,0.00,0.75,0.67,1,0.00,10,3574.95,0,1,5,org.apache.lucene.search.grouping.term.TermGroupFacetCollector,0.53,23,3,21,0,23,3,0,4,602,1
"org.apache.lucene.search.grouping.term.TermGroupFacetCollector$SV$MV$SegmentResult_0",2,1.00,2.00,11,0.15,5876.71,3,1,9,5,1,117.46,0,16,0,2,117.46,0.00,0.50,0.50,0,2.00,3,452.00,0,0,1,AbstractGroupFacetCollector.SegmentResult,0.00,3,1,4,0,3,2,0,0,98,2
"org.apache.lucene.search.grouping.term.TermGroupFacetCollector$SV$SegmentResult",2,1.00,2.00,11,0.14,4801.04,3,1,9,5,1,118.15,0,15,0,2,118.15,0.00,0.50,0.50,0,2.00,3,428.97,0,0,1,AbstractGroupFacetCollector.SegmentResult,0.00,3,1,4,0,3,2,0,0,94,2
"org.apache.lucene.search.grouping.term.TermSecondPassGroupingCollector",3,0.50,2.33,26,0.43,13024.01,7,4,9,13,11,129.09,9,35,4,3,108.47,0.00,0.67,0.58,0,0.00,4,1279.09,1,1,7,org.apache.lucene.search.grouping.AbstractSecondPassGroupingCollector,0.21,10,2,7,0,10,2,0,3,245,1
"org.apache.solr.client.solrj.LargeVolumeTestBase",2,0.00,2.00,30,0.35,12017.18,4,2,8,15,9,97.45,9,31,3,4,97.21,1.00,0.43,0.50,1,2.00,3,1049.20,1,0,6,org.apache.solr.SolrJettyTestBase,0.00,13,3,4,3,13,2,0,6,206,2
"org.apache.solr.client.solrj.LargeVolumeTestBase$DocThread",2,0.50,3.50,36,0.49,34845.16,4,2,8,16,3,90.49,1,45,0,2,90.49,0.00,0.50,0.75,0,0.00,6,1477.36,0,0,3,java.lang.Thread,0.00,14,1,7,0,14,2,0,1,265,1
"org.apache.solr.client.solrj.MergeIndexesExampleTestBase",15,0.26,1.20,81,1.24,35437.36,18,3,10,48,12,168.32,17,109,0,4,118.32,0.33,0.60,0.09,5,37.00,4,3715.32,2,11,12,org.apache.solr.client.solrj.SolrExampleTestBase,0.52,33,3,18,1,33,4,0,12,734,2
"org.apache.solr.client.solrj.MultiCoreExampleTestBase",12,0.41,1.42,100,1.86,104320.75,14,2,12,58,14,156.21,18,120,2,4,106.21,0.67,0.50,0.12,5,28.00,4,5594.59,4,9,12,org.apache.solr.client.solrj.SolrExampleTestBase,0.55,46,3,17,2,46,3,0,15,914,2
"org.apache.solr.client.solrj.ResponseParser",4,0.00,1.00,6,0.05,372.72,4,0,3,4,10,195.38,9,10,9,1,155.49,0.00,0.00,0.00,0,4.00,1,137.28,0,4,1,java.lang.Object,0.00,0,0,4,3,0,0,0,3,43,2
"org.apache.solr.client.solrj.SolrExampleBinaryTest",2,0.00,1.50,14,0.16,4308.38,2,0,7,11,6,133.75,7,23,0,5,113.13,0.00,0.80,0.00,0,2.00,2,473.07,1,1,6,org.apache.solr.client.solrj.SolrExampleTests,0.05,9,4,3,0,9,1,0,4,100,1
"org.apache.solr.client.solrj.SolrExampleTestBase",6,0.00,1.00,14,0.12,1523.03,6,0,1,8,4,180.72,15,17,2,3,140.84,2.50,0.25,0.00,1,6.00,1,370.43,2,5,2,org.apache.solr.util.AbstractSolrTestCase,0.31,2,2,6,5,2,1,0,4,99,2
"org.apache.solr.client.solrj.SolrExampleTests",22,0.00,2.68,663,10.95,712787.95,22,0,37,167,37,30.16,202,733,5,4,80.15,1.67,0.33,0.00,2,22.00,8,32848.00,2,2,32,org.apache.solr.SolrJettyTestBase,0.00,145,3,59,5,145,20,0,187,5366,2
"org.apache.solr.client.solrj.SolrExampleTests$StreamingResponseCallback",2,0.00,1.00,7,0.08,1100.54,2,0,37,6,1,131.62,1,11,0,1,131.62,0.00,0.00,0.00,0,2.00,1,238.31,0,0,1,java.lang.Object,0.00,4,0,2,0,4,2,0,1,58,0
"org.apache.solr.client.solrj.SolrExceptionTest",1,0.00,2.00,11,0.13,2577.20,1,0,4,10,4,94.78,15,15,0,2,105.13,0.00,0.50,0.00,0,1.00,2,389.95,0,0,4,org.apache.lucene.util.LuceneTestCase,0.00,9,1,2,0,9,1,0,7,79,1
"org.apache.solr.client.solrj.SolrQuery",0,0.00,0.00,2,0.01,75.00,0,0,11,0,32,171.00,7,2,24,3,171.00,0.00,0.67,0.00,0,0.00,0,30.00,0,0,8,org.apache.solr.common.params.ModifiableSolrParams,0.00,0,2,0,0,0,0,0,1,10,1
"org.apache.solr.client.solrj.SolrQuery$ORDER",1,0.00,28.00,380,7.62,1737778.30,2,1,11,40,7,74.29,167,511,0,1,24.86,0.00,0.00,1.00,0,0.00,28,22847.09,0,1,7,java.lang.Object,0.00,39,0,28,0,39,0,0,35,2808,1
"org.apache.solr.client.solrj.SolrQueryTest",9,0.00,1.00,174,3.05,117209.20,9,0,7,112,3,140.90,14,184,0,2,90.90,0.00,0.50,0.00,0,9.00,1,9136.85,0,0,3,org.apache.lucene.util.LuceneTestCase,0.00,103,1,9,0,103,9,0,10,1613,1
"org.apache.solr.client.solrj.SolrRequest",12,0.18,1.00,28,0.20,2566.27,16,4,5,12,27,191.42,18,40,21,1,141.42,0.00,0.00,0.08,0,52.00,1,606.52,0,6,7,java.lang.Object,0.00,0,0,12,17,0,6,1,7,169,2
"org.apache.solr.client.solrj.SolrRequest$METHOD",0,0.00,0.00,2,0.01,39.30,0,0,5,0,0,171.00,0,4,0,1,171.00,0.00,0.00,0.00,0,0.00,0,19.65,0,0,0,java.lang.Object,0.00,0,0,0,0,0,0,1,0,7,1
"org.apache.solr.client.solrj.SolrResponse",3,0.00,1.00,4,0.03,279.90,3,0,2,3,7,205.49,5,6,6,1,155.49,0.00,0.00,0.00,0,3.00,1,101.74,0,1,1,java.lang.Object,0.00,0,0,3,9,0,2,1,1,33,2
"org.apache.solr.client.solrj.SolrServer",26,0.50,1.15,80,1.01,19455.67,28,2,17,47,58,88.25,183,109,47,1,130.54,0.00,0.00,0.02,8,50.00,3,3024.42,0,26,14,java.lang.Object,0.00,21,0,30,5,21,0,1,26,704,2
"org.apache.solr.client.solrj.SolrServerException",4,1.00,1.50,17,0.11,2473.96,5,1,0,5,42,176.47,5,24,42,2,126.47,0.00,0.50,0.00,0,4.00,3,334.25,0,1,0,java.lang.Exception,0.00,1,1,6,0,1,3,0,1,88,1
"org.apache.solr.client.solrj.StartSolrJetty",1,0.00,3.00,23,0.30,9832.62,1,0,4,19,0,50.95,12,31,0,1,88.51,0.00,0.00,0.00,0,1.00,3,913.04,0,0,0,java.lang.Object,0.00,18,0,3,0,18,1,0,10,156,1
"org.apache.solr.client.solrj.StreamingResponseCallback",2,0.00,1.00,3,0.03,166.11,2,0,1,2,6,138.01,11,4,5,1,155.89,0.00,0.00,0.00,0,2.00,1,77.12,0,0,1,java.lang.Object,0.00,0,0,2,0,0,2,0,3,25,2
"org.apache.solr.client.solrj.TestBatchUpdate",5,0.75,1.00,36,0.44,10106.94,6,1,12,20,8,163.44,9,47,0,4,113.44,0.00,0.75,0.40,1,7.00,1,1314.28,2,0,8,org.apache.solr.SolrJettyTestBase,0.00,15,3,5,0,15,5,0,4,276,1
"org.apache.solr.client.solrj.TestBatchUpdate$Bean",0,0.00,0.00,3,0.02,354.94,2,2,12,0,0,171.00,0,6,0,1,171.00,0.00,0.00,0.00,0,0.00,0,65.73,0,0,0,java.lang.Object,0.00,0,0,0,0,0,0,0,0,19,2
"org.apache.solr.client.solrj.TestBatchUpdate$Iterator<Bean>",3,0.00,1.00,9,0.07,1437.34,3,0,12,4,0,132.09,1,12,0,1,132.09,0.00,0.00,0.00,0,4.00,1,216.90,0,0,0,java.lang.Object,0.00,1,0,3,0,1,3,0,1,57,0
"org.apache.solr.client.solrj.TestBatchUpdate$Iterator<SolrInputDocument>",3,0.00,1.00,9,0.08,1569.95,3,0,12,5,1,131.79,1,12,0,1,131.79,0.00,0.00,0.00,0,4.00,1,228.01,0,1,1,java.lang.Object,0.00,2,0,3,0,2,2,0,1,59,0
"org.apache.solr.client.solrj.TestLBHttpSolrServer",9,0.04,2.44,130,1.90,79649.61,12,3,21,50,9,146.96,16,140,0,2,96.96,0.00,0.50,0.37,2,18.00,5,5698.53,2,0,9,org.apache.lucene.util.LuceneTestCase,0.00,41,1,22,0,41,9,0,11,1036,1
"org.apache.solr.client.solrj.TestLBHttpSolrServer$SolrInstance",10,0.04,1.20,46,0.45,8629.47,16,6,21,24,3,125.38,2,61,0,1,125.38,0.00,0.00,0.20,3,38.00,2,1356.82,0,6,3,java.lang.Object,0.00,14,0,12,0,14,4,0,2,304,1
"org.apache.lucene.codecs.ramonly.RAMOnlyPostingsFormat",4,0.39,1.50,58,0.81,25127.76,10,6,34,22,22,98.48,16,75,0,2,98.24,0.00,0.50,0.46,0,0.00,2,2430.76,0,2,22,org.apache.lucene.codecs.PostingsFormat,0.00,18,1,6,0,18,2,0,12,434,1
"org.apache.lucene.codecs.ramonly.RAMOnlyPostingsFormat$Comparator<BytesRef>",2,0.00,2.50,19,0.23,19523.06,2,0,34,2,1,153.78,2,25,0,1,103.78,0.00,0.00,0.00,0,2.00,4,700.93,0,0,1,java.lang.Object,0.00,0,0,5,0,0,2,0,2,144,0
"org.apache.lucene.codecs.ramonly.RAMOnlyPostingsFormat$RAMDoc",1,2.00,1.00,7,0.05,849.83,4,3,34,1,0,116.41,0,9,0,1,116.41,0.00,0.00,0.33,0,0.00,1,155.24,0,0,0,java.lang.Object,0.00,0,0,1,0,0,1,0,0,42,1
"org.apache.lucene.codecs.ramonly.RAMOnlyPostingsFormat$RAMDocsAndPositionsEnum",10,0.09,1.30,38,0.38,8702.55,15,5,34,14,3,129.99,1,61,0,4,129.99,0.00,0.75,0.28,1,0.00,4,1146.05,0,1,3,org.apache.lucene.index.DocsAndPositionsEnum,1.80,4,3,13,0,4,9,0,1,269,2
"org.apache.lucene.codecs.ramonly.RAMOnlyPostingsFormat$RAMDocsEnum",5,0.15,1.60,28,0.27,6609.47,10,5,34,8,2,120.24,1,41,0,3,120.24,0.00,0.67,0.32,1,0.00,4,812.57,0,0,2,org.apache.lucene.index.DocsEnum,1.20,3,2,8,0,3,5,0,1,184,2
"org.apache.lucene.codecs.ramonly.RAMOnlyPostingsFormat$RAMField",7,0.10,1.00,20,0.18,2837.79,12,5,34,10,2,139.23,0,34,0,2,139.23,0.00,0.50,0.11,0,27.00,1,530.01,0,2,2,org.apache.lucene.index.Terms,0.71,3,1,7,0,3,5,0,0,136,1
"org.apache.lucene.codecs.ramonly.RAMOnlyPostingsFormat$RAMFieldsConsumer",3,0.25,1.33,13,0.15,3385.94,5,2,34,9,3,124.44,1,20,0,2,124.44,0.00,0.50,0.33,0,4.00,2,454.32,0,1,3,org.apache.lucene.codecs.FieldsConsumer,0.33,6,1,4,0,6,2,0,1,103,2
"org.apache.lucene.codecs.ramonly.RAMOnlyPostingsFormat$RAMFieldsEnum",3,0.17,1.33,15,0.13,2328.47,6,3,34,8,2,122.10,0,22,0,2,122.10,0.00,0.50,0.44,0,1.00,2,396.70,0,2,2,org.apache.lucene.index.FieldsEnum,0.67,5,1,4,0,5,1,0,0,100,1
"org.apache.lucene.codecs.ramonly.RAMOnlyPostingsFormat$RAMPostings",4,0.67,1.00,9,0.09,1450.95,5,1,34,8,3,139.61,0,18,0,3,139.61,0.00,0.67,0.50,0,4.00,1,283.47,0,2,3,org.apache.lucene.codecs.FieldsProducer,1.00,4,2,4,0,4,2,0,0,76,1
"org.apache.lucene.codecs.ramonly.RAMOnlyPostingsFormat$RAMPostingsWriterImpl",4,0.33,1.50,22,0.30,13135.80,7,3,34,7,2,117.14,0,32,0,2,117.14,0.00,0.50,0.58,0,0.00,3,910.30,0,0,2,org.apache.lucene.codecs.PostingsConsumer,0.50,3,1,6,0,3,4,0,0,192,2
"org.apache.lucene.codecs.ramonly.RAMOnlyPostingsFormat$RAMTerm",1,3.00,1.00,6,0.05,840.17,4,3,34,2,0,118.94,0,8,0,1,118.94,0.00,0.00,0.00,0,1.00,1,158.81,0,0,0,java.lang.Object,0.00,1,0,1,0,1,1,0,0,40,1
"org.apache.lucene.codecs.ramonly.RAMOnlyPostingsFormat$RAMTermsConsumer",5,0.00,1.00,22,0.24,5026.53,8,3,34,12,4,124.90,0,32,0,2,124.90,0.00,0.50,0.33,0,6.00,1,734.83,0,2,4,org.apache.lucene.codecs.TermsConsumer,0.40,7,1,5,0,7,3,0,0,172,2
"org.apache.lucene.codecs.ramonly.RAMOnlyPostingsFormat$RAMTermsEnum",11,0.13,1.55,45,0.49,11334.32,14,3,34,28,5,124.71,1,73,0,2,124.71,0.00,0.50,0.45,0,0.00,4,1461.79,0,5,5,org.apache.lucene.index.TermsEnum,0.42,17,1,17,0,17,6,0,1,339,1
"org.apache.lucene.facet.search.params.association.AssociationFloatSumFacetRequest",5,0.00,1.00,12,0.12,2088.90,5,0,8,7,9,121.26,26,24,2,2,139.13,0.00,0.50,0.00,0,5.00,1,373.44,0,1,7,org.apache.lucene.facet.search.params.FacetRequest,0.14,2,1,5,0,2,4,0,3,95,1
"org.apache.lucene.facet.search.params.association.AssociationIntSumFacetRequest",5,0.00,1.00,12,0.12,2088.90,5,0,8,7,9,121.26,26,24,2,2,139.13,0.00,0.50,0.00,0,5.00,1,373.44,0,1,7,org.apache.lucene.facet.search.params.FacetRequest,0.14,2,1,5,0,2,4,0,3,95,1
"org.apache.lucene.analysis.hy.ArmenianAnalyzer",5,0.50,1.20,21,0.26,6053.81,7,2,15,16,13,76.12,42,31,1,3,124.22,0.00,0.67,0.10,0,8.00,2,777.74,0,2,12,org.apache.lucene.analysis.util.StopwordAnalyzerBase,0.00,11,2,6,0,11,3,0,8,177,2
"org.apache.lucene.analysis.hy.ArmenianAnalyzer$DefaultSetHolder",0,0.00,0.00,6,0.05,732.71,1,1,15,0,2,171.00,2,11,0,1,171.00,0.00,0.00,0.00,0,0.00,0,149.07,0,0,2,java.lang.Object,0.00,0,0,0,0,0,0,0,2,37,2
"org.apache.lucene.analysis.hy.TestArmenianAnalyzer",4,0.00,1.00,15,0.16,2494.63,4,0,4,7,4,181.19,7,21,0,3,131.19,0.00,0.67,0.00,0,4.00,1,481.49,3,0,4,org.apache.lucene.analysis.BaseTokenStreamTestCase,0.00,3,2,4,0,3,4,0,6,114,1
"org.apache.solr.util.AbstractSolrTestCase",33,0.06,1.85,157,2.07,64222.66,41,8,26,92,46,122.73,142,228,36,2,122.50,32.00,0.03,0.07,10,251.00,6,6219.60,2,15,10,org.apache.lucene.util.LuceneTestCase,0.00,59,1,61,32,59,18,0,35,1291,2
"org.apache.solr.util.AbstractSolrTestCase$Doc",1,0.00,1.00,4,0.02,212.03,2,1,26,1,0,130.22,0,5,0,1,130.22,0.00,0.00,1.00,0,0.00,1,66.54,0,1,0,java.lang.Object,0.00,0,0,1,0,0,0,0,0,21,2
"org.apache.solr.util.BCDUtils",12,0.27,5.00,206,2.97,376808.38,14,2,0,15,11,122.70,240,249,11,1,89.32,0.00,0.00,0.25,5,44.00,13,8896.33,0,4,0,java.lang.Object,0.00,3,0,60,0,3,8,0,136,1661,1
"org.apache.solr.util.Base100S",2,0.00,1.00,5,0.05,677.94,2,0,7,4,4,139.85,0,10,1,2,139.85,0.00,0.50,0.00,0,2.00,1,137.42,0,2,3,org.apache.solr.util.Converter,0.00,2,1,2,0,2,0,0,0,39,0
"org.apache.solr.util.Base10kS",2,0.00,1.00,5,0.05,677.94,2,0,7,4,4,139.85,0,10,1,2,139.85,0.00,0.50,0.00,0,2.00,1,137.42,0,2,3,org.apache.solr.util.Converter,0.00,2,1,2,0,2,0,0,0,39,0
"org.apache.solr.util.BitSetPerf",2,1.00,21.00,161,2.05,375377.28,3,1,4,24,2,39.91,11,139,0,1,57.78,0.00,0.00,0.50,1,2.00,40,6147.82,0,0,2,java.lang.Object,0.00,22,0,42,0,22,2,0,2,955,1
"org.apache.solr.util.BoundedTreeSet",9,0.88,1.44,30,0.26,4294.01,10,1,1,11,4,132.02,5,43,4,2,132.02,0.00,0.50,0.22,2,19.00,2,776.79,2,0,0,java.util.TreeSet,0.00,2,1,13,0,2,9,0,1,197,1
"org.apache.solr.util.ConcurrentLFUCache",16,0.08,3.31,176,2.47,132174.28,31,15,10,59,3,101.27,64,226,3,1,101.03,0.00,0.00,0.14,3,50.00,8,7405.81,1,4,0,java.lang.Object,0.00,43,0,53,0,43,12,0,27,1376,1
"org.apache.solr.util.ConcurrentLFUCache$CacheEntry",5,0.00,1.80,23,0.29,9080.49,11,6,10,9,0,122.74,0,34,0,1,122.74,0.00,0.00,0.17,0,2.00,5,862.35,0,1,0,java.lang.Object,0.00,4,0,9,0,4,4,1,0,201,2
"org.apache.solr.util.ConcurrentLFUCache$CleanupThread",4,0.00,2.25,22,0.18,3708.09,6,2,10,9,1,121.38,0,35,0,2,121.38,0.00,0.50,0.50,0,2.00,6,533.05,0,0,1,org.apache.solr.util.Thread,0.00,5,1,9,0,5,4,0,0,126,2
"org.apache.solr.util.ConcurrentLFUCache$EvictionListener",1,0.00,1.00,2,0.02,128.38,1,0,10,1,0,143.17,0,3,0,1,143.17,0.00,0.00,0.00,0,1.00,1,57.06,0,0,0,,0.00,0,0,1,0,0,1,0,0,18,2
"org.apache.solr.util.ConcurrentLFUCache$Stats",8,0.24,1.00,25,0.31,5865.72,14,6,10,15,0,130.64,0,37,0,1,130.64,0.00,0.00,0.38,0,4.00,1,940.72,0,0,0,java.lang.Object,0.00,7,0,8,0,7,8,0,0,236,2
"org.apache.solr.util.ConcurrentLFUCache$Thread",1,0.00,1.00,3,0.01,120.97,1,0,10,2,0,136.80,0,5,0,1,136.80,0.00,0.00,0.00,0,1.00,1,42.87,0,0,0,java.lang.Object,0.00,1,0,1,0,1,1,0,0,15,0
"org.apache.solr.util.ConcurrentLRUCache",16,0.09,4.06,233,3.40,454644.87,30,14,13,61,4,60.63,106,284,3,1,92.85,0.00,0.00,0.15,3,50.00,22,10198.71,1,3,1,java.lang.Object,0.00,45,0,65,0,45,13,0,78,1776,1
"org.apache.solr.util.ConcurrentLRUCache$CacheEntry<K,V>",6,0.05,1.33,20,0.23,5058.63,10,4,13,8,0,130.10,0,30,0,1,130.10,0.00,0.00,0.21,0,6.00,3,687.17,0,1,0,java.lang.Object,0.00,2,0,8,0,2,5,1,0,170,2
"org.apache.solr.util.ConcurrentLRUCache$CleanupThread",4,0.00,2.25,22,0.18,3708.09,6,2,13,9,1,121.38,0,34,0,2,121.38,0.00,0.50,0.50,0,2.00,6,533.05,0,0,1,org.apache.solr.util.Thread,0.00,5,1,9,0,5,4,0,0,126,2
"org.apache.solr.util.ConcurrentLRUCache$EvictionListener<K,V>",1,0.00,1.00,2,0.02,128.38,1,0,13,1,0,143.17,0,3,0,1,143.17,0.00,0.00,0.00,0,1.00,1,57.06,0,0,0,,0.00,0,0,1,0,0,1,0,0,18,2
"org.apache.solr.util.ConcurrentLRUCache$PQueue",4,0.17,1.50,22,0.28,9080.65,6,2,13,6,1,118.41,2,31,0,2,118.41,0.00,0.50,0.62,0,0.00,3,829.44,3,0,1,org.apache.lucene.util.PriorityQueue,0.00,2,1,6,0,2,4,0,2,185,2
"org.apache.solr.util.ConcurrentLRUCache$Stats",8,0.24,1.00,25,0.31,5865.72,14,6,13,15,0,130.64,0,37,0,1,130.64,0.00,0.00,0.38,0,4.00,1,940.72,0,0,0,java.lang.Object,0.00,7,0,8,0,7,8,0,0,236,2
"org.apache.solr.util.ConcurrentLRUCache$Thread",1,0.00,1.00,3,0.01,120.97,1,0,13,2,0,136.80,0,5,0,1,136.80,0.00,0.00,0.00,0,1.00,1,42.87,0,0,0,java.lang.Object,0.00,1,0,1,0,1,1,0,0,15,0
"org.apache.solr.util.Converter",2,0.00,1.00,3,0.01,84.38,2,0,7,2,11,158.20,0,4,9,1,158.20,0.00,0.00,0.00,0,2.00,1,44.19,0,2,2,java.lang.Object,0.00,0,0,2,8,0,0,0,0,18,1
"org.apache.solr.util.DOMUtilTestBase",4,0.17,1.00,13,0.17,2663.68,6,2,10,12,1,130.97,0,19,1,2,130.97,2.00,0.25,0.38,2,6.00,1,507.07,1,3,0,org.apache.lucene.util.LuceneTestCase,0.00,8,1,4,2,8,1,0,0,122,2
"org.apache.solr.util.DateMathParser",7,0.07,3.29,98,1.56,113115.47,12,5,9,28,9,74.69,99,145,8,1,94.83,0.00,0.00,0.26,3,25.00,12,4666.75,0,3,1,java.lang.Object,0.00,21,0,23,0,21,4,0,21,842,1
"org.apache.solr.util.DateMathParserTest",14,0.15,1.43,160,2.24,58468.39,17,3,11,39,1,153.56,22,186,0,2,103.56,0.00,0.50,0.48,6,0.00,4,6705.05,0,3,1,org.apache.lucene.util.LuceneTestCase,0.00,25,1,20,0,25,11,0,14,1206,1
"org.apache.solr.util.DefaultSolrThreadFactory",2,1.00,2.00,14,0.21,4921.34,6,4,2,12,5,112.61,0,23,5,1,112.61,0.00,0.00,0.75,0,0.00,2,638.59,0,1,0,java.lang.Object,0.00,10,0,4,0,10,1,1,0,138,1
"org.apache.solr.util.ExternalPaths",1,6.00,4.00,18,0.28,9974.47,7,6,2,10,18,44.26,8,24,17,1,92.37,0.00,0.00,0.00,0,1.00,4,853.95,0,1,1,java.lang.Object,0.00,9,0,4,0,9,0,0,4,173,1
"org.apache.solr.util.FindClasses",5,0.38,4.20,67,1.08,63608.32,7,2,14,41,2,117.41,17,89,2,1,96.80,0.00,0.00,0.20,0,11.00,9,3239.52,0,3,0,java.lang.Object,0.00,36,0,21,0,36,2,0,5,575,0
"org.apache.solr.util.Float2Float",2,0.00,1.00,5,0.06,896.91,2,0,7,4,4,138.89,0,10,1,2,138.89,0.00,0.50,0.00,0,2.00,1,171.52,0,2,3,org.apache.solr.util.Converter,0.00,2,1,2,0,2,0,0,0,47,0
"org.apache.solr.util.Int2Int",2,0.00,1.00,5,0.06,896.91,2,0,7,4,4,138.89,0,10,1,2,138.89,0.00,0.50,0.00,0,2.00,1,171.52,0,2,3,org.apache.solr.util.Converter,0.00,2,1,2,0,2,0,0,0,47,0
"org.apache.solr.util.LongPriorityQueue",17,0.19,1.82,109,0.91,36120.99,22,5,1,20,3,97.76,91,142,3,1,115.63,0.00,0.00,0.38,6,0.00,4,2742.36,0,0,0,java.lang.Object,0.00,3,0,31,0,3,17,0,39,634,1
"org.apache.solr.util.NumberUtils",25,0.00,1.28,94,1.26,44665.32,25,0,2,44,23,177.54,28,121,22,1,127.54,0.00,0.00,0.00,8,25.00,4,3767.61,0,15,1,java.lang.Object,0.00,19,0,32,0,19,10,0,26,862,1
"org.apache.solr.util.PrimUtils",2,0.00,12.00,71,1.16,347549.34,2,0,0,4,2,34.01,24,85,2,1,71.57,0.00,0.00,0.00,1,2.00,18,3469.11,0,0,0,java.lang.Object,0.00,2,0,24,0,2,2,0,6,617,1
"org.apache.solr.util.PrimUtils$IntComparator",3,0.00,1.00,6,0.06,667.98,3,0,0,3,0,141.28,0,9,0,1,141.28,0.00,0.00,0.00,1,3.00,1,171.32,0,0,0,java.lang.Object,0.00,0,0,3,0,0,3,0,0,50,3
"org.apache.solr.util.PrimUtilsTest",2,0.00,6.00,64,0.76,73166.95,2,0,2,13,2,78.51,1,54,0,2,78.51,0.00,0.50,0.00,0,2.00,7,2279.81,0,0,2,org.apache.lucene.util.LuceneTestCase,0.00,11,1,12,0,11,2,0,1,417,1
"org.apache.solr.util.PrimUtilsTest$PrimUtils.IntComparator",1,0.00,1.00,3,0.03,457.63,1,0,2,1,0,182.25,1,5,0,1,132.25,0.00,0.00,0.00,0,1.00,1,76.45,0,0,0,java.lang.Object,0.00,0,0,1,0,0,1,0,1,23,0
"org.apache.solr.util.RefCounted",6,0.20,1.17,16,0.12,1748.70,8,2,1,10,23,190.33,11,23,23,1,140.33,0.00,0.00,0.33,1,10.00,2,347.87,0,2,0,java.lang.Object,0.00,4,0,7,0,4,4,0,1,96,2
"org.apache.solr.util.SimplePostTool",18,0.00,3.06,159,2.45,111412.69,30,12,13,61,1,147.08,48,238,1,1,107.20,0.00,0.00,0.08,9,94.00,14,7342.92,0,2,0,java.lang.Object,0.00,43,0,55,0,43,16,0,15,1334,1
"org.apache.solr.util.SolrPluginUtils",20,0.13,3.70,222,3.58,191392.33,26,6,31,108,52,52.03,200,285,21,1,100.50,0.00,0.00,0.04,6,74.00,9,10750.45,0,14,33,java.lang.Object,0.00,88,0,74,1,88,6,0,37,1999,1
"org.apache.solr.util.SolrPluginUtils$DisjunctionMaxQueryParser",7,0.83,4.43,96,1.63,94997.21,8,1,31,66,20,46.56,64,134,0,4,96.56,0.00,0.75,0.29,1,18.00,8,4903.59,2,4,20,org.apache.solr.search.SolrQueryParser,0.00,59,3,31,0,59,3,0,11,863,2
"org.apache.solr.util.SolrPluginUtils$DisjunctionMaxQueryParser$Alias",0,0.00,0.00,3,0.02,296.92,2,2,31,0,0,171.00,0,4,0,1,171.00,0.00,0.00,0.00,0,0.00,0,74.23,0,0,0,java.lang.Object,0.00,0,0,0,0,0,0,0,0,19,2
"org.apache.solr.util.SolrPluginUtils$DisjunctionMaxQueryParser$IdentityRegenerator",1,0.00,1.00,4,0.05,614.64,1,0,31,2,3,126.58,0,11,0,1,126.58,0.00,0.00,0.00,0,1.00,1,136.34,0,0,3,java.lang.Object,0.00,1,0,1,0,1,1,1,0,34,2
"org.apache.solr.util.SolrPluginUtilsTest",13,0.00,1.23,215,3.89,247795.91,13,0,26,66,17,142.33,21,283,0,3,92.33,0.00,0.67,0.00,0,31.00,3,11659.97,2,3,17,org.apache.solr.SolrTestCaseJ4,0.00,53,2,16,0,53,10,0,19,1949,1
"org.apache.solr.util.SortDouble",2,0.00,1.00,5,0.05,677.94,2,0,7,4,4,139.85,0,10,1,2,139.85,0.00,0.50,0.00,0,2.00,1,137.42,0,2,3,org.apache.solr.util.Converter,0.00,2,1,2,0,2,0,0,0,39,0
"org.apache.solr.util.SortFloat",2,0.00,1.00,5,0.05,677.94,2,0,7,4,4,139.85,0,10,1,2,139.85,0.00,0.50,0.00,0,2.00,1,137.42,0,2,3,org.apache.solr.util.Converter,0.00,2,1,2,0,2,0,0,0,39,0
"org.apache.solr.util.SortInt",2,0.00,1.00,5,0.05,677.94,2,0,7,4,4,139.85,0,10,1,2,139.85,0.00,0.50,0.00,0,2.00,1,137.42,0,2,3,org.apache.solr.util.Converter,0.00,2,1,2,0,2,0,0,0,39,0
"org.apache.solr.util.SortLong",2,0.00,1.00,5,0.05,677.94,2,0,7,4,4,139.85,0,10,1,2,139.85,0.00,0.50,0.00,0,2.00,1,137.42,0,2,3,org.apache.solr.util.Converter,0.00,2,1,2,0,2,0,0,0,39,0
"org.apache.solr.util.SuggestMissingFactories",1,0.00,3.00,22,0.41,23366.17,1,0,14,13,1,68.40,5,34,0,1,86.27,0.00,0.00,0.00,0,1.00,3,1241.59,0,0,1,java.lang.Object,0.00,12,0,3,0,12,1,0,1,212,1
"org.apache.solr.util.TestHarness",31,0.12,2.06,182,2.21,75255.46,36,5,35,81,31,100.23,160,274,12,1,118.10,0.00,0.00,0.08,8,224.00,6,6632.13,0,21,19,java.lang.Object,0.00,50,0,64,0,50,10,0,33,1391,1
"org.apache.solr.util.TestHarness$Initializer",3,0.25,1.67,23,0.28,9063.66,7,4,35,16,6,111.95,2,33,0,2,111.95,0.00,0.50,0.42,0,1.00,2,844.19,0,2,6,CoreContainer.Initializer,0.00,13,1,5,0,13,1,0,2,180,1
"org.apache.solr.util.TestHarness$Initializer$SolrResourceLoader",0,0.00,0.00,5,0.05,533.28,0,0,35,1,0,171.00,0,7,0,1,171.00,0.00,0.00,0.00,0,0.00,0,144.43,0,0,0,java.lang.Object,0.00,1,0,0,0,1,0,0,0,34,0
"org.apache.solr.util.TestHarness$LocalRequestFactory",2,0.50,2.50,18,0.29,17603.19,6,4,35,8,3,54.13,18,22,0,1,104.13,0.00,0.00,0.50,0,2.00,4,862.48,0,1,3,java.lang.Object,0.00,6,0,5,0,6,1,0,1,168,1
"org.apache.solr.util.TestNumberUtils",7,0.07,3.71,104,1.58,80612.96,12,5,7,29,11,116.58,25,107,0,2,95.96,0.00,0.50,0.26,5,3.00,9,4737.49,0,1,11,org.apache.lucene.util.LuceneTestCase,0.00,22,1,26,0,22,6,0,25,891,1
"org.apache.solr.util.TestUtils",3,0.00,1.67,79,1.30,74056.57,3,0,8,36,3,133.51,5,87,0,2,83.51,0.00,0.50,0.00,0,3.00,3,3885.58,0,0,3,org.apache.lucene.util.LuceneTestCase,0.00,33,1,5,0,33,3,0,3,698,1
"org.apache.solr.util.VersionedFile",2,1.00,5.50,41,0.52,41365.93,3,1,11,16,2,39.99,16,51,2,1,88.09,0.00,0.00,0.50,1,2.00,7,1567.26,0,1,0,java.lang.Object,0.00,14,0,11,0,14,1,0,9,285,1
"org.apache.solr.util.VersionedFile$FilenameFilter",1,0.00,1.00,3,0.02,217.60,1,0,11,2,0,134.79,0,4,0,1,134.79,0.00,0.00,0.00,0,1.00,1,68.92,0,0,0,java.lang.Object,0.00,1,0,1,0,1,1,0,0,20,0
"org.apache.lucene.analysis.stempel.StempelFilter",3,0.20,2.00,20,0.24,5510.14,8,5,5,9,7,66.11,27,28,2,4,116.11,0.00,0.75,0.33,0,5.00,4,708.94,0,0,5,org.apache.lucene.analysis.TokenFilter,0.27,6,3,6,0,6,3,0,6,155,2
"org.apache.lucene.analysis.stempel.StempelStemmer",4,0.33,1.75,24,0.29,8406.16,6,2,7,18,6,73.39,30,36,3,1,115.68,0.00,0.00,0.25,1,6.00,3,877.89,0,1,3,java.lang.Object,0.00,14,0,7,0,14,3,0,5,188,1
"org.apache.lucene.queryparser.complexPhrase.ComplexPhraseQueryParser",9,0.04,2.00,57,0.68,19203.31,12,3,21,20,17,97.72,51,92,1,3,115.60,0.00,0.67,0.37,1,0.00,3,2030.47,8,7,16,org.apache.lucene.queryparser.classic.QueryParser,0.00,11,2,18,0,11,2,0,28,432,1
"org.apache.lucene.queryparser.complexPhrase.ComplexPhraseQueryParser$ComplexPhraseQuery",7,0.25,5.14,113,1.72,131624.55,11,4,21,32,13,92.28,29,157,0,2,92.05,0.00,0.50,0.46,1,0.00,12,5159.18,0,2,13,org.apache.lucene.search.Query,0.12,25,1,36,0,25,5,0,29,911,1
"org.apache.lucene.queryparser.complexPhrase.TestComplexPhraseQuery",5,0.29,2.00,68,0.89,27674.28,11,6,14,33,13,120.43,18,78,0,2,99.81,0.00,0.50,0.40,2,1.00,4,2657.63,2,0,13,org.apache.lucene.util.LuceneTestCase,0.00,28,1,10,0,28,5,0,18,492,1
"org.apache.lucene.queryparser.complexPhrase.TestComplexPhraseQuery$DocData",1,2.00,1.00,7,0.04,592.22,3,2,14,1,0,117.64,0,9,0,1,117.64,0.00,0.00,0.00,0,1.00,1,121.45,0,0,0,java.lang.Object,0.00,0,0,1,0,0,1,0,0,36,1
"org.apache.lucene.analysis.hu.HungarianAnalyzer",5,0.50,1.20,21,0.26,6053.81,7,2,17,16,15,76.12,42,31,1,3,124.22,0.00,0.67,0.10,0,8.00,2,777.74,0,2,14,org.apache.lucene.analysis.util.StopwordAnalyzerBase,0.00,11,2,6,0,11,3,0,8,177,2
"org.apache.lucene.analysis.hu.HungarianAnalyzer$DefaultSetHolder",0,0.00,0.00,6,0.07,1089.77,1,1,17,0,4,171.00,2,11,0,1,171.00,0.00,0.00,0.00,0,0.00,0,202.05,0,0,4,java.lang.Object,0.00,0,0,0,0,0,0,0,2,47,2
"org.apache.lucene.analysis.hu.HungarianLightStemFilter",2,0.33,2.00,14,0.16,3794.18,5,3,6,9,9,113.74,9,20,3,4,113.50,0.00,0.75,0.50,0,2.00,3,481.98,0,0,6,org.apache.lucene.analysis.TokenFilter,0.29,7,3,4,0,7,2,0,1,107,2
"org.apache.lucene.analysis.hu.HungarianLightStemmer",6,0.00,7.33,65,1.75,137495.05,6,0,1,7,1,148.90,8,155,1,1,98.90,0.00,0.00,0.00,2,6.00,18,5261.27,0,0,0,java.lang.Object,0.00,1,0,44,0,1,6,0,2,935,1
"org.apache.lucene.analysis.hu.TestHungarianAnalyzer",4,0.00,1.00,15,0.16,2494.63,4,0,4,7,4,181.19,7,21,0,3,131.19,0.00,0.67,0.00,0,4.00,1,481.49,3,0,4,org.apache.lucene.analysis.BaseTokenStreamTestCase,0.00,3,2,4,0,3,4,0,6,114,1
"org.apache.lucene.analysis.hu.TestHungarianLightStemFilter",2,0.00,1.00,8,0.06,714.45,2,0,8,5,5,168.32,4,12,0,3,128.44,0.00,0.67,0.00,0,2.00,1,177.62,1,0,5,org.apache.lucene.analysis.BaseTokenStreamTestCase,0.00,3,2,2,0,3,2,0,2,48,1
"org.apache.lucene.analysis.hu.TestHungarianLightStemFilter$Analyzer",1,0.00,1.00,4,0.05,1009.20,1,0,8,4,3,124.89,0,7,0,1,124.89,0.00,0.00,0.00,0,1.00,1,159.62,0,1,3,java.lang.Object,0.00,3,0,1,0,3,0,0,0,38,0
"org.apache.lucene.analysis.hu.TestHungarianLightStemFilter$Analyzer_0",1,0.00,1.00,4,0.05,753.46,1,0,8,4,3,125.89,0,6,0,1,125.89,0.00,0.00,0.00,0,1.00,1,135.44,0,1,3,java.lang.Object,0.00,3,0,1,0,3,0,0,0,34,0
"org.apache.lucene.search.AssertingIndexSearcher",6,1.00,1.17,20,0.23,4440.93,7,1,7,11,8,180.57,6,30,0,2,130.57,0.00,0.50,0.17,0,10.00,2,698.60,2,0,8,org.apache.lucene.search.IndexSearcher,0.05,5,1,7,0,5,6,0,2,172,1
"org.apache.lucene.search.AssertingIndexSearcher$FilteredQuery",1,0.00,1.00,3,0.03,303.26,1,0,7,1,1,133.66,0,5,0,1,133.66,0.00,0.00,0.00,0,0.00,1,87.51,0,0,1,java.lang.Object,0.00,0,0,1,0,0,1,0,0,24,0
"org.apache.lucene.search.AssertingIndexSearcher$Weight",6,0.00,1.33,19,0.23,6908.46,6,0,7,12,6,129.03,2,35,0,1,129.03,0.00,0.00,0.00,0,6.00,3,688.14,0,0,6,java.lang.Object,0.00,6,0,8,0,6,6,0,2,157,0
"org.apache.lucene.search.AutomatonQuery",5,0.17,3.60,45,0.60,25145.02,8,3,9,21,17,73.74,31,65,8,3,105.96,1.00,0.40,0.47,0,5.00,10,1793.11,3,2,9,org.apache.lucene.search.MultiTermQuery,0.12,16,2,18,2,16,3,0,7,377,1
"org.apache.lucene.search.BaseTestRangeFilter",5,0.11,3.20,91,1.29,69605.43,14,9,15,35,11,111.89,15,103,3,2,91.28,3.00,0.20,0.20,1,7.00,9,3869.33,0,2,8,org.apache.lucene.util.LuceneTestCase,0.00,30,1,16,3,30,3,0,8,689,1
"org.apache.lucene.search.BaseTestRangeFilter$TestIndex",1,3.00,2.00,12,0.10,1914.19,5,4,15,2,1,104.74,0,14,0,1,104.74,0.00,0.00,0.25,0,0.00,2,292.42,0,0,1,java.lang.Object,0.00,1,0,2,0,1,1,0,0,69,1
"org.apache.lucene.search.BitsFilteredDocIdSet",3,1.00,1.67,10,0.12,2610.36,4,1,1,6,16,97.71,20,16,13,3,129.94,0.00,0.67,0.33,0,4.00,2,351.79,0,0,3,org.apache.lucene.search.FilteredDocIdSet,0.38,3,2,5,0,3,3,0,3,87,2
"org.apache.lucene.search.BooleanClause",10,0.11,1.30,27,0.28,6503.93,12,2,0,13,56,177.44,24,43,55,1,137.56,0.00,0.00,0.40,1,10.00,3,829.67,0,3,1,java.lang.Object,0.00,3,0,13,0,3,7,0,7,210,1
"org.apache.lucene.search.BooleanClause$Occur",3,0.00,1.00,10,0.05,506.19,3,0,0,3,0,156.28,10,5,0,1,135.66,0.00,0.00,0.00,0,3.00,1,147.66,0,3,0,java.lang.Object,0.00,0,0,3,0,0,0,0,3,45,2
"org.apache.lucene.search.BooleanQuery",19,0.07,2.21,103,1.38,77086.02,23,4,14,49,148,98.46,96,142,137,2,116.33,0.00,0.50,0.18,5,114.00,11,4143.97,2,7,12,org.apache.lucene.search.Query,0.14,30,1,42,0,30,12,1,36,836,1
"org.apache.lucene.search.BooleanQuery$BooleanWeight",10,0.07,4.70,161,2.46,179843.68,15,5,14,55,17,132.11,28,204,0,2,92.22,0.00,0.50,0.26,2,6.00,13,7391.83,0,2,17,org.apache.lucene.search.Weight,0.50,45,1,47,0,45,8,0,28,1257,1
"org.apache.lucene.search.BooleanQuery$TooManyClauses",1,0.00,1.00,3,0.02,128.38,1,0,14,1,0,136.60,0,5,0,2,136.60,0.00,0.50,0.00,0,0.00,1,51.35,0,0,0,java.lang.RuntimeException,0.00,0,1,1,0,0,1,0,0,17,2
"org.apache.lucene.search.BooleanScorer",9,0.02,3.00,99,1.29,87755.33,16,7,7,30,7,82.62,51,120,4,3,100.49,0.00,0.67,0.16,1,19.00,9,3873.05,0,2,3,org.apache.lucene.search.Scorer,0.79,21,2,27,0,21,7,0,20,719,1
"org.apache.lucene.search.BooleanScorer$BooleanScorerCollector",5,0.17,1.20,27,0.29,13004.55,8,3,7,6,3,157.88,11,38,0,2,117.99,0.00,0.50,0.20,0,8.00,2,881.52,0,0,3,org.apache.lucene.search.Collector,0.44,1,1,6,0,1,5,0,11,192,3
"org.apache.lucene.search.BooleanScorer$Bucket",0,0.00,0.00,6,0.04,541.33,5,5,7,0,0,171.00,8,7,0,1,171.00,0.00,0.00,0.00,0,0.00,0,116.00,0,0,0,java.lang.Object,0.00,0,0,0,0,0,0,0,8,29,2
"org.apache.lucene.search.BooleanScorer$BucketScorer",6,0.20,1.00,16,0.11,1491.25,9,3,7,6,2,140.91,0,16,0,3,140.91,0.00,0.67,0.17,0,22.00,1,340.49,0,0,2,org.apache.lucene.search.Scorer,0.94,0,2,6,0,0,6,0,0,96,3
"org.apache.lucene.search.BooleanScorer$BucketTable",3,0.12,1.33,15,0.12,2695.47,7,4,7,5,1,171.60,3,15,0,1,121.60,0.00,0.00,0.17,0,5.00,2,373.73,0,1,1,java.lang.Object,0.00,2,0,4,0,2,2,0,3,92,2
"org.apache.lucene.search.BooleanScorer$SubScorer",1,4.00,2.00,12,0.11,2670.02,5,4,7,2,2,103.84,4,17,0,1,103.60,0.00,0.00,0.00,0,1.00,2,321.36,0,0,2,java.lang.Object,0.00,1,0,2,0,1,1,0,4,75,2
"org.apache.lucene.search.BooleanScorer2",16,0.07,2.06,85,1.22,43512.39,23,7,7,39,8,138.33,61,145,1,3,117.71,0.00,0.67,0.21,3,94.00,5,3671.04,0,1,7,org.apache.lucene.search.Scorer,0.69,23,2,33,0,23,15,0,27,772,0
"org.apache.lucene.search.BooleanScorer2$ConjunctionScorer",1,0.00,3.00,11,0.14,3604.29,3,2,7,2,0,71.67,6,14,0,1,103.89,0.00,0.00,1.00,0,0.00,3,420.66,1,0,0,java.lang.Object,0.00,1,0,3,0,1,1,0,6,90,0
"org.apache.lucene.search.BooleanScorer2$Coordinator",1,1.00,3.00,11,0.12,2915.20,4,3,7,2,0,125.23,3,11,0,1,104.62,0.00,0.00,0.67,0,0.00,3,368.76,0,0,0,java.lang.Object,0.00,1,0,3,0,1,1,0,3,79,1
"org.apache.lucene.search.BooleanScorer2$DisjunctionSumScorer",1,0.00,3.00,11,0.11,3174.77,3,2,7,2,0,144.21,2,14,0,1,104.33,0.00,0.00,1.00,0,0.00,3,334.14,1,0,0,java.lang.Object,0.00,1,0,3,0,1,1,0,2,74,0
"org.apache.lucene.search.BooleanScorer2$SingleMatchScorer",5,0.08,1.40,21,0.19,4166.86,8,3,7,9,1,125.46,2,33,0,3,125.46,0.00,0.67,0.40,1,0.00,3,573.81,0,0,1,org.apache.lucene.search.Scorer,0.80,4,2,7,0,4,5,0,2,141,1
"org.apache.lucene.search.BoostAttribute",2,0.00,1.00,3,0.02,77.91,2,0,3,2,12,126.25,12,4,9,2,158.47,0.00,0.50,0.00,0,2.00,1,46.77,0,0,3,,0.00,0,1,2,0,0,2,0,4,18,1
"org.apache.lucene.search.BoostAttributeImpl",4,0.33,1.00,10,0.08,950.90,5,1,1,5,2,141.06,3,17,0,2,141.06,0.00,0.50,0.75,0,0.00,1,245.34,0,0,2,org.apache.lucene.util.AttributeImpl,0.22,1,1,4,0,1,4,1,1,68,2
"org.apache.lucene.search.CachingCollector",10,0.08,1.70,57,0.74,22173.24,22,12,5,21,10,70.35,82,77,7,2,118.46,2.00,0.25,0.16,2,38.00,4,2226.47,0,3,3,org.apache.lucene.search.Collector,0.14,11,1,17,2,11,7,0,16,463,2
"org.apache.lucene.search.CachingCollector$CachedScorer",6,0.40,1.00,15,0.11,1512.70,8,2,5,7,1,140.86,4,15,0,3,140.86,0.00,0.67,0.17,0,14.00,1,326.33,0,0,1,org.apache.lucene.search.Scorer,0.94,1,2,6,0,1,6,0,4,93,3
"org.apache.lucene.search.CachingCollector$Collector",4,0.00,1.00,6,0.06,512.27,4,0,5,4,2,154.40,0,11,0,1,154.40,0.00,0.00,0.00,0,4.00,1,169.08,0,0,2,java.lang.Object,0.00,0,0,4,0,0,4,0,0,51,0
"org.apache.lucene.search.CachingCollector$NoScoreCachingCollector",6,0.00,2.50,51,0.51,30063.00,6,0,5,10,3,107.97,5,69,0,3,107.97,0.00,0.67,0.00,0,10.00,6,1523.80,2,1,3,org.apache.lucene.search.CachingCollector,0.15,4,2,15,0,4,5,0,5,309,3
"org.apache.lucene.search.CachingCollector$ScoreCachingCollector",6,0.40,2.50,78,0.86,55598.24,10,4,5,15,3,98.00,5,96,0,3,98.00,0.00,0.67,0.58,0,0.00,6,2581.06,2,1,3,org.apache.lucene.search.CachingCollector,0.00,9,2,15,0,9,5,0,5,500,3
"org.apache.lucene.search.CachingCollector$SegStart",1,2.00,1.00,6,0.04,607.65,3,2,5,1,1,120.05,0,8,0,1,120.05,0.00,0.00,0.00,0,1.00,1,132.64,0,0,1,java.lang.Object,0.00,0,0,1,0,0,1,0,0,37,2
"org.apache.lucene.search.CachingWrapperFilter",7,0.07,2.14,55,0.63,25319.85,12,5,9,23,20,79.06,43,72,11,2,111.28,0.00,0.50,0.26,1,10.00,4,1900.50,0,3,9,org.apache.lucene.search.Filter,0.00,16,1,15,0,16,4,0,15,388,1
"org.apache.lucene.search.CheckHits",12,0.45,3.83,177,3.16,238328.61,14,2,10,52,25,44.09,112,234,16,1,94.09,0.00,0.00,0.08,4,22.00,15,9469.25,0,2,10,java.lang.Object,0.00,40,0,46,0,40,10,0,24,1648,1
"org.apache.lucene.search.CheckHits$ExplanationAsserter",6,0.03,1.17,29,0.37,8747.87,12,6,10,15,6,123.59,1,45,0,2,123.59,0.00,0.50,0.19,0,10.00,2,1103.86,0,0,6,org.apache.lucene.search.Collector,0.60,9,1,7,0,9,6,0,1,238,2
"org.apache.lucene.search.CheckHits$ExplanationAssertingSearcher",6,0.00,1.00,17,0.21,3347.02,6,0,10,7,7,138.14,0,34,0,2,138.14,0.00,0.50,0.00,1,6.00,1,638.61,1,0,7,org.apache.lucene.search.IndexSearcher,0.00,1,1,6,0,1,6,0,0,155,2
"org.apache.lucene.search.CheckHits$SetCollector",5,0.25,1.00,12,0.13,1734.76,7,2,10,7,3,139.77,0,21,0,2,139.77,0.00,0.50,0.30,0,7.00,1,377.86,0,0,3,org.apache.lucene.search.Collector,0.67,2,1,5,0,2,5,0,0,98,2
"org.apache.lucene.search.CollectionStatistics",6,0.04,1.00,26,0.20,8862.98,11,5,2,6,20,105.71,34,33,18,1,123.58,0.00,0.00,0.17,0,26.00,1,608.32,0,1,2,java.lang.Object,0.00,0,0,6,0,0,5,0,10,154,1
"org.apache.lucene.search.Collector",4,0.00,1.00,5,0.04,303.38,4,0,3,4,84,163.46,141,6,82,1,156.20,0.00,0.00,0.00,0,4.00,1,126.78,0,0,3,java.lang.Object,0.00,0,0,4,91,0,4,0,5,41,2
"org.apache.lucene.search.ComplexExplanation",6,1.00,1.50,17,0.18,3030.30,7,1,0,8,21,106.17,37,25,20,2,138.39,0.00,0.50,0.17,2,10.00,3,525.10,3,2,1,org.apache.lucene.search.Explanation,0.21,2,1,9,0,2,4,0,7,131,1
"org.apache.lucene.search.ConjunctionScorer",7,0.11,2.57,62,0.72,36886.88,10,3,4,15,4,128.40,25,73,1,3,107.79,0.00,0.67,0.43,1,0.00,5,2145.81,0,0,3,org.apache.lucene.search.Scorer,0.71,8,2,18,0,8,7,0,25,441,0
"org.apache.lucene.search.ConjunctionScorer$Comparator<Scorer>",1,0.00,1.00,3,0.03,480.85,1,0,4,2,1,182.08,1,4,0,1,132.08,0.00,0.00,0.00,0,1.00,1,93.66,0,0,1,java.lang.Object,0.00,1,0,1,0,1,1,0,1,27,0
"org.apache.lucene.search.ConjunctionTermScorer",6,0.20,1.83,43,0.46,20584.53,10,4,5,12,7,161.50,7,56,2,3,111.50,0.50,0.50,0.42,0,0.00,5,1390.98,0,0,5,org.apache.lucene.search.Scorer,0.75,6,2,11,1,6,6,0,7,301,0
"org.apache.lucene.search.ConjunctionTermScorer$Comparator<DocsAndFreqs>",1,0.00,1.00,3,0.03,437.67,1,0,5,1,0,132.40,0,4,0,1,132.40,0.00,0.00,0.00,0,1.00,1,86.26,0,0,0,java.lang.Object,0.00,0,0,1,0,0,1,0,0,25,0
"org.apache.lucene.search.ConjunctionTermScorer$DocsAndFreqs",1,5.00,1.00,11,0.09,1326.69,6,5,5,1,1,107.56,0,13,0,1,107.56,0.00,0.00,0.00,0,1.00,1,264.06,0,0,1,java.lang.Object,0.00,0,0,1,0,0,1,0,0,67,2
"org.apache.lucene.search.ConstantScoreAutoRewrite",9,0.03,1.89,55,0.77,32698.59,13,4,12,28,18,153.68,24,73,3,3,113.79,0.50,0.50,0.28,2,0.00,6,2300.92,1,1,16,org.apache.lucene.search.TermCollectingRewrite,0.23,19,2,17,1,19,8,0,18,447,0
"org.apache.lucene.search.ConstantScoreAutoRewrite$CutOffTermCollector",3,0.21,1.67,26,0.38,16632.91,10,7,12,14,6,107.71,0,35,0,2,107.71,0.00,0.50,0.29,0,4.00,3,1132.62,0,0,6,org.apache.lucene.search.TermCollector,0.00,11,1,5,0,11,3,0,0,221,2
"org.apache.lucene.search.ConstantScoreAutoRewrite$TermStateByteStart",4,0.33,1.25,20,0.25,9430.67,5,1,12,6,3,118.32,0,29,0,2,118.32,0.00,0.50,0.75,0,0.00,2,739.03,3,0,3,org.apache.lucene.util.DirectBytesStartArray,0.00,2,1,5,0,2,4,0,0,164,2
"org.apache.lucene.search.ConstantScoreQuery",10,0.11,2.20,40,0.56,21122.99,12,2,7,23,32,172.18,19,70,23,2,122.18,2.00,0.25,0.40,1,10.00,6,1670.78,3,5,9,org.apache.lucene.search.Query,0.10,13,1,22,2,13,5,0,9,377,1
"org.apache.lucene.search.ConstantScoreQuery$ConstantScorer",8,0.14,1.25,27,0.27,5842.12,10,2,7,13,4,130.60,2,45,0,3,130.60,0.00,0.67,0.38,1,4.00,2,805.50,1,1,4,org.apache.lucene.search.Scorer,0.67,5,2,10,0,5,7,0,2,200,1
"org.apache.lucene.search.ConstantScoreQuery$ConstantScorer$Collector",4,0.00,1.00,9,0.11,1765.65,4,0,7,9,2,138.94,1,17,0,1,138.94,0.00,0.00,0.00,0,4.00,1,325.18,0,0,2,java.lang.Object,0.00,5,0,4,0,5,4,0,1,85,0
"org.apache.lucene.search.ConstantScoreQuery$ConstantWeight",7,0.11,2.14,47,0.66,26476.35,10,3,7,24,11,113.62,2,66,0,2,113.62,0.00,0.50,0.43,1,0.00,4,1977.73,0,3,11,org.apache.lucene.search.Weight,0.62,17,1,15,0,17,4,0,2,391,1
"org.apache.lucene.search.DisjunctionMaxQuery",12,0.23,2.17,74,0.96,50433.20,14,2,9,32,21,95.39,61,100,14,2,113.26,0.00,0.50,0.29,3,22.00,8,2894.76,2,5,7,org.apache.lucene.search.Query,0.18,20,1,26,0,20,7,1,18,599,1
"org.apache.lucene.search.DisjunctionMaxQuery$DisjunctionMaxWeight",6,0.60,2.67,48,0.68,31097.19,7,1,9,27,11,157.84,11,62,0,2,107.84,0.00,0.50,0.50,0,2.00,5,2051.13,0,3,11,org.apache.lucene.search.Weight,0.50,21,1,16,0,21,3,0,11,396,1
"org.apache.lucene.search.DisjunctionMaxScorer",9,0.21,2.78,92,1.00,57566.71,15,6,1,14,3,124.11,35,117,1,3,103.49,0.00,0.67,0.35,4,0.00,6,3004.03,0,0,2,org.apache.lucene.search.Scorer,0.63,5,2,25,0,5,9,0,13,623,0
"org.apache.lucene.search.DisjunctionSumScorer",11,0.11,2.73,79,0.81,31306.90,18,7,3,23,5,69.75,87,110,1,3,112.04,0.00,0.67,0.25,2,5.00,7,2436.60,0,1,4,org.apache.lucene.search.Scorer,0.57,12,2,30,0,12,10,0,21,511,0
"org.apache.lucene.search.DocIdSet",0,0.00,0.00,3,0.02,467.02,0,0,2,1,86,171.00,5,2,85,1,171.00,0.00,0.00,0.00,0,0.00,0,51.89,0,0,1,java.lang.Object,0.00,1,0,0,11,1,0,0,2,15,2
"org.apache.lucene.search.DocIdSet$DocIdSet",6,0.00,1.00,14,0.09,990.31,6,0,2,7,2,142.54,25,25,0,1,142.31,0.00,0.00,0.00,0,6.00,1,255.71,0,4,2,java.lang.Object,0.00,1,0,6,0,1,2,0,4,78,0
"org.apache.lucene.search.DocIdSet$DocIdSet$DocIdSetIterator",3,0.00,1.00,7,0.05,603.80,3,0,2,3,0,141.63,0,7,0,1,141.63,0.00,0.00,0.00,0,3.00,1,146.65,0,0,0,java.lang.Object,0.00,0,0,3,0,0,3,0,0,43,0
"org.apache.lucene.search.DocIdSetIterator",3,1.00,1.00,5,0.04,464.21,4,1,1,3,142,197.70,66,6,142,1,153.76,0.00,0.00,0.00,0,3.00,1,132.13,0,0,0,java.lang.Object,0.00,0,0,3,79,0,3,0,5,40,2
"org.apache.lucene.search.ElevationComparatorSource",2,1.00,1.00,6,0.08,1228.49,3,1,12,3,9,131.24,0,10,2,2,131.24,0.00,0.50,0.00,0,2.00,1,236.60,0,1,7,org.apache.lucene.search.FieldComparatorSource,0.00,1,1,2,0,1,1,0,0,57,0
"org.apache.lucene.search.ElevationComparatorSource$FieldComparator<Integer>",7,0.08,1.29,26,0.33,7577.29,11,4,12,14,3,129.25,1,40,0,1,129.25,0.00,0.00,0.32,1,10.00,3,1003.49,0,2,3,java.lang.Object,0.00,7,0,9,0,7,5,0,1,229,0
"org.apache.lucene.search.ExactPhraseScorer",8,0.19,5.62,158,1.97,305074.79,18,10,4,17,6,107.44,26,206,2,3,86.83,0.00,0.67,0.26,0,0.00,18,5904.51,0,1,4,org.apache.lucene.search.Scorer,0.83,9,2,45,0,9,7,0,26,1070,1
"org.apache.lucene.search.ExactPhraseScorer$ChunkState",1,7.00,1.00,12,0.09,1258.33,8,7,4,1,1,106.33,0,14,0,1,106.33,0.00,0.00,0.00,0,1.00,1,257.84,0,0,1,java.lang.Object,0.00,0,0,1,0,0,1,0,0,65,3
"org.apache.lucene.search.Explanation",13,0.25,1.54,61,0.54,19145.61,16,3,1,21,91,173.49,24,67,91,1,123.49,0.00,0.00,0.10,4,53.00,4,1611.15,0,6,0,java.lang.Object,0.00,8,0,20,1,8,7,0,14,369,1
"org.apache.lucene.search.FieldCache",23,1.00,1.00,57,0.71,15653.79,24,1,16,30,83,99.90,291,75,70,1,137.46,0.00,0.00,0.00,0,23.00,1,2123.74,0,8,14,,0.00,7,0,23,0,7,15,0,46,489,1
"org.apache.lucene.search.FieldCache$ByteParser",1,0.00,1.00,2,0.01,60.50,1,0,16,1,1,195.74,1,3,0,2,145.74,0.00,0.50,0.00,0,1.00,1,35.16,0,0,1,,0.00,0,1,1,0,0,1,0,1,13,1
"org.apache.lucene.search.FieldCache$ByteParser_0",3,0.00,1.00,7,0.05,684.98,3,0,16,6,2,191.20,4,11,0,1,141.20,0.00,0.00,0.00,0,3.00,1,163.27,0,2,2,java.lang.Object,0.00,3,0,3,0,3,1,0,4,47,0
"org.apache.lucene.search.FieldCache$CacheEntry",9,1.00,1.11,25,0.32,8785.34,10,1,16,18,1,136.20,8,32,0,1,136.20,0.00,0.00,0.11,7,16.00,2,956.93,0,7,1,java.lang.Object,0.00,9,0,10,0,9,2,0,2,217,3
"org.apache.lucene.search.FieldCache$CreationPlaceholder",0,0.00,0.00,2,0.01,104.61,1,1,16,0,0,171.00,0,3,0,1,171.00,0.00,0.00,0.00,0,0.00,0,34.87,0,0,0,java.lang.Object,0.00,0,0,0,0,0,0,0,0,11,3
"org.apache.lucene.search.FieldCache$DocTerms",3,0.00,1.00,4,0.03,193.87,3,0,16,3,1,196.63,7,5,0,1,156.74,0.00,0.00,0.00,0,3.00,1,86.72,0,1,1,java.lang.Object,0.00,0,0,3,0,0,2,0,3,30,3
"org.apache.lucene.search.FieldCache$DocTermsIndex",8,0.00,1.50,18,0.22,11225.39,8,0,16,9,2,174.78,17,28,0,1,134.89,0.00,0.00,0.00,3,8.00,5,666.84,0,4,2,java.lang.Object,0.00,1,0,12,0,1,4,0,10,161,3
"org.apache.lucene.search.FieldCache$DoubleParser",1,0.00,1.00,2,0.01,60.50,1,0,16,1,1,195.74,1,3,0,2,145.74,0.00,0.50,0.00,0,1.00,1,35.16,0,0,1,,0.00,0,1,1,0,0,1,0,1,13,1
"org.apache.lucene.search.FieldCache$DoubleParser_5",3,0.00,1.00,7,0.05,684.98,3,0,16,6,2,191.20,4,11,0,1,141.20,0.00,0.00,0.00,0,3.00,1,163.27,0,2,2,java.lang.Object,0.00,3,0,3,0,3,1,0,4,47,0
"org.apache.lucene.search.FieldCache$DoubleParser_9",3,0.00,1.33,8,0.08,1459.42,3,0,16,8,3,138.54,0,13,0,1,138.54,0.00,0.00,0.00,0,3.00,2,251.66,0,2,3,java.lang.Object,0.00,5,0,4,0,5,1,0,0,64,0
"org.apache.lucene.search.FieldCache$FloatParser",1,0.00,1.00,2,0.01,60.50,1,0,16,1,1,195.74,1,3,0,2,145.74,0.00,0.50,0.00,0,1.00,1,35.16,0,0,1,,0.00,0,1,1,0,0,1,0,1,13,1
"org.apache.lucene.search.FieldCache$FloatParser_3",3,0.00,1.00,7,0.05,684.98,3,0,16,6,2,191.20,4,11,0,1,141.20,0.00,0.00,0.00,0,3.00,1,163.27,0,2,2,java.lang.Object,0.00,3,0,3,0,3,1,0,4,47,0
"org.apache.lucene.search.FieldCache$FloatParser_7",3,0.00,1.33,8,0.08,1459.42,3,0,16,8,3,138.54,0,13,0,1,138.54,0.00,0.00,0.00,0,3.00,2,251.66,0,2,3,java.lang.Object,0.00,5,0,4,0,5,1,0,0,64,0
"org.apache.lucene.search.FieldCache$IntParser",1,0.00,1.00,2,0.01,60.50,1,0,16,1,1,195.74,1,3,0,2,145.74,0.00,0.50,0.00,0,1.00,1,35.16,0,0,1,,0.00,0,1,1,0,0,1,0,1,13,1
"org.apache.lucene.search.FieldCache$IntParser_2",3,0.00,1.00,7,0.05,684.98,3,0,16,6,2,191.20,4,11,0,1,141.20,0.00,0.00,0.00,0,3.00,1,163.27,0,2,2,java.lang.Object,0.00,3,0,3,0,3,1,0,4,47,0
"org.apache.lucene.search.FieldCache$IntParser_6",3,0.00,1.33,8,0.08,1283.98,3,0,16,7,3,138.98,0,13,0,1,138.98,0.00,0.00,0.00,0,3.00,2,231.98,0,2,3,java.lang.Object,0.00,4,0,4,0,4,1,0,0,60,0
"org.apache.lucene.search.FieldCache$LongParser",1,0.00,1.00,2,0.01,60.50,1,0,16,1,1,195.74,1,3,0,2,145.74,0.00,0.50,0.00,0,1.00,1,35.16,0,0,1,,0.00,0,1,1,0,0,1,0,1,13,1
"org.apache.lucene.search.FieldCache$LongParser_4",3,0.00,1.00,7,0.05,684.98,3,0,16,6,2,191.20,4,11,0,1,141.20,0.00,0.00,0.00,0,3.00,1,163.27,0,2,2,java.lang.Object,0.00,3,0,3,0,3,1,0,4,47,0
"org.apache.lucene.search.FieldCache$LongParser_8",3,0.00,1.33,8,0.08,1283.98,3,0,16,7,3,138.98,0,13,0,1,138.98,0.00,0.00,0.00,0,3.00,2,231.98,0,2,3,java.lang.Object,0.00,4,0,4,0,4,1,0,0,60,0
"org.apache.lucene.search.FieldCache$Parser",0,0.00,0.00,1,0.00,12.00,0,0,16,0,0,171.00,0,2,0,1,171.00,0.00,0.00,0.00,0,0.00,0,8.00,0,0,0,,0.00,0,0,0,0,0,0,0,0,4,1
"org.apache.lucene.search.FieldCache$ShortParser",1,0.00,1.00,2,0.01,60.50,1,0,16,1,1,195.74,1,3,0,2,145.74,0.00,0.50,0.00,0,1.00,1,35.16,0,0,1,,0.00,0,1,1,0,0,1,0,1,13,1
"org.apache.lucene.search.FieldCache$ShortParser_1",3,0.00,1.00,7,0.05,684.98,3,0,16,6,2,191.20,4,11,0,1,141.20,0.00,0.00,0.00,0,3.00,1,163.27,0,2,2,java.lang.Object,0.00,3,0,3,0,3,1,0,4,47,0
"org.apache.lucene.search.FieldCache$StopFillCacheException",0,0.00,0.00,1,0.01,72.00,0,0,16,0,0,171.00,0,2,0,2,171.00,0.00,0.50,0.00,0,0.00,0,24.00,0,0,0,java.lang.RuntimeException,0.00,0,1,0,0,0,0,0,0,8,3
"org.apache.lucene.search.FieldCacheDocIdSet",5,0.38,1.40,19,0.14,2725.06,7,2,4,9,17,131.81,20,27,11,2,131.58,0.00,0.50,0.20,0,7.00,3,434.09,0,2,6,org.apache.lucene.search.DocIdSet,0.00,4,1,7,0,4,3,0,7,112,2
"org.apache.lucene.search.FieldCacheDocIdSet$Bits",2,0.00,1.00,5,0.02,191.59,2,0,4,3,0,144.17,0,7,0,1,144.17,0.00,0.00,0.00,0,2.00,1,71.86,0,0,0,java.lang.Object,0.00,1,0,2,0,1,2,0,0,24,0
"org.apache.lucene.search.FieldCacheDocIdSet$Bits_0",2,0.00,1.00,5,0.03,421.69,2,0,4,3,0,141.47,0,7,0,1,141.47,0.00,0.00,0.00,0,2.00,1,98.61,0,0,0,java.lang.Object,0.00,1,0,2,0,1,2,0,0,30,0
"org.apache.lucene.search.FieldCacheDocIdSet$DocIdSetIterator",3,0.00,2.00,19,0.13,3648.63,4,1,4,4,0,117.52,0,25,0,1,117.52,0.00,0.00,1.00,0,0.00,3,382.17,0,0,0,java.lang.Object,0.00,1,0,6,0,1,3,0,0,94,0
"org.apache.lucene.search.FieldCacheDocIdSet$DocIdSetIterator_1",3,0.00,2.00,19,0.15,5034.36,4,1,4,4,0,116.42,0,25,0,1,116.42,0.00,0.00,1.00,0,0.00,3,460.55,0,0,0,java.lang.Object,0.00,1,0,6,0,1,3,0,0,107,0
"org.apache.lucene.search.FieldCacheDocIdSet$FilteredDocIdSetIterator",1,0.00,1.00,3,0.04,390.76,1,0,4,2,1,132.79,0,5,0,1,132.79,0.00,0.00,0.00,0,1.00,1,107.23,0,0,1,java.lang.Object,0.00,1,0,1,0,1,1,0,0,30,0
"org.apache.lucene.search.FieldCacheImpl",20,0.58,1.65,105,1.71,62273.91,21,1,26,58,32,167.30,31,143,14,1,117.30,0.00,0.00,0.45,7,38.00,7,5128.79,0,1,19,java.lang.Object,0.00,38,0,33,0,38,19,1,22,1040,0
"org.apache.lucene.search.FieldCacheImpl$ByteCache",2,0.00,7.00,40,0.55,39736.22,2,0,26,15,8,138.17,2,58,0,2,88.17,0.00,0.50,0.00,0,2.00,13,1651.91,0,1,8,org.apache.lucene.search.Cache,0.00,13,1,14,0,13,1,0,2,277,2
"org.apache.lucene.search.FieldCacheImpl$Cache",6,0.00,2.83,67,0.82,51596.15,8,2,26,24,3,150.93,11,84,0,1,100.93,0.00,0.00,0.50,1,2.00,7,2462.54,0,2,3,java.lang.Object,0.00,18,0,17,0,18,4,0,10,479,2
"org.apache.lucene.search.FieldCacheImpl$CacheEntryImpl",6,0.04,1.17,22,0.19,3897.61,11,5,26,6,0,131.02,4,27,0,2,131.02,0.00,0.50,0.17,0,26.00,2,566.99,0,5,0,org.apache.lucene.search.CacheEntry,0.00,0,1,7,0,0,1,0,4,145,3
"org.apache.lucene.search.FieldCacheImpl$DocTermsIndexImpl",14,0.05,1.00,43,0.54,9644.83,20,6,26,21,4,130.85,2,65,0,2,130.85,0.00,0.50,0.12,2,126.00,1,1630.70,0,5,4,org.apache.lucene.search.DocTermsIndex,0.00,7,1,14,0,7,9,0,2,384,2
"org.apache.lucene.search.FieldCacheImpl$DocTermsIndexImpl$DocTermOrdsCache",2,0.00,1.00,5,0.05,721.19,2,0,26,3,3,139.63,1,10,0,2,139.63,0.00,0.50,0.00,0,2.00,1,157.53,0,1,3,org.apache.lucene.search.Cache,0.00,1,1,2,0,1,1,0,1,42,2
"org.apache.lucene.search.FieldCacheImpl$DocTermsIndexImpl$DocTermsCache",2,0.00,6.00,42,0.59,41627.30,2,0,26,19,9,69.39,10,58,0,2,87.26,0.00,0.50,0.00,0,2.00,11,1778.50,0,1,9,org.apache.lucene.search.Cache,0.00,17,1,12,0,17,1,0,10,290,2
"org.apache.lucene.search.FieldCacheImpl$DocTermsIndexImpl$DocTermsImpl",4,0.00,1.00,13,0.15,2558.25,6,2,26,7,1,131.11,0,21,0,2,131.11,0.00,0.50,0.50,0,0.00,1,441.40,0,1,1,org.apache.lucene.search.DocTerms,0.00,3,1,4,0,3,3,0,0,112,2
"org.apache.lucene.search.FieldCacheImpl$DocTermsIndexImpl$DocTermsIndexCache",2,0.00,7.50,61,0.86,87051.36,2,0,26,22,10,46.69,12,80,0,2,78.91,0.00,0.50,0.00,0,2.00,14,2594.42,0,1,10,org.apache.lucene.search.Cache,0.00,20,1,15,0,20,1,0,12,408,1
"org.apache.lucene.search.FieldCacheImpl$DocTermsIndexImpl$DocTermsIndexEnum",13,0.11,1.62,72,0.88,39738.65,19,6,26,18,7,117.37,6,107,0,2,117.37,0.00,0.50,0.27,1,22.00,5,2639.74,0,7,7,org.apache.lucene.index.TermsEnum,0.46,5,1,21,0,5,6,0,6,553,0
"org.apache.lucene.search.FieldCacheImpl$DocsWithFieldCache",2,0.00,5.50,34,0.44,27635.68,2,0,26,14,7,131.99,5,48,0,2,92.10,0.00,0.50,0.00,0,2.00,10,1311.80,0,1,7,org.apache.lucene.search.Cache,0.00,12,1,11,0,12,1,0,5,231,2
"org.apache.lucene.search.FieldCacheImpl$DoubleCache",2,0.00,8.50,46,0.64,50412.65,2,0,26,15,8,124.94,4,68,0,2,85.05,0.00,0.50,0.00,0,2.00,16,1922.60,0,1,8,org.apache.lucene.search.Cache,0.00,13,1,17,0,13,1,0,4,318,2
"org.apache.lucene.search.FieldCacheImpl$Entry",3,0.25,3.00,17,0.17,5591.07,5,2,26,7,0,168.92,5,26,0,1,118.92,0.00,0.00,0.67,0,1.00,6,523.26,0,0,0,java.lang.Object,0.00,4,0,9,0,4,3,0,5,125,1
"org.apache.lucene.search.FieldCacheImpl$FloatCache",2,0.00,8.50,46,0.63,49792.74,2,0,26,15,7,124.98,4,68,0,2,85.09,0.00,0.50,0.00,0,2.00,16,1891.93,0,1,7,org.apache.lucene.search.Cache,0.00,13,1,17,0,13,1,0,4,314,2
"org.apache.lucene.search.FieldCacheImpl$IndexReader.ReaderClosedListener",1,0.00,1.00,4,0.04,621.43,1,0,26,2,3,126.54,0,6,0,1,126.54,0.00,0.00,0.00,0,1.00,1,117.70,0,0,3,java.lang.Object,0.00,1,0,1,0,1,1,0,0,31,0
"org.apache.lucene.search.FieldCacheImpl$IntCache",2,0.00,8.50,46,0.63,50588.21,2,0,26,15,7,124.93,4,68,0,2,85.04,0.00,0.50,0.00,0,2.00,16,1886.10,0,1,7,org.apache.lucene.search.Cache,0.00,13,1,17,0,13,1,0,4,314,2
"org.apache.lucene.search.FieldCacheImpl$LongCache",2,0.00,8.50,46,0.64,50412.65,2,0,26,15,8,124.94,4,68,0,2,85.05,0.00,0.50,0.00,0,2.00,16,1922.60,0,1,8,org.apache.lucene.search.Cache,0.00,13,1,17,0,13,1,0,4,318,2
"org.apache.lucene.search.FieldCacheImpl$SegmentReader.CoreClosedListener",1,0.00,1.00,3,0.03,288.02,1,0,26,2,2,133.83,0,5,0,1,133.83,0.00,0.00,0.00,0,1.00,1,84.04,0,0,2,java.lang.Object,0.00,1,0,1,0,1,1,0,0,24,0
"org.apache.lucene.search.FieldCacheImpl$ShortCache",2,0.00,7.00,40,0.55,39736.22,2,0,26,15,8,138.17,2,58,0,2,88.17,0.00,0.50,0.00,0,2.00,13,1651.91,0,1,8,org.apache.lucene.search.Cache,0.00,13,1,14,0,13,1,0,2,277,2
"org.apache.lucene.search.FieldCacheImpl$StopFillCacheException",0,0.00,0.00,1,0.01,49.13,0,0,26,0,0,171.00,0,2,0,2,171.00,0.00,0.50,0.00,0,0.00,0,19.65,0,0,0,java.lang.RuntimeException,0.00,0,1,0,0,0,0,0,0,7,2
"org.apache.lucene.search.FieldCacheRangeFilter",24,0.05,1.75,76,1.27,51081.04,30,6,10,39,14,127.10,103,98,3,2,126.87,0.00,0.50,0.12,7,152.00,10,3804.92,0,17,11,org.apache.lucene.search.Filter,0.00,15,1,42,0,15,7,0,22,835,2
"org.apache.lucene.search.FieldCacheRangeFilter$FieldCacheRangeFilter<Byte>",1,0.00,8.00,18,0.32,21999.63,1,0,10,4,5,89.50,0,25,0,1,89.50,0.00,0.00,0.00,0,0.00,8,957.38,0,1,5,java.lang.Object,0.00,3,0,8,0,3,0,0,0,171,0
"org.apache.lucene.search.FieldCacheRangeFilter$FieldCacheRangeFilter<Byte>$FieldCacheDocIdSet_0",1,0.00,1.00,3,0.04,795.39,1,0,10,1,0,130.36,0,5,0,1,130.36,0.00,0.00,0.00,0,1.00,1,133.95,0,0,0,java.lang.Object,0.00,0,0,1,0,0,1,0,0,35,0
"org.apache.lucene.search.FieldCacheRangeFilter$FieldCacheRangeFilter<Double>",1,0.00,8.00,20,0.38,26590.21,1,0,10,7,6,107.76,3,27,0,1,87.15,0.00,0.00,0.00,0,0.00,8,1139.36,0,1,6,java.lang.Object,0.00,6,0,8,0,6,0,0,3,197,0
"org.apache.lucene.search.FieldCacheRangeFilter$FieldCacheRangeFilter<Double>$FieldCacheDocIdSet_5",1,0.00,1.00,3,0.04,795.39,1,0,10,1,0,130.36,0,5,0,1,130.36,0.00,0.00,0.00,0,1.00,1,133.95,0,0,0,java.lang.Object,0.00,0,0,1,0,0,1,0,0,35,0
"org.apache.lucene.search.FieldCacheRangeFilter$FieldCacheRangeFilter<Float>",1,0.00,8.00,20,0.38,26590.21,1,0,10,7,6,127.03,2,27,0,1,87.15,0.00,0.00,0.00,0,0.00,8,1139.36,0,1,6,java.lang.Object,0.00,6,0,8,0,6,0,0,2,197,0
"org.apache.lucene.search.FieldCacheRangeFilter$FieldCacheRangeFilter<Float>$FieldCacheDocIdSet_4",1,0.00,1.00,3,0.04,795.39,1,0,10,1,0,130.36,0,5,0,1,130.36,0.00,0.00,0.00,0,1.00,1,133.95,0,0,0,java.lang.Object,0.00,0,0,1,0,0,1,0,0,35,0
"org.apache.lucene.search.FieldCacheRangeFilter$FieldCacheRangeFilter<Integer>",1,0.00,8.00,18,0.30,20298.34,1,0,10,4,5,89.78,0,25,0,1,89.78,0.00,0.00,0.00,0,0.00,8,911.34,0,1,5,java.lang.Object,0.00,3,0,8,0,3,0,0,0,163,0
"org.apache.lucene.search.FieldCacheRangeFilter$FieldCacheRangeFilter<Integer>$FieldCacheDocIdSet_2",1,0.00,1.00,3,0.04,795.39,1,0,10,1,0,130.36,0,5,0,1,130.36,0.00,0.00,0.00,0,1.00,1,133.95,0,0,0,java.lang.Object,0.00,0,0,1,0,0,1,0,0,35,0
"org.apache.lucene.search.FieldCacheRangeFilter$FieldCacheRangeFilter<Long>",1,0.00,8.00,18,0.30,20298.34,1,0,10,4,5,89.78,0,25,0,1,89.78,0.00,0.00,0.00,0,0.00,8,911.34,0,1,5,java.lang.Object,0.00,3,0,8,0,3,0,0,0,163,0
"org.apache.lucene.search.FieldCacheRangeFilter$FieldCacheRangeFilter<Long>$FieldCacheDocIdSet_3",1,0.00,1.00,3,0.04,795.39,1,0,10,1,0,130.36,0,5,0,1,130.36,0.00,0.00,0.00,0,1.00,1,133.95,0,0,0,java.lang.Object,0.00,0,0,1,0,0,1,0,0,35,0
"org.apache.lucene.search.FieldCacheRangeFilter$FieldCacheRangeFilter<Short>",1,0.00,8.00,18,0.32,21722.67,1,0,10,4,5,89.55,0,25,0,1,89.55,0.00,0.00,0.00,0,0.00,8,945.87,0,1,5,java.lang.Object,0.00,3,0,8,0,3,0,0,0,169,0
"org.apache.lucene.search.FieldCacheRangeFilter$FieldCacheRangeFilter<Short>$FieldCacheDocIdSet_1",1,0.00,1.00,3,0.04,795.39,1,0,10,1,0,130.36,0,5,0,1,130.36,0.00,0.00,0.00,0,1.00,1,133.95,0,0,0,java.lang.Object,0.00,0,0,1,0,0,1,0,0,35,0
"org.apache.lucene.search.FieldCacheRangeFilter$FieldCacheRangeFilter<String>",1,0.00,10.00,28,0.44,39267.29,1,0,10,7,5,80.55,4,33,0,1,80.31,0.00,0.00,0.00,0,0.00,10,1324.64,0,1,5,java.lang.Object,0.00,6,0,10,0,6,0,0,4,230,0
"org.apache.lucene.search.FieldCacheRangeFilter$FieldCacheRangeFilter<String>$FieldCacheDocIdSet",1,0.00,1.00,4,0.06,1280.12,1,0,10,2,0,124.07,0,6,0,1,124.07,0.00,0.00,0.00,0,1.00,1,171.82,0,0,0,java.lang.Object,0.00,1,0,1,0,1,1,0,0,42,0
"org.apache.lucene.search.FieldCacheRewriteMethod",1,0.00,1.00,6,0.07,1225.90,1,0,9,5,11,69.18,10,9,1,2,117.65,0.00,0.50,0.00,0,1.00,1,207.51,0,1,10,MultiTermQuery.RewriteMethod,0.00,4,1,1,0,4,0,0,1,50,2
"org.apache.lucene.search.FieldCacheRewriteMethod$MultiTermQueryFieldCacheWrapperFilter",6,0.20,1.83,30,0.36,12549.91,7,1,9,21,8,168.64,11,42,0,2,118.64,0.00,0.50,0.83,1,0.00,4,1092.00,0,3,8,org.apache.lucene.search.Filter,0.00,15,1,11,0,15,3,0,6,233,1
"org.apache.lucene.search.FieldCacheRewriteMethod$MultiTermQueryFieldCacheWrapperFilter$FieldCacheDocIdSet",1,0.00,1.00,3,0.05,626.61,1,0,9,3,0,131.18,0,5,0,1,131.18,0.00,0.00,0.00,0,1.00,1,139.99,0,0,0,java.lang.Object,0.00,2,0,1,0,2,1,0,0,36,0
"org.apache.lucene.search.FieldCacheRewriteMethod$MultiTermQueryFieldCacheWrapperFilter$Terms",6,0.00,1.00,13,0.12,1807.96,6,0,9,8,2,140.25,0,25,0,1,140.25,0.00,0.00,0.00,0,6.00,1,351.26,0,2,2,java.lang.Object,0.00,2,0,6,0,2,4,0,0,95,0
"org.apache.lucene.search.FieldCacheTermsFilter",4,0.33,1.75,28,0.31,11424.29,6,2,7,12,11,121.27,69,30,2,2,112.13,1.00,0.33,0.25,1,6.00,3,923.87,0,1,9,org.apache.lucene.util.Filter,0.00,8,1,7,1,8,3,0,1,195,1
"org.apache.lucene.search.FieldCacheTermsFilter$FieldCacheDocIdSet",1,0.00,1.00,3,0.04,515.71,1,0,7,3,0,131.84,0,5,0,1,131.84,0.00,0.00,0.00,0,1.00,1,127.96,0,0,0,java.lang.Object,0.00,2,0,1,0,2,1,0,0,34,0
"org.apache.lucene.search.FieldComparator",8,0.00,1.38,30,0.41,9769.81,8,0,16,9,60,155.10,153,35,53,1,128.82,0.00,0.00,0.00,0,8.00,4,1215.84,0,1,7,java.lang.Object,0.00,1,0,11,16,1,7,0,22,273,2
"org.apache.lucene.search.FieldComparator$ByteComparator",7,0.12,1.29,28,0.38,9500.52,11,4,16,11,2,123.82,6,44,0,2,123.82,0.00,0.50,0.36,0,0.00,2,1150.79,1,1,2,org.apache.lucene.search.NumericComparator,0.00,4,1,9,0,4,6,0,6,256,3
"org.apache.lucene.search.FieldComparator$DocComparator",7,0.06,1.00,19,0.21,4199.19,10,3,16,8,2,137.89,5,33,0,2,137.89,0.00,0.50,0.38,0,0.00,1,635.42,0,1,2,org.apache.lucene.search.FieldComparator,0.67,1,1,7,0,1,6,0,5,161,3
"org.apache.lucene.search.FieldComparator$DoubleComparator",7,0.12,1.86,40,0.48,15223.81,11,4,16,11,2,118.50,6,58,0,2,118.50,0.00,0.50,0.36,0,0.00,4,1425.24,1,1,2,org.apache.lucene.search.NumericComparator,0.00,4,1,13,0,4,6,0,6,308,3
"org.apache.lucene.search.FieldComparator$FloatComparator",7,0.12,1.86,40,0.48,15223.81,11,4,16,11,2,168.50,9,58,0,2,118.50,0.00,0.50,0.36,0,0.00,4,1425.24,1,1,2,org.apache.lucene.search.NumericComparator,0.00,4,1,13,0,4,6,0,9,308,3
"org.apache.lucene.search.FieldComparator$FloatDocValuesComparator",7,0.12,1.71,38,0.41,12039.89,11,4,16,12,3,119.32,0,55,0,2,119.32,0.00,0.50,0.36,0,0.00,3,1228.81,0,1,3,org.apache.lucene.search.FieldComparator,0.67,5,1,12,0,5,6,0,0,272,3
"org.apache.lucene.search.FieldComparator$IntComparator",7,0.12,1.86,40,0.47,16062.21,11,4,16,11,2,158.21,15,58,0,2,118.32,0.00,0.50,0.36,0,0.00,4,1414.61,1,1,2,org.apache.lucene.search.NumericComparator,0.00,4,1,13,0,4,6,0,15,308,3
"org.apache.lucene.search.FieldComparator$IntDocValuesComparator",7,0.12,1.71,38,0.41,11751.99,11,4,16,12,3,119.41,4,55,0,2,119.41,0.00,0.50,0.36,0,0.00,3,1221.24,0,1,3,org.apache.lucene.search.FieldComparator,0.67,5,1,12,0,5,6,0,4,271,3
"org.apache.lucene.search.FieldComparator$LongComparator",7,0.12,1.86,40,0.48,15223.81,11,4,16,11,2,168.50,10,58,0,2,118.50,0.00,0.50,0.36,0,0.00,4,1425.24,1,1,2,org.apache.lucene.search.NumericComparator,0.00,4,1,13,0,4,6,0,10,308,3
"org.apache.lucene.search.FieldComparator$NumericComparator",2,0.33,2.00,15,0.17,4295.66,5,3,16,4,3,113.08,1,21,0,2,113.08,0.00,0.50,0.50,0,2.00,3,496.81,0,0,3,org.apache.lucene.search.FieldComparator,0.00,2,1,4,0,2,2,0,1,109,3
"org.apache.lucene.search.FieldComparator$RelevanceComparator",9,0.04,1.56,28,0.36,9991.67,12,3,16,13,4,129.12,6,47,0,2,129.12,0.00,0.50,0.30,0,7.00,3,1072.71,0,1,4,org.apache.lucene.search.FieldComparator,0.71,4,1,14,0,4,8,0,6,253,3
"org.apache.lucene.search.FieldComparator$ShortComparator",7,0.12,1.29,28,0.38,9500.52,11,4,16,11,2,123.82,6,44,0,2,123.82,0.00,0.50,0.36,0,0.00,2,1150.79,1,1,2,org.apache.lucene.search.NumericComparator,0.00,4,1,9,0,4,6,0,6,256,3
"org.apache.lucene.search.FieldComparator$TermOrdValComparator",7,0.21,2.86,82,0.98,48632.90,18,11,16,21,3,69.44,44,106,0,2,101.66,0.00,0.50,0.27,0,4.00,7,2950.22,0,1,3,org.apache.lucene.search.FieldComparator,0.53,14,1,20,0,14,6,0,21,571,3
"org.apache.lucene.search.FieldComparator$TermOrdValComparator$AnyOrdComparator",3,0.00,2.33,28,0.29,10998.73,6,3,16,6,1,157.14,4,38,0,2,107.14,0.00,0.50,0.33,0,1.00,3,877.88,0,0,1,org.apache.lucene.search.PerSegmentComparator,0.00,3,1,7,0,3,3,0,4,190,2
"org.apache.lucene.search.FieldComparator$TermOrdValComparator$ByteOrdComparator",3,0.00,2.33,28,0.29,11270.57,6,3,16,5,1,157.06,4,37,0,2,107.06,0.00,0.50,0.33,0,1.00,3,858.96,0,0,1,org.apache.lucene.search.PerSegmentComparator,0.00,2,1,7,0,2,3,0,4,185,2
"org.apache.lucene.search.FieldComparator$TermOrdValComparator$IntOrdComparator",3,0.00,2.33,28,0.27,10557.14,6,3,16,5,1,157.28,4,37,0,2,107.28,0.00,0.50,0.33,0,1.00,3,816.95,0,0,1,org.apache.lucene.search.PerSegmentComparator,0.00,2,1,7,0,2,3,0,4,180,2
"org.apache.lucene.search.FieldComparator$TermOrdValComparator$PerSegmentComparator",5,0.00,1.60,17,0.19,4352.25,5,0,16,10,3,129.94,0,30,0,2,129.94,0.00,0.50,0.00,0,5.00,4,569.75,0,1,3,org.apache.lucene.search.FieldComparator,0.46,5,1,8,0,5,4,0,0,141,1
"org.apache.lucene.search.FieldComparator$TermOrdValComparator$ShortOrdComparator",3,0.00,2.33,28,0.29,11270.57,6,3,16,5,1,157.06,4,37,0,2,107.06,0.00,0.50,0.33,0,1.00,3,858.96,0,0,1,org.apache.lucene.search.PerSegmentComparator,0.00,2,1,7,0,2,3,0,4,185,2
"org.apache.lucene.search.FieldComparator$TermOrdValComparator$TermOrdValDocValuesComparator",9,0.15,3.33,110,1.49,89692.27,21,12,16,35,4,66.76,62,148,0,2,98.98,0.00,0.50,0.21,1,12.00,11,4467.20,0,1,4,org.apache.lucene.search.FieldComparator,0.47,26,1,30,0,26,8,0,34,830,3
"org.apache.lucene.search.FieldComparator$TermOrdValComparator$TermOrdValDocValuesComparator$AnyOrdComparator_4",3,1.00,2.00,19,0.19,6057.06,4,1,16,4,1,165.79,4,28,0,2,115.79,0.00,0.50,0.00,0,1.00,3,567.15,0,0,1,org.apache.lucene.search.PerSegmentComparator,0.00,1,1,6,0,1,3,0,4,129,2
"org.apache.lucene.search.FieldComparator$TermOrdValComparator$TermOrdValDocValuesComparator$AnyPackedDocToOrdComparator",3,0.25,2.00,22,0.24,7507.79,5,2,16,5,1,162.55,4,30,0,2,112.56,0.00,0.50,0.33,0,1.00,3,706.82,0,0,1,org.apache.lucene.search.PerSegmentComparator,0.00,2,1,6,0,2,3,0,4,157,2
"org.apache.lucene.search.FieldComparator$TermOrdValComparator$TermOrdValDocValuesComparator$ByteOrdComparator_1",3,0.00,2.00,24,0.26,8125.65,6,3,16,5,1,160.12,4,32,0,2,110.12,0.00,0.50,0.33,0,1.00,3,770.45,0,0,1,org.apache.lucene.search.PerSegmentComparator,0.00,2,1,6,0,2,3,0,4,169,2
"org.apache.lucene.search.FieldComparator$TermOrdValComparator$TermOrdValDocValuesComparator$IntOrdComparator_3",3,0.00,2.00,24,0.24,7627.31,6,3,16,5,1,160.34,4,32,0,2,110.34,0.00,0.50,0.33,0,1.00,3,734.68,0,0,1,org.apache.lucene.search.PerSegmentComparator,0.00,2,1,6,0,2,3,0,4,165,2
"org.apache.lucene.search.FieldComparator$TermOrdValComparator$TermOrdValDocValuesComparator$PerSegmentComparator_0",5,0.00,1.00,13,0.16,3033.89,5,0,16,9,3,137.86,0,24,0,2,137.86,0.00,0.50,0.00,0,8.00,1,484.02,0,1,3,org.apache.lucene.search.FieldComparator,0.46,4,1,5,0,4,4,0,0,123,1
"org.apache.lucene.search.FieldComparator$TermOrdValComparator$TermOrdValDocValuesComparator$ShortOrdComparator_2",3,0.00,2.00,24,0.26,8125.65,6,3,16,5,1,160.12,4,32,0,2,110.12,0.00,0.50,0.33,0,1.00,3,770.45,0,0,1,org.apache.lucene.search.PerSegmentComparator,0.00,2,1,6,0,2,3,0,4,169,2
"org.apache.lucene.search.FieldComparator$TermOrdValComparator$TermOrdValDocValuesComparator$TermValComparator",8,0.09,2.25,47,0.50,15172.01,13,5,16,13,3,118.93,0,70,0,2,118.93,0.00,0.50,0.28,0,0.00,4,1498.77,0,1,3,org.apache.lucene.search.FieldComparator,0.62,5,1,18,0,5,7,0,0,334,3
"org.apache.lucene.search.FieldComparator$TermOrdValComparator$TermOrdValDocValuesComparator$TermValDocValuesComparator",8,0.09,1.25,35,0.42,11437.66,13,5,16,15,4,123.64,0,53,0,2,123.64,0.00,0.50,0.28,0,0.00,2,1268.75,0,1,4,org.apache.lucene.search.FieldComparator,0.62,7,1,10,0,7,7,0,0,287,3
"org.apache.lucene.search.FieldComparatorSource",1,0.00,1.00,2,0.03,371.83,1,0,1,1,13,129.17,15,4,12,1,139.53,0.00,0.00,0.00,0,1.00,1,90.84,0,0,1,java.lang.Object,0.00,0,0,1,5,0,1,0,2,24,2
"org.apache.lucene.search.FieldDoc",4,1.00,1.25,21,0.22,6678.19,5,1,0,10,12,81.94,50,25,11,2,119.50,1.00,0.33,0.25,0,6.00,2,649.75,1,1,1,org.apache.lucene.search.ScoreDoc,0.29,6,1,5,1,6,3,0,10,148,1
"org.apache.lucene.search.FieldValueFilter",8,0.14,2.62,42,0.45,15382.93,10,2,5,15,7,139.46,31,67,2,2,118.84,0.00,0.50,0.62,0,0.00,8,1340.80,0,3,5,org.apache.lucene.util.Filter,0.00,7,1,21,0,7,5,0,7,300,1
"org.apache.lucene.search.FieldValueFilter$FieldCacheDocIdSet",1,0.00,1.00,3,0.04,515.79,1,0,5,2,0,131.84,0,5,0,1,131.84,0.00,0.00,0.00,0,1.00,1,114.04,0,0,0,java.lang.Object,0.00,1,0,1,0,1,1,0,0,31,0
"org.apache.lucene.search.FieldValueFilter$FieldCacheDocIdSet_0",1,0.00,1.00,3,0.04,437.74,1,0,5,2,0,132.40,0,5,0,1,132.40,0.00,0.00,0.00,0,1.00,1,108.36,0,0,0,java.lang.Object,0.00,1,0,1,0,1,1,0,0,30,0
"org.apache.lucene.search.FieldValueHitQueue",8,0.00,1.62,42,0.53,18842.08,12,4,2,13,21,86.04,53,50,17,2,118.26,2.00,0.25,0.25,0,16.00,3,1587.92,0,1,4,org.apache.lucene.util.PriorityQueue,0.00,5,1,13,2,5,7,0,16,341,2
"org.apache.lucene.search.FieldValueHitQueue$Entry",2,1.00,1.00,7,0.07,911.22,3,1,2,2,1,132.27,0,11,0,2,132.27,0.00,0.50,0.50,0,2.00,1,197.96,1,1,1,org.apache.lucene.search.ScoreDoc,0.40,0,1,2,0,0,1,0,0,53,2
"org.apache.lucene.search.FieldValueHitQueue$MultiComparatorsFieldValueHitQueue",2,0.00,3.00,23,0.29,15518.32,2,0,2,3,2,151.27,2,25,0,3,101.27,0.00,0.67,0.00,0,0.00,3,863.24,1,0,2,org.apache.lucene.search.FieldValueHitQueue,0.00,1,2,6,0,1,2,0,2,175,3
"org.apache.lucene.search.FieldValueHitQueue$OneComparatorFieldValueHitQueue",2,0.00,2.00,15,0.21,7810.13,3,1,2,3,2,131.65,7,21,0,3,111.03,0.00,0.67,1.00,0,0.00,2,643.50,1,0,2,org.apache.lucene.search.FieldValueHitQueue,0.00,1,2,4,0,1,2,0,2,139,3
"org.apache.lucene.search.Filter",1,0.00,1.00,2,0.02,130.77,1,0,5,1,68,180.14,30,3,63,1,143.10,0.00,0.00,0.00,0,1.00,1,54.63,0,1,5,java.lang.Object,0.00,0,0,1,17,0,0,0,2,17,2
"org.apache.lucene.search.FilteredDocIdSet",5,0.25,1.20,15,0.13,3688.60,6,1,2,10,10,98.35,33,24,7,2,130.58,2.00,0.25,0.80,0,0.00,2,393.14,0,2,3,org.apache.lucene.search.DocIdSet,0.00,5,1,6,2,5,3,0,5,103,2
"org.apache.lucene.search.FilteredDocIdSet$Bits",2,0.00,1.00,5,0.04,565.12,2,0,2,5,1,140.47,0,7,0,1,140.47,0.00,0.00,0.00,0,2.00,1,128.82,0,0,1,java.lang.Object,0.00,3,0,2,0,3,2,0,0,37,0
"org.apache.lucene.search.FilteredDocIdSet$FilteredDocIdSetIterator",1,0.00,1.00,3,0.03,379.11,1,0,2,2,1,132.90,0,5,0,1,132.90,0.00,0.00,0.00,0,1.00,1,83.95,0,0,1,java.lang.Object,0.00,1,0,1,0,1,1,0,0,24,0
"org.apache.lucene.search.FilteredDocIdSetIterator",5,0.12,2.40,27,0.22,7325.12,7,2,1,7,4,140.41,16,42,3,2,119.80,1.00,0.33,0.60,1,0.00,5,674.60,0,0,1,org.apache.lucene.search.DocIdSetIterator,0.75,2,1,12,1,2,5,0,3,161,2
"org.apache.lucene.search.FilteredQuery",10,0.06,1.50,49,0.57,21486.50,12,2,7,28,26,122.44,43,71,17,2,122.21,1.00,0.33,0.45,1,6.00,3,1696.34,3,5,10,org.apache.lucene.search.Query,0.10,18,1,15,1,18,5,0,14,383,1
"org.apache.lucene.search.FilteredQuery$Weight",6,0.00,2.17,41,0.60,31142.64,6,0,7,23,9,152.42,13,58,0,1,112.54,0.00,0.00,0.00,0,10.00,5,1801.62,0,2,9,java.lang.Object,0.00,17,0,13,0,17,4,0,13,345,0
"org.apache.lucene.search.FilteredQuery$Weight$Scorer",6,0.00,2.50,43,0.37,13714.38,8,2,7,12,2,162.81,6,55,0,1,112.81,0.00,0.00,0.50,1,2.00,5,1104.14,0,0,2,java.lang.Object,0.00,6,0,15,0,6,6,0,6,246,0
"org.apache.lucene.search.FuzzyQuery",11,0.14,2.45,66,0.93,37893.20,18,7,8,31,28,96.04,58,98,19,3,113.91,0.00,0.67,0.27,0,21.00,9,2796.00,4,3,9,org.apache.lucene.search.MultiTermQuery,0.10,20,2,27,0,20,8,0,12,574,1
"org.apache.lucene.search.FuzzyTermsEnum",22,0.04,1.86,136,2.11,113967.82,41,19,25,65,26,133.20,67,190,3,2,112.58,0.00,0.50,0.09,4,86.00,8,6323.42,0,9,23,org.apache.lucene.index.TermsEnum,0.34,43,1,41,0,43,13,0,31,1192,2
"org.apache.lucene.search.FuzzyTermsEnum$AutomatonFuzzyTermsEnum",3,0.33,3.00,33,0.43,16857.26,6,3,25,10,7,122.99,11,42,0,3,102.37,0.00,0.67,0.56,1,0.00,5,1294.83,0,1,7,org.apache.lucene.index.FilteredTermsEnum,0.00,7,2,9,0,7,2,0,11,254,1
"org.apache.lucene.search.FuzzyTermsEnum$LevenshteinAutomataAttribute",1,0.00,1.00,2,0.01,109.13,1,0,25,1,0,143.72,0,3,0,2,143.72,0.00,0.50,0.00,0,1.00,1,43.65,0,1,0,,0.00,0,1,1,0,0,0,0,0,15,2
"org.apache.lucene.search.FuzzyTermsEnum$LevenshteinAutomataAttributeImpl",5,0.00,1.40,16,0.19,4312.61,6,1,25,12,2,130.01,0,29,0,2,130.01,0.00,0.50,1.00,0,0.00,3,578.59,0,1,2,org.apache.lucene.util.AttributeImpl,0.20,7,1,7,0,7,4,1,0,140,3
"org.apache.lucene.search.FuzzyTermsEnum$LinearFuzzyTermsEnum",4,0.28,4.25,65,1.01,115945.03,10,6,25,14,6,139.89,99,73,0,3,90.61,0.00,0.67,0.38,1,0.00,11,3024.08,1,1,6,org.apache.lucene.index.FilteredTermsEnum,0.00,10,2,17,0,10,3,0,37,562,1
"org.apache.lucene.search.HitQueue",3,0.00,1.33,7,0.11,3479.32,3,0,1,4,6,115.43,42,16,4,2,135.57,0.00,0.50,0.00,0,3.00,2,324.05,0,1,2,org.apache.lucene.util.PriorityQueue,0.12,1,1,4,0,1,2,0,4,82,1
"org.apache.lucene.search.IndexSearcher",33,0.02,1.58,168,2.22,94199.70,42,9,28,76,332,67.61,297,215,307,1,117.61,0.00,0.00,0.09,5,373.00,6,6668.75,0,9,29,java.lang.Object,0.00,43,0,52,7,43,24,0,53,1358,1
"org.apache.lucene.search.IndexSearcher$SearcherCallableNoSort",2,0.71,2.00,30,0.32,9510.83,9,7,28,6,5,148.01,2,35,0,1,98.01,0.00,0.00,0.50,0,2.00,3,963.73,0,0,5,java.lang.Object,0.00,4,0,4,0,4,2,1,2,197,3
"org.apache.lucene.search.IndexSearcher$SearcherCallableWithSort",5,0.09,1.40,54,0.68,23737.59,13,8,28,21,11,86.80,27,65,0,1,104.67,0.00,0.00,0.20,0,10.00,2,2049.30,0,1,11,java.lang.Object,0.00,16,0,7,0,16,4,1,4,405,3
"org.apache.lucene.search.IndexSearcher$SearcherCallableWithSort$ExecutionHelper",6,0.20,1.50,21,0.22,4174.99,8,2,28,13,1,130.72,1,33,0,1,130.72,0.00,0.00,0.33,2,6.00,4,654.18,0,1,1,java.lang.Object,0.00,7,0,9,0,7,5,2,1,157,3
"org.apache.lucene.search.IndexSearcher$SearcherCallableWithSort$FakeScorer",6,0.40,1.00,15,0.10,1185.38,8,2,28,7,1,141.69,0,27,0,3,141.69,0.00,0.67,0.17,0,14.00,1,294.95,0,0,1,org.apache.lucene.search.Scorer,0.94,1,2,6,0,1,6,0,0,87,2
"org.apache.lucene.search.IndexSearcher$SearcherCallableWithSort$LeafSlice",1,1.00,1.00,4,0.03,364.00,2,1,28,1,1,128.37,0,7,0,1,128.37,0.00,0.00,0.00,0,1.00,1,81.51,0,0,1,java.lang.Object,0.00,0,0,1,0,0,1,0,0,24,2
"org.apache.lucene.search.JustCompileSearch",0,0.00,0.00,18,0.26,4712.48,1,1,8,0,7,171.00,7,28,0,1,171.00,0.00,0.00,0.00,0,0.00,0,765.78,0,0,7,java.lang.Object,0.00,0,0,0,0,0,0,0,1,135,1
"org.apache.lucene.search.JustCompileSearch$JustCompileCollector",4,0.00,1.00,9,0.10,1231.92,4,0,8,5,3,140.17,0,19,0,2,140.17,0.00,0.50,0.00,0,0.00,1,285.84,0,0,3,org.apache.lucene.search.Collector,0.50,1,1,4,0,1,4,0,0,75,2
"org.apache.lucene.search.JustCompileSearch$JustCompileDocIdSet",1,0.00,1.00,3,0.03,333.41,1,0,8,2,2,133.33,0,6,0,2,133.33,0.00,0.50,0.00,0,0.00,1,80.57,0,1,2,org.apache.lucene.search.DocIdSet,0.00,1,1,1,0,1,0,0,0,23,2
"org.apache.lucene.search.JustCompileSearch$JustCompileDocIdSetIterator",3,0.00,1.00,7,0.07,905.87,3,0,8,4,1,140.24,0,14,0,2,140.24,0.00,0.50,0.00,0,0.00,1,201.08,0,0,1,org.apache.lucene.search.DocIdSetIterator,1.00,1,1,3,0,1,3,0,0,55,2
"org.apache.lucene.search.JustCompileSearch$JustCompileExtendedFieldCacheDoubleParser",1,0.00,1.00,3,0.03,225.40,1,0,8,2,1,134.67,0,5,0,1,134.67,0.00,0.00,0.00,0,0.00,1,75.13,0,0,1,java.lang.Object,0.00,1,0,1,0,1,1,1,0,22,2
"org.apache.lucene.search.JustCompileSearch$JustCompileExtendedFieldCacheLongParser",1,0.00,1.00,3,0.03,225.40,1,0,8,2,1,134.67,0,5,0,1,134.67,0.00,0.00,0.00,0,0.00,1,75.13,0,0,1,java.lang.Object,0.00,1,0,1,0,1,1,1,0,22,2
"org.apache.lucene.search.JustCompileSearch$JustCompileFieldComparator",6,0.00,1.00,13,0.15,2203.19,6,0,8,7,2,139.57,0,27,0,2,139.57,0.00,0.50,0.00,0,0.00,1,464.87,0,2,2,org.apache.lucene.search.FieldComparator,0.71,1,1,6,0,1,4,0,0,119,2
"org.apache.lucene.search.JustCompileSearch$JustCompileFieldComparatorSource",1,0.00,1.00,3,0.05,834.74,1,0,8,2,2,130.20,0,7,0,2,130.20,0.00,0.50,0.00,0,0.00,1,143.45,0,1,2,org.apache.lucene.search.FieldComparatorSource,0.00,1,1,1,0,1,0,0,0,34,2
"org.apache.lucene.search.JustCompileSearch$JustCompileFilter",1,0.00,1.00,3,0.03,313.57,1,0,8,1,4,173.43,2,6,0,2,133.54,0.00,0.50,0.00,0,1.00,1,87.65,0,1,4,org.apache.lucene.search.Filter,0.00,0,1,1,0,0,0,0,2,24,2
"org.apache.lucene.search.JustCompileSearch$JustCompileFilteredDocIdSet",2,0.00,1.00,5,0.04,367.80,2,0,8,3,2,141.94,0,9,0,3,141.94,0.00,0.67,0.00,0,2.00,1,110.57,0,0,2,org.apache.lucene.search.FilteredDocIdSet,0.43,1,2,2,0,1,2,0,0,33,2
"org.apache.lucene.search.JustCompileSearch$JustCompileFilteredDocIdSetIterator",2,0.00,1.00,5,0.04,367.80,2,0,8,3,2,141.94,0,9,0,3,141.94,0.00,0.67,0.00,0,2.00,1,110.57,0,0,2,org.apache.lucene.search.FilteredDocIdSetIterator,0.30,1,2,2,0,1,2,0,0,33,2
"org.apache.lucene.search.JustCompileSearch$JustCompilePhraseScorer",2,0.00,1.00,5,0.06,683.78,2,0,8,3,2,139.82,0,10,0,4,139.82,0.00,0.75,0.00,0,2.00,1,173.30,0,0,2,org.apache.lucene.search.PhraseScorer,0.19,1,3,2,0,1,2,0,0,46,2
"org.apache.lucene.search.JustCompileSearch$JustCompileQuery",1,0.00,1.00,3,0.03,325.43,1,0,8,2,1,133.42,0,6,0,2,133.42,0.00,0.50,0.00,0,0.00,1,78.86,0,1,1,org.apache.lucene.search.Query,0.00,1,1,1,0,1,0,0,0,23,2
"org.apache.lucene.search.JustCompileSearch$JustCompileScorer",6,0.00,1.00,13,0.13,1706.94,6,0,8,7,3,140.45,0,26,0,3,140.45,0.00,0.67,0.00,0,0.00,1,385.45,0,0,3,org.apache.lucene.search.Scorer,0.75,1,2,6,0,1,6,0,0,103,2
"org.apache.lucene.search.JustCompileSearch$JustCompileSimilarity",4,0.00,1.00,9,0.12,1452.30,4,0,8,5,6,139.61,0,18,0,2,139.61,0.00,0.50,0.00,0,0.00,1,347.65,0,3,6,org.apache.lucene.search.similarities.Similarity,0.00,1,1,4,0,1,1,0,0,86,2
"org.apache.lucene.search.JustCompileSearch$JustCompileTopDocsCollector",8,0.00,1.00,17,0.18,2223.10,8,0,8,9,6,140.53,0,34,0,3,140.53,0.00,0.67,0.00,0,0.00,1,525.81,0,3,6,org.apache.lucene.search.TopDocsCollector,0.75,1,2,8,0,1,5,0,0,139,2
"org.apache.lucene.search.JustCompileSearch$JustCompileWeight",5,0.00,1.00,11,0.13,1705.36,5,0,8,6,6,139.83,0,24,0,2,139.83,0.00,0.50,0.00,0,0.00,1,389.90,0,3,6,org.apache.lucene.search.Weight,0.55,1,1,5,0,1,2,0,0,99,2
"org.apache.lucene.search.MatchAllDocsQuery",5,0.00,1.20,17,0.19,3988.77,5,0,7,12,56,130.31,4,28,48,2,130.31,0.00,0.50,0.00,0,5.00,2,580.74,1,2,8,org.apache.lucene.search.Query,0.13,7,1,6,0,7,3,0,1,143,1
"org.apache.lucene.search.MatchAllDocsQuery$MatchAllDocsWeight",7,0.17,1.14,22,0.25,4913.24,9,2,7,13,9,130.76,1,40,0,2,130.76,0.00,0.50,0.36,0,3.00,2,749.59,0,4,9,org.apache.lucene.search.Weight,0.46,6,1,8,0,6,3,0,1,179,1
"org.apache.lucene.search.MatchAllDocsQuery$MatchAllScorer",5,0.06,1.40,24,0.22,5710.06,9,4,7,6,4,124.39,0,36,0,3,124.39,0.00,0.67,0.30,1,4.00,3,662.25,0,0,4,org.apache.lucene.search.Scorer,0.80,1,2,7,0,1,5,0,0,157,1
"org.apache.lucene.search.MatchOnlyConjunctionTermScorer",2,0.00,1.50,9,0.09,1961.49,2,0,1,3,3,124.89,1,14,1,4,124.89,0.00,0.75,0.00,0,2.00,2,265.24,0,0,2,org.apache.lucene.search.ConjunctionTermScorer,0.22,1,3,3,0,1,2,0,1,63,1
"org.apache.lucene.search.MatchOnlyTermScorer",7,0.17,1.00,20,0.19,2844.51,9,2,3,11,5,139.46,30,32,1,3,139.23,0.00,0.67,0.36,1,8.00,1,571.29,0,1,4,org.apache.lucene.search.Scorer,0.88,4,2,7,0,4,6,0,5,149,1
"org.apache.lucene.search.MaxNonCompetitiveBoostAttribute",4,0.00,1.00,5,0.03,124.80,4,0,3,4,8,159.47,16,6,5,2,159.23,0.00,0.50,0.00,0,4.00,1,78.03,0,1,3,,0.00,0,1,4,0,0,3,0,5,30,1
"org.apache.lucene.search.MaxNonCompetitiveBoostAttributeImpl",6,0.00,1.00,18,0.15,2170.46,8,2,2,8,4,133.06,3,27,1,2,133.06,0.00,0.50,0.50,0,2.00,1,454.19,0,1,3,org.apache.lucene.util.AttributeImpl,0.18,2,1,6,0,2,5,1,1,117,2
"org.apache.lucene.search.MockFilter",3,0.00,1.00,9,0.07,910.84,4,1,4,6,7,133.65,0,14,1,2,133.65,0.00,0.50,1.00,0,0.00,1,210.51,0,1,6,org.apache.lucene.search.Filter,0.00,3,1,3,0,3,2,0,0,56,1
"org.apache.lucene.search.MultiCollector",6,1.00,3.33,48,0.40,26460.64,7,1,4,12,17,108.57,26,64,14,2,108.34,0.00,0.50,0.00,0,6.00,10,1202.94,0,1,3,org.apache.lucene.search.Collector,0.40,6,1,20,0,6,5,0,6,262,1
"org.apache.lucene.search.MultiCollectorTest",3,0.00,1.67,29,0.34,10566.78,3,0,6,12,4,147.24,8,37,0,2,107.36,0.00,0.50,0.00,0,3.00,2,1023.98,0,0,4,org.apache.lucene.util.LuceneTestCase,0.00,9,1,5,0,9,3,0,8,213,1
"org.apache.lucene.search.MultiCollectorTest$DummyCollector",4,0.00,1.00,14,0.12,1767.65,8,4,6,4,3,132.37,0,24,0,2,132.37,0.00,0.50,0.25,0,12.00,1,366.33,0,0,3,org.apache.lucene.search.Collector,0.50,0,1,4,0,0,4,0,0,95,2
"org.apache.lucene.search.MultiPhraseQuery",15,0.00,2.67,126,1.64,92089.53,19,4,19,48,41,127.87,48,154,20,2,107.26,0.00,0.50,0.25,2,52.00,9,4929.16,1,4,21,org.apache.lucene.search.Query,0.08,33,1,40,0,33,11,0,17,959,1
"org.apache.lucene.search.MultiPhraseQuery$MultiPhraseWeight",6,0.27,3.67,92,1.51,117146.57,9,3,19,55,23,143.04,9,115,0,2,93.04,0.00,0.50,0.56,0,0.00,12,4523.50,0,2,23,org.apache.lucene.search.Weight,0.50,49,1,22,0,49,4,0,9,754,1
"org.apache.lucene.search.MultiPhraseQuery$UnionDocsAndPositionsEnum",10,0.00,1.80,66,0.80,38256.67,14,4,19,38,7,113.63,6,88,0,4,113.63,0.00,0.75,0.25,1,30.00,4,2402.22,0,1,7,org.apache.lucene.index.DocsAndPositionsEnum,1.80,28,3,18,0,28,9,0,6,474,0
"org.apache.lucene.search.MultiPhraseQuery$UnionDocsAndPositionsEnum$DocsQueue",2,0.00,2.00,10,0.14,3161.84,2,0,19,7,3,119.58,0,16,0,2,119.58,0.00,0.50,0.00,0,2.00,3,416.34,1,0,3,org.apache.lucene.util.PriorityQueue,0.00,5,1,4,0,5,2,0,0,94,3
"org.apache.lucene.search.MultiPhraseQuery$UnionDocsAndPositionsEnum$IntQueue",6,0.40,1.17,22,0.18,3555.04,10,4,19,8,0,131.33,0,30,0,1,131.33,0.00,0.00,0.58,1,0.00,2,554.95,0,0,0,java.lang.Object,0.00,2,0,7,0,2,6,0,0,142,3
"org.apache.lucene.search.MultiTermQuery",9,0.03,1.78,43,0.57,21589.10,13,4,9,20,62,111.44,143,59,53,2,121.79,11.00,0.08,0.22,1,3.00,7,1695.98,1,5,11,org.apache.lucene.search.Query,0.11,11,1,16,11,11,4,0,16,367,2
"org.apache.lucene.search.MultiTermQuery$ConstantScoreAutoRewrite",0,0.00,0.00,1,0.02,186.81,0,0,9,0,1,171.00,0,1,0,4,171.00,0.00,0.75,0.00,0,0.00,0,51.89,0,0,1,org.apache.lucene.search.ConstantScoreAutoRewrite,0.00,0,3,0,0,0,0,0,0,15,2
"org.apache.lucene.search.MultiTermQuery$ConstantScoreAutoRewrite_1",2,0.00,1.00,5,0.04,499.34,2,0,9,3,0,140.89,0,9,0,1,140.89,0.00,0.00,0.00,0,2.00,1,129.84,0,0,0,java.lang.Object,0.00,1,0,2,0,1,2,0,0,36,0
"org.apache.lucene.search.MultiTermQuery$RewriteMethod",2,0.00,1.00,4,0.05,570.99,2,0,9,3,6,180.32,5,6,0,1,140.43,0.00,0.00,0.00,0,2.00,1,142.53,0,2,6,java.lang.Object,0.00,1,0,2,0,1,0,0,2,39,3
"org.apache.lucene.search.MultiTermQuery$RewriteMethod_0",1,0.00,1.00,5,0.06,1508.92,1,0,9,5,5,119.90,0,7,0,1,119.90,0.00,0.00,0.00,0,1.00,1,179.90,0,1,5,java.lang.Object,0.00,4,0,1,0,4,0,0,0,42,0
"org.apache.lucene.search.MultiTermQuery$TopTermsBoostOnlyBooleanQueryRewrite",4,0.00,1.00,11,0.13,2102.87,4,0,9,10,7,188.35,7,19,0,4,138.35,0.00,0.75,0.00,0,4.00,1,404.48,0,0,7,org.apache.lucene.search.TopTermsRewrite,0.57,6,3,4,0,6,4,0,1,97,3
"org.apache.lucene.search.MultiTermQuery$TopTermsScoringBooleanQueryRewrite",4,0.00,1.00,11,0.13,2069.52,4,0,9,9,5,188.40,7,19,0,4,138.40,0.00,0.75,0.00,0,4.00,1,385.28,0,0,5,org.apache.lucene.search.TopTermsRewrite,0.57,5,3,4,0,5,4,0,1,94,3
"org.apache.lucene.search.MultiTermQueryWrapperFilter",6,0.20,2.17,40,0.49,21267.89,7,1,9,20,14,114.08,29,53,5,2,113.84,3.00,0.20,0.83,1,0.00,5,1475.71,0,2,9,org.apache.lucene.util.Filter,0.00,14,1,13,3,14,4,0,11,299,1
"org.apache.lucene.search.MultiThreadTermVectorsReader",6,0.05,2.17,48,0.53,13770.54,10,4,12,26,10,110.67,3,56,1,1,110.67,0.00,0.00,0.21,2,10.00,3,1599.90,0,0,9,java.lang.Object,0.00,20,0,13,0,20,6,1,3,336,0
"org.apache.lucene.search.NGramPhraseQuery",4,0.67,3.00,36,0.47,36731.79,5,1,3,8,6,86.07,20,48,2,3,103.94,0.00,0.67,0.50,0,4.00,7,1415.48,6,1,4,org.apache.lucene.search.PhraseQuery,0.11,4,2,12,0,4,3,0,10,279,1
"org.apache.lucene.search.NRTManager",14,0.06,1.79,86,0.96,31352.74,22,8,18,40,15,73.17,101,126,2,2,115.46,0.00,0.50,0.18,1,74.00,7,2891.18,2,1,13,org.apache.lucene.search.ReferenceManager,0.16,26,1,25,0,26,13,0,15,603,1
"org.apache.lucene.search.NRTManager$TrackingIndexWriter",19,0.39,1.63,56,0.65,11900.57,21,2,18,29,7,137.63,15,76,0,1,137.63,0.00,0.00,0.87,0,0.00,3,1939.42,0,1,7,java.lang.Object,0.00,10,0,31,0,10,18,0,15,465,2
"org.apache.lucene.search.NRTManager$WaitingListener",1,0.00,1.00,2,0.01,52.70,1,0,18,1,0,146.21,0,3,0,1,146.21,0.00,0.00,0.00,0,1.00,1,31.26,0,0,0,,0.00,0,0,1,0,0,1,0,0,12,2
"org.apache.lucene.search.NRTManagerReopenThread",4,0.20,3.50,48,0.55,25631.87,9,5,3,18,3,144.42,90,68,1,2,100.48,0.00,0.50,0.35,0,2.00,9,1637.81,0,0,2,java.lang.Thread,0.00,14,1,14,0,14,4,2,21,314,1
"org.apache.lucene.search.NumericRangeFilter",14,0.00,1.00,29,0.59,17172.69,14,0,6,24,14,103.23,91,66,7,3,135.45,0.00,0.67,0.00,0,34.00,1,1773.35,0,8,8,org.apache.lucene.search.MultiTermQueryWrapperFilter,0.00,10,2,14,0,10,6,0,15,415,2
"org.apache.lucene.search.NumericRangeQuery",18,0.02,2.06,74,1.58,63369.19,28,10,16,36,29,76.32,211,140,17,3,120.45,0.00,0.67,0.12,0,90.00,7,4750.04,5,10,13,org.apache.lucene.search.MultiTermQuery,0.08,18,2,37,0,18,8,0,24,956,2
"org.apache.lucene.search.NumericRangeQuery$NumericRangeTermsEnum",4,0.58,9.00,72,1.08,101384.50,8,4,16,17,4,128.88,10,102,0,3,88.99,0.00,0.67,0.69,1,0.00,27,3253.16,0,2,4,org.apache.lucene.index.FilteredTermsEnum,0.00,13,2,36,0,13,2,0,10,583,2
"org.apache.lucene.search.NumericRangeQuery$NumericRangeTermsEnum$NumericUtils.IntRangeBuilder",1,0.00,1.00,4,0.04,629.26,1,0,16,1,1,126.50,0,6,0,1,126.50,0.00,0.00,0.00,0,0.00,1,113.18,0,0,1,java.lang.Object,0.00,0,0,1,0,0,1,0,0,31,0
"org.apache.lucene.search.NumericRangeQuery$NumericRangeTermsEnum$NumericUtils.LongRangeBuilder",1,0.00,1.00,4,0.04,629.26,1,0,16,1,1,126.50,0,6,0,1,126.50,0.00,0.00,0.00,0,0.00,1,113.18,0,0,1,java.lang.Object,0.00,0,0,1,0,0,1,0,0,31,0
"org.apache.lucene.search.PhrasePositions",6,0.22,1.67,39,0.35,6249.19,16,10,2,10,7,138.71,23,51,4,1,118.09,0.00,0.00,0.28,1,0.00,2,1048.72,0,1,3,java.lang.Object,0.00,4,0,10,0,4,5,0,16,238,1
"org.apache.lucene.search.PhraseQuery",13,0.10,2.15,90,1.19,65869.58,18,5,20,39,72,133.24,44,112,53,2,112.62,1.00,0.33,0.29,2,15.00,8,3561.09,2,4,20,org.apache.lucene.search.Query,0.17,26,1,28,1,26,9,0,12,717,1
"org.apache.lucene.search.PhraseQuery$PhraseWeight",8,0.10,2.25,76,1.28,69336.92,11,3,20,50,23,154.21,8,95,0,2,104.21,0.00,0.50,0.42,1,0.00,8,3850.73,0,2,23,org.apache.lucene.search.Weight,0.43,42,1,18,0,42,6,0,8,673,1
"org.apache.lucene.search.PhraseQuery$PostingsAndFreq",4,0.47,5.00,57,0.64,37042.04,9,5,20,10,2,96.64,1,66,0,1,96.64,0.00,0.00,0.55,0,0.00,7,1914.03,0,0,2,java.lang.Object,0.00,6,0,20,0,6,4,1,1,398,1
"org.apache.lucene.search.PhraseQueue",2,0.00,2.50,12,0.14,8137.34,2,0,1,2,3,163.34,2,21,1,2,113.34,0.00,0.50,0.00,0,2.00,4,427.10,0,0,2,org.apache.lucene.util.PriorityQueue,0.00,0,1,5,0,0,2,0,2,102,1
"org.apache.lucene.search.PhraseScorer",9,0.09,1.78,51,0.55,20758.48,13,4,2,12,6,138.93,33,69,2,3,118.31,1.00,0.40,0.33,1,0.00,5,1654.71,0,1,4,org.apache.lucene.search.Scorer,0.79,3,2,16,2,3,8,0,16,356,1
"org.apache.lucene.search.PositiveScoresOnlyCollector",5,0.00,1.20,15,0.15,2610.20,7,2,2,11,5,181.76,7,26,1,2,131.76,0.00,0.50,0.50,0,0.00,2,453.39,0,0,4,org.apache.lucene.search.Collector,0.67,6,1,6,0,6,5,0,3,117,1
"org.apache.lucene.search.PrefixFilter",3,0.00,1.00,11,0.10,2058.03,3,0,1,9,5,180.87,5,14,2,3,130.87,0.00,0.67,0.00,1,4.00,1,285.89,0,2,3,org.apache.lucene.search.MultiTermQueryWrapperFilter,0.33,6,2,3,0,6,1,0,2,76,1
"org.apache.lucene.search.PrefixQuery",6,0.20,2.50,35,0.43,14916.11,7,1,6,19,26,167.98,10,51,19,3,117.98,0.00,0.67,0.83,0,0.00,7,1283.84,4,3,7,org.apache.lucene.search.MultiTermQuery,0.12,13,2,15,0,13,3,0,5,282,1
"org.apache.lucene.search.PrefixTermsEnum",2,1.00,1.50,10,0.09,1352.60,3,1,5,3,6,143.16,7,15,2,3,122.55,0.00,0.67,0.50,0,2.00,2,263.12,1,1,4,org.apache.lucene.index.FilteredTermsEnum,0.00,1,2,3,0,1,1,0,1,65,1
"org.apache.lucene.search.Query",10,0.67,1.50,31,0.32,7118.74,11,1,4,15,395,130.88,47,47,393,1,130.65,0.00,0.00,0.40,1,18.00,5,955.90,1,5,4,java.lang.Object,0.00,5,0,15,61,5,5,1,11,232,2
"org.apache.lucene.search.QueryUtils",12,1.00,2.42,113,2.02,96215.16,13,1,20,62,49,104.69,51,160,27,1,104.46,0.00,0.00,0.08,7,22.00,7,6059.39,0,1,23,java.lang.Object,0.00,50,0,29,0,50,11,0,28,1136,1
"org.apache.lucene.search.QueryUtils$Collector",4,0.00,4.25,47,1.16,83690.32,7,3,20,22,6,147.80,4,72,0,1,97.80,0.00,0.00,0.33,0,4.00,12,3469.64,0,0,6,java.lang.Object,0.00,18,0,17,0,18,4,0,4,559,0
"org.apache.lucene.search.QueryUtils$Collector_0",4,0.00,2.25,40,0.76,41497.40,7,3,20,20,7,151.89,4,51,0,1,101.89,0.00,0.00,0.33,0,4.00,4,2289.98,0,0,7,java.lang.Object,0.00,16,0,9,0,16,4,0,4,398,0
"org.apache.lucene.search.QueryUtils$FCInvisibleMultiReader",3,0.50,1.00,8,0.06,892.58,4,1,20,4,2,140.29,0,14,0,5,140.29,0.00,0.80,0.67,0,1.00,1,184.47,0,2,2,org.apache.lucene.index.MultiReader,0.19,1,4,3,0,1,1,0,0,52,2
"org.apache.lucene.search.QueryUtils$Query",1,0.00,1.00,3,0.02,200.88,1,0,20,1,0,135.07,0,5,0,1,135.07,0.00,0.00,0.00,0,1.00,1,52.97,0,1,0,java.lang.Object,0.00,0,0,1,0,0,0,0,0,17,0
"org.apache.lucene.search.QueryWrapperFilter",6,0.20,1.17,17,0.19,3577.72,7,1,3,12,23,177.76,15,29,17,2,137.88,0.00,0.50,0.83,1,0.00,2,573.51,0,2,6,org.apache.lucene.util.Filter,0.00,6,1,7,0,6,4,0,4,141,1
"org.apache.lucene.search.QueryWrapperFilter$DocIdSet",2,0.00,1.00,5,0.04,515.98,2,0,3,3,1,140.78,0,7,0,1,140.78,0.00,0.00,0.00,0,2.00,1,127.94,0,1,1,java.lang.Object,0.00,1,0,2,0,1,1,0,0,35,0
"org.apache.lucene.search.RandomSimilarityProvider",5,0.21,1.60,58,0.76,20928.17,17,12,36,35,30,143.41,14,84,0,3,103.53,0.00,0.67,0.25,0,0.00,2,2270.47,0,2,30,org.apache.lucene.search.similarities.PerFieldSimilarityWrapper,0.38,30,2,8,0,30,3,0,13,445,1
"org.apache.lucene.search.ReferenceManager",11,0.13,1.55,51,0.44,13001.22,14,3,4,15,3,106.37,63,72,2,1,124.25,0.00,0.00,0.21,8,32.00,4,1312.29,0,0,1,java.lang.Object,0.00,4,0,17,2,4,11,1,14,299,2
"org.apache.lucene.search.RegexpQuery",4,0.00,1.25,17,0.20,5053.89,4,0,6,14,20,113.71,63,24,14,4,124.07,0.00,0.75,0.00,0,6.00,2,589.47,1,1,6,org.apache.lucene.search.AutomatonQuery,0.00,10,3,5,0,10,3,0,7,140,1
"org.apache.lucene.search.RegexpQuery$AutomatonProvider",1,0.00,1.00,3,0.02,141.06,1,0,6,1,1,136.28,0,4,0,1,136.28,0.00,0.00,0.00,0,1.00,1,51.02,0,1,1,java.lang.Object,0.00,0,0,1,0,0,0,0,0,16,0
"org.apache.lucene.search.ReqExclScorer",6,0.27,2.67,47,0.41,17969.79,9,3,1,12,3,94.00,32,67,1,3,111.87,0.00,0.67,0.56,0,0.00,5,1235.39,0,0,2,org.apache.lucene.search.Scorer,0.75,6,2,16,0,6,6,0,11,283,0
"org.apache.lucene.search.ReqOptSumScorer",5,0.00,1.60,23,0.24,9999.95,7,2,1,9,2,143.05,17,38,1,3,122.44,0.00,0.67,0.50,0,0.00,4,721.20,0,0,1,org.apache.lucene.search.Scorer,0.80,4,2,8,0,4,5,0,4,171,0
"org.apache.lucene.search.ScoreCachingWrappingScorer",7,0.06,1.14,23,0.23,4446.23,10,3,1,11,6,181.10,12,38,4,3,131.10,0.00,0.67,0.38,0,0.00,2,686.38,0,0,2,org.apache.lucene.search.Scorer,0.71,4,2,8,0,4,7,0,2,173,1
"org.apache.lucene.search.ScoreDoc",3,0.00,1.00,12,0.10,1357.27,6,3,0,3,114,79.52,24,17,114,1,127.63,0.00,0.00,0.33,0,4.00,1,304.50,0,1,0,java.lang.Object,0.00,0,0,3,3,0,2,0,8,83,1
"org.apache.lucene.search.Scorer",7,1.00,1.29,24,0.21,3953.59,8,1,3,11,165,83.37,58,33,164,2,131.47,41.00,0.02,0.14,0,17.00,2,628.27,0,2,3,org.apache.lucene.search.DocIdSetIterator,0.00,4,1,9,41,4,5,0,9,155,2
"org.apache.lucene.search.Scorer$ChildScorer",1,2.00,1.00,6,0.04,570.78,3,2,3,1,1,120.27,0,8,0,1,120.27,0.00,0.00,0.00,0,1.00,1,130.51,0,0,1,java.lang.Object,0.00,0,0,1,0,0,1,0,0,37,2
"org.apache.lucene.search.ScoringRewrite",2,0.00,2.00,26,0.45,26395.99,2,0,13,15,14,67.46,27,30,2,3,96.84,0.00,0.67,0.00,0,2.00,3,1336.27,3,0,13,org.apache.lucene.search.TermCollectingRewrite,0.00,13,2,4,0,13,2,0,5,246,2
"org.apache.lucene.search.ScoringRewrite$ParallelArraysTermCollector",2,0.50,1.50,21,0.38,16794.62,6,4,13,17,8,152.70,2,27,0,2,102.70,0.00,0.50,0.50,0,2.00,2,1133.71,0,0,8,org.apache.lucene.search.TermCollector,0.00,15,1,3,0,15,2,0,2,214,1
"org.apache.lucene.search.ScoringRewrite$RewriteMethod",2,0.00,1.50,9,0.10,2856.48,2,0,13,8,5,173.61,3,13,0,1,123.61,0.00,0.00,0.00,0,2.00,2,313.76,0,2,5,java.lang.Object,0.00,6,0,3,0,6,0,0,3,70,0
"org.apache.lucene.search.ScoringRewrite$ScoringRewrite<BooleanQuery>",4,0.00,1.25,11,0.14,2457.34,4,0,13,10,4,137.76,1,20,0,1,137.76,0.00,0.00,0.00,0,4.00,2,414.94,0,1,4,java.lang.Object,0.00,6,0,5,0,6,3,0,1,99,0
"org.apache.lucene.search.ScoringRewrite$TermFreqBoostByteStart",4,0.33,1.25,24,0.34,16475.72,6,2,13,7,3,113.46,0,33,0,2,113.46,0.00,0.50,0.75,0,0.00,2,1007.70,3,0,3,org.apache.lucene.util.DirectBytesStartArray,0.00,3,1,5,0,3,4,0,0,216,2
"org.apache.lucene.search.SearchEquivalenceTestBase",9,0.10,1.89,91,1.11,47475.67,15,6,19,45,25,86.37,47,96,3,2,104.24,3.00,0.20,0.26,3,18.00,4,3330.98,0,3,22,org.apache.lucene.util.LuceneTestCase,0.00,36,1,17,3,36,6,0,19,627,2
"org.apache.lucene.search.SearchEquivalenceTestBase$FilteredQuery",1,0.00,1.00,3,0.02,216.01,1,0,19,1,1,134.82,0,5,0,1,134.82,0.00,0.00,0.00,0,1.00,1,72.62,0,0,1,java.lang.Object,0.00,0,0,1,0,0,1,0,0,21,0
"org.apache.lucene.search.SearchEquivalenceTestBase$FilteredQuery_0",1,0.00,1.00,3,0.02,216.01,1,0,19,1,1,134.82,0,5,0,1,134.82,0.00,0.00,0.00,0,1.00,1,72.62,0,0,1,java.lang.Object,0.00,0,0,1,0,0,1,0,0,21,0
"org.apache.lucene.search.SearcherFactory",1,0.00,1.00,3,0.02,275.49,1,0,6,2,8,183.47,26,5,3,1,133.99,0.00,0.00,0.00,0,1.00,1,61.77,0,1,5,java.lang.Object,0.00,1,0,1,0,1,0,0,3,19,1
"org.apache.lucene.search.SearcherLifetimeManager",6,0.07,2.83,57,0.71,29378.39,9,3,10,29,6,153.38,138,73,1,1,106.11,0.00,0.00,0.39,1,0.00,5,2123.11,0,1,5,java.lang.Object,0.00,23,0,17,0,23,5,1,29,418,1
"org.apache.lucene.search.SearcherLifetimeManager$PruneByAge",2,1.00,1.50,8,0.08,1472.60,3,1,10,3,1,125.87,0,13,0,1,125.87,0.00,0.00,0.50,0,2.00,2,235.55,0,0,1,java.lang.Object,0.00,1,0,3,0,1,2,1,0,59,3
"org.apache.lucene.search.SearcherLifetimeManager$Pruner",1,0.00,1.00,2,0.01,54.79,1,0,10,1,1,128.21,5,3,0,1,146.08,0.00,0.00,0.00,0,1.00,1,36.53,0,0,1,,0.00,0,0,1,0,0,1,0,1,13,1
"org.apache.lucene.search.SearcherLifetimeManager$SearcherTracker",3,0.17,1.67,18,0.18,3611.87,6,3,10,8,1,157.48,6,25,0,1,117.60,0.00,0.00,0.44,0,2.00,3,544.61,0,0,1,java.lang.Object,0.00,5,0,5,0,5,3,2,6,129,2
"org.apache.lucene.search.SearcherManager",7,1.00,1.71,42,0.50,16560.34,8,1,5,17,9,65.28,68,62,2,2,115.28,0.00,0.50,0.14,1,18.00,3,1492.16,2,2,7,org.apache.lucene.search.ReferenceManager,0.00,10,1,12,0,10,5,0,5,319,2
"org.apache.lucene.search.ShardSearchingTestBase",3,1.00,4.00,44,0.66,27656.41,4,1,18,22,15,54.42,23,56,0,2,96.71,0.00,0.50,0.00,0,3.00,6,1966.32,0,1,15,org.apache.lucene.util.LuceneTestCase,0.00,19,1,12,0,19,2,0,23,362,2
"org.apache.lucene.search.ShardSearchingTestBase$FieldAndShardVersion",4,0.56,1.25,17,0.20,5209.17,7,3,18,6,0,123.96,0,26,0,1,123.96,0.00,0.00,0.75,0,0.00,2,599.97,0,1,0,java.lang.Object,0.00,2,0,5,0,2,3,0,0,145,2
"org.apache.lucene.search.ShardSearchingTestBase$NodeState",10,0.19,1.80,97,1.27,59254.30,23,13,18,44,9,145.45,23,119,0,1,105.56,0.00,0.00,0.25,0,0.00,4,3798.92,0,2,9,java.lang.Object,0.00,34,0,18,0,34,8,1,21,735,2
"org.apache.lucene.search.ShardSearchingTestBase$NodeState$ChangeIndices",1,0.00,7.00,23,0.41,28037.61,1,0,18,12,2,134.73,1,33,0,2,84.73,0.00,0.50,0.00,0,0.00,7,1217.66,0,0,2,org.apache.lucene.index.Thread,0.00,11,1,7,0,11,1,0,1,209,2
"org.apache.lucene.search.ShardSearchingTestBase$NodeState$SearcherAndVersion",1,2.00,1.00,6,0.04,607.65,3,2,18,1,1,120.05,0,8,0,1,120.05,0.00,0.00,0.00,0,1.00,1,132.64,0,0,1,java.lang.Object,0.00,0,0,1,0,0,1,0,0,37,2
"org.apache.lucene.search.ShardSearchingTestBase$NodeState$ShardIndexSearcher",10,0.17,3.40,139,1.88,154428.52,12,2,18,30,11,136.07,27,159,0,2,96.18,0.00,0.50,0.65,0,0.00,7,5635.30,5,0,11,org.apache.lucene.search.IndexSearcher,0.19,20,1,34,0,20,10,0,27,1022,1
"org.apache.lucene.search.ShardSearchingTestBase$SearcherExpiredException",1,0.00,1.00,3,0.02,124.13,1,0,18,1,0,136.71,0,5,0,2,136.71,0.00,0.50,0.00,0,1.00,1,49.65,0,0,0,java.lang.RuntimeException,0.00,0,1,1,0,0,1,0,0,17,2
"org.apache.lucene.search.ShardSearchingTestBase$TermAndShardVersion",3,0.50,1.33,15,0.17,4847.23,6,3,18,5,1,119.60,0,22,0,1,119.60,0.00,0.00,0.67,0,1.00,2,505.95,0,0,1,java.lang.Object,0.00,2,0,4,0,2,3,0,0,122,2
"org.apache.lucene.search.SingleDocTestFilter",2,1.00,1.50,9,0.12,3318.35,3,1,4,8,6,123.09,0,13,1,2,123.09,0.00,0.50,0.50,0,2.00,2,348.89,0,1,5,org.apache.lucene.search.Filter,0.00,6,1,3,0,6,1,0,0,78,1
"org.apache.lucene.search.SloppyPhraseScorer",21,0.02,4.19,303,3.62,271520.68,30,9,10,69,9,63.32,146,336,2,4,95.54,0.00,0.75,0.13,13,164.00,12,10846.40,0,4,7,org.apache.lucene.search.PhraseScorer,0.10,48,3,88,0,48,17,0,91,2042,1
"org.apache.lucene.search.SloppyPhraseScorer$Comparator<PhrasePositions>",1,0.00,1.00,3,0.03,437.67,1,0,10,1,1,132.40,0,4,0,1,132.40,0.00,0.00,0.00,0,1.00,1,86.26,0,0,1,java.lang.Object,0.00,0,0,1,0,0,1,0,0,25,0
"org.apache.lucene.search.Sort",10,0.22,1.70,43,0.46,17455.60,13,3,2,18,107,74.41,109,55,106,1,122.89,0.00,0.00,0.13,1,18.00,4,1371.11,0,3,2,java.lang.Object,0.00,8,0,17,0,8,7,0,13,312,1
"org.apache.lucene.search.SortField",22,0.02,2.50,133,2.15,112254.46,32,10,4,52,98,80.34,136,206,92,1,112.56,0.00,0.00,0.12,1,178.00,16,6441.58,0,7,6,java.lang.Object,0.00,30,0,55,1,30,15,0,39,1228,1
"org.apache.lucene.search.SortField$Type",0,0.00,0.00,2,0.03,150.12,0,0,4,0,0,171.00,2,15,0,1,171.00,0.00,0.00,0.00,0,0.00,0,75.06,0,0,0,java.lang.Object,0.00,0,0,0,0,0,0,0,1,18,2
"org.apache.lucene.search.TermCollectingRewrite",4,0.00,2.75,29,0.48,32391.63,4,0,12,14,14,158.47,6,38,3,2,108.47,6.00,0.12,0.00,1,4.00,8,1425.37,0,0,11,MultiTermQuery.RewriteMethod,0.00,10,1,11,6,10,4,0,6,261,1
"org.apache.lucene.search.TermCollectingRewrite$TermCollector",3,3.00,1.00,9,0.08,1247.23,6,3,12,4,5,182.58,3,11,0,1,132.58,0.00,0.00,0.00,0,3.00,1,252.57,0,0,5,java.lang.Object,0.00,1,0,3,0,1,3,0,3,67,3
"org.apache.lucene.search.TermQuery",9,0.08,1.44,43,0.50,14655.16,12,3,16,25,221,163.05,18,61,205,2,123.17,0.00,0.50,0.41,2,0.00,3,1489.79,1,3,16,org.apache.lucene.search.Query,0.11,16,1,13,0,16,6,0,12,334,1
"org.apache.lucene.search.TermQuery$TermWeight",10,0.04,1.50,56,0.89,31743.02,13,3,16,41,19,167.26,11,80,0,2,117.26,0.00,0.50,0.30,2,26.00,3,2681.67,0,6,19,org.apache.lucene.search.Weight,0.38,31,1,15,0,31,4,0,7,530,1
"org.apache.lucene.search.TermRangeFilter",8,0.00,1.25,19,0.23,5151.21,8,0,1,15,14,105.38,54,21,11,3,137.60,0.00,0.67,0.00,0,8.00,3,675.59,0,5,3,org.apache.lucene.search.MultiTermQueryWrapperFilter,0.00,7,2,10,0,7,3,0,10,172,1
"org.apache.lucene.search.TermRangeQuery",10,0.28,3.60,64,0.94,44526.68,14,4,6,24,42,113.18,44,84,35,3,112.95,0.00,0.67,0.50,0,0.00,12,2826.94,4,5,7,org.apache.lucene.search.MultiTermQuery,0.10,14,2,36,0,14,5,0,9,590,1
"org.apache.lucene.search.TermRangeTermsEnum",2,1.00,3.50,29,0.32,10937.21,7,5,5,5,5,116.66,36,40,2,3,98.52,0.00,0.67,0.70,0,0.00,4,968.92,1,1,3,org.apache.lucene.index.FilteredTermsEnum,0.00,3,2,7,0,3,1,0,6,199,1
"org.apache.lucene.search.TermScorer",7,0.08,1.00,20,0.20,3102.00,9,2,3,12,5,139.17,28,32,1,3,138.93,0.00,0.67,0.43,1,0.00,1,595.44,0,1,4,org.apache.lucene.search.Scorer,0.88,5,2,7,0,5,6,0,5,155,1
"org.apache.lucene.search.TermStatistics",4,0.11,1.00,16,0.12,3139.10,7,3,2,4,23,165.63,10,21,21,1,125.75,0.00,0.00,0.25,0,10.00,1,345.71,0,1,2,java.lang.Object,0.00,0,0,4,0,0,3,0,5,92,1
"org.apache.lucene.search.TestAutomatonQuery",11,0.08,1.09,94,1.38,33749.52,15,4,16,49,19,149.72,29,123,0,2,109.83,0.00,0.50,0.32,2,14.00,2,4127.24,2,1,19,org.apache.lucene.util.LuceneTestCase,0.00,38,1,12,0,38,10,0,16,830,1
"org.apache.lucene.search.TestAutomatonQueryUnicode",6,0.10,1.00,64,0.75,23776.25,10,4,11,23,12,145.25,13,74,0,2,105.36,0.00,0.50,0.33,2,10.00,1,2264.07,2,1,12,org.apache.lucene.util.LuceneTestCase,0.00,17,1,6,0,17,5,0,4,441,1
"org.apache.lucene.search.TestBoolean2",15,0.14,1.87,204,3.39,156838.89,25,10,18,61,27,147.65,15,242,1,2,97.65,0.00,0.50,0.23,1,0.00,9,10175.83,0,1,26,org.apache.lucene.util.LuceneTestCase,0.00,46,1,28,0,46,14,0,13,1827,1
"org.apache.lucene.search.TestBoolean2$Callback",1,0.00,1.00,2,0.01,52.70,1,0,18,1,1,146.21,0,3,0,1,146.21,0.00,0.00,0.00,0,1.00,1,31.26,0,0,1,,0.00,0,0,1,0,0,1,0,0,12,2
"org.apache.lucene.search.TestBoolean2$DefaultSimilarity",1,0.00,1.00,3,0.03,601.38,1,0,18,1,0,131.32,0,5,0,1,131.32,0.00,0.00,0.00,0,1.00,1,93.95,0,0,0,java.lang.Object,0.00,0,0,1,0,0,1,0,0,26,0
"org.apache.lucene.search.TestBooleanMinShouldMatch",19,0.20,1.63,206,3.96,158919.39,22,3,12,54,16,84.82,113,241,0,2,102.70,0.00,0.50,0.14,2,63.00,8,11872.40,0,0,16,org.apache.lucene.util.LuceneTestCase,0.00,35,1,31,0,35,19,0,112,2256,1
"org.apache.lucene.search.TestBooleanMinShouldMatch$TestBoolean2.Callback",1,0.00,3.00,10,0.12,3530.76,1,0,12,5,2,105.51,0,9,0,1,105.51,0.00,0.00,0.00,0,1.00,3,345.51,0,0,2,java.lang.Object,0.00,4,0,3,0,4,1,0,0,72,0
"org.apache.lucene.search.TestBooleanOr",8,0.32,1.00,73,1.08,31366.32,17,9,8,25,12,127.72,29,90,0,2,107.11,0.00,0.50,0.39,0,8.00,1,3226.32,2,0,12,org.apache.lucene.util.LuceneTestCase,0.00,17,1,8,0,17,8,0,9,683,1
"org.apache.lucene.search.TestBooleanQuery",5,0.00,5.00,178,3.30,236178.54,5,0,18,67,24,96.84,17,197,0,2,76.22,0.00,0.50,0.00,0,5.00,19,9904.63,0,0,24,org.apache.lucene.util.LuceneTestCase,0.00,62,1,25,0,62,5,0,17,1563,1
"org.apache.lucene.search.TestBooleanScorer",3,0.25,2.33,75,1.26,57994.77,5,2,14,32,16,134.91,4,79,0,2,84.91,0.00,0.50,0.33,0,5.00,3,3791.14,0,0,16,org.apache.lucene.util.LuceneTestCase,0.00,29,1,7,0,29,3,0,4,635,1
"org.apache.lucene.search.TestBooleanScorer$Collector",4,0.67,1.00,9,0.08,974.14,5,1,14,5,2,140.98,0,17,0,1,140.98,0.00,0.00,0.50,0,4.00,1,234.46,0,0,2,java.lang.Object,0.00,1,0,4,0,1,4,0,0,66,0
"org.apache.lucene.search.TestBooleanScorer$Collector_0",4,1.00,1.00,10,0.11,1566.64,5,1,14,7,3,139.35,1,18,0,1,139.35,0.00,0.00,0.00,0,4.00,1,316.97,0,0,3,java.lang.Object,0.00,3,0,4,0,3,4,0,1,82,0
"org.apache.lucene.search.TestCachingCollector",5,0.25,3.20,69,0.86,34356.59,6,1,3,18,3,119.58,19,68,0,2,98.96,0.00,0.50,0.80,0,0.00,4,2567.32,0,0,3,org.apache.lucene.util.LuceneTestCase,0.00,13,1,16,0,13,5,0,19,492,1
"org.apache.lucene.search.TestCachingCollector$Collector",4,1.00,1.00,9,0.08,1041.96,5,1,3,5,2,140.75,0,15,0,1,140.75,0.00,0.00,0.25,0,6.00,1,253.44,0,0,2,java.lang.Object,0.00,1,0,4,0,1,4,0,0,70,0
"org.apache.lucene.search.TestCachingCollector$MockScorer",5,0.00,1.00,11,0.08,896.67,5,0,3,5,1,142.02,0,13,0,3,142.02,0.00,0.67,0.00,0,5.00,1,234.91,0,0,1,org.apache.lucene.search.Scorer,0.80,0,2,5,0,0,5,0,0,69,2
"org.apache.lucene.search.TestCachingCollector$NoOpCollector",5,1.00,1.00,9,0.08,837.06,6,1,3,5,3,153.49,0,16,0,2,153.49,0.00,0.50,0.20,0,8.00,1,245.92,0,0,3,org.apache.lucene.search.Collector,0.44,0,1,5,0,0,5,0,0,72,2
"org.apache.lucene.search.TestCachingWrapperFilter",7,0.00,1.29,147,2.37,144694.12,7,0,16,53,27,69.77,39,162,0,2,87.64,0.00,0.50,0.00,1,7.00,2,7109.39,0,1,27,org.apache.lucene.util.LuceneTestCase,0.00,46,1,9,0,46,6,0,39,1223,1
"org.apache.lucene.search.TestCachingWrapperFilter$Filter",1,0.00,1.00,3,0.02,204.75,1,0,16,1,3,135.00,0,5,0,1,135.00,0.00,0.00,0.00,0,1.00,1,65.11,0,1,3,java.lang.Object,0.00,0,0,1,0,0,0,0,0,19,0
"org.apache.lucene.search.TestCachingWrapperFilter$Filter_0",1,0.00,1.00,3,0.02,189.62,1,0,16,2,3,135.26,0,5,0,1,135.26,0.00,0.00,0.00,0,1.00,1,59.81,0,1,3,java.lang.Object,0.00,1,0,1,0,1,0,0,0,18,0
"org.apache.lucene.search.TestCachingWrapperFilter$Filter_0$DocIdSet",1,0.00,1.00,3,0.01,149.03,1,0,16,1,1,136.09,0,5,0,1,136.09,0.00,0.00,0.00,0,1.00,1,44.54,0,1,1,java.lang.Object,0.00,0,0,1,0,0,0,0,0,15,0
"org.apache.lucene.search.TestCachingWrapperFilter$Filter_1",1,0.00,1.00,3,0.04,492.38,1,0,16,4,4,132.00,0,5,0,1,132.00,0.00,0.00,0.00,0,1.00,1,108.08,0,1,4,java.lang.Object,0.00,3,0,1,0,3,0,0,0,28,0
"org.apache.lucene.search.TestComplexExplanations",24,0.00,1.00,196,3.41,141980.04,24,0,4,52,15,107.61,20,238,1,3,107.61,0.50,0.50,0.00,1,104.00,1,10239.84,9,1,14,org.apache.lucene.search.TestExplanations,0.00,28,2,24,1,28,23,0,13,1921,1
"org.apache.lucene.search.TestComplexExplanations$DefaultSimilarity",1,0.00,1.00,3,0.02,200.88,1,0,4,1,0,185.07,1,5,0,1,135.07,0.00,0.00,0.00,0,1.00,1,52.97,0,0,0,java.lang.Object,0.00,0,0,1,0,0,1,0,1,17,0
"org.apache.lucene.search.TestComplexExplanationsOfNonMatches",1,0.00,1.00,3,0.04,549.65,1,0,0,2,3,180.90,24,7,0,4,131.62,0.00,0.75,0.00,0,0.00,1,119.24,0,0,3,org.apache.lucene.search.TestComplexExplanations,0.00,1,3,1,0,1,1,0,3,30,1
"org.apache.lucene.search.TestConstantScoreQuery",4,0.00,1.50,68,1.17,51862.15,4,0,10,35,20,142.62,6,75,0,2,92.62,0.00,0.50,0.00,1,4.00,3,3523.79,0,0,20,org.apache.lucene.util.LuceneTestCase,0.00,31,1,6,0,31,4,0,5,633,1
"org.apache.lucene.search.TestConstantScoreQuery$Collector",4,1.00,1.25,14,0.18,4517.67,5,1,10,9,3,129.11,0,23,0,1,129.11,0.00,0.00,0.00,0,4.00,2,550.28,0,0,3,java.lang.Object,0.00,5,0,5,0,5,4,0,0,125,0
"org.apache.lucene.search.TestConstantScoreQuery$DefaultSimilarity",1,0.00,1.00,3,0.02,200.88,1,0,10,1,0,135.07,0,5,0,1,135.07,0.00,0.00,0.00,0,1.00,1,52.97,0,0,0,java.lang.Object,0.00,0,0,1,0,0,1,0,0,17,0
"org.apache.lucene.search.TestCustomSearcherSort",7,0.08,2.57,85,1.19,54881.00,11,4,15,39,14,57.57,50,99,0,2,99.86,0.00,0.50,0.32,3,4.00,5,3556.86,2,0,14,org.apache.lucene.util.LuceneTestCase,0.00,32,1,18,0,32,7,0,40,659,1
"org.apache.lucene.search.TestCustomSearcherSort$CustomSearcher",3,0.50,1.00,15,0.26,5681.72,4,1,15,8,10,101.25,17,25,0,2,119.12,0.00,0.50,0.67,0,1.00,1,779.83,1,2,10,org.apache.lucene.search.IndexSearcher,0.00,5,1,3,0,5,1,0,3,162,1
"org.apache.lucene.search.TestCustomSearcherSort$RandomGen",2,0.00,1.00,7,0.08,1012.32,4,2,15,6,1,131.91,1,11,0,1,131.91,0.00,0.00,0.50,0,2.00,1,246.16,0,1,1,java.lang.Object,0.00,4,0,2,0,4,1,0,1,62,1
"org.apache.lucene.search.TestDateFilter",2,0.00,1.00,61,1.30,56870.47,2,0,10,20,13,70.47,31,79,0,2,80.83,0.00,0.50,0.00,0,2.00,1,3901.42,0,0,13,org.apache.lucene.util.LuceneTestCase,0.00,18,1,2,0,18,2,0,23,640,1
"org.apache.lucene.search.TestDateSort",4,0.42,1.25,48,0.66,16441.75,8,4,11,24,15,102.47,16,53,0,2,102.23,0.00,0.50,0.56,1,0.00,2,1985.20,2,1,15,org.apache.lucene.util.LuceneTestCase,0.00,20,1,5,0,20,3,0,13,375,1
"org.apache.lucene.search.TestDisjunctionMaxQuery",15,0.13,2.00,260,4.66,211078.68,21,6,17,61,25,112.89,52,336,0,2,92.27,0.00,0.50,0.29,2,0.00,3,13994.70,2,2,25,org.apache.lucene.util.LuceneTestCase,0.00,46,1,30,0,46,13,0,41,2371,1
"org.apache.lucene.search.TestDisjunctionMaxQuery$TestSimilarity",4,0.00,1.25,8,0.09,1278.66,4,0,17,6,3,140.00,1,16,0,4,140.00,0.00,0.75,0.00,0,4.00,2,261.11,1,0,3,org.apache.lucene.search.similarities.DefaultSimilarity,0.23,2,3,5,0,2,4,0,1,71,2
"org.apache.lucene.search.TestDocBoost",1,0.00,3.00,29,0.46,20878.31,1,0,9,23,12,49.96,6,32,0,2,82.18,0.00,0.50,0.00,0,1.00,3,1366.72,0,0,12,org.apache.lucene.util.LuceneTestCase,0.00,22,1,3,0,22,1,0,3,225,1
"org.apache.lucene.search.TestDocBoost$Collector",4,0.17,1.00,11,0.11,1680.83,6,2,9,5,2,139.11,0,19,0,1,139.11,0.00,0.00,0.38,0,4.00,1,330.56,0,0,2,java.lang.Object,0.00,1,0,4,0,1,4,0,0,85,0
"org.apache.lucene.search.TestDocIdSet",3,0.00,2.33,51,0.82,29220.85,3,0,13,33,13,133.38,6,59,0,2,93.50,0.00,0.50,0.00,0,3.00,5,2452.70,0,0,13,org.apache.lucene.util.LuceneTestCase,0.00,30,1,7,0,30,3,0,6,434,1
"org.apache.lucene.search.TestDocIdSet$DocIdSet",1,0.00,1.00,3,0.01,138.80,1,0,13,2,1,136.33,0,5,0,1,136.33,0.00,0.00,0.00,0,1.00,1,39.70,0,1,1,java.lang.Object,0.00,1,0,1,0,1,0,0,0,14,0
"org.apache.lucene.search.TestDocIdSet$DocIdSet$DocIdSetIterator",3,0.00,1.67,10,0.09,1823.63,4,1,13,3,0,131.16,0,16,0,1,131.16,0.00,0.00,1.00,0,0.00,2,270.60,0,0,0,java.lang.Object,0.00,0,0,5,0,0,3,0,0,70,0
"org.apache.lucene.search.TestDocIdSet$Filter",1,0.00,1.00,3,0.03,276.44,1,0,13,1,3,133.98,0,5,0,1,133.98,0.00,0.00,0.00,0,1.00,1,76.00,0,1,3,java.lang.Object,0.00,0,0,1,0,0,0,0,0,21,0
"org.apache.lucene.search.TestDocIdSet$Filter_0",1,0.00,1.00,4,0.03,493.63,1,0,13,3,4,127.33,0,6,0,1,127.33,0.00,0.00,0.00,0,1.00,1,95.57,0,1,4,java.lang.Object,0.00,2,0,1,0,2,0,0,0,25,0
"org.apache.lucene.search.TestDocIdSet$Filter_0$DocIdSet_1",1,0.00,1.00,3,0.01,149.03,1,0,13,1,1,136.09,0,5,0,1,136.09,0.00,0.00,0.00,0,1.00,1,44.54,0,1,1,java.lang.Object,0.00,0,0,1,0,0,0,0,0,15,0
"org.apache.lucene.search.TestDocIdSet$Filter_0$FilteredDocIdSet_2",1,0.00,1.00,3,0.02,180.53,1,0,13,1,0,135.43,0,5,0,1,135.43,0.00,0.00,0.00,0,1.00,1,58.21,0,0,0,java.lang.Object,0.00,0,0,1,0,0,1,0,0,18,0
"org.apache.lucene.search.TestDocIdSet$FilteredDocIdSet",1,0.00,1.00,3,0.03,358.99,1,0,13,1,0,183.08,1,5,0,1,133.08,0.00,0.00,0.00,0,1.00,1,78.03,0,0,0,java.lang.Object,0.00,0,0,1,0,0,1,0,1,22,0
"org.apache.lucene.search.TestDocValuesScoring",1,0.00,1.00,54,0.95,49401.38,2,1,19,27,20,113.36,22,57,0,2,69.42,0.00,0.50,1.00,0,0.00,1,2864.66,0,0,20,org.apache.lucene.util.LuceneTestCase,0.00,26,1,1,0,26,1,0,12,456,1
"org.apache.lucene.search.TestDocValuesScoring$BoostingSimilarity",5,0.12,1.00,18,0.24,4370.50,7,2,19,14,6,130.04,0,28,0,2,130.04,0.00,0.50,0.60,0,0.00,1,712.88,0,3,6,org.apache.lucene.search.similarities.Similarity,0.00,9,1,5,0,9,2,0,0,167,1
"org.apache.lucene.search.TestDocValuesScoring$BoostingSimilarity$ExactSimScorer",2,0.00,1.00,10,0.16,4869.78,2,0,19,8,1,118.26,0,14,0,1,118.26,0.00,0.00,0.00,0,2.00,1,480.65,0,1,1,java.lang.Object,0.00,6,0,2,0,6,1,0,0,105,0
"org.apache.lucene.search.TestDocValuesScoring$BoostingSimilarity$SloppySimScorer",4,0.00,1.00,14,0.22,5869.57,4,0,19,12,2,128.27,0,22,0,1,128.27,0.00,0.00,0.00,0,6.00,1,649.83,0,1,2,java.lang.Object,0.00,8,0,4,0,8,3,0,0,148,0
"org.apache.lucene.search.TestDocValuesScoring$PerFieldSimilarityWrapper",3,1.00,1.33,8,0.09,1483.78,4,1,19,7,1,138.49,0,14,0,1,138.49,0.00,0.00,0.33,0,4.00,2,278.43,0,1,1,java.lang.Object,0.00,4,0,4,0,4,2,0,0,73,0
"org.apache.lucene.search.TestElevationComparator",4,0.67,1.75,58,1.10,40894.99,5,1,12,38,19,117.16,14,68,0,2,96.54,0.00,0.50,0.50,3,4.00,2,3312.39,0,2,19,org.apache.lucene.util.LuceneTestCase,0.00,34,1,7,0,34,2,0,4,583,1
"org.apache.lucene.search.TestExplanations",19,0.03,1.11,80,1.03,25843.89,26,7,18,42,24,163.73,49,104,4,2,123.84,7.00,0.11,0.11,6,73.00,2,3083.76,0,14,20,org.apache.lucene.util.LuceneTestCase,0.00,23,1,21,7,23,5,0,22,684,1
"org.apache.lucene.search.TestExplanations$ItemizedFilter",3,0.00,1.33,13,0.12,4244.92,3,0,18,3,1,123.66,0,15,0,3,123.66,0.00,0.67,0.00,0,4.00,2,351.62,0,1,1,org.apache.lucene.search.FieldCacheTermsFilter,0.00,0,2,4,0,0,2,0,0,87,2
"org.apache.lucene.search.TestFieldCache",8,0.21,5.62,303,5.75,839232.47,14,6,22,95,17,112.45,17,283,0,2,72.57,0.00,0.50,0.35,1,0.00,22,17238.95,0,1,17,org.apache.lucene.util.LuceneTestCase,0.00,87,1,45,0,87,7,0,17,2557,1
"org.apache.lucene.search.TestFieldCache$Runnable",1,0.00,1.00,4,0.02,240.37,1,0,22,3,0,129.79,0,6,0,1,129.79,0.00,0.00,0.00,0,1.00,1,74.61,0,0,0,java.lang.Object,0.00,2,0,1,0,2,1,0,0,22,0
"org.apache.lucene.search.TestFieldCache$Thread",1,0.00,9.00,31,0.38,31932.84,1,0,22,13,1,119.28,2,35,0,1,79.39,0.00,0.00,0.00,0,0.00,9,1148.03,0,0,1,java.lang.Object,0.00,12,0,9,0,12,1,0,2,197,0
"org.apache.lucene.search.TestFieldCacheRangeFilter",8,0.00,1.12,343,9.23,1187651.32,8,0,9,45,13,90.31,30,358,0,3,69.70,0.00,0.67,0.00,0,0.00,2,27694.53,1,0,13,org.apache.lucene.search.BaseTestRangeFilter,0.00,37,2,9,0,37,8,0,22,4479,1
"org.apache.lucene.search.TestFieldCacheRewriteMethod",1,0.00,1.00,9,0.16,3830.91,1,0,3,7,8,107.42,4,12,0,3,107.19,0.00,0.67,0.00,0,0.00,1,480.80,0,0,8,org.apache.lucene.search.TestRegexpRandom2,0.00,6,2,1,0,6,1,0,2,96,1
"org.apache.lucene.search.TestFieldCacheTermsFilter",1,0.00,2.00,34,0.56,30722.01,1,0,8,20,9,46.15,6,34,0,2,78.38,0.00,0.50,0.00,0,1.00,2,1682.67,0,0,9,org.apache.lucene.util.LuceneTestCase,0.00,19,1,2,0,19,1,0,2,278,1
"org.apache.lucene.search.TestFieldValueFilter",3,0.00,4.00,69,0.95,41375.81,3,0,10,28,13,137.29,3,73,0,2,87.29,0.00,0.50,0.00,1,3.00,4,2857.02,0,0,13,org.apache.lucene.util.LuceneTestCase,0.00,25,1,12,0,25,3,0,1,493,1
"org.apache.lucene.search.TestFilteredQuery",21,0.03,1.29,186,3.26,131731.64,26,5,13,73,27,147.24,44,227,0,2,107.35,0.00,0.50,0.17,9,63.00,4,9781.66,2,2,27,org.apache.lucene.util.LuceneTestCase,0.00,52,1,27,0,52,19,0,33,1852,1
"org.apache.lucene.search.TestFilteredQuery$Filter",1,0.00,4.00,7,0.11,3296.84,1,0,13,6,4,111.45,0,9,0,1,111.45,0.00,0.00,0.00,0,1.00,4,325.29,0,1,4,java.lang.Object,0.00,5,0,4,0,5,0,0,0,70,0
"org.apache.lucene.search.TestFilteredQuery$Filter_0",1,0.00,1.00,6,0.06,1109.64,1,0,13,5,4,117.99,0,8,0,1,117.99,0.00,0.00,0.00,0,1.00,1,182.23,0,1,4,java.lang.Object,0.00,4,0,1,0,4,0,0,0,42,0
"org.apache.lucene.search.TestFilteredQuery$FilteredQueryRA",2,1.00,1.00,7,0.06,770.38,3,1,13,2,4,132.84,0,11,0,3,132.84,0.00,0.67,0.50,0,2.00,1,187.74,0,0,4,org.apache.lucene.search.FilteredQuery,0.00,0,2,2,0,0,2,0,0,50,3
"org.apache.lucene.search.TestFilteredSearch",2,1.00,2.50,37,0.56,15752.98,3,1,15,30,17,113.90,7,42,0,2,93.28,0.00,0.50,0.50,1,2.00,4,1690.27,0,0,17,org.apache.lucene.util.LuceneTestCase,0.00,28,1,5,0,28,2,0,5,300,1
"org.apache.lucene.search.TestFilteredSearch$SimpleDocIdSetFilter",3,0.00,2.33,21,0.25,14770.57,5,2,15,9,5,110.21,0,26,0,2,110.21,0.00,0.50,0.50,0,1.00,5,735.15,0,1,5,org.apache.lucene.search.Filter,0.00,6,1,7,0,6,2,0,0,148,3
"org.apache.lucene.search.TestFuzzyQuery",8,0.00,1.50,321,6.27,1024278.33,8,0,12,34,13,53.05,45,330,0,2,70.93,0.00,0.50,0.00,1,8.00,3,18810.61,0,0,13,org.apache.lucene.util.LuceneTestCase,0.00,26,1,12,0,26,8,0,36,3146,1
"org.apache.lucene.search.TestFuzzyQuery2",3,0.25,3.00,59,1.16,53367.86,5,2,14,41,13,128.88,65,70,0,2,89.58,0.00,0.50,0.33,2,5.00,6,3477.51,0,1,13,org.apache.lucene.util.LuceneTestCase,0.00,38,1,9,0,38,2,0,7,563,1
"org.apache.lucene.search.TestMatchAllDocsQuery",3,1.00,1.00,47,0.79,28473.01,4,1,11,33,15,145.81,5,52,0,2,95.81,0.00,0.50,0.33,1,4.00,1,2383.04,0,0,15,org.apache.lucene.util.LuceneTestCase,0.00,30,1,3,0,30,3,0,2,425,1
"org.apache.lucene.search.TestMultiTermConstantScore",13,0.14,1.62,244,5.17,653949.72,16,3,17,49,23,126.93,37,272,0,3,87.04,0.00,0.67,0.21,4,13.00,3,15513.93,1,4,23,org.apache.lucene.search.BaseTestRangeFilter,0.00,36,2,21,0,36,9,0,37,2665,1
"org.apache.lucene.search.TestMultiTermConstantScore$Collector",4,0.17,1.00,11,0.12,1576.28,6,2,17,6,2,139.33,0,19,0,1,139.33,0.00,0.00,0.38,0,4.00,1,354.47,0,0,2,java.lang.Object,0.00,2,0,4,0,2,4,0,0,90,0
"org.apache.lucene.search.TestMultiTermQueryRewrites",13,0.12,1.69,134,1.74,65552.11,22,9,16,53,19,104.42,5,155,0,2,104.42,0.00,0.50,0.22,6,19.00,3,5234.63,0,2,19,org.apache.lucene.util.LuceneTestCase,0.00,40,1,22,0,40,11,0,5,1017,1
"org.apache.lucene.search.TestMultiTermQueryRewrites$MultiTermQuery",2,0.00,1.00,5,0.06,854.63,2,0,16,5,5,139.05,0,9,0,1,139.05,0.00,0.00,0.00,0,2.00,1,181.45,0,2,5,java.lang.Object,0.00,3,0,2,0,3,0,0,0,46,0
"org.apache.lucene.search.TestMultiTermQueryRewrites$MultiTermQuery$BytesRef",1,0.00,1.00,5,0.07,1019.00,2,1,16,5,1,121.24,0,8,0,1,121.24,0.00,0.00,1.00,0,0.00,1,207.14,1,1,1,java.lang.Object,0.00,4,0,1,0,4,0,0,0,51,0
"org.apache.lucene.search.TestMultiThreadTermVectors",4,0.11,3.50,63,0.66,32362.11,7,3,12,27,14,146.07,6,69,0,2,96.07,0.00,0.50,0.25,0,0.00,6,1986.34,2,0,14,org.apache.lucene.util.LuceneTestCase,0.00,23,1,14,0,23,4,0,6,378,1
"org.apache.lucene.search.TestMultiValuedNumericRangeQuery",1,0.00,5.00,40,0.65,30474.63,1,0,12,25,12,57.69,5,37,0,2,75.56,0.00,0.50,0.00,0,1.00,5,1957.56,0,0,12,org.apache.lucene.util.LuceneTestCase,0.00,24,1,5,0,24,1,0,1,309,1
"org.apache.lucene.search.TestNGramPhraseQuery",3,0.50,1.00,52,0.72,42681.02,5,2,7,18,7,142.40,3,52,0,2,92.40,0.00,0.50,0.83,0,0.00,1,2152.20,0,0,7,org.apache.lucene.util.LuceneTestCase,0.00,15,1,3,0,15,3,0,3,410,1
"org.apache.lucene.search.TestNot",1,0.00,1.00,17,0.27,5895.56,1,0,7,18,10,95.65,4,19,0,2,95.41,0.00,0.50,0.00,0,1.00,1,823.15,0,0,10,org.apache.lucene.util.LuceneTestCase,0.00,17,1,1,0,17,1,0,1,147,1
"org.apache.lucene.search.TestNumericRangeQuery32",39,0.00,1.49,412,7.69,566998.19,45,6,21,105,32,100.83,26,505,0,2,100.83,0.00,0.50,0.17,8,288.00,5,23072.44,1,0,32,org.apache.lucene.util.LuceneTestCase,0.00,66,1,58,0,66,39,0,26,4005,1
"org.apache.lucene.search.TestNumericRangeQuery64",46,0.03,1.41,430,7.90,570155.99,52,6,21,111,32,103.09,26,538,0,2,103.09,0.00,0.50,0.14,8,358.00,5,23699.85,1,0,32,org.apache.lucene.util.LuceneTestCase,0.00,65,1,65,0,65,46,0,26,4132,1
"org.apache.lucene.search.TestPhrasePrefixQuery",1,0.00,2.00,46,0.79,52662.53,1,0,12,29,12,21.64,9,49,0,2,71.64,0.00,0.50,0.00,0,1.00,2,2367.76,0,0,12,org.apache.lucene.util.LuceneTestCase,0.00,28,1,2,0,28,1,0,5,373,1
"org.apache.lucene.search.TestPhraseQuery",20,0.11,1.55,427,6.91,368862.06,25,5,18,80,24,70.11,100,452,0,2,87.99,0.00,0.50,0.30,0,0.00,12,20744.63,1,0,24,org.apache.lucene.util.LuceneTestCase,0.00,60,1,31,0,60,20,0,73,3591,1
"org.apache.lucene.search.TestPhraseQuery$Analyzer",2,0.00,1.00,5,0.05,758.91,2,0,18,4,1,139.46,0,9,0,1,139.46,0.00,0.00,0.00,0,2.00,1,158.85,0,1,1,java.lang.Object,0.00,2,0,2,0,2,1,0,0,42,0
"org.apache.lucene.search.TestPositionIncrement",2,1.00,4.50,143,2.55,202154.19,3,1,26,50,26,13.71,21,163,0,2,62.19,0.00,0.50,0.50,0,2.00,8,7647.15,0,0,26,org.apache.lucene.util.LuceneTestCase,0.00,48,1,9,0,48,2,0,17,1201,1
"org.apache.lucene.search.TestPositionIncrement$Analyzer",1,0.00,1.00,3,0.02,303.26,1,0,26,3,1,133.66,0,5,0,1,133.66,0.00,0.00,0.00,0,1.00,1,72.73,0,1,1,java.lang.Object,0.00,2,0,1,0,2,0,0,0,21,0
"org.apache.lucene.search.TestPositionIncrement$Analyzer$Tokenizer",2,0.67,1.50,18,0.22,4765.58,8,6,26,6,3,108.72,0,23,0,1,108.72,0.00,0.00,0.50,0,2.00,2,671.74,1,0,3,java.lang.Object,0.00,4,0,3,0,4,2,0,0,141,0
"org.apache.lucene.search.TestPositiveScoresOnlyCollector",1,0.00,5.00,34,0.52,21882.38,2,1,6,20,14,61.45,5,36,0,2,79.33,0.00,0.50,1.00,0,0.00,5,1553.02,0,0,14,org.apache.lucene.util.LuceneTestCase,0.00,19,1,5,0,19,1,0,5,259,1
"org.apache.lucene.search.TestPositiveScoresOnlyCollector$SimpleScorer",5,0.25,1.60,13,0.15,3184.60,6,1,6,5,2,137.58,0,17,0,3,137.58,0.00,0.67,0.80,0,0.00,2,450.94,0,0,2,org.apache.lucene.search.Scorer,0.80,0,2,8,0,0,5,0,0,111,3
"org.apache.lucene.search.TestPrefixFilter",1,0.00,2.00,53,0.91,64983.92,1,0,7,17,11,39.24,13,56,0,2,68.62,0.00,0.50,0.00,0,1.00,2,2733.80,0,0,11,org.apache.lucene.util.LuceneTestCase,0.00,16,1,2,0,16,1,0,10,451,1
"org.apache.lucene.search.TestPrefixInBooleanQuery",6,0.45,1.33,51,0.66,16513.36,10,4,10,23,12,160.16,10,64,0,2,110.16,0.00,0.50,0.62,0,0.00,3,1974.56,0,0,12,org.apache.lucene.util.LuceneTestCase,0.00,17,1,8,0,17,6,0,1,397,1
"org.apache.lucene.search.TestPrefixQuery",1,0.00,2.00,28,0.47,18512.74,1,0,9,20,11,83.49,4,30,0,2,83.25,0.00,0.50,0.00,0,1.00,2,1400.73,0,0,11,org.apache.lucene.util.LuceneTestCase,0.00,19,1,2,0,19,1,0,1,232,1
"org.apache.lucene.search.TestPrefixRandom",2,1.00,2.00,27,0.38,11421.77,5,3,19,19,18,120.32,7,31,0,2,99.70,0.00,0.50,0.83,0,0.00,3,1137.32,2,0,18,org.apache.lucene.util.LuceneTestCase,0.00,17,1,4,0,17,2,0,4,204,1
"org.apache.lucene.search.TestPrefixRandom$DumbPrefixQuery",5,0.50,1.20,23,0.27,4942.13,6,1,19,16,9,124.92,4,28,0,3,124.92,0.00,0.67,0.60,0,5.00,2,807.56,0,2,9,org.apache.lucene.search.MultiTermQuery,0.00,11,2,6,0,11,3,0,2,186,1
"org.apache.lucene.search.TestPrefixRandom$DumbPrefixQuery$SimplePrefixTermsEnum",2,1.00,1.50,8,0.09,1588.62,3,1,19,4,4,125.61,0,13,0,3,125.61,0.00,0.67,0.50,0,2.00,2,275.44,1,1,4,org.apache.lucene.index.FilteredTermsEnum,0.00,2,2,3,0,2,1,0,0,67,1
"org.apache.lucene.search.TestQueryWrapperFilter",3,0.00,3.00,98,1.56,67264.29,3,0,13,40,17,130.34,5,98,0,2,80.34,0.00,0.50,0.00,0,3.00,5,4682.70,0,0,17,org.apache.lucene.util.LuceneTestCase,0.00,37,1,9,0,37,3,0,5,779,1
"org.apache.lucene.search.TestRegexpQuery",11,0.05,1.00,42,0.43,6088.10,15,4,14,25,13,131.60,10,59,0,2,131.60,0.00,0.50,0.20,1,36.00,1,1290.11,2,1,13,org.apache.lucene.util.LuceneTestCase,0.00,14,1,11,0,14,10,0,3,304,1
"org.apache.lucene.search.TestRegexpQuery$AutomatonProvider",1,0.00,2.00,4,0.08,1133.72,2,1,14,5,3,174.33,1,9,0,1,124.33,0.00,0.00,1.00,0,0.00,2,236.09,0,1,3,java.lang.Object,0.00,4,0,2,0,4,0,0,1,56,0
"org.apache.lucene.search.TestRegexpRandom",6,0.00,1.83,78,0.86,24079.19,9,3,15,34,14,150.93,6,84,0,2,100.93,0.00,0.50,0.33,2,10.00,3,2570.58,2,1,14,org.apache.lucene.util.LuceneTestCase,0.00,28,1,11,0,28,5,0,2,484,1
"org.apache.lucene.search.TestRegexpRandom2",2,1.00,3.00,39,0.53,19434.43,7,5,27,23,24,112.26,7,44,1,2,91.65,1.00,0.33,0.70,0,0.00,5,1578.87,2,0,23,org.apache.lucene.util.LuceneTestCase,0.00,21,1,6,1,21,2,0,4,271,1
"org.apache.lucene.search.TestRegexpRandom2$DumbRegexpQuery",5,0.75,1.60,27,0.37,7908.17,6,1,27,22,12,169.63,6,34,0,3,119.63,0.00,0.67,0.40,1,10.00,4,1118.17,0,2,12,org.apache.lucene.search.MultiTermQuery,0.00,17,2,8,0,17,3,0,4,238,1
"org.apache.lucene.search.TestRegexpRandom2$DumbRegexpQuery$SimpleAutomatonTermsEnum",2,0.00,1.50,9,0.13,2474.79,4,2,27,7,6,124.10,0,15,0,3,124.10,0.00,0.67,0.50,0,2.00,2,403.09,1,1,6,org.apache.lucene.index.FilteredTermsEnum,0.00,5,2,3,0,5,1,0,0,92,1
"org.apache.lucene.search.TestScoreCachingWrappingScorer",1,0.00,3.00,25,0.37,11360.63,2,1,7,17,9,136.67,1,28,0,2,86.67,0.00,0.50,1.00,0,0.00,3,1103.27,0,0,9,org.apache.lucene.util.LuceneTestCase,0.00,16,1,3,0,16,1,0,1,196,1
"org.apache.lucene.search.TestScoreCachingWrappingScorer$ScoreCachingCollector",5,0.08,1.20,18,0.18,4694.40,8,3,7,7,4,129.75,2,26,0,2,129.75,0.00,0.50,0.27,0,7.00,2,553.16,0,0,4,org.apache.lucene.search.Collector,0.44,2,1,6,0,2,5,0,2,134,3
"org.apache.lucene.search.TestScoreCachingWrappingScorer$SimpleScorer",5,0.12,1.60,14,0.16,3510.01,7,2,7,5,2,137.25,4,18,0,3,137.25,0.00,0.67,0.40,0,5.00,2,488.16,0,0,2,org.apache.lucene.search.Scorer,0.80,0,2,8,0,0,5,0,4,119,3
"org.apache.lucene.search.TestScorerPerf",11,0.08,3.82,200,2.64,140904.61,17,6,14,53,17,43.04,120,196,0,2,91.52,0.00,0.50,0.24,3,35.00,7,7925.66,0,3,17,org.apache.lucene.util.LuceneTestCase,0.00,42,1,42,0,42,8,0,22,1403,1
"org.apache.lucene.search.TestScorerPerf$CountingHitCollector",6,0.00,1.00,16,0.12,1732.00,9,3,14,6,3,140.40,1,22,0,2,140.40,0.00,0.50,0.33,0,10.00,1,366.75,0,0,3,org.apache.lucene.search.Collector,0.40,0,1,6,0,0,6,0,1,101,2
"org.apache.lucene.search.TestScorerPerf$Filter",1,0.00,1.00,4,0.03,408.71,1,0,14,3,4,127.98,0,6,0,1,127.98,0.00,0.00,0.00,0,1.00,1,103.91,0,1,4,java.lang.Object,0.00,2,0,1,0,2,0,0,0,27,0
"org.apache.lucene.search.TestScorerPerf$MatchingHitCollector",2,0.00,1.50,10,0.11,2339.41,4,2,14,4,0,120.67,0,14,0,2,120.67,0.00,0.50,0.50,0,2.00,2,335.01,1,0,0,org.apache.lucene.search.CountingHitCollector,0.00,2,1,3,0,2,2,0,0,78,2
"org.apache.lucene.search.TestSearchAfter",5,0.08,2.20,61,0.86,33919.37,8,3,9,27,17,150.39,6,65,0,2,100.39,0.00,0.50,0.40,2,6.00,3,2588.40,2,0,17,org.apache.lucene.util.LuceneTestCase,0.00,22,1,11,0,22,5,0,4,494,1
"org.apache.lucene.search.TestSimilarity",1,0.00,1.00,31,0.48,13097.90,1,0,14,25,17,40.66,7,36,0,2,82.95,0.00,0.50,0.00,0,1.00,1,1429.55,0,0,17,org.apache.lucene.util.LuceneTestCase,0.00,24,1,1,0,24,1,0,4,250,1
"org.apache.lucene.search.TestSimilarity$Collector",4,1.00,1.00,9,0.09,1090.26,5,1,14,6,2,140.59,0,16,0,1,140.59,0.00,0.00,0.25,0,6.00,1,259.02,0,0,2,java.lang.Object,0.00,2,0,4,0,2,4,0,0,70,0
"org.apache.lucene.search.TestSimilarity$Collector_0",4,0.17,1.00,11,0.12,1633.42,6,2,14,6,2,139.21,1,19,0,1,139.21,0.00,0.00,0.38,0,4.00,1,350.01,0,0,2,java.lang.Object,0.00,2,0,4,0,2,4,0,1,89,0
"org.apache.lucene.search.TestSimilarity$Collector_1",4,1.00,1.00,9,0.09,1090.26,5,1,14,6,2,140.59,1,16,0,1,140.59,0.00,0.00,0.25,0,6.00,1,259.02,0,0,2,java.lang.Object,0.00,2,0,4,0,2,4,0,1,70,0
"org.apache.lucene.search.TestSimilarity$Collector_2",4,1.00,1.00,9,0.09,1090.26,5,1,14,6,2,140.59,1,16,0,1,140.59,0.00,0.00,0.25,0,6.00,1,259.02,0,0,2,java.lang.Object,0.00,2,0,4,0,2,4,0,1,70,0
"org.apache.lucene.search.TestSimilarity$SimpleSimilarity",7,0.00,1.00,15,0.14,1631.67,7,0,14,10,6,141.13,0,11,0,4,141.13,0.00,0.75,0.00,0,7.00,1,411.91,1,1,6,org.apache.lucene.search.similarities.DefaultSimilarity,0.53,3,3,7,0,3,6,0,0,113,2
"org.apache.lucene.search.TestSimilarityProvider",3,0.67,1.33,45,0.63,20433.49,6,3,17,26,19,146.88,3,50,0,2,96.88,0.00,0.50,0.78,0,0.00,2,1896.74,2,0,19,org.apache.lucene.util.LuceneTestCase,0.00,23,1,4,0,23,3,0,3,358,1
"org.apache.lucene.search.TestSimilarityProvider$ExampleSimilarityProvider",1,0.00,2.00,8,0.06,842.64,3,2,17,4,2,114.11,0,11,0,3,114.11,0.00,0.67,1.00,0,0.00,2,185.77,0,1,2,org.apache.lucene.search.similarities.PerFieldSimilarityWrapper,0.00,3,2,2,0,3,0,0,0,47,1
"org.apache.lucene.search.TestSimilarityProvider$Sim1",7,0.00,1.00,15,0.13,1401.66,7,0,17,8,4,141.65,0,28,0,3,141.65,0.00,0.67,0.00,0,7.00,1,391.81,1,0,4,org.apache.lucene.search.similarities.TFIDFSimilarity,0.54,1,2,7,0,1,7,0,0,108,1
"org.apache.lucene.search.TestSimilarityProvider$Sim2",7,0.00,1.00,15,0.13,1401.66,7,0,17,8,4,141.65,0,28,0,3,141.65,0.00,0.67,0.00,0,7.00,1,391.81,1,0,4,org.apache.lucene.search.similarities.TFIDFSimilarity,0.54,1,2,7,0,1,7,0,0,108,1
"org.apache.lucene.search.TestSimpleExplanations",68,0.00,1.00,513,9.20,279792.68,68,0,1,88,12,111.01,16,586,1,3,111.01,0.50,0.50,0.00,0,0.00,1,27592.86,2,0,11,org.apache.lucene.search.TestExplanations,0.00,20,2,68,1,20,68,0,14,5570,1
"org.apache.lucene.search.TestSimpleExplanationsOfNonMatches",1,0.00,1.00,3,0.04,549.65,1,0,0,2,3,180.90,24,7,0,4,131.62,0.00,0.75,0.00,0,0.00,1,119.24,0,0,3,org.apache.lucene.search.TestSimpleExplanations,0.00,1,3,1,0,1,1,0,3,30,1
"org.apache.lucene.search.TestSimpleSearchEquivalence",12,0.00,1.00,124,1.37,39200.93,12,0,2,23,7,126.64,36,136,0,3,106.03,0.00,0.67,0.00,0,12.00,1,4100.54,3,0,7,org.apache.lucene.search.SearchEquivalenceTestBase,0.00,11,2,12,0,11,12,0,19,893,1
"org.apache.lucene.search.TestSloppyPhraseQuery",13,0.02,1.92,171,2.40,68028.67,28,15,13,40,15,139.90,37,197,0,2,100.01,0.00,0.50,0.09,2,63.00,4,7205.77,0,2,15,org.apache.lucene.util.LuceneTestCase,0.00,27,1,25,0,27,11,0,18,1343,1
"org.apache.lucene.search.TestSloppyPhraseQuery$Collector",4,1.00,1.00,10,0.11,1426.62,5,1,13,8,2,139.67,1,18,0,1,139.67,0.00,0.00,0.25,0,6.00,1,318.07,0,0,2,java.lang.Object,0.00,4,0,4,0,4,4,0,1,84,0
"org.apache.lucene.search.TestSloppyPhraseQuery$MaxFreqCollector",4,0.11,1.00,12,0.11,1504.06,7,3,13,6,3,132.92,0,21,0,2,132.92,0.00,0.50,0.25,0,6.00,1,335.38,0,0,3,org.apache.lucene.search.Collector,0.50,2,1,4,0,2,4,0,0,87,1
"org.apache.lucene.search.TestSloppyPhraseQuery2",10,0.00,2.10,169,1.69,78793.83,10,0,3,21,5,145.23,12,158,0,3,95.23,0.00,0.67,0.00,1,10.00,3,5078.36,2,1,5,org.apache.lucene.search.SearchEquivalenceTestBase,0.00,11,2,21,0,11,9,0,10,1012,1
"org.apache.lucene.search.TestSort",22,0.06,3.27,352,7.45,531439.01,38,16,39,103,32,131.18,64,442,0,2,91.30,0.00,0.50,0.12,7,134.00,24,22338.29,2,11,32,org.apache.lucene.util.LuceneTestCase,0.00,81,1,72,0,81,11,0,51,3710,1
"org.apache.lucene.search.TestSort$FieldCache.ByteParser",1,0.00,1.00,3,0.04,622.45,1,0,39,1,1,131.20,0,4,0,1,131.20,0.00,0.00,0.00,0,1.00,1,107.51,0,0,1,java.lang.Object,0.00,0,0,1,0,0,1,0,0,29,0
"org.apache.lucene.search.TestSort$FieldCache.DoubleParser",1,0.00,1.00,3,0.05,1031.80,1,0,39,2,1,129.47,0,4,0,1,129.47,0.00,0.00,0.00,0,1.00,1,148.95,0,0,1,java.lang.Object,0.00,1,0,1,0,1,1,0,0,38,0
"org.apache.lucene.search.TestSort$FieldCache.FloatParser",1,0.00,1.00,3,0.04,559.02,1,0,39,2,1,131.57,0,4,0,1,131.57,0.00,0.00,0.00,0,1.00,1,111.51,0,0,1,java.lang.Object,0.00,1,0,1,0,1,1,0,0,30,0
"org.apache.lucene.search.TestSort$FieldCache.IntParser",1,0.00,1.00,3,0.04,630.45,1,0,39,1,1,131.16,0,4,0,1,131.16,0.00,0.00,0.00,0,1.00,1,111.42,0,0,1,java.lang.Object,0.00,0,0,1,0,0,1,0,0,29,0
"org.apache.lucene.search.TestSort$FieldCache.LongParser",1,0.00,1.00,3,0.04,630.45,1,0,39,1,1,131.16,0,4,0,1,131.16,0.00,0.00,0.00,0,1.00,1,111.42,0,0,1,java.lang.Object,0.00,0,0,1,0,0,1,0,0,29,0
"org.apache.lucene.search.TestSort$FieldCache.ShortParser",1,0.00,1.00,3,0.04,622.45,1,0,39,1,1,131.20,0,4,0,1,131.20,0.00,0.00,0.00,0,1.00,1,107.51,0,0,1,java.lang.Object,0.00,0,0,1,0,0,1,0,0,29,0
"org.apache.lucene.search.TestSort$MyFieldComparator",28,0.22,2.79,500,8.83,664738.65,31,3,39,115,31,140.41,51,561,0,2,90.41,0.00,0.50,0.12,2,244.00,20,26475.15,0,2,31,org.apache.lucene.search.FieldComparator,0.28,87,1,78,0,87,26,0,51,4532,1
"org.apache.lucene.search.TestSort$MyFieldComparator$FieldCache.IntParser_0",1,0.00,1.00,3,0.04,630.45,1,0,39,1,1,131.16,0,4,0,1,131.16,0.00,0.00,0.00,0,1.00,1,111.42,0,0,1,java.lang.Object,0.00,0,0,1,0,0,1,0,0,29,0
"org.apache.lucene.search.TestSort$MyFieldComparator$Filter",1,0.00,1.00,7,0.10,2469.12,1,0,39,7,4,112.76,0,9,0,1,112.76,0.00,0.00,0.00,0,1.00,1,309.19,0,1,4,java.lang.Object,0.00,6,0,1,0,6,0,0,0,66,0
"org.apache.lucene.search.TestSort$MyFieldComparator$MyFieldComparatorSource",1,0.00,1.00,3,0.04,648.69,1,0,39,2,2,131.06,0,6,0,2,131.06,0.00,0.50,0.00,0,1.00,1,125.32,0,1,2,org.apache.lucene.search.FieldComparatorSource,0.00,1,1,1,0,1,0,0,0,31,1
"org.apache.lucene.search.TestSort$MyFieldComparator$RandomFilter",2,0.50,2.00,22,0.33,13716.76,6,4,39,15,6,151.78,2,25,0,2,101.79,0.00,0.50,0.50,0,2.00,3,1004.88,0,1,6,org.apache.lucene.search.Filter,0.00,13,1,4,0,13,1,0,2,194,2
"org.apache.lucene.search.TestSort$SortMissingLastTestHelper",1,3.00,1.00,8,0.06,804.06,4,3,39,1,1,114.43,0,10,0,1,114.43,0.00,0.00,0.00,0,1.00,1,168.49,0,0,1,java.lang.Object,0.00,0,0,1,0,0,1,0,0,47,2
"org.apache.lucene.search.TestSubScorerFreqs",5,0.42,2.80,96,1.71,94280.55,8,3,12,42,13,89.39,1,107,0,2,89.39,0.00,0.50,0.67,0,0.00,7,5118.07,0,0,13,org.apache.lucene.util.LuceneTestCase,0.00,37,1,14,0,37,5,0,1,869,1
"org.apache.lucene.search.TestSubScorerFreqs$CountingCollector",7,0.10,1.57,35,0.54,15729.13,12,5,12,28,4,118.43,0,49,0,2,118.43,0.00,0.50,0.29,1,4.00,3,1606.76,0,0,4,org.apache.lucene.search.Collector,0.36,21,1,11,0,21,7,0,0,343,2
"org.apache.lucene.search.TestTermRangeFilter",2,0.00,1.00,89,2.35,281382.92,2,0,4,9,8,26.86,15,128,0,3,69.15,0.00,0.67,0.00,0,0.00,1,7050.15,1,0,8,org.apache.lucene.search.BaseTestRangeFilter,0.00,7,2,2,0,7,2,0,7,1152,1
"org.apache.lucene.search.TestTermRangeQuery",8,0.14,1.12,123,2.05,80001.18,10,2,15,40,15,95.60,4,135,0,2,95.60,0.00,0.50,0.38,1,0.00,2,6142.57,2,0,15,org.apache.lucene.util.LuceneTestCase,0.00,32,1,9,0,32,8,0,3,1134,1
"org.apache.lucene.search.TestTermRangeQuery$SingleCharAnalyzer",7,0.00,1.14,70,0.97,27835.80,7,0,15,24,9,125.94,23,75,0,2,105.32,0.00,0.50,0.00,3,8.00,2,2906.88,0,1,9,org.apache.lucene.index.Analyzer,0.00,17,1,8,0,17,6,0,23,558,2
"org.apache.lucene.search.TestTermRangeQuery$SingleCharAnalyzer$SingleCharTokenizer",3,0.33,1.67,18,0.18,3449.55,6,3,15,6,2,117.75,0,29,0,4,117.75,0.00,0.75,0.56,0,0.00,3,531.14,1,0,2,org.apache.lucene.analysis.Tokenizer,0.24,3,3,5,0,3,3,0,0,120,2
"org.apache.lucene.search.TestTermScorer",5,0.40,1.20,61,1.04,34029.69,10,5,14,37,16,140.40,14,77,0,2,100.52,0.00,0.50,0.52,0,0.00,2,3122.57,2,0,16,org.apache.lucene.util.LuceneTestCase,0.00,32,1,6,0,32,5,0,6,575,1
"org.apache.lucene.search.TestTermScorer$Collector",4,0.17,1.00,15,0.18,4339.36,6,2,14,8,2,129.30,0,24,0,1,129.30,0.00,0.00,0.38,0,4.00,1,537.89,0,0,2,java.lang.Object,0.00,4,0,4,0,4,4,0,0,123,0
"org.apache.lucene.search.TestTermScorer$TestHit",2,0.00,1.00,8,0.07,837.28,4,2,14,2,0,127.90,0,12,0,1,127.90,0.00,0.00,0.50,0,2.00,1,202.21,0,1,0,java.lang.Object,0.00,0,0,2,0,0,1,0,0,55,1
"org.apache.lucene.search.TestTermVectors",18,0.12,2.72,385,6.13,325083.59,21,3,19,93,27,137.93,32,406,0,2,87.93,0.00,0.50,0.22,5,66.00,7,18404.98,0,2,27,org.apache.lucene.util.LuceneTestCase,0.00,75,1,49,0,75,16,0,27,2982,1
"org.apache.lucene.search.TestTimeLimitingCollector",16,0.06,1.81,150,1.89,65613.69,28,12,15,60,16,127.43,52,189,0,2,106.82,0.00,0.50,0.14,7,84.00,5,5682.39,2,2,16,org.apache.lucene.util.LuceneTestCase,0.00,44,1,29,0,44,14,0,34,1073,1
"org.apache.lucene.search.TestTimeLimitingCollector$MyHitCollector",7,0.04,1.29,25,0.25,7290.10,11,4,15,12,4,129.38,4,40,0,2,129.38,0.00,0.50,0.29,0,16.00,3,757.98,0,0,4,org.apache.lucene.search.Collector,0.36,5,1,9,0,5,7,0,2,175,1
"org.apache.lucene.search.TestTimeLimitingCollector$Thread",1,0.00,2.00,8,0.05,807.21,1,0,15,4,0,114.26,0,12,0,1,114.26,0.00,0.00,0.00,0,1.00,2,143.93,0,0,0,java.lang.Object,0.00,3,0,2,0,3,1,0,0,36,0
"org.apache.lucene.search.TestTopDocsCollector",11,0.10,1.18,73,1.05,29693.21,15,4,7,26,11,164.91,18,89,0,2,114.91,0.00,0.50,0.16,1,40.00,2,3141.33,2,1,11,org.apache.lucene.util.LuceneTestCase,0.00,15,1,13,0,15,10,0,18,650,1
"org.apache.lucene.search.TestTopDocsCollector$MyTopsDocCollector",6,0.30,1.50,27,0.29,8623.89,8,2,7,11,6,123.58,1,38,0,3,123.58,0.00,0.67,0.25,0,10.00,4,875.82,0,1,6,org.apache.lucene.search.TopDocsCollector,0.33,5,2,9,0,5,5,0,1,194,3
"org.apache.lucene.search.TestTopDocsMerge",1,0.00,27.00,144,2.98,396677.57,1,0,18,45,23,8.08,12,145,0,2,45.64,0.00,0.50,0.00,0,1.00,27,8944.57,0,0,23,org.apache.lucene.util.LuceneTestCase,0.00,44,1,27,0,44,1,0,12,1205,1
"org.apache.lucene.search.TestTopDocsMerge$ShardSearcher",4,0.33,1.00,11,0.11,1557.81,5,1,18,4,6,139.37,0,17,0,2,139.37,0.00,0.50,0.75,1,0.00,1,339.70,0,2,6,org.apache.lucene.search.IndexSearcher,0.00,0,1,4,0,0,2,0,0,89,2
"org.apache.lucene.search.TestTopScoreDocCollector",1,0.00,4.00,33,0.47,18709.42,1,0,6,20,10,80.63,4,32,0,2,80.40,0.00,0.50,0.00,0,1.00,4,1423.80,0,0,10,org.apache.lucene.util.LuceneTestCase,0.00,19,1,4,0,19,1,0,4,235,1
"org.apache.lucene.search.TestWildcard",11,0.00,2.09,203,4.15,228825.02,11,0,11,55,18,72.13,56,267,0,2,90.00,0.00,0.50,0.00,1,11.00,12,12457.10,1,1,18,org.apache.lucene.util.LuceneTestCase,0.00,44,1,23,0,44,10,0,30,2062,1
"org.apache.lucene.search.TestWildcardRandom",6,0.00,2.17,75,0.84,24762.24,9,3,14,33,13,152.09,7,83,0,2,102.09,0.00,0.50,0.33,3,10.00,3,2522.65,2,1,13,org.apache.lucene.util.LuceneTestCase,0.00,27,1,13,0,27,5,0,3,479,1
"org.apache.lucene.search.TimeLimitingCollector",12,0.04,1.25,46,0.46,10230.74,19,7,4,18,9,87.78,93,67,4,2,130.07,0.00,0.50,0.18,1,42.00,3,1388.52,0,1,5,org.apache.lucene.search.Collector,0.25,6,1,15,0,6,11,0,15,322,1
"org.apache.lucene.search.TimeLimitingCollector$SuppressWarnings",4,0.11,1.00,15,0.12,1889.67,7,3,4,4,0,132.14,3,21,0,2,132.14,0.00,0.50,0.25,0,10.00,1,347.22,0,0,0,java.lang.RuntimeException,0.00,0,1,4,0,0,4,0,3,90,2
"org.apache.lucene.search.TimeLimitingCollector$TimerThread",7,0.00,1.29,28,0.24,3748.89,13,6,4,12,2,109.12,36,40,0,2,127.00,0.00,0.50,0.17,0,33.00,3,726.17,0,0,2,org.apache.lucene.index.Thread,0.00,5,1,9,0,5,7,0,16,175,3
"org.apache.lucene.search.TimeLimitingCollector$TimerThreadHolder",0,0.00,0.00,5,0.03,386.10,1,1,4,0,1,171.00,0,7,0,1,171.00,0.00,0.00,0.00,0,0.00,0,104.65,0,0,1,java.lang.Object,0.00,0,0,0,0,0,0,0,0,30,3
"org.apache.lucene.search.TopDocs",5,0.25,2.40,55,0.72,63464.60,8,3,2,17,110,67.42,32,63,107,1,99.64,0.00,0.00,0.13,0,11.00,8,2161.51,0,1,4,java.lang.Object,0.00,12,0,12,1,12,4,0,17,394,1
"org.apache.lucene.search.TopDocs$MergeSortQueue",2,1.00,6.50,55,0.75,60597.69,5,3,2,7,7,49.66,13,55,0,2,81.89,0.00,0.50,0.83,0,0.00,8,2255.47,0,0,7,org.apache.lucene.util.PriorityQueue,0.00,5,1,13,0,5,2,0,13,404,2
"org.apache.lucene.search.TopDocs$ScoreMergeSortQueue",2,1.00,3.50,26,0.29,17409.11,3,1,2,2,3,138.02,4,29,0,2,98.13,0.00,0.50,0.50,0,2.00,5,856.58,0,0,3,org.apache.lucene.util.PriorityQueue,0.00,0,1,7,0,0,2,0,4,184,2
"org.apache.lucene.search.TopDocs$ShardRef",2,0.00,1.00,7,0.05,658.53,4,2,2,2,0,183.38,2,11,0,1,133.38,0.00,0.00,0.50,0,2.00,1,163.92,0,1,0,java.lang.Object,0.00,0,0,2,0,0,1,0,2,46,2
"org.apache.lucene.search.TopDocsCollector",8,0.05,1.62,35,0.39,16116.68,11,3,1,12,20,73.93,82,39,16,2,122.41,10.00,0.08,0.29,4,14.00,3,1183.37,0,4,4,org.apache.lucene.search.Collector,0.00,4,1,13,10,4,4,0,35,263,2
"org.apache.lucene.search.TopFieldCollector",6,0.03,3.83,84,1.05,52746.88,13,7,4,29,26,130.26,120,113,17,3,96.88,1.00,0.40,0.17,0,6.00,14,3136.65,0,2,9,org.apache.lucene.search.TopDocsCollector,0.17,23,2,23,2,23,4,0,29,588,2
"org.apache.lucene.search.TopFieldCollector$MultiComparatorNonScoringCollector",5,0.17,3.40,64,0.64,50784.44,8,3,4,14,5,138.80,11,63,0,4,98.91,0.00,0.75,0.47,1,0.00,11,1918.68,1,0,5,org.apache.lucene.search.TopFieldCollector,0.35,9,3,17,0,9,5,0,11,382,2
"org.apache.lucene.search.TopFieldCollector$MultiComparatorScoringMaxScoreCollector",4,1.00,3.75,54,0.54,51339.85,5,1,4,10,2,136.68,10,56,0,2,96.79,0.00,0.50,0.25,1,6.00,12,1623.12,1,0,2,org.apache.lucene.search.MultiComparatorNonScoringCollector,0.00,6,1,15,0,6,4,0,10,317,2
"org.apache.lucene.search.TopFieldCollector$MultiComparatorScoringNoMaxScoreCollector",4,1.00,3.50,52,0.53,52519.85,5,1,4,10,2,136.61,11,53,0,2,96.73,0.00,0.50,0.25,1,8.00,11,1576.08,1,0,2,org.apache.lucene.search.MultiComparatorNonScoringCollector,0.00,6,1,14,0,6,4,0,11,310,2
"org.apache.lucene.search.TopFieldCollector$OneComparatorNonScoringCollector",5,0.17,1.60,32,0.38,11788.40,8,3,4,14,5,165.31,7,46,0,4,115.31,0.00,0.75,0.47,1,0.00,4,1126.73,1,0,5,org.apache.lucene.search.TopFieldCollector,0.35,9,3,8,0,9,5,0,7,242,2
"org.apache.lucene.search.TopFieldCollector$OneComparatorScoringMaxScoreCollector",4,1.00,2.00,29,0.32,13130.88,5,1,4,10,2,161.63,7,42,0,2,111.63,0.00,0.50,0.25,1,6.00,5,964.30,1,0,2,org.apache.lucene.search.OneComparatorNonScoringCollector,0.00,6,1,8,0,6,4,0,7,203,2
"org.apache.lucene.search.TopFieldCollector$OneComparatorScoringNoMaxScoreCollector",4,1.00,1.75,27,0.31,12429.29,5,1,4,11,2,154.23,8,39,0,2,114.34,0.00,0.50,0.25,1,8.00,4,916.35,0,0,2,org.apache.lucene.search.OneComparatorNonScoringCollector,0.00,7,1,7,0,7,4,0,8,196,2
"org.apache.lucene.search.TopFieldCollector$OutOfOrderMultiComparatorNonScoringCollector",3,0.00,4.67,46,0.45,50659.55,3,0,4,8,1,133.37,8,48,0,2,93.48,0.00,0.50,0.00,0,4.00,12,1352.93,0,0,1,org.apache.lucene.search.MultiComparatorNonScoringCollector,0.00,5,1,14,0,5,3,0,8,257,2
"org.apache.lucene.search.TopFieldCollector$OutOfOrderMultiComparatorScoringMaxScoreCollector",3,0.00,5.00,49,0.49,55663.67,3,0,4,9,1,131.99,8,52,0,2,92.10,0.00,0.50,0.00,0,4.00,13,1471.45,0,0,1,org.apache.lucene.search.MultiComparatorScoringMaxScoreCollector,0.00,6,1,15,0,6,3,0,8,276,3
"org.apache.lucene.search.TopFieldCollector$OutOfOrderMultiComparatorScoringNoMaxScoreCollector",4,0.00,3.75,51,0.52,57861.55,4,0,4,10,2,137.56,10,56,0,2,97.68,0.00,0.50,0.00,0,6.00,12,1554.84,1,0,2,org.apache.lucene.search.MultiComparatorScoringNoMaxScoreCollector,0.00,6,1,15,0,6,4,0,10,299,3
"org.apache.lucene.search.TopFieldCollector$OutOfOrderOneComparatorNonScoringCollector",3,0.00,2.00,20,0.25,14832.95,3,0,4,8,1,162.72,4,31,0,2,112.72,0.00,0.50,0.00,0,4.00,4,742.57,0,0,1,org.apache.lucene.search.OneComparatorNonScoringCollector,0.00,5,1,6,0,5,3,0,4,149,2
"org.apache.lucene.search.TopFieldCollector$OutOfOrderOneComparatorScoringMaxScoreCollector",3,0.00,2.33,23,0.28,18393.52,3,0,4,9,1,159.45,4,35,0,2,109.46,0.00,0.50,0.00,0,4.00,5,849.05,0,0,1,org.apache.lucene.search.OneComparatorScoringMaxScoreCollector,0.00,6,1,7,0,6,3,0,4,167,2
"org.apache.lucene.search.TopFieldCollector$OutOfOrderOneComparatorScoringNoMaxScoreCollector",3,0.00,2.00,22,0.28,18885.18,3,0,4,9,1,149.29,6,34,0,2,109.40,0.00,0.50,0.00,0,4.00,4,839.49,0,0,1,org.apache.lucene.search.OneComparatorScoringNoMaxScoreCollector,0.00,6,1,6,0,6,3,0,6,166,2
"org.apache.lucene.search.TopFieldDocs",1,1.00,1.00,5,0.05,671.54,2,1,0,1,10,172.15,26,8,8,2,122.66,0.00,0.50,0.00,0,1.00,1,148.28,0,0,3,org.apache.lucene.search.TopDocs,0.00,0,1,1,0,0,1,0,4,38,1
"org.apache.lucene.search.TopScoreDocCollector",6,0.27,2.17,38,0.42,13052.98,9,3,2,15,29,73.22,44,52,23,3,115.51,2.00,0.29,0.11,1,14.00,5,1256.68,0,3,6,org.apache.lucene.search.TopDocsCollector,0.17,9,2,13,4,9,3,0,14,270,2
"org.apache.lucene.search.TopScoreDocCollector$InOrderPagingScoreDocCollector",6,0.00,1.67,29,0.35,13526.69,9,3,2,10,4,172.02,6,43,0,4,122.02,0.00,0.75,0.33,0,10.00,3,1042.79,1,1,4,org.apache.lucene.search.TopScoreDocCollector,0.50,4,3,10,0,4,5,0,6,228,2
"org.apache.lucene.search.TopScoreDocCollector$InOrderTopScoreDocCollector",3,0.00,1.33,15,0.14,5338.79,3,0,2,5,1,169.27,4,22,0,4,119.27,0.00,0.75,0.00,0,4.00,2,434.26,0,0,1,org.apache.lucene.search.TopScoreDocCollector,0.38,2,3,4,0,2,3,0,4,97,2
"org.apache.lucene.search.TopScoreDocCollector$OutOfOrderPagingScoreDocCollector",6,0.00,1.83,31,0.37,16357.37,9,3,2,10,4,117.73,5,46,0,4,117.73,0.00,0.75,0.33,0,10.00,4,1097.54,1,1,4,org.apache.lucene.search.TopScoreDocCollector,0.50,4,3,11,0,4,5,0,5,239,2
"org.apache.lucene.search.TopScoreDocCollector$OutOfOrderTopScoreDocCollector",3,0.00,1.67,17,0.16,8273.91,3,0,2,5,1,167.72,3,25,0,4,117.72,0.00,0.75,0.00,0,4.00,3,493.19,0,0,1,org.apache.lucene.search.TopScoreDocCollector,0.38,2,3,5,0,2,3,0,3,108,2
"org.apache.lucene.search.TopTermsRewrite",6,0.40,2.17,32,0.54,26395.66,7,1,12,18,14,155.94,15,42,5,3,116.06,1.00,0.40,0.67,0,0.00,7,1609.14,3,0,9,org.apache.lucene.search.TermCollectingRewrite,0.00,12,2,13,2,12,6,0,5,314,2
"org.apache.lucene.search.TopTermsRewrite$Comparator<ScoreTerm>",1,0.00,1.00,4,0.05,1456.24,1,0,12,2,0,123.63,0,6,0,1,123.63,0.00,0.00,0.00,0,1.00,1,158.63,0,0,0,java.lang.Object,0.00,1,0,1,0,1,1,0,0,41,0
"org.apache.lucene.search.TopTermsRewrite$ScoreTerm",2,0.25,1.50,10,0.15,3575.00,6,4,12,5,2,119.22,0,16,0,1,119.22,0.00,0.00,0.12,0,2.00,2,442.40,0,0,2,java.lang.Object,0.00,3,0,3,0,3,2,1,0,104,2
"org.apache.lucene.search.TopTermsRewrite$TermCollector",3,0.50,4.00,55,0.90,59753.46,10,7,12,31,6,110.62,11,69,0,1,90.00,0.00,0.00,0.48,1,0.00,7,2689.60,0,0,6,java.lang.Object,0.00,28,0,12,0,28,3,0,11,478,0
"org.apache.lucene.search.TotalHitCountCollector",5,0.75,1.00,10,0.07,621.93,6,1,1,5,6,143.28,4,20,3,2,143.28,0.00,0.50,0.40,0,7.00,1,207.09,0,0,3,org.apache.lucene.search.Collector,0.67,0,1,5,0,0,5,0,2,63,1
"org.apache.lucene.search.UseNoMemoryExpensiveCodec",17,0.12,2.82,181,2.87,103939.89,25,8,24,84,23,153.64,22,250,0,3,103.64,0.00,0.67,0.24,1,17.00,6,8595.45,2,3,23,org.apache.lucene.index.ThreadedIndexingAndSearchingTestCase,0.34,67,2,48,0,67,14,0,20,1523,1
"org.apache.lucene.search.UseNoMemoryExpensiveCodec$LatchedIndexWriter",2,0.33,2.50,15,0.17,3817.07,5,3,24,5,8,113.43,0,25,0,2,113.43,0.00,0.50,0.50,0,2.00,4,511.60,1,0,8,org.apache.lucene.index.IndexWriter,0.00,3,1,5,0,3,2,0,0,110,2
"org.apache.lucene.search.UseNoMemoryExpensiveCodec$PreviousSearchState",1,6.00,1.00,16,0.17,3054.51,8,7,13,3,3,98.64,0,18,0,1,98.64,0.00,0.00,0.14,0,0.00,1,499.68,0,0,3,java.lang.Object,0.00,2,0,1,0,2,1,0,0,111,2
"org.apache.lucene.search.UseNoMemoryExpensiveCodec$Runnable",1,0.00,5.00,13,0.14,3689.36,1,0,23,6,1,140.87,2,20,0,1,100.99,0.00,0.00,0.00,0,1.00,5,416.60,0,0,1,java.lang.Object,0.00,5,0,5,0,5,1,0,2,85,0
"org.apache.lucene.search.UseNoMemoryExpensiveCodec$SearcherFactory",1,0.00,1.00,6,0.08,1486.26,1,0,24,5,4,116.99,0,8,0,1,116.99,0.00,0.00,0.00,0,1.00,1,229.14,0,1,4,java.lang.Object,0.00,4,0,1,0,4,0,0,0,50,0
"org.apache.lucene.search.UseNoMemoryExpensiveCodec$SearcherFactory_0",1,0.00,3.00,7,0.07,1484.11,1,0,23,5,2,164.25,1,12,0,1,114.25,0.00,0.00,0.00,0,1.00,3,212.46,0,1,2,java.lang.Object,0.00,4,0,3,0,4,0,0,1,47,0
"org.apache.lucene.search.UseNoMemoryExpensiveCodec$SearcherFactory_1",1,0.00,1.00,3,0.03,373.67,1,0,24,2,2,132.94,0,5,0,1,132.94,0.00,0.00,0.00,0,1.00,1,78.32,0,1,2,java.lang.Object,0.00,1,0,1,0,1,0,0,0,22,0
"org.apache.lucene.search.UseNoMemoryExpensiveCodec$Thread",1,0.00,2.00,9,0.08,1306.00,1,0,24,8,2,150.59,2,13,0,1,110.71,0.00,0.00,0.00,0,1.00,2,252.42,0,0,2,java.lang.Object,0.00,7,0,2,0,7,1,0,2,56,0
"org.apache.lucene.search.UseNoMemoryExpensiveCodec$Thread_0",1,0.00,1.00,4,0.02,169.27,1,0,24,3,0,130.99,0,5,0,1,130.99,0.00,0.00,0.00,0,1.00,1,70.91,0,0,0,java.lang.Object,0.00,2,0,1,0,2,1,0,0,21,0
"org.apache.lucene.search.Weight",6,0.00,1.00,8,0.07,529.77,6,0,6,6,91,135.53,86,9,85,1,155.68,0.00,0.00,0.00,0,6.00,1,212.35,0,3,8,java.lang.Object,0.00,0,0,6,19,0,3,0,7,65,2
"org.apache.lucene.search.WildcardQuery",4,0.11,2.50,38,0.49,27349.47,7,3,7,19,29,62.70,28,50,23,4,105.00,0.00,0.75,0.25,0,6.00,6,1462.30,2,3,6,org.apache.lucene.search.AutomatonQuery,0.00,15,3,10,0,15,1,0,10,287,1
"org.apache.lucene.validation.LicenseCheckTask",6,0.15,3.83,74,1.20,59779.36,10,4,16,47,1,81.08,35,105,0,2,98.95,0.00,0.50,0.38,1,2.00,9,3607.62,0,0,1,org.apache.tools.ant.Task,0.00,41,1,23,0,41,6,0,14,622,1
"org.apache.lucene.validation.LicenseType",6,0.30,1.00,17,0.19,2155.35,8,2,0,7,1,139.88,29,37,1,1,139.65,0.00,0.00,0.25,0,14.00,1,580.64,0,4,0,java.lang.Object,0.00,1,0,6,0,1,2,0,7,137,1
"org.apache.solr.client.solrj.beans.BindingException",2,0.00,1.00,5,0.03,221.18,2,0,0,2,2,95.57,16,8,2,2,143.68,0.00,0.50,0.00,0,2.00,1,88.69,0,0,0,java.lang.RuntimeException,0.00,0,1,2,0,0,2,0,1,29,1
"org.apache.solr.client.solrj.beans.DocumentObjectBinder",7,1.00,2.71,58,0.86,40973.37,8,1,8,32,6,107.42,6,77,2,1,107.42,0.00,0.00,0.14,2,12.00,5,2577.41,0,4,4,java.lang.Object,0.00,25,0,19,0,25,3,0,1,506,1
"org.apache.solr.client.solrj.beans.DocumentObjectBinder$DocField",7,0.44,9.00,168,2.36,156642.11,16,9,8,51,2,84.99,31,224,0,1,84.76,0.00,0.00,0.49,4,0.00,16,7093.67,0,2,2,java.lang.Object,0.00,44,0,63,0,44,5,0,21,1268,2
"org.apache.solr.client.solrj.beans.TestDocumentObjectBinder",5,0.75,1.00,98,2.03,105457.94,6,1,18,49,8,89.25,4,129,0,2,89.25,0.00,0.50,0.40,0,7.00,1,6103.10,0,0,8,org.apache.lucene.util.LuceneTestCase,0.00,44,1,5,0,44,5,0,4,1049,1
"org.apache.solr.client.solrj.beans.TestDocumentObjectBinder$Item",4,0.07,1.00,18,0.20,4994.54,13,9,18,4,0,124.16,1,32,0,1,124.16,0.00,0.00,0.06,0,4.00,1,597.57,0,1,0,java.lang.Object,0.00,0,0,4,0,0,3,0,1,134,2
"org.apache.solr.client.solrj.beans.TestDocumentObjectBinder$NotGettableItem",3,0.17,1.00,10,0.07,948.52,6,3,18,3,0,133.52,0,17,0,1,133.52,0.00,0.00,0.22,0,5.00,1,217.16,0,1,0,java.lang.Object,0.00,0,0,3,0,0,2,0,0,60,2
"org.apache.lucene.collation.tokenattributes.CollatedTermAttributeImpl",2,1.00,1.00,10,0.11,1892.83,3,1,3,6,3,103.62,10,14,1,3,121.49,0.00,0.67,0.50,0,2.00,1,323.30,2,0,2,org.apache.lucene.analysis.tokenattributes.CharTermAttributeImpl,0.09,4,2,2,0,4,2,0,4,79,1
"org.apache.lucene.collation.tokenattributes.ICUCollatedTermAttributeImpl",2,0.00,1.50,14,0.15,2899.11,4,2,4,7,3,114.72,9,20,1,3,114.49,0.00,0.67,0.50,0,2.00,2,439.28,2,0,2,org.apache.lucene.analysis.tokenattributes.CharTermAttributeImpl,0.09,5,2,3,0,5,2,0,3,102,1
"org.apache.lucene.analysis.shingle.ShingleAnalyzerWrapper",13,0.03,1.31,50,0.49,12796.67,19,6,4,24,6,169.46,37,76,2,3,129.57,0.00,0.67,0.14,0,70.00,5,1460.10,0,3,4,org.apache.lucene.analysis.AnalyzerWrapper,0.00,11,2,17,0,11,10,0,6,341,2
"org.apache.lucene.analysis.shingle.ShingleAnalyzerWrapperTest",12,0.05,1.25,130,2.49,74267.62,16,4,17,39,22,153.79,18,222,0,3,103.79,0.00,0.67,0.21,1,36.00,2,7476.19,3,0,22,org.apache.lucene.analysis.BaseTokenStreamTestCase,0.00,27,2,15,0,27,12,0,4,1370,1
"org.apache.lucene.analysis.shingle.ShingleFilter",14,0.09,3.07,168,2.06,120418.28,38,24,10,48,16,61.94,179,216,9,4,99.50,0.00,0.75,0.12,5,58.00,11,6183.98,1,0,7,org.apache.lucene.analysis.TokenFilter,0.31,34,3,43,0,34,14,0,43,1132,2
"org.apache.lucene.analysis.shingle.ShingleFilter$CircularSequence",6,0.27,1.50,23,0.12,1612.00,9,3,10,6,0,116.11,32,31,0,1,133.98,0.00,0.00,0.56,1,0.00,3,372.47,0,0,0,java.lang.Object,0.00,0,0,9,0,0,6,0,5,105,1
"org.apache.lucene.analysis.shingle.ShingleFilter$InputWindowToken",1,4.00,1.00,9,0.08,1196.00,5,4,10,2,3,111.17,0,11,0,1,111.17,0.00,0.00,0.00,0,1.00,1,244.00,0,0,3,java.lang.Object,0.00,1,0,1,0,1,1,0,0,61,1
"org.apache.lucene.analysis.shingle.ShingleFilterTest",47,0.02,1.02,228,10.45,1762274.63,140,93,12,67,10,112.52,10,932,0,3,112.52,0.00,0.67,0.03,3,511.00,2,31349.97,4,2,10,org.apache.lucene.analysis.BaseTokenStreamTestCase,0.00,20,2,48,0,20,45,0,8,4659,1
"org.apache.lucene.analysis.shingle.ShingleFilterTest$Analyzer",1,0.00,1.00,4,0.05,1009.20,1,0,12,4,3,124.89,0,6,0,1,124.89,0.00,0.00,0.00,0,1.00,1,159.62,0,1,3,java.lang.Object,0.00,3,0,1,0,3,0,0,0,38,0
"org.apache.lucene.analysis.shingle.ShingleFilterTest$Analyzer_0",1,0.00,1.00,4,0.05,1009.20,1,0,12,4,3,124.89,0,6,0,1,124.89,0.00,0.00,0.00,0,1.00,1,159.62,0,1,3,java.lang.Object,0.00,3,0,1,0,3,0,0,0,38,0
"org.apache.lucene.analysis.shingle.ShingleFilterTest$Analyzer_1",1,0.00,1.00,4,0.05,753.46,1,0,12,4,3,125.89,0,6,0,1,125.89,0.00,0.00,0.00,0,1.00,1,135.44,0,1,3,java.lang.Object,0.00,3,0,1,0,3,0,0,0,34,0
"org.apache.lucene.analysis.shingle.ShingleFilterTest$TestTokenStream",2,0.67,1.50,25,0.29,6867.43,8,6,12,12,6,102.81,0,30,0,3,102.81,0.00,0.67,0.50,0,2.00,2,870.71,0,0,6,org.apache.lucene.analysis.TokenStream,0.30,10,2,3,0,10,2,0,0,177,1
"org.apache.lucene.queryparser.flexible.standard.nodes.AbstractRangeQueryNode",10,0.33,2.00,72,0.83,30339.48,12,2,8,25,9,94.02,55,100,2,2,111.90,2.00,0.25,0.20,4,26.00,5,2504.70,4,3,7,org.apache.lucene.queryparser.flexible.core.nodes.QueryNodeImpl,0.07,15,1,20,2,15,7,1,9,534,1
"org.apache.lucene.queryparser.flexible.standard.nodes.BooleanModifierNode",1,0.00,1.00,3,0.02,146.18,1,0,3,1,3,93.86,7,5,1,3,136.15,0.00,0.67,0.00,0,1.00,1,58.69,0,0,3,org.apache.lucene.queryparser.flexible.core.nodes.ModifierQueryNode,0.00,0,2,1,0,0,1,0,1,19,1
"org.apache.lucene.queryparser.flexible.standard.nodes.MultiPhraseQueryNode",6,0.00,2.33,39,0.43,14074.81,6,0,7,17,10,115.24,5,53,4,2,115.24,0.00,0.50,0.00,0,6.00,4,1281.56,4,4,6,org.apache.lucene.queryparser.flexible.core.nodes.QueryNodeImpl,0.16,11,1,14,0,11,2,1,2,276,1
"org.apache.lucene.queryparser.flexible.standard.nodes.NumericQueryNode",10,0.26,1.10,30,0.27,3394.67,13,3,8,14,10,115.38,54,47,5,2,133.25,0.00,0.50,0.10,4,22.00,2,803.85,1,6,5,org.apache.lucene.queryparser.flexible.core.nodes.QueryNodeImpl,0.07,4,1,11,0,4,4,1,9,205,1
"org.apache.lucene.queryparser.flexible.standard.nodes.NumericRangeQueryNode",5,1.00,2.80,42,0.62,29391.41,6,1,6,17,11,65.10,35,70,4,3,107.39,0.00,0.67,0.20,1,8.00,6,1869.45,5,3,7,org.apache.lucene.queryparser.flexible.standard.nodes.AbstractRangeQueryNode,0.09,12,2,14,0,12,2,0,4,376,1
"org.apache.lucene.queryparser.flexible.standard.nodes.PrefixWildcardQueryNode",4,0.00,1.00,10,0.12,1817.28,4,0,1,8,6,90.74,33,19,4,4,138.84,0.00,0.75,0.00,0,4.00,1,360.01,1,2,2,org.apache.lucene.queryparser.flexible.standard.nodes.WildcardQueryNode,0.17,4,3,4,0,4,2,0,4,96,1
"org.apache.lucene.queryparser.flexible.standard.nodes.RegexpQueryNode",10,0.22,1.10,27,0.25,4334.63,12,2,6,13,10,188.98,13,42,4,2,138.98,0.00,0.50,0.30,0,26.00,2,757.91,2,7,6,org.apache.lucene.queryparser.flexible.core.nodes.QueryNodeImpl,0.14,3,1,11,0,3,3,2,2,200,1
"org.apache.lucene.queryparser.flexible.standard.nodes.StandardBooleanQueryNode",2,1.00,1.00,7,0.05,671.28,3,1,5,2,7,115.44,11,10,3,3,133.31,0.00,0.67,0.00,0,2.00,1,153.76,0,0,4,org.apache.lucene.queryparser.flexible.core.nodes.BooleanQueryNode,0.00,0,2,2,0,0,2,0,2,42,1
"org.apache.lucene.queryparser.flexible.standard.nodes.TermRangeQueryNode",1,0.00,1.00,3,0.03,323.99,1,0,1,1,8,132.96,16,6,6,3,133.43,0.00,0.67,0.00,0,1.00,1,96.64,1,0,2,org.apache.lucene.queryparser.flexible.standard.nodes.AbstractRangeQueryNode,0.00,0,2,1,0,0,1,0,2,28,1
"org.apache.lucene.queryparser.flexible.standard.nodes.WildcardQueryNode",5,0.00,1.20,15,0.17,3062.00,5,0,2,9,9,151.83,15,26,7,3,131.21,0.50,0.50,0.00,0,5.00,2,515.59,2,3,2,org.apache.lucene.queryparser.flexible.core.nodes.FieldQueryNode,0.14,4,2,6,1,4,2,0,3,132,1
"org.apache.lucene.benchmark.quality.Judge",3,0.00,1.00,4,0.03,150.71,3,0,1,3,5,109.50,24,5,4,1,157.60,0.00,0.00,0.00,0,3.00,1,89.40,0,0,1,,0.00,0,0,3,0,0,3,0,4,30,1
"org.apache.lucene.benchmark.quality.QualityBenchmark",7,0.08,1.86,57,0.75,29903.57,13,6,8,22,12,66.29,53,67,2,1,108.58,0.00,0.00,0.24,0,15.00,5,2255.25,0,2,10,java.lang.Object,0.00,15,0,13,0,15,5,0,18,421,1
"org.apache.lucene.benchmark.quality.QualityQuery",5,0.12,1.20,18,0.18,4122.49,7,2,1,10,11,97.97,34,26,11,1,130.20,0.00,0.00,0.40,0,9.00,2,534.55,0,3,0,java.lang.Object,0.00,5,0,6,0,5,2,1,8,136,1
"org.apache.lucene.benchmark.quality.QualityQueryParser",1,0.00,1.00,2,0.01,69.06,1,0,2,1,6,97.18,8,3,3,1,145.29,0.00,0.00,0.00,0,1.00,1,36.53,0,1,3,,0.00,0,0,1,0,0,0,0,2,13,1
"org.apache.lucene.benchmark.quality.QualityStats",16,0.12,2.25,141,1.95,169083.71,28,12,3,40,4,105.67,75,165,4,1,105.44,0.00,0.00,0.19,4,112.00,7,5853.81,0,4,0,java.lang.Object,0.00,24,0,36,0,24,12,0,25,1096,1
"org.apache.lucene.benchmark.quality.QualityStats$RecallPoint",3,0.25,1.00,10,0.06,670.02,5,2,3,3,0,134.70,2,14,0,1,134.70,0.00,0.00,0.33,0,5.00,1,171.59,0,0,0,java.lang.Object,0.00,0,0,3,0,0,3,0,2,51,2
"org.apache.lucene.benchmark.quality.TestQualityRun",4,0.00,4.00,93,1.71,153083.01,4,0,13,32,13,65.92,22,116,0,3,83.80,0.00,0.67,0.00,1,4.00,13,5139.38,4,0,13,org.apache.lucene.benchmark.BenchmarkTestCase,0.00,28,2,16,0,28,4,0,16,800,1
"org.apache.lucene.queryparser.flexible.messages.Message",4,0.00,1.00,5,0.02,107.33,4,0,1,4,9,209.75,4,6,9,1,159.75,0.00,0.00,0.00,0,4.00,1,66.38,0,4,0,,0.00,0,0,4,0,0,0,0,1,27,1
"org.apache.lucene.queryparser.flexible.messages.MessageImpl",7,2.00,1.43,26,0.25,7538.00,9,2,1,13,30,129.24,4,34,28,1,129.24,0.00,0.00,0.00,3,7.00,4,740.32,0,5,2,java.lang.Object,0.00,6,0,10,0,6,2,1,1,175,1
"org.apache.lucene.queryparser.flexible.messages.MessagesTestBundle",1,4.00,1.00,8,0.07,1453.35,5,4,0,2,2,151.71,21,11,1,2,112.41,0.00,0.50,0.00,0,1.00,1,205.96,0,0,1,org.apache.lucene.queryparser.flexible.messages.NLS,0.00,1,1,1,0,1,1,0,6,53,1
"org.apache.lucene.queryparser.flexible.messages.NLS",11,0.90,3.09,64,1.03,40303.99,12,1,11,35,7,116.84,52,100,7,1,116.60,0.00,0.00,0.18,6,25.00,6,3091.34,0,5,0,java.lang.Object,0.00,24,0,34,2,24,6,0,21,613,1
"org.apache.lucene.queryparser.flexible.messages.NLS$PrivilegedAction<Void>",1,0.00,1.00,4,0.02,199.70,1,0,11,2,0,130.43,0,5,0,1,130.43,0.00,0.00,0.00,0,1.00,1,69.84,0,1,0,java.lang.Object,0.00,1,0,1,0,1,0,0,0,21,0
"org.apache.lucene.queryparser.flexible.messages.NLSException",1,0.00,1.00,2,0.01,29.41,1,0,0,1,3,193.33,28,3,2,1,148.21,0.00,0.00,0.00,0,1.00,1,19.61,0,0,1,,0.00,0,0,1,0,0,1,0,3,9,1
"org.apache.lucene.queryparser.flexible.messages.TestNLS",6,0.00,1.83,27,0.46,8439.99,6,0,2,15,4,144.23,22,52,0,2,123.61,0.00,0.50,0.00,0,6.00,3,1393.40,0,0,4,org.apache.lucene.util.LuceneTestCase,0.00,9,1,11,0,9,6,0,6,301,1
"org.apache.lucene.facet.example.merge.TaxonomyMergeUtils",3,0.00,1.00,20,0.29,7643.90,3,0,13,19,10,95.01,44,32,1,1,115.15,0.00,0.00,0.00,1,3.00,1,855.39,0,0,9,java.lang.Object,0.00,16,0,3,0,16,3,0,7,177,1
"org.apache.lucene.analysis.hi.HindiAnalyzer",5,0.33,1.40,27,0.32,8765.26,8,3,13,18,12,70.83,53,38,1,3,119.31,0.00,0.67,0.07,0,7.00,3,970.90,0,2,11,org.apache.lucene.analysis.util.StopwordAnalyzerBase,0.00,13,2,7,0,13,3,0,8,211,2
"org.apache.lucene.analysis.hi.HindiAnalyzer$DefaultSetHolder",0,0.00,0.00,6,0.05,732.71,1,1,13,0,2,171.00,2,10,0,1,171.00,0.00,0.00,0.00,0,0.00,0,149.07,0,0,2,java.lang.Object,0.00,0,0,0,0,0,0,0,2,37,2
"org.apache.lucene.analysis.hi.HindiNormalizationFilter",2,0.33,2.00,11,0.14,2865.07,5,3,6,9,10,102.04,11,18,4,4,119.91,0.00,0.75,0.50,0,2.00,3,425.46,0,0,6,org.apache.lucene.analysis.TokenFilter,0.29,7,3,4,0,7,2,0,1,98,2
"org.apache.lucene.analysis.hi.HindiNormalizer",1,0.00,38.00,82,1.01,71236.74,1,0,1,1,1,74.34,34,124,1,1,60.56,0.00,0.00,0.00,0,1.00,38,3040.63,0,0,0,java.lang.Object,0.00,0,0,38,0,0,1,0,10,470,1
"org.apache.lucene.analysis.hi.HindiStemFilter",2,0.33,2.00,12,0.15,3087.32,5,3,5,9,9,166.70,3,18,4,4,116.70,0.00,0.75,0.50,0,2.00,3,437.52,0,0,5,org.apache.lucene.analysis.TokenFilter,0.29,7,3,4,0,7,2,0,1,100,2
"org.apache.lucene.analysis.hi.HindiStemmer",1,0.00,6.00,8,1.03,63343.52,1,0,1,2,1,78.95,14,82,1,1,99.09,0.00,0.00,0.00,0,1.00,6,3091.63,0,0,0,java.lang.Object,0.00,1,0,6,0,1,1,0,6,479,1
"org.apache.lucene.analysis.hi.TestHindiAnalyzer",4,0.00,1.00,13,0.13,1916.37,4,0,3,7,4,114.22,23,19,0,3,132.09,0.00,0.67,0.00,0,4.00,1,401.26,2,0,4,org.apache.lucene.analysis.BaseTokenStreamTestCase,0.00,3,2,4,0,3,4,0,5,99,1
"org.apache.lucene.analysis.hi.TestHindiNormalizer",4,0.00,1.00,26,0.23,3348.57,4,0,9,8,7,158.84,11,31,0,3,118.96,0.00,0.67,0.00,1,4.00,1,689.58,2,0,7,org.apache.lucene.analysis.BaseTokenStreamTestCase,0.00,4,2,4,0,4,4,0,7,160,1
"org.apache.lucene.analysis.hi.TestHindiNormalizer$Analyzer",1,0.00,1.00,4,0.05,753.46,1,0,9,4,3,125.89,0,6,0,1,125.89,0.00,0.00,0.00,0,1.00,1,135.44,0,1,3,java.lang.Object,0.00,3,0,1,0,3,0,0,0,34,0
"org.apache.lucene.analysis.hi.TestHindiStemmer",6,0.00,1.00,33,0.27,4025.19,6,0,9,10,7,162.55,17,40,0,3,122.67,0.00,0.67,0.00,1,6.00,1,811.61,2,0,7,org.apache.lucene.analysis.BaseTokenStreamTestCase,0.00,4,2,6,0,4,6,0,5,199,1
"org.apache.lucene.analysis.hi.TestHindiStemmer$Analyzer",1,0.00,1.00,4,0.05,753.46,1,0,9,4,3,125.89,0,6,0,1,125.89,0.00,0.00,0.00,0,1.00,1,135.44,0,1,3,java.lang.Object,0.00,3,0,1,0,3,0,0,0,34,0
"org.apache.solr.uima.processor.SolrUIMAConfiguration",8,0.02,1.00,31,0.27,7396.94,15,7,1,8,3,129.85,5,42,3,1,129.85,0.00,0.00,0.12,0,50.00,1,812.97,0,5,0,java.lang.Object,0.00,0,0,8,0,0,3,0,1,199,1
"org.apache.solr.uima.processor.SolrUIMAConfiguration$MapField",3,0.33,2.67,20,0.19,5695.41,6,3,1,8,0,115.93,2,29,0,1,115.93,0.00,0.00,0.56,0,0.00,4,584.22,0,2,0,java.lang.Object,0.00,5,0,8,0,5,1,0,2,132,2
"org.apache.solr.uima.processor.SolrUIMAConfigurationReader",10,0.44,1.60,57,0.83,45360.66,11,1,5,24,3,116.02,8,70,1,1,116.02,0.00,0.00,0.60,2,0.00,5,2475.83,0,7,2,java.lang.Object,0.00,14,0,16,0,14,3,0,3,493,1
"org.apache.solr.uima.processor.UIMAToSolrMapper",2,0.33,3.50,30,0.54,31952.70,5,3,11,19,3,75.87,11,38,1,1,93.74,0.00,0.00,0.50,0,2.00,6,1622.84,0,0,2,java.lang.Object,0.00,17,0,7,0,17,2,0,2,279,1
"org.apache.solr.uima.processor.UIMAUpdateRequestProcessor",5,0.19,3.20,70,1.18,72407.18,9,4,18,44,12,115.83,17,90,2,2,95.21,0.00,0.50,0.40,3,0.00,9,3536.39,1,2,10,org.apache.solr.update.processor.UpdateRequestProcessor,0.00,39,1,16,0,39,3,0,11,617,1
"org.apache.solr.uima.processor.UIMAUpdateRequestProcessorFactory",2,1.00,1.00,6,0.10,1612.54,3,1,5,7,8,170.20,5,14,1,2,130.31,0.00,0.50,0.50,0,2.00,1,308.98,0,1,7,org.apache.solr.update.processor.UpdateRequestProcessorFactory,0.00,5,1,2,0,5,1,0,1,73,1
"org.apache.solr.uima.processor.UIMAUpdateRequestProcessorTest",8,0.00,1.50,71,1.08,25698.18,8,0,22,33,16,109.60,7,136,0,3,109.60,0.00,0.67,0.00,1,16.00,5,3244.69,7,0,16,org.apache.solr.SolrTestCaseJ4,0.04,25,2,12,0,25,8,0,3,623,1
"org.apache.solr.uima.processor.UIMAUpdateRequestProcessorTest$SolrQueryRequestBase",0,0.00,0.00,1,0.01,69.74,0,0,22,0,0,171.00,0,1,0,1,171.00,0.00,0.00,0.00,0,0.00,0,34.87,0,0,0,java.lang.Object,0.00,0,0,0,0,0,0,0,0,11,0
"org.apache.lucene.analysis.tr.TestTurkishAnalyzer",4,0.00,1.00,15,0.16,2613.59,4,0,4,7,4,181.03,7,21,0,3,131.03,0.00,0.67,0.00,0,4.00,1,476.37,3,0,4,org.apache.lucene.analysis.BaseTokenStreamTestCase,0.00,3,2,4,0,3,4,0,6,114,1
"org.apache.lucene.analysis.tr.TestTurkishLowerCaseFilter",4,0.00,1.00,16,0.22,3487.52,4,0,9,8,7,146.00,14,27,0,3,125.39,0.00,0.67,0.00,0,4.00,1,656.57,2,0,7,org.apache.lucene.analysis.BaseTokenStreamTestCase,0.00,4,2,4,0,4,4,0,4,146,1
"org.apache.lucene.analysis.tr.TestTurkishLowerCaseFilter$Analyzer",1,0.00,1.00,4,0.05,753.46,1,0,9,4,3,125.89,0,6,0,1,125.89,0.00,0.00,0.00,0,1.00,1,135.44,0,1,3,java.lang.Object,0.00,3,0,1,0,3,0,0,0,34,0
"org.apache.lucene.analysis.tr.TurkishAnalyzer",5,0.33,1.20,22,0.27,6149.05,8,3,14,16,13,74.17,46,32,1,3,124.17,0.00,0.67,0.07,0,8.00,2,815.22,0,2,12,org.apache.lucene.analysis.util.StopwordAnalyzerBase,0.00,11,2,6,0,11,3,0,9,185,2
"org.apache.lucene.analysis.tr.TurkishAnalyzer$DefaultSetHolder",0,0.00,0.00,6,0.05,732.71,1,1,14,0,2,171.00,2,11,0,1,171.00,0.00,0.00,0.00,0,0.00,0,149.07,0,0,2,java.lang.Object,0.00,0,0,0,0,0,0,0,2,37,2
"org.apache.lucene.analysis.tr.TurkishLowerCaseFilter",4,0.13,3.25,47,0.59,38986.60,9,5,4,14,9,58.18,29,59,6,4,100.47,0.00,0.75,0.30,1,4.00,6,1760.91,0,0,3,org.apache.lucene.analysis.TokenFilter,0.25,10,3,13,0,10,4,0,10,339,2
"org.apache.solr.util.xslt.TransformerProvider",3,0.58,2.67,45,0.69,27862.91,9,6,14,29,6,77.78,17,63,2,1,95.66,0.00,0.00,0.56,0,0.00,4,2084.14,0,2,4,java.lang.Object,0.00,26,0,8,0,26,1,0,9,369,1
"org.apache.lucene.analysis.standard.std.Deprecated",24,0.05,2.50,254,27.11,942105.24,65,41,3,33,3,49.21,197,3453,0,1,97.31,0.00,0.00,0.07,2,234.00,23,81341.65,0,1,3,java.lang.Object,0.00,9,0,60,0,9,23,1,73,7944,2
"org.apache.solr.spelling.AbstractLuceneSpellChecker",12,0.05,2.75,113,1.74,115831.02,30,18,29,45,32,124.41,40,151,8,2,103.79,3.00,0.20,0.10,2,70.00,12,5220.05,1,8,24,org.apache.solr.spelling.SolrSpellChecker,0.19,33,1,33,3,33,4,0,13,895,2
"org.apache.solr.spelling.DirectSolrSpellChecker",6,0.18,4.00,92,1.72,92564.12,27,21,22,35,22,94.06,26,123,1,2,93.83,0.00,0.50,0.20,0,0.00,12,5157.63,1,2,21,org.apache.solr.spelling.SolrSpellChecker,0.27,29,1,24,0,29,4,0,4,847,1
"org.apache.solr.spelling.DirectSolrSpellCheckerTest",3,0.50,1.00,37,0.79,30484.88,4,1,15,30,17,149.19,5,49,0,3,99.19,0.00,0.67,0.67,0,1.00,1,2374.79,5,0,17,org.apache.solr.SolrTestCaseJ4,0.00,27,2,3,0,27,3,0,3,410,1
"org.apache.solr.spelling.FileBasedSpellChecker",5,0.06,2.00,42,0.69,24865.08,9,4,15,38,16,128.66,18,64,1,3,108.04,0.00,0.67,0.30,1,1.00,5,2056.00,1,3,15,org.apache.solr.spelling.AbstractLuceneSpellChecker,0.00,33,2,10,0,33,2,0,10,370,1
"org.apache.solr.spelling.FileBasedSpellCheckerTest",5,0.00,1.00,106,2.46,116462.13,6,1,13,39,13,127.17,12,117,0,3,87.29,0.00,0.67,1.00,0,0.00,1,7369.83,3,0,13,org.apache.solr.SolrTestCaseJ4,0.00,34,2,5,0,34,5,0,6,1157,1
"org.apache.solr.spelling.IndexBasedSpellChecker",6,0.10,2.00,39,0.44,11496.17,10,4,11,18,12,136.58,22,59,4,3,115.97,0.50,0.50,0.17,1,2.00,3,1330.29,2,2,8,org.apache.solr.spelling.AbstractLuceneSpellChecker,0.00,12,2,12,1,12,4,0,11,281,1
"org.apache.solr.spelling.IndexBasedSpellCheckerTest",7,0.08,1.29,200,4.45,297822.28,9,2,28,62,27,120.39,14,242,0,3,80.51,0.00,0.67,0.43,0,0.00,2,13341.41,3,0,27,org.apache.solr.SolrTestCaseJ4,0.00,55,2,9,0,55,7,0,12,2027,1
"org.apache.solr.spelling.IndexBasedSpellCheckerTest$TestSpellChecker",1,0.00,1.00,3,0.02,168.05,1,0,28,1,2,135.68,0,7,0,4,135.68,0.00,0.75,0.00,0,0.00,1,52.05,0,1,2,org.apache.solr.spelling.IndexBasedSpellChecker,0.14,0,3,1,0,0,0,0,0,17,1
"org.apache.solr.spelling.PossibilityIterator",7,0.12,3.57,96,1.26,117042.62,11,4,9,42,5,96.13,31,109,2,1,95.90,0.00,0.00,0.36,1,8.00,11,3780.76,0,2,3,java.lang.Object,0.00,35,0,25,0,35,5,1,3,663,1
"org.apache.solr.spelling.QueryConverter",4,0.50,1.00,10,0.07,810.83,6,2,5,4,7,93.50,34,14,3,1,141.60,0.00,0.00,0.12,0,6.00,1,216.72,0,2,4,java.lang.Object,0.00,0,0,4,3,0,2,1,3,62,2
"org.apache.solr.spelling.RankedSpellPossibility",6,0.10,1.33,22,0.24,6297.39,8,2,1,15,5,129.35,1,30,4,1,129.35,0.00,0.00,0.42,0,6.00,3,726.57,0,2,1,java.lang.Object,0.00,9,0,8,0,9,4,1,1,171,1
"org.apache.solr.spelling.SampleComparator",1,0.00,1.00,3,0.04,596.66,1,0,2,2,1,131.58,4,6,0,1,131.34,0.00,0.00,0.00,0,1.00,1,118.39,0,0,1,java.lang.Object,0.00,1,0,1,0,1,1,1,1,32,1
"org.apache.solr.spelling.SimpleQueryConverter",1,0.00,3.00,26,0.47,21227.46,1,0,14,26,13,66.02,5,32,3,3,83.89,0.00,0.67,0.00,0,1.00,3,1415.22,0,1,10,org.apache.solr.spelling.SpellingQueryConverter,0.00,25,2,3,0,25,0,0,2,234,0
"org.apache.solr.spelling.SolrSpellChecker",9,0.02,2.89,82,1.23,88660.22,17,8,19,42,26,85.84,48,89,10,1,103.71,0.00,0.00,0.14,1,22.00,14,3694.00,0,4,16,java.lang.Object,0.00,33,0,26,7,33,5,0,15,641,2
"org.apache.solr.spelling.SpellCheckCollation",9,0.09,1.11,26,0.20,3559.02,13,4,1,12,4,139.30,0,38,3,1,139.30,0.00,0.00,0.17,0,36.00,2,602.36,0,2,1,java.lang.Object,0.00,3,0,10,0,3,7,1,0,161,1
"org.apache.solr.spelling.SpellCheckCollator",2,1.00,8.00,70,1.30,106784.65,3,1,15,51,15,125.70,3,89,1,1,75.70,0.00,0.00,0.50,1,2.00,13,3892.78,0,2,14,java.lang.Object,0.00,49,0,16,0,49,0,0,3,588,1
"org.apache.solr.spelling.SpellCheckCollatorTest",6,0.00,1.50,223,4.13,259212.10,6,0,19,36,14,96.52,18,246,0,3,75.91,0.00,0.67,0.00,0,0.00,3,12392.94,3,0,14,org.apache.solr.SolrTestCaseJ4,0.00,30,2,9,0,30,6,0,18,1934,1
"org.apache.solr.spelling.SpellCheckCorrection",6,0.20,1.00,16,0.09,916.94,9,3,1,6,3,142.57,0,23,2,1,142.57,0.00,0.00,0.17,0,18.00,1,275.03,0,2,1,java.lang.Object,0.00,0,0,6,0,0,4,0,0,82,1
"org.apache.solr.spelling.SpellPossibilityIteratorTest",3,0.25,3.00,93,1.65,106729.18,5,2,7,16,4,79.28,0,107,0,3,79.28,0.00,0.67,0.67,0,0.00,6,4935.30,1,0,4,org.apache.solr.SolrTestCaseJ4,0.04,13,2,9,0,13,3,0,0,842,1
"org.apache.solr.spelling.SpellingOptions",5,7.00,1.00,27,0.28,5826.23,12,7,4,5,12,72.67,43,33,9,1,120.78,0.00,0.00,0.00,0,5.00,1,828.90,0,0,3,java.lang.Object,0.00,0,0,5,0,0,5,0,10,192,1
"org.apache.solr.spelling.SpellingQueryConverter",2,0.17,3.50,48,0.79,27491.07,8,6,16,32,16,86.17,32,65,7,2,86.64,2.00,0.25,0.08,1,2.00,5,2378.75,0,1,9,org.apache.solr.spelling.QueryConverter,0.00,30,1,7,2,30,1,0,8,426,1
"org.apache.solr.spelling.SpellingQueryConverterTest",5,0.00,1.40,62,0.99,47636.11,5,0,6,19,4,119.95,15,72,0,2,99.33,0.00,0.50,0.00,0,5.00,3,2978.65,0,0,4,org.apache.lucene.util.LuceneTestCase,0.00,14,1,7,0,14,5,0,10,571,1
"org.apache.solr.spelling.SpellingResult",12,0.09,1.33,40,0.48,13285.29,16,4,5,16,11,129.40,51,56,10,1,129.16,0.00,0.00,0.17,1,64.00,3,1450.18,0,5,1,java.lang.Object,0.00,4,0,16,0,4,7,0,10,334,1
"org.apache.solr.spelling.SuggestQueryConverter",1,0.00,3.00,9,0.11,3919.36,1,0,6,5,3,107.09,4,15,1,3,106.86,0.00,0.67,0.00,0,1.00,3,333.31,1,1,2,org.apache.solr.spelling.SpellingQueryConverter,0.00,4,2,3,0,4,0,0,2,69,1
"org.apache.solr.spelling.TestSuggestSpellingConverter",3,0.00,1.00,17,0.23,4451.53,4,1,16,10,13,119.95,2,21,0,3,119.95,0.00,0.67,1.00,1,0.00,1,701.12,1,0,13,org.apache.lucene.analysis.BaseTokenStreamTestCase,0.00,7,2,3,0,7,3,0,2,154,1
"org.apache.solr.spelling.TestSuggestSpellingConverter$Analyzer",1,0.00,1.00,7,0.10,1892.79,1,0,16,7,6,113.67,0,10,0,1,113.67,0.00,0.00,0.00,0,1.00,1,295.34,0,1,6,java.lang.Object,0.00,6,0,1,0,6,0,0,0,62,0
"org.apache.lucene.analysis.standard.std.Deprecated",24,0.05,2.42,246,6.06,244551.85,63,39,3,33,3,53.83,196,779,0,1,101.93,0.00,0.00,0.07,2,234.00,21,18184.46,0,1,3,java.lang.Object,0.00,9,0,58,0,9,23,1,73,2570,2
"org.apache.lucene.benchmark.byTask.programmatic.Sample",2,0.00,1.00,37,0.47,13719.49,2,0,9,17,7,45.49,20,40,0,1,93.97,0.00,0.00,0.00,1,2.00,1,1405.53,0,1,7,java.lang.Object,0.00,15,0,2,0,15,1,0,14,262,1
"org.apache.lucene.analysis.th.TestThaiAnalyzer",14,0.00,1.00,63,1.21,25491.78,14,0,12,20,10,172.87,24,116,0,3,122.87,0.00,0.67,0.00,0,14.00,1,3621.23,6,0,10,org.apache.lucene.analysis.BaseTokenStreamTestCase,0.00,6,2,14,0,6,14,0,14,718,1
"org.apache.lucene.analysis.th.TestThaiAnalyzer$Analyzer",1,0.00,1.00,4,0.05,771.22,1,0,12,4,3,125.81,0,6,0,1,125.81,0.00,0.00,0.00,0,1.00,1,141.98,0,1,3,java.lang.Object,0.00,3,0,1,0,3,0,0,0,35,0
"org.apache.lucene.analysis.th.ThaiAnalyzer",4,2.00,1.50,16,0.22,4539.79,6,2,13,11,12,80.26,44,25,1,3,124.39,0.00,0.67,0.00,0,6.00,2,646.05,0,2,11,org.apache.lucene.analysis.util.StopwordAnalyzerBase,0.00,7,2,6,0,7,2,0,8,147,2
"org.apache.lucene.analysis.th.ThaiAnalyzer$DefaultSetHolder",0,0.00,0.00,6,0.05,732.71,1,1,13,0,2,171.00,2,11,0,1,171.00,0.00,0.00,0.00,0,0.00,0,149.07,0,0,2,java.lang.Object,0.00,0,0,0,0,0,0,0,2,37,2
"org.apache.lucene.analysis.th.ThaiWordFilter",3,0.54,4.67,64,0.95,50721.10,16,13,13,27,13,39.92,24,81,5,4,88.03,0.00,0.75,0.44,0,0.00,10,2843.50,1,0,8,org.apache.lucene.analysis.TokenFilter,0.53,24,3,14,0,24,3,0,10,512,2
"org.apache.lucene.facet.example.association.AssociationIndexer",1,0.00,4.00,38,0.61,31922.71,1,0,16,20,18,36.07,55,40,2,1,76.28,0.00,0.00,0.00,0,1.00,4,1833.88,0,0,16,java.lang.Object,0.00,19,0,4,0,19,1,0,25,292,1
"org.apache.lucene.facet.example.association.AssociationMain",3,0.00,1.00,25,0.28,6874.11,3,0,6,13,9,62.38,31,29,2,1,110.85,0.00,0.00,0.00,0,3.00,1,825.66,0,2,7,java.lang.Object,0.00,10,0,3,0,10,1,0,9,173,1
"org.apache.lucene.facet.example.association.AssociationSearcher",2,0.00,1.00,17,0.26,7280.91,2,0,10,10,11,89.13,28,26,1,1,109.27,0.00,0.00,0.00,0,2.00,1,773.15,0,2,10,java.lang.Object,0.00,8,0,2,0,8,0,0,8,152,1
"org.apache.lucene.facet.example.association.AssociationUtils",0,0.00,0.00,4,0.16,4254.55,3,3,6,5,9,171.00,37,26,3,1,171.00,0.00,0.00,0.00,0,0.00,0,480.00,0,0,6,java.lang.Object,0.00,5,0,0,0,5,0,0,14,96,1
"org.apache.lucene.analysis.sinks.DateRecognizerSinkFilter",3,0.17,2.00,16,0.16,3510.02,6,3,5,7,3,141.22,10,25,1,2,120.61,0.00,0.50,0.22,0,4.00,4,476.42,0,0,2,TeeSinkTokenFilter.SinkFilter,0.00,4,1,6,0,4,3,0,3,107,1
"org.apache.lucene.analysis.sinks.DateRecognizerSinkTokenizerTest",1,0.00,3.00,16,0.22,6974.39,1,0,6,10,4,95.56,0,20,0,3,95.56,0.00,0.67,0.00,0,1.00,3,665.18,0,0,4,org.apache.lucene.analysis.BaseTokenStreamTestCase,0.00,9,2,3,0,9,1,0,0,125,1
"org.apache.lucene.analysis.sinks.TeeSinkTokenFilter",7,1.00,2.43,46,0.53,16895.54,8,1,9,23,8,71.00,77,61,4,4,115.13,0.00,0.75,0.00,1,12.00,6,1587.60,1,0,4,org.apache.lucene.analysis.TokenFilter,0.42,16,3,17,0,16,7,0,11,334,2
"org.apache.lucene.analysis.sinks.TeeSinkTokenFilter$SinkFilter",2,0.00,1.00,3,0.02,126.08,2,0,9,2,1,157.06,9,5,0,1,156.83,0.00,0.00,0.00,0,2.00,1,59.16,0,0,1,java.lang.Object,0.00,0,0,2,0,0,2,0,3,21,3
"org.apache.lucene.analysis.sinks.TeeSinkTokenFilter$SinkFilter_0",1,0.00,1.00,3,0.02,175.12,1,0,9,1,1,135.54,0,5,0,1,135.54,0.00,0.00,0.00,0,1.00,1,54.60,0,0,1,java.lang.Object,0.00,0,0,1,0,0,1,0,0,17,0
"org.apache.lucene.analysis.sinks.TeeSinkTokenFilter$SinkTokenStream",7,0.04,1.57,29,0.31,6731.83,11,4,9,15,2,124.95,1,44,0,3,124.95,0.00,0.67,0.29,0,20.00,3,930.29,0,0,2,org.apache.lucene.analysis.TokenStream,0.60,8,2,11,0,8,7,0,1,215,3
"org.apache.lucene.analysis.sinks.TestTeeSinkTokenFilter",5,0.31,3.60,163,2.73,164038.44,9,4,22,66,23,99.61,15,157,0,3,79.00,0.00,0.67,0.50,0,2.00,11,8180.78,2,0,23,org.apache.lucene.analysis.BaseTokenStreamTestCase,0.00,61,2,18,0,61,5,0,9,1338,1
"org.apache.lucene.analysis.sinks.TestTeeSinkTokenFilter$ModuloSinkFilter",2,0.50,1.00,9,0.08,1499.92,4,2,22,2,1,125.90,0,13,0,2,125.90,0.00,0.50,0.75,0,0.00,1,227.39,0,0,1,TeeSinkTokenFilter.SinkFilter,0.00,0,1,2,0,0,2,0,0,57,0
"org.apache.lucene.analysis.sinks.TestTeeSinkTokenFilter$ModuloTokenFilter",2,0.00,1.50,15,0.11,3531.74,4,2,22,2,0,113.81,1,19,0,2,113.81,0.00,0.50,0.50,0,2.00,2,315.33,0,0,0,org.apache.lucene.index.TokenFilter,0.00,0,1,3,0,0,2,0,1,77,0
"org.apache.lucene.analysis.sinks.TestTeeSinkTokenFilter$TeeSinkTokenFilter.SinkFilter",1,0.00,1.00,4,0.05,853.17,1,0,22,4,2,125.46,0,6,0,1,125.46,0.00,0.00,0.00,0,1.00,1,149.49,0,0,2,java.lang.Object,0.00,3,0,1,0,3,1,0,0,37,0
"org.apache.lucene.analysis.sinks.TestTeeSinkTokenFilter$TeeSinkTokenFilter.SinkFilter_0",1,0.00,1.00,4,0.05,853.17,1,0,22,4,2,125.46,0,6,0,1,125.46,0.00,0.00,0.00,0,1.00,1,149.49,0,0,2,java.lang.Object,0.00,3,0,1,0,3,1,0,0,37,0
"org.apache.lucene.analysis.sinks.TokenRangeSinkFilter",3,0.17,1.33,15,0.12,2323.64,6,3,2,3,2,172.11,4,24,1,2,122.11,0.00,0.50,0.44,0,1.00,2,357.84,0,0,1,TeeSinkTokenFilter.SinkFilter,0.00,0,1,4,0,0,3,0,1,90,1
"org.apache.lucene.analysis.sinks.TokenRangeSinkTokenizerTest",1,0.00,3.00,16,0.21,6981.06,1,0,4,9,4,95.56,0,20,0,3,95.56,0.00,0.67,0.00,0,1.00,3,626.27,0,0,4,org.apache.lucene.analysis.BaseTokenStreamTestCase,0.00,8,2,3,0,8,1,0,0,120,1
"org.apache.lucene.analysis.sinks.TokenTypeSinkFilter",2,0.00,1.50,9,0.09,1646.64,4,2,2,5,3,165.37,4,14,1,2,125.49,0.00,0.50,0.50,0,2.00,2,275.77,0,0,2,TeeSinkTokenFilter.SinkFilter,0.00,3,1,3,0,3,2,0,2,67,1
"org.apache.lucene.analysis.sinks.TokenTypeSinkTokenizerTest",1,0.00,4.00,23,0.38,17178.61,1,0,8,14,8,86.54,0,28,0,3,86.54,0.00,0.67,0.00,0,1.00,4,1151.06,0,0,8,org.apache.lucene.analysis.BaseTokenStreamTestCase,0.00,13,2,4,0,13,1,0,0,202,1
"org.apache.lucene.analysis.sinks.TokenTypeSinkTokenizerTest$WordTokenFilter",2,0.00,2.00,10,0.11,2043.22,4,2,8,6,4,121.07,0,15,0,4,121.07,0.00,0.75,0.50,0,2.00,3,340.40,0,0,4,org.apache.lucene.analysis.TokenFilter,0.29,4,3,4,0,4,2,0,0,81,1
"org.apache.solr.spelling.suggest.jaspell.JaspellLookupFactory",2,0.00,1.00,8,0.09,1436.38,4,2,7,5,6,176.05,3,13,1,2,126.05,0.00,0.50,0.50,0,2.00,1,276.36,0,2,5,org.apache.solr.spelling.suggest.LookupFactory,0.50,3,1,2,0,3,0,0,1,66,1
"org.apache.lucene.codecs.nestedpulsing.NestedPulsingPostingsFormat",4,0.00,1.50,28,0.38,13847.43,4,0,16,14,16,151.40,8,48,2,2,111.51,0.00,0.50,0.00,0,4.00,2,1138.30,0,2,14,org.apache.lucene.codecs.PostingsFormat,0.00,10,1,6,0,10,2,0,5,229,1
"org.apache.lucene.analysis.snowball.Deprecated",3,0.17,2.00,18,0.32,11269.77,6,3,9,15,11,71.37,23,31,0,2,113.66,0.00,0.50,0.44,0,1.00,4,974.85,0,1,11,org.apache.lucene.analysis.Analyzer,0.00,12,1,6,0,12,2,0,6,199,2
"org.apache.lucene.analysis.snowball.SnowballFilter",3,0.17,2.67,26,0.36,11590.09,6,3,8,18,30,66.55,22,39,23,4,108.84,0.00,0.75,0.44,0,1.00,4,1074.57,0,0,7,org.apache.lucene.analysis.TokenFilter,0.27,15,3,8,0,15,3,0,3,217,2
"org.apache.lucene.analysis.snowball.TestSnowball",8,0.00,1.12,50,0.78,17246.26,8,0,16,23,14,165.69,14,69,0,3,115.69,0.00,0.67,0.00,0,8.00,2,2329.50,3,0,14,org.apache.lucene.analysis.BaseTokenStreamTestCase,0.00,15,2,9,0,15,8,0,6,466,1
"org.apache.lucene.analysis.snowball.TestSnowball$Analyzer",1,0.00,1.00,4,0.05,771.22,1,0,16,4,3,125.81,0,6,0,1,125.81,0.00,0.00,0.00,0,1.00,1,141.98,0,1,3,java.lang.Object,0.00,3,0,1,0,3,0,0,0,35,0
"org.apache.lucene.analysis.snowball.TestSnowball$TestTokenStream",2,0.67,1.00,18,0.24,4507.22,8,6,16,11,8,109.00,0,22,0,3,109.00,0.00,0.67,0.50,0,2.00,1,709.55,0,0,8,org.apache.lucene.analysis.TokenStream,0.30,9,2,2,0,9,2,0,0,149,2
"org.apache.lucene.analysis.snowball.TestSnowballVocab",2,0.00,1.50,23,0.24,3094.52,2,0,7,5,3,58.84,16,28,0,2,106.94,0.00,0.50,0.00,1,2.00,2,716.64,0,0,3,org.apache.lucene.util.LuceneTestCase,0.00,3,1,3,0,3,2,0,9,140,1
"org.apache.lucene.analysis.snowball.TestSnowballVocab$Analyzer",1,0.00,1.00,4,0.05,771.22,1,0,7,4,3,125.81,0,7,0,1,125.81,0.00,0.00,0.00,0,1.00,1,141.98,0,1,3,java.lang.Object,0.00,3,0,1,0,3,0,0,0,35,0
"org.apache.lucene.analysis.gl.GalicianAnalyzer",5,0.50,1.20,21,0.25,5941.93,7,2,15,15,14,76.18,42,31,1,3,124.29,0.00,0.67,0.10,0,8.00,2,759.17,0,2,13,org.apache.lucene.analysis.util.StopwordAnalyzerBase,0.00,10,2,6,0,10,3,0,8,174,2
"org.apache.lucene.analysis.gl.GalicianAnalyzer$DefaultSetHolder",0,0.00,0.00,6,0.07,1184.64,1,1,15,0,4,171.00,2,11,0,1,171.00,0.00,0.00,0.00,0,0.00,0,206.69,0,0,4,java.lang.Object,0.00,0,0,0,0,0,0,0,2,48,2
"org.apache.lucene.analysis.gl.GalicianMinimalStemFilter",2,0.33,2.00,14,0.16,3794.18,5,3,6,9,9,113.74,9,20,3,4,113.50,0.00,0.75,0.50,0,2.00,3,481.98,0,0,6,org.apache.lucene.analysis.TokenFilter,0.29,7,3,4,0,7,2,0,1,107,2
"org.apache.lucene.analysis.gl.GalicianMinimalStemmer",1,0.00,1.00,4,0.06,973.48,2,1,1,3,2,76.90,8,7,1,2,125.01,0.00,0.50,1.00,0,0.00,1,170.48,0,0,1,org.apache.lucene.analysis.pt.RSLPStemmerBase,0.00,2,1,1,0,2,1,0,1,42,1
"org.apache.lucene.analysis.gl.GalicianStemFilter",2,0.33,2.00,15,0.18,4744.35,5,3,6,9,10,94.87,10,21,4,4,112.74,0.00,0.75,0.50,0,2.00,3,535.08,0,0,6,org.apache.lucene.analysis.TokenFilter,0.29,7,3,4,0,7,2,0,2,116,2
"org.apache.lucene.analysis.gl.GalicianStemmer",1,0.00,9.00,41,0.51,38559.53,8,7,2,2,2,44.84,13,40,1,2,74.22,0.00,0.50,1.00,0,0.00,9,1518.51,1,0,1,org.apache.lucene.analysis.pt.RSLPStemmerBase,0.00,1,1,9,0,1,1,0,4,280,1
"org.apache.lucene.analysis.gl.TestGalicianAnalyzer",4,0.00,1.00,15,0.16,2494.63,4,0,4,7,4,181.19,7,21,0,3,131.19,0.00,0.67,0.00,0,4.00,1,481.49,3,0,4,org.apache.lucene.analysis.BaseTokenStreamTestCase,0.00,3,2,4,0,3,4,0,6,114,1
"org.apache.lucene.analysis.gl.TestGalicianMinimalStemFilter",4,0.00,1.00,16,0.12,1591.29,4,0,7,6,5,178.07,4,22,0,3,128.07,0.00,0.67,0.00,0,4.00,1,363.52,3,0,5,org.apache.lucene.analysis.BaseTokenStreamTestCase,0.00,2,2,4,0,2,4,0,2,98,1
"org.apache.lucene.analysis.gl.TestGalicianMinimalStemFilter$Analyzer",1,0.00,1.00,4,0.05,1009.20,1,0,7,4,3,124.89,0,6,0,1,124.89,0.00,0.00,0.00,0,1.00,1,159.62,0,1,3,java.lang.Object,0.00,3,0,1,0,3,0,0,0,38,0
"org.apache.lucene.analysis.gl.TestGalicianMinimalStemFilter$Analyzer_0",1,0.00,1.00,4,0.05,753.46,1,0,7,4,3,125.89,0,6,0,1,125.89,0.00,0.00,0.00,0,1.00,1,135.44,0,1,3,java.lang.Object,0.00,3,0,1,0,3,0,0,0,34,0
"org.apache.lucene.analysis.gl.TestGalicianStemFilter",2,0.00,1.00,8,0.06,714.45,2,0,10,5,7,168.32,4,12,0,3,128.44,0.00,0.67,0.00,0,2.00,1,177.62,1,0,7,org.apache.lucene.analysis.BaseTokenStreamTestCase,0.00,3,2,2,0,3,2,0,2,48,1
"org.apache.lucene.analysis.gl.TestGalicianStemFilter$Analyzer",1,0.00,1.00,5,0.06,1073.53,1,0,10,5,5,121.06,0,8,0,1,121.06,0.00,0.00,0.00,0,1.00,1,188.94,0,1,5,java.lang.Object,0.00,4,0,1,0,4,0,0,0,44,0
"org.apache.lucene.analysis.gl.TestGalicianStemFilter$Analyzer_0",1,0.00,1.00,4,0.05,753.46,1,0,10,4,3,125.89,0,6,0,1,125.89,0.00,0.00,0.00,0,1.00,1,135.44,0,1,3,java.lang.Object,0.00,3,0,1,0,3,0,0,0,34,0
"org.apache.solr.servlet.CacheHeaderTest",9,0.44,1.33,128,1.82,74393.72,11,2,11,41,1,147.33,17,174,0,5,97.33,0.00,0.80,0.11,2,23.00,2,5462.13,5,2,1,org.apache.solr.servlet.CacheHeaderTestBase,0.00,32,4,12,0,32,7,0,15,1015,1
"org.apache.solr.servlet.CacheHeaderTestBase",10,0.00,2.10,52,0.71,28107.47,10,0,9,24,4,117.60,1,78,2,4,117.60,0.67,0.50,0.00,3,10.00,6,2120.56,1,3,2,org.apache.solr.SolrJettyTestBase,0.00,14,3,21,2,14,7,0,1,442,2
"org.apache.solr.servlet.DirectSolrConnection",5,0.12,3.00,51,0.76,37230.43,7,2,22,34,22,85.08,27,75,4,1,102.95,0.00,0.00,0.60,1,0.00,6,2286.16,0,3,18,java.lang.Object,0.00,29,0,15,0,29,2,0,7,429,1
"org.apache.solr.servlet.DirectSolrConnectionTest",5,0.50,1.60,30,0.34,10587.42,6,1,2,11,3,165.67,5,45,0,3,115.68,0.00,0.67,0.60,0,2.00,3,1020.22,1,2,3,org.apache.solr.util.AbstractSolrTestCase,0.24,6,2,8,0,6,3,0,5,215,1
"org.apache.solr.servlet.FileItemContentStream",2,0.00,1.00,10,0.08,946.18,3,1,30,7,12,123.86,0,15,1,2,123.86,0.00,0.50,1.00,0,0.00,1,241.60,0,1,11,org.apache.solr.common.util.ContentStreamBase,0.00,5,1,2,0,5,1,0,0,62,0
"org.apache.solr.servlet.HttpRequestContentStream",2,1.00,1.50,10,0.09,1543.69,3,1,30,6,12,172.09,2,15,1,2,122.10,0.00,0.50,0.50,0,2.00,2,284.88,0,1,11,org.apache.solr.common.util.ContentStreamBase,0.00,4,1,3,0,4,1,0,2,68,0
"org.apache.solr.servlet.LoadAdminUiServlet",2,0.00,1.50,18,0.30,9949.15,2,0,11,15,1,126.82,6,36,0,2,106.20,0.00,0.50,0.00,1,2.00,2,908.05,0,0,1,javax.servlet.http.HttpServlet,0.00,13,1,3,0,13,2,0,2,165,2
"org.apache.solr.servlet.LogLevelSelection",5,0.38,6.20,125,2.05,134996.00,7,2,11,41,1,83.77,20,179,0,2,83.54,0.00,0.50,0.20,2,11.00,12,6135.67,0,2,1,javax.servlet.http.HttpServlet,0.00,36,1,31,0,36,3,0,12,998,2
"org.apache.solr.servlet.LogLevelSelection$LogWrapper",6,0.07,2.83,31,0.37,11935.12,9,3,11,15,0,118.71,0,47,0,1,118.71,0.00,0.00,0.28,1,10.00,7,1106.25,0,1,0,java.lang.Object,0.00,9,0,17,0,9,5,1,0,254,2
"org.apache.solr.servlet.MultipartRequestParser",2,0.00,2.50,20,0.31,12940.92,3,1,30,20,16,103.71,8,33,3,1,103.48,0.00,0.00,1.00,0,0.00,4,938.67,0,1,14,java.lang.Object,0.00,18,0,5,0,18,1,1,8,167,0
"org.apache.solr.servlet.NoCacheHeaderTest",7,0.00,1.00,75,0.95,37945.98,7,0,6,16,1,144.18,15,109,0,5,104.29,0.00,0.80,0.00,3,7.00,1,2852.80,5,0,1,org.apache.solr.servlet.CacheHeaderTestBase,0.17,9,4,7,0,9,7,0,13,565,1
"org.apache.solr.servlet.RawRequestParser",1,0.00,1.00,4,0.06,1072.66,1,0,30,5,16,92.46,6,9,3,1,124.68,0.00,0.00,0.00,0,1.00,1,167.50,0,1,14,java.lang.Object,0.00,4,0,1,0,4,0,1,6,39,0
"org.apache.solr.servlet.SimpleRequestParser",1,0.00,1.00,3,0.03,513.01,1,0,30,2,13,131.86,0,8,1,1,131.86,0.00,0.00,0.00,0,1.00,1,100.82,0,1,12,java.lang.Object,0.00,1,0,1,0,1,0,1,0,26,0
"org.apache.solr.servlet.SolrDispatchFilter",15,0.02,4.60,236,3.93,295589.07,22,7,40,129,30,75.09,87,319,4,1,92.96,0.00,0.00,0.12,6,100.00,28,11799.42,0,5,26,java.lang.Object,0.00,114,0,69,0,114,10,1,52,1944,1
"org.apache.solr.servlet.SolrDispatchFilter$ServletSolrParams",0,0.00,0.00,1,0.00,17.41,0,0,40,0,0,171.00,0,0,0,1,171.00,0.00,0.00,0.00,0,0.00,0,11.61,0,0,0,java.lang.Object,0.00,0,0,0,0,0,0,0,0,5,0
"org.apache.solr.servlet.SolrRequestParser",1,0.00,1.00,2,0.02,209.87,1,0,30,1,16,141.49,0,5,5,1,141.49,0.00,0.00,0.00,0,1.00,1,63.36,0,1,11,,0.00,0,0,1,0,0,0,0,0,18,0
"org.apache.solr.servlet.SolrRequestParserTest",6,0.40,1.67,86,1.59,78943.77,7,1,22,48,11,145.69,9,117,0,3,95.69,0.00,0.67,0.67,0,0.00,2,4761.05,1,0,11,org.apache.solr.SolrTestCaseJ4,0.00,42,2,10,0,42,6,0,9,817,1
"org.apache.solr.servlet.SolrRequestParsers",6,0.11,3.83,90,1.29,73840.33,15,9,30,38,21,115.23,20,122,7,1,94.61,0.00,0.00,0.20,1,10.00,13,3883.57,0,3,16,java.lang.Object,0.00,32,0,23,0,32,3,0,15,694,1
"org.apache.solr.servlet.SolrRequestParsers$SolrQueryRequestBase",0,0.00,0.00,1,0.01,23.26,0,0,30,0,0,171.00,0,0,0,1,171.00,0.00,0.00,0.00,0,0.00,0,15.51,0,0,0,java.lang.Object,0.00,0,0,0,0,0,0,0,0,6,0
"org.apache.solr.servlet.StandardRequestParser",2,0.00,4.00,22,0.33,13923.68,4,2,30,15,16,151.57,2,35,2,1,101.57,0.00,0.00,0.50,0,2.00,7,993.39,0,1,14,java.lang.Object,0.00,13,0,8,0,13,1,1,2,185,0
"org.apache.solr.servlet.ZookeeperInfoServlet",3,1.00,1.33,25,0.40,15581.36,4,1,20,15,4,128.60,9,39,0,2,107.99,0.00,0.50,0.00,1,3.00,2,1186.31,0,0,4,javax.servlet.http.HttpServlet,0.00,12,1,4,0,12,3,0,5,221,2
"org.apache.solr.servlet.ZookeeperInfoServlet$ZKPrinter",8,0.09,5.88,192,2.55,141723.54,21,13,20,55,3,106.27,26,241,0,1,85.65,0.00,0.00,0.15,3,2.00,18,7652.20,0,1,3,java.lang.Object,0.00,47,0,47,0,47,7,0,20,1298,1
"org.apache.lucene.analysis.sv.SwedishAnalyzer",5,0.50,1.20,21,0.26,6053.81,7,2,17,16,15,76.12,42,31,1,3,124.22,0.00,0.67,0.10,0,8.00,2,777.74,0,2,14,org.apache.lucene.analysis.util.StopwordAnalyzerBase,0.00,11,2,6,0,11,3,0,8,177,2
"org.apache.lucene.analysis.sv.SwedishAnalyzer$DefaultSetHolder",0,0.00,0.00,6,0.07,1089.77,1,1,17,0,4,171.00,2,11,0,1,171.00,0.00,0.00,0.00,0,0.00,0,202.05,0,0,4,java.lang.Object,0.00,0,0,0,0,0,0,0,2,47,2
"org.apache.lucene.analysis.sv.SwedishLightStemFilter",2,0.33,2.00,14,0.16,3794.18,5,3,6,9,9,113.74,9,20,3,4,113.50,0.00,0.75,0.50,0,2.00,3,481.98,0,0,6,org.apache.lucene.analysis.TokenFilter,0.29,7,3,4,0,7,2,0,1,107,2
"org.apache.lucene.analysis.sv.SwedishLightStemmer",1,0.00,8.00,10,0.42,31455.50,1,0,1,2,1,55.51,7,41,1,1,97.80,0.00,0.00,0.00,0,1.00,8,1250.96,0,0,0,java.lang.Object,0.00,1,0,8,0,1,1,0,1,221,1
"org.apache.lucene.analysis.sv.TestSwedishAnalyzer",4,0.00,1.00,15,0.16,2494.63,4,0,4,7,4,181.19,7,21,0,3,131.19,0.00,0.67,0.00,0,4.00,1,481.49,3,0,4,org.apache.lucene.analysis.BaseTokenStreamTestCase,0.00,3,2,4,0,3,4,0,6,114,1
"org.apache.lucene.analysis.sv.TestSwedishLightStemFilter",3,0.00,1.00,10,0.08,885.78,3,0,8,6,5,183.75,5,15,0,3,133.75,0.00,0.67,0.00,0,3.00,1,234.73,2,0,5,org.apache.lucene.analysis.BaseTokenStreamTestCase,0.00,3,2,3,0,3,3,0,3,63,1
"org.apache.lucene.analysis.sv.TestSwedishLightStemFilter$Analyzer",1,0.00,1.00,4,0.05,1009.20,1,0,8,4,3,124.89,0,7,0,1,124.89,0.00,0.00,0.00,0,1.00,1,159.62,0,1,3,java.lang.Object,0.00,3,0,1,0,3,0,0,0,38,0
"org.apache.lucene.analysis.sv.TestSwedishLightStemFilter$Analyzer_0",1,0.00,1.00,4,0.05,753.46,1,0,8,4,3,125.89,0,6,0,1,125.89,0.00,0.00,0.00,0,1.00,1,135.44,0,1,3,java.lang.Object,0.00,3,0,1,0,3,0,0,0,34,0
"org.apache.solr.handler.clustering.AbstractClusteringTestCase",1,1.00,2.00,48,1.06,57288.48,3,2,3,6,4,22.55,8,142,2,3,70.66,1.00,0.40,0.50,0,0.00,2,3192.21,3,0,2,org.apache.solr.SolrTestCaseJ4,0.00,5,2,2,2,5,1,0,6,501,2
"org.apache.solr.handler.clustering.ClusteringComponent",13,0.00,3.46,134,2.20,130266.94,18,5,21,57,20,141.79,34,179,3,2,101.91,0.00,0.50,0.20,2,46.00,15,6596.47,1,7,17,org.apache.solr.handler.component.SearchComponent,0.29,44,1,45,0,44,6,1,16,1147,1
"org.apache.solr.handler.clustering.ClusteringComponentTest",1,0.00,1.00,33,0.50,17580.54,1,0,12,15,14,48.71,6,36,0,4,80.93,0.00,0.75,0.00,0,0.00,1,1491.90,0,0,14,org.apache.solr.handler.clustering.AbstractClusteringTestCase,0.00,14,3,1,0,14,1,0,3,253,1
"org.apache.solr.handler.clustering.ClusteringEngine",2,0.33,1.00,9,0.07,1013.17,5,3,2,3,5,167.13,4,12,3,1,127.24,0.00,0.00,0.50,0,0.00,1,217.49,0,2,2,java.lang.Object,0.00,1,0,2,4,1,0,0,1,57,1
"org.apache.solr.handler.clustering.ClusteringParams",0,0.00,0.00,6,0.08,1642.33,5,5,0,0,3,171.00,23,7,3,1,171.00,0.00,0.00,0.00,0,0.00,0,246.35,0,0,0,,0.00,0,0,0,0,0,0,0,3,57,1
"org.apache.solr.handler.clustering.DistributedClusteringComponentTest",2,0.00,1.50,14,0.20,4901.31,2,0,2,5,4,162.69,3,24,0,4,112.69,0.00,0.75,0.00,0,2.00,2,587.89,4,1,4,org.apache.solr.BaseDistributedSearchTestCase,0.07,3,3,3,0,3,1,0,3,111,1
"org.apache.solr.handler.clustering.DocumentClusteringEngine",2,0.00,1.00,3,0.03,163.57,2,0,3,2,6,107.46,20,4,2,2,155.94,1.00,0.33,0.00,0,2.00,1,76.87,0,2,4,org.apache.solr.handler.clustering.ClusteringEngine,0.00,0,1,2,1,0,0,0,3,25,2
"org.apache.solr.handler.clustering.MockDocumentClusteringEngine",2,0.00,1.00,7,0.06,1066.67,2,0,3,3,4,171.61,4,12,0,3,131.73,0.00,0.67,0.00,0,2.00,1,179.66,0,2,4,org.apache.solr.handler.clustering.DocumentClusteringEngine,0.00,1,2,2,0,1,0,0,1,48,1
"org.apache.solr.handler.clustering.SearchClusteringEngine",4,0.00,1.00,7,0.12,1437.61,4,0,9,6,9,171.49,12,14,2,2,150.88,1.00,0.33,0.00,0,4.00,1,346.64,0,4,7,org.apache.solr.handler.clustering.ClusteringEngine,0.00,2,1,4,1,2,0,0,3,85,2
"org.apache.lucene.facet.search.AdaptiveAccumulatorTest",1,0.00,1.00,5,0.06,1150.60,1,0,5,3,7,120.35,16,11,0,5,120.82,0.00,0.80,0.00,0,1.00,1,173.83,0,1,7,org.apache.lucene.facet.search.sampling.BaseSampleTestTopK,0.00,2,4,1,0,2,0,0,1,41,1
"org.apache.lucene.facet.search.AdaptiveFacetsAccumulator",6,0.80,1.50,23,0.24,5304.61,7,1,12,11,16,81.80,52,37,2,3,129.91,0.00,0.67,0.33,1,10.00,3,731.20,2,3,14,org.apache.lucene.facet.search.StandardFacetsAccumulator,0.00,5,2,9,0,5,3,0,10,171,2
"org.apache.lucene.facet.search.BaseTestTopK",8,0.02,1.38,41,0.57,15625.45,15,7,14,20,14,158.83,19,63,3,3,118.94,3.00,0.22,0.12,2,24.00,2,1720.55,3,5,11,org.apache.lucene.facet.FacetTestBase,0.30,12,2,11,6,12,3,0,4,372,2
"org.apache.lucene.facet.search.CategoryListIterator",3,0.00,1.00,4,0.03,147.66,3,0,1,3,13,175.81,55,5,13,1,157.67,0.00,0.00,0.00,0,3.00,1,75.83,0,0,0,,0.00,0,0,3,0,0,3,0,5,27,1
"org.apache.lucene.facet.search.CategoryListIteratorTest",2,0.00,6.00,82,1.31,70135.87,3,1,25,34,21,30.51,23,87,0,2,74.64,0.00,0.50,1.00,0,0.00,7,3935.50,0,0,21,org.apache.lucene.util.LuceneTestCase,0.00,32,1,12,0,32,2,0,6,629,1
"org.apache.lucene.facet.search.CategoryListIteratorTest$Analyzer",1,0.00,1.00,3,0.04,595.79,1,0,25,3,1,131.35,0,5,0,1,131.35,0.00,0.00,0.00,0,1.00,1,112.25,0,1,1,java.lang.Object,0.00,2,0,1,0,2,0,0,0,29,0
"org.apache.lucene.facet.search.CategoryListIteratorTest$DataTokenStream",3,0.36,1.67,27,0.30,7506.38,10,7,25,13,6,108.53,0,33,0,3,108.53,0.00,0.67,0.38,0,2.00,3,887.99,0,0,6,org.apache.lucene.analysis.TokenStream,0.27,10,2,5,0,10,3,0,0,184,3
"org.apache.lucene.facet.search.DrillDown",7,0.00,1.43,29,0.42,13819.54,7,0,9,20,15,80.22,49,39,7,1,122.51,0.00,0.00,0.00,2,7.00,4,1251.75,0,7,8,java.lang.Object,0.00,13,0,10,0,13,0,0,9,273,2
"org.apache.lucene.facet.search.DrillDownTest",7,0.22,2.00,85,1.28,42742.07,13,6,28,39,23,101.01,31,104,0,2,100.77,0.00,0.50,0.36,0,6.00,6,3833.22,0,0,23,org.apache.lucene.util.LuceneTestCase,0.00,32,1,14,0,32,7,0,16,729,1
"org.apache.lucene.facet.search.FacetArrays",5,0.35,1.80,29,0.21,3809.65,10,5,0,9,17,73.99,41,40,15,1,122.10,0.00,0.00,0.48,0,0.00,3,620.80,0,0,2,java.lang.Object,0.00,4,0,9,0,4,5,0,11,156,1
"org.apache.lucene.facet.search.FacetResultsHandler",9,2.00,1.00,18,0.17,2304.74,11,2,6,10,14,103.24,113,25,9,1,140.81,0.00,0.00,0.00,0,9.00,1,504.03,0,6,6,java.lang.Object,0.00,1,0,9,2,1,3,0,13,140,2
"org.apache.lucene.facet.search.FacetsAccumulator",7,0.10,1.29,28,0.24,4113.69,15,8,7,8,24,89.12,85,38,18,1,126.68,0.00,0.00,0.04,0,17.00,3,734.79,0,1,6,java.lang.Object,0.00,1,0,9,4,1,6,0,16,177,2
"org.apache.lucene.facet.search.FacetsCollector",8,0.07,1.38,31,0.33,5606.12,12,4,10,18,21,88.43,60,52,10,2,130.72,0.00,0.50,0.31,0,0.00,3,979.22,0,1,11,org.apache.lucene.search.Collector,0.33,10,1,11,0,10,7,0,8,231,1
"org.apache.lucene.facet.search.FloatArrayAllocator",3,1.00,1.00,9,0.08,1265.51,4,1,1,4,7,112.39,43,15,6,2,132.53,0.00,0.50,0.33,0,4.00,1,251.14,0,0,1,org.apache.lucene.facet.search.TemporaryObjectAllocator,0.25,1,1,3,0,1,3,0,4,67,2
"org.apache.lucene.facet.search.Heap",6,0.00,1.00,7,0.03,191.17,6,0,0,6,3,126.94,40,8,3,1,159.16,0.00,0.00,0.00,0,6.00,1,102.28,0,0,0,,0.00,0,0,6,0,0,6,0,8,41,1
"org.apache.lucene.facet.search.IntArrayAllocator",3,1.00,1.00,9,0.08,1333.70,4,1,1,4,7,112.21,43,15,6,2,132.35,0.00,0.50,0.33,0,4.00,1,249.55,0,0,1,org.apache.lucene.facet.search.TemporaryObjectAllocator,0.25,1,1,3,0,1,3,0,4,67,2
"org.apache.lucene.facet.search.PayloadIntDecodingIterator",7,0.14,1.43,35,0.38,9324.12,13,6,5,20,10,88.02,44,50,4,1,120.24,0.00,0.00,0.29,0,9.00,3,1143.18,0,0,6,java.lang.Object,0.00,13,0,10,0,13,7,1,4,261,1
"org.apache.lucene.facet.search.PayloadIterator",6,0.05,2.33,40,0.49,22381.22,10,4,8,17,8,65.55,49,57,1,1,113.65,0.00,0.00,0.29,0,14.00,9,1481.94,0,0,7,java.lang.Object,0.00,11,0,14,1,11,6,0,14,297,1
"org.apache.lucene.facet.search.SamplingWrapper",6,0.00,1.33,35,0.43,15795.03,8,2,8,22,8,75.63,43,49,1,2,117.93,0.00,0.50,0.50,2,0.00,3,1284.20,0,1,7,org.apache.lucene.facet.search.FacetsAccumulator,0.77,16,1,8,0,16,5,0,14,264,1
"org.apache.lucene.facet.search.SamplingWrapperTest",1,0.00,1.00,4,0.05,913.99,1,0,5,3,8,124.75,16,10,0,5,125.23,0.00,0.80,0.00,0,1.00,1,162.67,0,1,8,org.apache.lucene.facet.search.sampling.BaseSampleTestTopK,0.00,2,4,1,0,2,0,0,1,39,1
"org.apache.lucene.facet.search.ScoredDocIDs",3,0.00,1.00,4,0.02,86.13,3,0,2,3,20,111.41,26,5,18,1,159.52,0.00,0.00,0.00,0,3.00,1,50.87,0,2,2,,0.00,0,0,3,0,0,1,0,5,21,1
"org.apache.lucene.facet.search.ScoredDocIDsIterator",3,1.00,1.00,5,0.03,250.46,4,1,0,3,16,105.87,29,6,16,1,155.87,0.00,0.00,0.00,0,3.00,1,91.50,0,0,0,,0.00,0,0,3,0,0,3,0,6,31,1
"org.apache.lucene.facet.search.ScoredDocIdCollector",7,0.28,1.14,18,0.16,2529.99,10,3,9,11,20,121.72,37,25,10,2,139.60,2.00,0.25,0.10,0,12.00,2,485.75,0,3,10,org.apache.lucene.search.Collector,0.00,4,1,8,2,4,4,0,5,128,2
"org.apache.lucene.facet.search.ScoredDocIdCollector$NonScoringDocIdCollector",7,1.00,1.00,17,0.14,1980.82,8,1,9,9,3,140.46,0,28,0,3,140.46,0.00,0.67,0.14,0,17.00,1,432.22,0,1,3,org.apache.lucene.facet.search.ScoredDocIdCollector,0.83,2,2,7,0,2,6,0,0,116,3
"org.apache.lucene.facet.search.ScoredDocIdCollector$NonScoringDocIdCollector$ScoredDocIDsIterator",3,0.00,1.33,13,0.09,1529.57,5,2,9,4,1,127.16,2,14,0,1,127.16,0.00,0.00,0.50,0,2.00,2,269.02,0,0,1,java.lang.Object,0.00,1,0,4,0,1,3,0,2,70,0
"org.apache.lucene.facet.search.ScoredDocIdCollector$ScoredDocIDs",3,0.00,1.00,7,0.03,241.62,3,0,9,4,2,144.76,0,10,0,1,144.76,0.00,0.00,0.00,0,5.00,1,92.54,0,2,2,java.lang.Object,0.00,1,0,3,0,1,1,0,0,31,0
"org.apache.lucene.facet.search.ScoredDocIdCollector$ScoringDocIdCollector",7,0.42,1.14,25,0.26,6479.82,9,2,9,12,4,129.81,0,35,0,3,129.81,0.00,0.67,0.14,0,13.00,2,789.59,0,1,4,org.apache.lucene.facet.search.ScoredDocIdCollector,0.83,5,2,8,0,5,6,0,0,181,3
"org.apache.lucene.facet.search.ScoredDocIdCollector$ScoringDocIdCollector$ScoredDocIDsIterator_0",3,0.33,1.67,17,0.12,2537.71,6,3,9,4,1,121.76,2,19,0,1,121.76,0.00,0.00,0.56,0,0.00,3,371.14,0,0,1,java.lang.Object,0.00,1,0,5,0,1,3,0,2,90,0
"org.apache.lucene.facet.search.StandardFacetsAccumulator",9,0.08,3.89,119,1.78,114911.85,17,8,16,57,29,59.24,114,167,11,2,96.80,2.00,0.25,0.19,4,15.00,14,5353.81,2,3,19,org.apache.lucene.facet.search.FacetsAccumulator,0.00,48,1,35,2,48,6,0,42,922,1
"org.apache.lucene.facet.search.TemporaryObjectAllocator",5,0.25,1.40,16,0.14,2802.54,7,2,1,9,2,131.01,80,22,2,1,131.48,0.00,0.00,0.30,2,7.00,2,431.33,0,0,0,java.lang.Object,0.00,4,0,7,2,4,5,0,10,111,2
"org.apache.lucene.facet.search.TestCategoryListCache",8,0.00,1.38,41,0.49,13620.59,8,0,16,26,11,159.29,21,61,0,3,119.41,0.00,0.67,0.00,2,14.00,4,1475.36,7,0,11,org.apache.lucene.facet.FacetTestBase,0.00,18,2,11,0,18,8,0,6,295,1
"org.apache.lucene.facet.search.TestCategoryListCache$CategoryListData",1,0.00,1.00,4,0.04,762.59,1,0,16,3,1,125.84,0,6,0,1,125.84,0.00,0.00,0.00,0,1.00,1,108.08,0,1,1,java.lang.Object,0.00,2,0,1,0,2,0,0,0,28,0
"org.apache.lucene.facet.search.TestCategoryListCache$CategoryListData$CategoryListIterator",3,0.00,1.67,10,0.10,3072.08,3,0,16,6,0,129.38,0,14,0,1,129.38,0.00,0.00,0.00,0,3.00,3,286.10,0,0,0,java.lang.Object,0.00,3,0,5,0,3,3,0,0,72,0
"org.apache.lucene.facet.search.TestFacetArrays",1,0.00,1.00,13,0.16,4876.22,1,0,5,8,3,133.79,20,16,0,2,100.40,0.00,0.50,0.00,0,1.00,1,486.57,0,0,3,org.apache.lucene.util.LuceneTestCase,0.00,7,1,1,0,7,1,0,5,102,1
"org.apache.lucene.facet.search.TestFacetsAccumulatorWithComplement",8,0.00,1.50,51,0.67,19613.17,8,0,21,28,16,115.42,35,79,0,3,115.19,0.00,0.67,0.00,3,8.00,4,2015.10,5,2,16,org.apache.lucene.facet.FacetTestBase,0.10,20,2,12,0,20,6,0,10,402,1
"org.apache.lucene.facet.search.TestMultipleCategoryLists",11,0.00,1.18,175,3.10,105295.37,11,0,37,54,32,95.98,47,228,0,2,95.74,0.00,0.50,0.00,6,11.00,3,9297.72,0,2,32,org.apache.lucene.util.LuceneTestCase,0.00,43,1,13,0,43,9,0,30,1619,1
"org.apache.lucene.facet.search.TestScoredDocIdCollector",8,0.00,1.88,72,1.13,47467.66,8,0,20,41,15,126.16,30,99,0,3,105.55,0.00,0.67,0.00,1,16.00,4,3403.34,6,3,15,org.apache.lucene.facet.FacetTestBase,0.10,33,2,15,0,33,5,0,15,605,1
"org.apache.lucene.facet.search.TestTopKInEachNodeResultHandler",2,0.00,8.00,204,4.50,791850.72,2,0,30,69,28,90.82,42,225,0,2,51.52,0.00,0.50,0.00,1,2.00,15,13503.77,0,0,28,org.apache.lucene.util.LuceneTestCase,0.00,67,1,16,0,67,2,0,27,1833,1
"org.apache.lucene.facet.search.TestTopKInEachNodeResultHandler$DefaultFacetIndexingParams",1,0.00,1.00,3,0.01,149.03,1,0,30,1,0,136.09,0,5,0,1,136.09,0.00,0.00,0.00,0,1.00,1,44.54,0,0,0,java.lang.Object,0.00,0,0,1,0,0,1,0,0,15,0
"org.apache.lucene.facet.search.TestTopKResultsHandler",6,0.80,2.00,107,2.01,155155.19,7,1,11,30,10,90.43,28,139,0,4,90.19,0.00,0.75,0.33,0,14.00,3,6022.05,4,2,10,org.apache.lucene.facet.search.BaseTestTopK,0.33,24,3,12,0,24,4,0,8,1006,1
"org.apache.lucene.facet.search.TestTopKResultsHandler$FacetsCollector",1,0.00,1.00,5,0.06,1164.06,1,0,11,3,5,120.78,0,7,0,1,120.78,0.00,0.00,0.00,0,1.00,1,175.73,0,1,5,java.lang.Object,0.00,2,0,1,0,2,0,0,0,42,0
"org.apache.lucene.facet.search.TestTopKResultsHandler$FacetsCollector_0",1,0.00,1.00,5,0.06,1164.06,1,0,11,3,5,120.78,0,7,0,1,120.78,0.00,0.00,0.00,0,1.00,1,175.73,0,1,5,java.lang.Object,0.00,2,0,1,0,2,0,0,0,42,0
"org.apache.lucene.facet.search.TestTopKResultsHandler$FacetsCollector_1",1,0.00,1.00,5,0.06,1164.06,1,0,11,3,5,120.78,0,7,0,1,120.78,0.00,0.00,0.00,0,1.00,1,175.73,0,1,5,java.lang.Object,0.00,2,0,1,0,2,0,0,0,42,0
"org.apache.lucene.facet.search.TestTopKResultsHandlerRandom",3,0.00,4.33,60,0.98,66553.55,3,0,11,20,9,50.34,38,68,0,4,87.91,0.00,0.75,0.00,1,4.00,10,2951.35,5,1,9,org.apache.lucene.facet.search.BaseTestTopK,0.12,17,3,13,0,17,2,0,9,483,1
"org.apache.lucene.facet.search.TestTopKResultsHandlerRandom$FacetsCollector",1,0.00,2.00,6,0.08,1961.19,1,0,11,3,5,115.89,0,10,0,1,115.89,0.00,0.00,0.00,0,1.00,2,240.79,0,1,5,java.lang.Object,0.00,2,0,2,0,2,0,0,0,53,0
"org.apache.lucene.facet.search.TestTotalFacetCounts",3,0.00,1.33,49,1.06,78752.84,3,0,12,28,8,43.11,25,58,0,2,91.22,0.00,0.50,0.00,2,3.00,2,3193.37,0,0,8,org.apache.lucene.util.LuceneTestCase,0.00,25,1,4,0,25,3,0,10,513,1
"org.apache.lucene.facet.search.TestTotalFacetCounts$DefaultFacetIndexingParams",1,0.00,1.00,3,0.01,149.03,1,0,12,1,0,136.09,0,5,0,1,136.09,0.00,0.00,0.00,0,1.00,1,44.54,0,0,0,java.lang.Object,0.00,0,0,1,0,0,1,0,0,15,0
"org.apache.lucene.facet.search.TestTotalFacetCountsCache",12,0.64,2.08,226,4.05,241716.32,13,1,38,84,31,40.11,116,255,1,2,90.11,0.00,0.50,0.42,5,22.00,6,12142.64,1,0,30,org.apache.lucene.util.LuceneTestCase,0.00,72,1,25,0,72,12,0,76,2039,1
"org.apache.lucene.facet.search.TestTotalFacetCountsCache$DefaultFacetIndexingParams",1,0.00,1.00,3,0.01,149.03,1,0,38,1,0,136.09,0,5,0,1,136.09,0.00,0.00,0.00,0,1.00,1,44.54,0,0,0,java.lang.Object,0.00,0,0,1,0,0,1,0,0,15,0
"org.apache.lucene.facet.search.TestTotalFacetCountsCache$Multi",3,0.25,1.33,17,0.15,2507.61,7,4,38,7,6,121.85,0,25,0,2,121.85,0.00,0.50,0.42,0,1.00,2,441.30,0,1,6,org.apache.lucene.analysis.Thread,0.00,4,1,4,0,4,2,0,0,108,0
"org.apache.lucene.facet.search.TestTotalFacetCountsCache$TFCThread",2,0.50,1.50,13,0.12,1985.61,6,4,38,3,4,118.28,0,19,0,2,118.28,0.00,0.50,0.50,0,2.00,2,371.86,0,0,4,org.apache.lucene.analysis.Thread,0.00,1,1,3,0,1,2,0,0,89,2
"org.apache.lucene.facet.search.TopKFacetResultsHandler",7,0.00,4.29,123,1.65,111638.69,7,0,10,44,12,54.11,86,151,3,2,91.67,0.00,0.50,0.00,1,3.00,10,4950.54,1,4,10,org.apache.lucene.facet.search.FacetResultsHandler,0.00,37,1,30,0,37,3,0,40,873,1
"org.apache.lucene.facet.search.TopKFacetResultsHandler$TopKFacetResult",3,1.00,1.00,8,0.07,863.99,4,1,10,3,6,122.53,15,12,0,2,140.40,0.00,0.50,0.33,0,4.00,1,217.28,0,1,6,org.apache.lucene.facet.search.results.FacetResult,0.00,0,1,3,0,0,2,1,5,59,2
"org.apache.lucene.facet.search.TopKInEachNodeHandler",11,0.00,5.73,264,3.97,523869.74,11,0,14,60,11,127.40,315,331,1,2,82.28,0.00,0.50,0.00,4,23.00,19,11921.28,1,5,11,org.apache.lucene.facet.search.FacetResultsHandler,0.00,49,1,63,0,49,6,0,123,1987,1
"org.apache.lucene.facet.search.TopKInEachNodeHandler$AACO",1,3.00,1.00,8,0.06,874.11,4,3,14,1,0,134.76,3,11,0,1,114.15,0.00,0.00,0.00,0,1.00,1,193.71,0,0,0,java.lang.Object,0.00,0,0,1,0,0,1,0,3,50,3
"org.apache.lucene.facet.search.TopKInEachNodeHandler$ACComparator",2,0.00,1.00,3,0.02,175.47,2,0,14,2,0,155.70,0,4,0,1,155.70,0.00,0.00,0.00,0,2.00,1,73.04,0,0,0,java.lang.Object,0.00,0,0,2,0,0,2,0,0,24,3
"org.apache.lucene.facet.search.TopKInEachNodeHandler$AggregatedCategory",1,2.00,1.00,6,0.04,397.36,3,2,14,1,0,121.51,0,8,0,1,121.51,0.00,0.00,0.00,0,1.00,1,122.20,0,0,0,java.lang.Object,0.00,0,0,1,0,0,1,0,0,34,3
"org.apache.lucene.facet.search.TopKInEachNodeHandler$AggregatedCategoryHeap",2,1.00,1.00,7,0.08,1280.02,3,1,14,3,1,131.10,0,11,0,2,131.10,0.00,0.50,0.50,0,2.00,1,244.74,0,0,1,org.apache.lucene.util.PriorityQueue,0.00,1,1,2,0,1,2,0,0,63,2
"org.apache.lucene.facet.search.TopKInEachNodeHandler$AscOrdACComparator",2,0.00,1.00,4,0.04,564.87,2,0,14,2,0,140.47,0,7,0,2,140.47,0.00,0.50,0.00,0,2.00,1,119.75,0,0,0,org.apache.lucene.facet.search.ACComparator,0.00,0,1,2,0,0,2,0,0,34,3
"org.apache.lucene.facet.search.TopKInEachNodeHandler$AscValueACComparator",2,0.00,1.00,4,0.04,564.87,2,0,14,2,0,140.47,0,7,0,2,140.47,0.00,0.50,0.00,0,2.00,1,119.75,0,0,0,org.apache.lucene.facet.search.ACComparator,0.00,0,1,2,0,0,2,0,0,34,3
"org.apache.lucene.facet.search.TopKInEachNodeHandler$DescOrdACComparator",2,0.00,1.00,4,0.04,564.87,2,0,14,2,0,140.47,0,7,0,2,140.47,0.00,0.50,0.00,0,2.00,1,119.75,0,0,0,org.apache.lucene.facet.search.ACComparator,0.00,0,1,2,0,0,2,0,0,34,3
"org.apache.lucene.facet.search.TopKInEachNodeHandler$DescValueACComparator",2,0.00,1.00,4,0.04,564.87,2,0,14,2,0,140.47,0,7,0,2,140.47,0.00,0.50,0.00,0,2.00,1,119.75,0,0,0,org.apache.lucene.facet.search.ACComparator,0.00,0,1,2,0,0,2,0,0,34,3
"org.apache.lucene.facet.search.TopKInEachNodeHandler$IntermediateFacetResultWithHash",2,5.00,1.00,14,0.12,1818.77,7,5,14,2,3,136.79,7,18,0,1,116.18,0.00,0.00,0.00,0,2.00,1,354.30,0,1,3,java.lang.Object,0.00,0,0,2,0,0,1,1,7,82,2
"org.apache.lucene.facet.search.TopKInEachNodeHandler$ResultNodeHeap",2,1.00,1.00,7,0.09,1383.02,3,1,14,5,2,130.84,0,11,0,2,130.84,0.00,0.50,0.50,0,2.00,1,261.09,0,0,2,org.apache.lucene.util.PriorityQueue,0.00,3,1,2,0,3,2,0,0,67,2
"org.apache.lucene.facet.search.TotalFacetCounts",7,0.06,2.29,74,0.96,37294.97,13,6,22,34,20,71.94,46,91,6,1,104.16,0.00,0.00,0.12,0,18.00,4,2875.49,0,2,15,java.lang.Object,0.00,27,0,16,0,27,5,0,9,572,1
"org.apache.lucene.facet.search.TotalFacetCounts$CreationType",0,0.00,0.00,2,0.00,11.61,0,0,22,0,0,171.00,0,1,0,1,171.00,0.00,0.00,0.00,0,0.00,0,11.61,0,0,0,java.lang.Object,0.00,0,0,0,0,0,0,0,0,5,0
"org.apache.lucene.facet.search.TotalFacetCounts$StandardFacetsAccumulator",1,0.00,2.00,9,0.14,5335.10,1,0,22,5,4,105.89,0,12,0,1,105.89,0.00,0.00,0.00,0,1.00,2,410.77,0,1,4,java.lang.Object,0.00,4,0,2,0,4,0,0,0,81,0
"org.apache.lucene.facet.search.TotalFacetCountsCache",11,0.02,1.73,59,0.77,22458.20,16,5,11,35,10,74.61,131,84,4,1,118.74,0.00,0.00,0.22,4,36.00,3,2305.03,0,3,6,java.lang.Object,0.00,24,0,19,0,24,8,0,24,490,2
"org.apache.lucene.facet.search.TotalFacetCountsCache$TFCKey",3,0.25,2.00,26,0.34,13835.53,9,6,11,11,4,108.30,1,36,0,1,108.30,0.00,0.00,0.33,0,2.00,4,1008.47,0,0,4,java.lang.Object,0.00,8,0,6,0,8,3,0,1,215,2
"org.apache.lucene.facet.enhancements.association.AssociationEnhancement",10,0.26,2.20,56,0.59,18124.44,13,3,11,22,14,119.32,45,83,5,1,119.09,0.00,0.00,0.10,2,26.00,6,1769.61,1,4,10,java.lang.Object,0.00,12,0,22,0,12,6,1,5,397,1
"org.apache.lucene.facet.enhancements.association.AssociationFloatProperty",6,0.00,1.33,19,0.23,4701.10,6,0,1,11,5,130.58,29,33,3,2,130.35,0.00,0.50,0.00,0,10.00,3,676.87,1,1,2,org.apache.lucene.facet.enhancements.association.AssociationProperty,0.20,5,1,8,0,5,5,0,3,166,1
"org.apache.lucene.facet.enhancements.association.AssociationIntProperty",4,0.00,1.50,15,0.14,3354.70,4,0,1,5,7,97.86,26,24,5,2,130.09,1.00,0.33,0.00,0,6.00,3,417.68,0,0,2,org.apache.lucene.facet.enhancements.association.AssociationProperty,0.00,1,1,6,1,1,4,0,3,104,1
"org.apache.lucene.facet.enhancements.association.AssociationListTokenizer",3,0.25,3.00,28,0.34,13198.55,5,2,8,19,9,64.17,21,48,1,6,106.46,0.00,0.83,0.67,0,0.00,7,1017.37,0,0,9,org.apache.lucene.facet.index.streaming.CategoryListTokenizer,0.55,16,5,9,0,16,3,0,2,197,1
"org.apache.lucene.facet.enhancements.association.AssociationProperty",4,0.67,1.00,10,0.09,1137.98,5,1,2,6,9,96.32,45,16,7,1,140.45,0.00,0.00,0.50,0,4.00,1,271.12,0,1,2,java.lang.Object,0.00,2,0,4,3,2,3,1,5,73,2
"org.apache.lucene.facet.enhancements.association.AssociationPropertyTest",3,0.00,1.00,25,0.32,9554.00,3,0,6,13,4,91.85,17,32,0,2,109.73,0.00,0.50,0.00,0,3.00,1,967.17,0,0,4,org.apache.lucene.util.LuceneTestCase,0.00,10,1,3,0,10,3,0,2,212,1
"org.apache.lucene.facet.enhancements.association.AssociationsPayloadIterator",7,0.17,3.00,61,0.64,21776.42,12,5,8,25,12,89.41,102,93,4,1,109.55,0.00,0.00,0.34,0,0.00,7,1910.58,0,1,8,java.lang.Object,0.00,18,0,21,0,18,6,0,28,402,1
"org.apache.lucene.facet.enhancements.association.CustomAssociationPropertyTest",1,0.00,3.00,41,0.65,26773.99,1,0,17,34,17,75.25,16,43,0,2,75.72,0.00,0.50,0.00,0,1.00,3,1964.71,0,0,17,org.apache.lucene.util.LuceneTestCase,0.00,33,1,3,0,33,1,0,1,307,1
"org.apache.lucene.facet.enhancements.association.CustomAssociationPropertyTest$CustomProperty",2,0.00,1.00,5,0.03,319.07,2,0,17,3,2,142.42,0,9,0,3,142.42,0.00,0.67,0.00,0,2.00,1,97.12,0,0,2,org.apache.lucene.facet.enhancements.association.AssociationIntProperty,0.00,1,2,2,0,1,2,0,0,30,0
"org.apache.solr.schema.AbstractSubTypeFieldType",7,0.10,1.57,49,0.63,19234.34,14,7,7,22,11,132.91,24,62,2,3,112.29,1.50,0.33,0.22,1,12.00,3,1877.95,0,4,9,org.apache.solr.schema.FieldType,0.00,15,2,11,3,15,3,1,7,380,2
"org.apache.solr.schema.BCDIntField",7,0.00,1.00,15,0.18,2382.99,7,0,7,13,10,139.83,5,30,2,4,139.83,0.67,0.50,0.00,2,7.00,1,530.82,1,6,8,org.apache.solr.schema.PrimitiveFieldType,0.00,6,3,7,2,6,1,0,3,138,1
"org.apache.solr.schema.BCDLongField",1,0.00,1.00,3,0.03,392.72,1,0,1,2,2,153.39,3,6,0,5,132.77,0.00,0.80,0.00,0,1.00,1,87.85,1,1,2,org.apache.solr.schema.BCDIntField,0.00,1,4,1,0,1,0,0,1,25,1
"org.apache.solr.schema.BCDStrField",1,0.00,1.00,3,0.02,246.12,1,0,1,1,2,92.08,7,6,0,5,134.37,0.00,0.80,0.00,0,1.00,1,69.28,1,1,2,org.apache.solr.schema.BCDIntField,0.00,0,4,1,0,0,0,0,2,21,1
"org.apache.solr.schema.BadIndexSchemaTest",7,0.00,1.43,25,0.30,8071.23,7,0,6,14,3,129.01,3,46,0,3,129.01,0.00,0.67,0.00,1,7.00,4,886.69,3,0,3,org.apache.solr.SolrTestCaseJ4,0.00,7,2,10,0,7,7,0,3,200,1
"org.apache.solr.schema.BinaryField",6,0.00,1.67,35,0.53,22654.58,6,0,8,22,10,116.64,1,49,1,3,116.64,0.00,0.67,0.00,2,10.00,5,1604.22,0,5,9,org.apache.solr.schema.FieldType,0.06,16,2,10,0,16,1,0,1,314,1
"org.apache.solr.schema.BoolField",11,0.22,1.36,38,0.53,12491.01,15,4,21,23,21,129.07,8,63,1,4,129.07,0.00,0.75,0.05,2,20.00,3,1594.00,1,10,20,org.apache.solr.schema.PrimitiveFieldType,0.21,12,3,15,0,12,1,0,6,358,1
"org.apache.solr.schema.BoolField$BoolFieldSource",5,0.00,1.40,26,0.33,12953.82,7,2,21,14,5,117.97,1,35,0,2,117.97,0.00,0.50,0.50,1,0.00,3,995.57,0,2,5,org.apache.lucene.queries.function.ValueSource,0.31,9,1,7,0,9,3,0,1,207,0
"org.apache.solr.schema.BoolField$BoolFieldSource$BoolDocValues",3,0.00,1.00,7,0.07,904.21,3,0,21,5,0,140.25,0,13,0,1,140.25,0.00,0.00,0.00,0,3.00,1,195.31,0,0,0,java.lang.Object,0.00,2,0,3,0,2,3,0,0,53,0
"org.apache.solr.schema.BoolField$BoolFieldSource$BoolDocValues$ValueFiller",2,0.00,1.00,8,0.08,1439.25,3,1,21,4,2,126.04,0,12,0,1,126.04,0.00,0.00,1.00,0,0.00,1,248.05,0,1,2,java.lang.Object,0.00,2,0,2,0,2,1,0,0,62,0
"org.apache.solr.schema.BoolField$SolrAnalyzer",1,0.00,1.00,4,0.03,491.60,1,0,21,3,1,127.35,0,6,0,1,127.35,0.00,0.00,0.00,0,1.00,1,97.92,0,1,1,java.lang.Object,0.00,2,0,1,0,2,0,0,0,26,0
"org.apache.solr.schema.BoolField$SolrAnalyzer$Tokenizer",2,0.50,2.50,14,0.17,4586.86,4,2,21,5,1,112.80,0,20,0,1,112.80,0.00,0.00,0.75,0,0.00,4,524.31,1,0,1,java.lang.Object,0.00,3,0,5,0,3,2,0,0,111,0
"org.apache.solr.schema.ByteField",5,0.00,1.40,21,0.28,6384.57,5,0,8,16,11,106.13,25,35,2,4,124.00,0.00,0.75,0.00,0,8.00,3,830.41,3,3,9,org.apache.solr.schema.PrimitiveFieldType,0.08,11,3,7,0,11,2,0,9,183,1
"org.apache.solr.schema.CollationField",10,0.67,3.30,69,1.40,75084.33,11,1,24,39,16,93.31,57,129,0,3,111.18,0.00,0.67,0.40,1,26.00,13,4210.89,2,7,16,org.apache.solr.schema.FieldType,0.16,29,2,33,0,29,3,0,14,783,1
"org.apache.solr.schema.CoordinateFieldType",1,2.00,1.00,6,0.05,767.99,4,3,0,1,2,158.55,21,8,1,4,119.25,0.33,0.60,0.33,0,0.00,1,151.44,0,0,1,org.apache.solr.schema.AbstractSubTypeFieldType,0.00,0,3,1,1,0,1,0,3,38,2
"org.apache.solr.schema.CopyField",6,0.00,1.50,23,0.22,6182.25,10,4,0,9,6,150.00,20,36,5,1,129.38,0.00,0.00,0.25,0,18.00,3,650.67,0,1,1,java.lang.Object,0.00,3,0,9,0,3,5,0,5,159,1
"org.apache.solr.schema.CopyFieldTest",7,0.00,2.00,67,1.05,41148.31,7,0,10,23,9,105.56,6,117,0,3,105.56,0.00,0.67,0.00,0,12.00,5,3146.60,5,0,9,org.apache.solr.SolrTestCaseJ4,0.00,16,2,14,0,16,7,0,1,630,1
"org.apache.solr.schema.CurrencyField",15,0.06,2.00,117,1.99,87627.46,30,15,35,59,23,159.66,25,156,1,3,109.66,0.00,0.67,0.12,4,86.00,8,5983.32,1,5,22,org.apache.solr.schema.FieldType,0.10,44,2,30,0,44,10,2,9,1101,1
"org.apache.solr.schema.CurrencyField$CurrencyValue",9,0.31,1.89,56,0.66,28481.79,11,2,35,22,2,82.04,62,69,0,1,114.26,0.00,0.00,0.22,3,22.00,5,1978.43,0,4,2,java.lang.Object,0.00,13,0,17,0,13,5,0,8,412,0
"org.apache.solr.schema.CurrencyField$CurrencyValueSource",6,0.24,2.33,31,0.53,22662.99,11,5,35,16,5,116.56,0,43,0,2,116.56,0.00,0.50,0.40,1,0.00,6,1579.05,0,3,5,org.apache.lucene.queries.function.ValueSource,0.29,10,1,14,0,10,3,0,0,343,0
"org.apache.solr.schema.CurrencyField$CurrencyValueSource$FunctionValues",7,0.05,2.57,60,0.73,37459.61,14,7,35,18,0,107.73,0,75,0,1,107.73,0.00,0.00,0.18,2,13.00,8,2183.50,0,3,0,java.lang.Object,0.00,11,0,18,0,11,4,0,0,440,0
"org.apache.solr.schema.CurrencyField$FileExchangeRateProvider",10,0.02,3.60,103,1.85,118359.04,15,5,35,46,3,141.21,29,144,0,1,101.33,0.00,0.00,0.18,3,30.00,13,5541.82,0,3,3,java.lang.Object,0.00,36,0,36,0,36,7,1,7,970,0
"org.apache.solr.schema.CurrencyFieldTest",8,0.00,2.50,126,2.01,106660.83,8,0,8,34,8,144.44,8,144,0,3,94.44,0.00,0.67,0.00,0,16.00,8,6037.90,6,0,8,org.apache.solr.SolrTestCaseJ4,0.00,26,2,20,0,26,8,0,6,1062,1
"org.apache.solr.schema.DateField",20,0.02,1.85,98,1.52,66022.28,29,9,21,47,32,102.82,118,160,13,4,120.69,0.33,0.60,0.09,8,136.00,7,4551.62,2,19,20,org.apache.solr.schema.PrimitiveFieldType,0.06,27,3,37,1,27,1,0,27,914,1
"org.apache.solr.schema.DateField$DateFieldSource",5,0.50,1.00,14,0.14,2177.67,7,2,21,7,5,138.99,1,25,0,3,138.99,0.00,0.67,0.10,0,11.00,1,423.53,2,2,5,org.apache.lucene.queries.function.valuesource.FieldCacheSource,0.32,2,2,5,0,2,3,0,1,110,0
"org.apache.solr.schema.DateField$DateFieldSource$StringIndexDocValues",8,0.00,1.25,28,0.31,6789.87,8,0,21,13,0,130.09,1,46,0,1,130.09,0.00,0.00,0.00,1,14.00,2,929.81,0,4,0,java.lang.Object,0.00,5,0,10,0,5,4,0,1,220,0
"org.apache.solr.schema.DateField$ISO8601CanonicalDateFormat",4,0.33,2.25,34,0.55,22688.17,6,2,21,24,0,157.57,6,57,0,2,107.57,0.00,0.50,0.25,0,8.00,4,1646.02,3,3,0,java.text.SimpleDateFormat,0.00,20,1,9,0,20,1,0,6,320,2
"org.apache.solr.schema.DateField$ThreadLocalDateFormat",2,0.00,1.00,7,0.05,679.49,3,1,21,3,0,133.27,0,12,0,2,133.27,0.00,0.50,1.00,0,0.00,1,154.32,0,1,0,java.lang.ThreadLocal,0.00,1,1,2,0,1,1,0,0,44,2
"org.apache.solr.schema.DateFieldTest",15,0.14,1.00,105,1.10,16363.18,18,3,8,31,6,165.55,25,123,0,2,115.55,0.00,0.50,0.20,5,7.00,1,3295.55,1,0,6,org.apache.lucene.util.LuceneTestCase,0.00,16,1,15,0,16,15,0,22,702,1
"org.apache.solr.schema.Deprecated",8,0.00,1.00,22,0.28,5101.28,8,0,17,19,18,177.57,17,39,0,4,137.69,0.00,0.75,0.00,1,8.00,1,850.25,1,7,18,org.apache.solr.schema.PrimitiveFieldType,0.00,11,3,8,0,11,1,0,2,207,1
"org.apache.solr.schema.DoubleField",5,0.00,1.40,21,0.28,6384.57,5,0,8,16,11,124.24,22,35,2,4,124.00,0.00,0.75,0.00,0,8.00,3,830.41,3,3,9,org.apache.solr.schema.PrimitiveFieldType,0.00,11,3,7,0,11,2,0,9,183,1
"org.apache.solr.schema.ExchangeRateProvider",5,0.00,1.00,6,0.05,334.27,5,0,3,5,7,114.34,35,7,5,1,156.63,0.00,0.00,0.00,0,5.00,1,144.77,0,1,2,,0.00,0,0,5,0,0,4,0,6,48,1
"org.apache.solr.schema.ExternalFileField",4,0.17,2.00,23,0.37,14516.09,8,4,9,13,10,74.44,31,35,0,3,116.73,0.00,0.67,0.38,0,4.00,4,1110.21,1,2,10,org.apache.solr.schema.FieldType,0.06,9,2,8,0,9,2,0,4,219,1
"org.apache.solr.schema.FieldProperties",6,0.05,2.17,54,0.73,22397.41,22,16,2,15,3,157.10,10,69,3,1,107.10,0.00,0.00,0.02,1,10.00,4,2198.31,0,2,0,java.lang.Object,0.00,9,0,13,35,9,4,0,6,424,2
"org.apache.solr.schema.FieldType",39,0.04,1.54,161,2.24,84883.24,50,11,29,96,108,104.29,232,228,84,2,122.16,33.00,0.03,0.05,10,470.00,10,6724.64,0,25,26,org.apache.solr.schema.FieldProperties,0.00,57,1,60,33,57,14,0,56,1365,2
"org.apache.solr.schema.FieldType$DefaultAnalyzer",2,1.00,1.00,7,0.05,729.94,3,1,29,4,2,133.03,0,11,0,3,133.03,0.00,0.67,0.00,0,2.00,1,164.66,0,1,2,org.apache.solr.analysis.SolrAnalyzer,0.00,2,2,2,0,2,1,0,0,45,2
"org.apache.solr.schema.FieldType$DefaultAnalyzer$Tokenizer",1,0.00,2.00,12,0.17,4065.09,4,3,29,9,2,102.16,0,14,0,1,102.16,0.00,0.00,1.00,0,0.00,2,505.08,0,0,2,java.lang.Object,0.00,8,0,2,0,8,1,0,0,105,0
"org.apache.solr.schema.FieldTypePluginLoader",6,0.10,4.50,93,1.72,102523.27,12,6,20,56,18,75.58,31,144,1,2,93.45,0.00,0.50,0.25,1,10.00,10,5172.07,0,2,18,org.apache.solr.util.plugin.AbstractPluginLoader,0.00,50,1,27,0,50,4,0,25,885,2
"org.apache.solr.schema.FieldTypePluginLoader$AbstractPluginLoader<CharFilterFactory>",2,0.00,2.00,9,0.15,4116.81,2,0,20,9,2,172.29,2,18,0,1,122.29,0.00,0.00,0.00,0,2.00,3,459.81,0,0,2,java.lang.Object,0.00,7,0,4,0,7,2,0,2,96,0
"org.apache.solr.schema.FieldTypePluginLoader$AbstractPluginLoader<TokenFilterFactory>",2,0.00,2.00,9,0.16,4193.29,2,0,20,9,2,172.23,2,16,0,1,122.23,0.00,0.00,0.00,0,2.00,3,470.72,0,1,2,java.lang.Object,0.00,7,0,4,0,7,1,0,2,98,0
"org.apache.solr.schema.FieldTypePluginLoader$AbstractPluginLoader<TokenizerFactory>",2,0.00,2.00,10,0.19,5813.14,2,0,20,11,3,167.49,2,19,0,1,117.49,0.00,0.00,0.00,0,2.00,3,556.72,0,0,3,java.lang.Object,0.00,9,0,4,0,9,2,0,2,111,0
"org.apache.solr.schema.FieldTypePluginLoader$MultiTermChainBuilder",2,1.00,5.00,27,0.38,16646.51,6,4,20,9,7,98.21,0,34,0,1,98.21,0.00,0.00,0.75,0,0.00,7,1149.00,0,1,7,java.lang.Object,0.00,7,0,10,0,7,1,0,0,237,2
"org.apache.solr.schema.FloatField",5,0.00,1.40,21,0.28,6384.57,5,0,8,16,11,124.24,21,35,2,4,124.00,0.00,0.75,0.00,0,8.00,3,830.41,3,3,9,org.apache.solr.schema.PrimitiveFieldType,0.08,11,3,7,0,11,2,0,8,183,1
"org.apache.solr.schema.GeoHashField",6,1.00,1.33,25,0.45,10190.21,7,1,19,22,16,162.93,13,43,0,3,123.04,0.00,0.67,0.17,1,10.00,2,1346.33,1,5,16,org.apache.solr.schema.FieldType,0.00,16,2,8,0,16,1,1,7,278,1
"org.apache.solr.schema.ICUCollationField",10,0.67,3.80,90,1.66,91016.01,11,1,23,46,16,71.70,62,147,0,3,103.92,0.00,0.67,0.40,1,26.00,22,4965.31,2,7,16,org.apache.solr.schema.FieldType,0.16,36,2,38,0,36,3,0,14,860,1
"org.apache.solr.schema.IndexSchema",45,0.01,2.67,381,6.00,395463.60,69,24,25,152,112,88.16,257,471,92,1,106.03,0.00,0.00,0.05,15,1252.00,28,17997.84,0,30,23,java.lang.Object,0.00,107,0,120,0,107,15,0,70,2995,2
"org.apache.solr.schema.IndexSchema$DynamicCopy",4,0.33,1.00,13,0.10,1040.43,6,2,25,5,2,134.18,0,19,0,2,134.18,0.00,0.50,0.25,0,4.00,1,287.97,0,2,2,org.apache.solr.schema.DynamicReplacement,0.00,1,1,4,0,1,2,0,0,80,1
"org.apache.solr.schema.IndexSchema$DynamicDestCopy",4,0.11,2.00,24,0.32,8313.37,7,3,25,12,2,115.69,0,37,0,2,115.69,0.00,0.50,0.42,0,4.00,3,946.91,0,2,2,org.apache.solr.schema.DynamicCopy,0.00,8,1,8,0,8,2,0,0,202,1
"org.apache.solr.schema.IndexSchema$DynamicField",3,0.50,1.00,9,0.06,745.54,4,1,25,5,1,184.34,5,14,0,2,134.34,0.00,0.50,0.67,0,1.00,1,190.29,0,2,1,org.apache.solr.schema.DynamicReplacement,0.00,2,1,3,0,2,1,0,5,56,2
"org.apache.solr.schema.IndexSchema$DynamicReplacement",3,0.60,2.33,20,0.25,5901.89,8,5,25,8,0,155.73,7,29,0,1,115.84,0.00,0.00,0.60,0,2.00,3,754.56,0,0,0,java.lang.Object,0.00,5,0,7,0,5,3,1,1,168,2
"org.apache.solr.schema.IndexSchema$SimilarityFactory",1,0.00,1.00,3,0.02,206.33,1,0,25,1,1,134.98,0,5,0,1,134.98,0.00,0.00,0.00,0,1.00,1,51.19,0,1,1,java.lang.Object,0.00,0,0,1,0,0,0,0,0,17,0
"org.apache.solr.schema.IndexSchema$SolrIndexAnalyzer",4,0.67,1.50,16,0.19,4909.27,5,1,25,10,2,124.12,0,23,0,3,124.12,0.00,0.67,0.50,0,4.00,2,563.23,0,3,2,org.apache.lucene.analysis.AnalyzerWrapper,0.00,6,2,6,0,6,1,0,0,131,1
"org.apache.solr.schema.IndexSchema$SolrQueryAnalyzer",2,0.00,2.00,11,0.15,4898.30,2,0,25,8,1,118.08,0,16,0,2,118.08,0.00,0.50,0.00,0,2.00,2,460.73,0,2,1,org.apache.solr.schema.SolrIndexAnalyzer,0.00,6,1,4,0,6,0,0,0,101,1
"org.apache.solr.schema.IndexSchemaRuntimeFieldTest",2,0.00,1.00,20,0.28,6216.79,2,0,7,15,7,126.81,6,31,0,3,106.19,0.00,0.67,0.00,0,2.00,1,852.20,6,0,7,org.apache.solr.SolrTestCaseJ4,0.00,13,2,2,0,13,2,0,6,155,1
"org.apache.solr.schema.IndexSchemaTest",4,0.00,1.00,33,0.48,13900.80,4,0,10,15,7,159.43,5,52,0,3,109.43,0.00,0.67,0.00,0,0.00,1,1447.34,6,0,7,org.apache.solr.SolrTestCaseJ4,0.00,11,2,4,0,11,4,0,1,282,1
"org.apache.solr.schema.IntField",5,0.00,1.40,21,0.28,6384.57,5,0,8,16,11,124.24,21,35,2,4,124.00,0.00,0.75,0.00,0,8.00,3,830.41,3,3,9,org.apache.solr.schema.PrimitiveFieldType,0.08,11,3,7,0,11,2,0,8,183,1
"org.apache.solr.schema.LatLonType",10,0.33,2.70,129,2.30,153575.70,12,2,26,45,22,147.55,13,167,0,4,97.55,0.00,0.75,0.20,0,22.00,8,6907.41,3,7,22,org.apache.solr.schema.AbstractSubTypeFieldType,0.13,35,3,27,0,35,3,1,11,1164,1
"org.apache.solr.schema.LatLonValueSource",3,1.00,1.00,9,0.08,1086.65,4,1,26,4,13,133.05,0,15,1,4,133.05,0.00,0.75,0.33,1,4.00,1,241.08,0,2,12,org.apache.lucene.queries.function.valuesource.VectorValueSource,0.38,1,3,3,0,1,1,0,0,64,0
"org.apache.solr.schema.LongField",5,0.00,1.40,21,0.28,6384.57,5,0,8,16,11,124.24,22,35,2,4,124.00,0.00,0.75,0.00,0,8.00,3,830.41,3,3,9,org.apache.solr.schema.PrimitiveFieldType,0.00,11,3,7,0,11,2,0,9,183,1
"org.apache.solr.schema.MockExchangeRateProvider",5,0.17,1.40,31,0.37,8334.46,8,3,5,13,3,116.52,4,44,0,1,116.52,0.00,0.00,0.47,0,4.00,3,1122.96,0,1,3,java.lang.Object,0.00,8,0,7,0,8,4,1,2,252,1
"org.apache.solr.schema.MultiTermTest",5,0.00,1.80,43,0.65,20932.15,5,0,5,14,5,108.66,0,53,0,3,108.66,0.00,0.67,0.00,0,2.00,3,1941.96,1,1,5,org.apache.solr.SolrTestCaseJ4,0.00,9,2,9,0,9,4,0,0,374,1
"org.apache.solr.schema.NotRequiredUniqueKeyTest",2,0.00,1.00,9,0.10,1407.45,2,0,5,9,4,146.73,6,15,0,3,126.12,0.00,0.67,0.00,0,2.00,1,305.68,1,0,4,org.apache.solr.SolrTestCaseJ4,0.00,7,2,2,0,7,2,0,1,72,1
"org.apache.solr.schema.NumericFieldsTest",3,1.00,3.00,45,0.88,58333.91,4,1,4,6,2,143.10,5,117,0,3,93.10,0.00,0.67,0.00,1,3.00,5,2634.68,6,1,2,org.apache.solr.SolrTestCaseJ4,0.00,3,2,9,0,3,2,0,5,461,1
"org.apache.solr.schema.PointType",10,0.00,2.50,99,1.62,87506.04,10,0,21,37,20,144.04,29,122,1,5,104.15,0.00,0.80,0.00,0,0.00,7,4869.43,3,7,19,org.apache.solr.schema.CoordinateFieldType,0.08,27,4,25,0,27,3,1,15,877,1
"org.apache.solr.schema.PointTypeValueSource",3,1.00,1.00,9,0.08,1086.65,4,1,21,4,16,133.05,0,15,1,4,133.05,0.00,0.75,0.33,1,4.00,1,241.08,0,2,15,org.apache.lucene.queries.function.valuesource.VectorValueSource,0.38,1,3,3,0,1,1,0,0,64,0
"org.apache.solr.schema.PolyFieldTest",5,0.00,2.00,98,1.57,80038.52,5,0,10,30,12,110.65,16,123,0,3,90.03,0.00,0.67,0.00,0,2.00,3,4723.04,10,0,12,org.apache.solr.SolrTestCaseJ4,0.00,25,2,10,0,25,5,0,12,789,1
"org.apache.solr.schema.PrimitiveFieldType",1,0.00,2.00,5,0.06,1239.17,1,0,1,2,14,102.54,5,9,12,3,120.41,10.00,0.09,0.00,0,0.00,2,182.50,1,0,2,org.apache.solr.schema.FieldType,0.00,1,2,2,20,1,1,0,1,43,2
"org.apache.solr.schema.PrimitiveFieldTypeTest",2,1.00,1.00,112,1.56,164724.56,7,5,6,48,16,34.86,12,118,0,3,67.08,0.00,0.67,0.70,0,0.00,1,4693.51,1,0,16,org.apache.solr.SolrTestCaseJ4,0.04,46,2,2,0,46,2,0,10,823,1
"org.apache.solr.schema.RandomSortField",5,0.00,1.00,20,0.29,9271.53,5,0,12,13,13,74.70,41,29,0,3,122.81,0.00,0.67,0.00,0,5.00,1,857.15,0,2,13,org.apache.solr.schema.FieldType,0.06,8,2,5,0,8,3,0,8,198,1
"org.apache.solr.schema.RandomSortField$FieldComparatorSource",1,0.00,1.00,3,0.04,662.33,1,0,12,2,1,130.99,0,5,0,1,130.99,0.00,0.00,0.00,0,1.00,1,119.49,0,1,1,java.lang.Object,0.00,1,0,1,0,1,0,0,0,29,0
"org.apache.solr.schema.RandomSortField$FieldComparatorSource$FieldComparator<Integer>",6,0.20,1.00,17,0.20,3604.03,9,3,12,6,2,137.89,1,29,0,1,137.89,0.00,0.00,0.50,0,0.00,1,590.35,0,2,2,java.lang.Object,0.00,0,0,6,0,0,4,0,1,147,0
"org.apache.solr.schema.RandomSortField$RandomValueSource",5,0.75,1.20,14,0.13,2692.53,6,1,12,7,4,138.22,0,24,0,2,138.22,0.00,0.50,0.40,1,7.00,2,404.72,0,2,4,org.apache.lucene.queries.function.ValueSource,0.31,2,1,6,0,2,3,0,0,105,1
"org.apache.solr.schema.RandomSortField$RandomValueSource$IntDocValues",1,0.00,1.00,4,0.04,543.48,2,1,12,2,0,127.00,0,6,0,1,127.00,0.00,0.00,1.00,0,0.00,1,123.83,0,0,0,java.lang.Object,0.00,1,0,1,0,1,1,0,0,33,0
"org.apache.solr.schema.RequiredFieldsTest",5,0.00,1.00,46,0.89,20492.62,5,0,6,20,4,107.19,23,76,0,3,106.96,0.00,0.67,0.00,0,7.00,1,2677.15,9,0,4,org.apache.solr.SolrTestCaseJ4,0.04,15,2,5,0,15,5,0,21,483,1
"org.apache.solr.schema.SchemaAware",1,0.00,1.00,2,0.01,41.48,1,0,0,1,5,167.18,33,3,5,1,147.03,0.00,0.00,0.00,0,1.00,1,27.65,0,0,1,,0.00,0,0,1,0,0,1,0,3,11,1
"org.apache.solr.schema.SchemaField",35,0.02,1.54,123,1.42,66196.04,40,5,7,48,146,177.30,60,158,141,2,127.30,0.00,0.50,0.18,2,371.00,13,4248.25,2,8,7,org.apache.solr.schema.FieldProperties,0.00,13,1,54,0,13,27,0,19,950,2
"org.apache.solr.schema.ShortField",5,0.00,1.40,21,0.28,6384.57,5,0,8,16,11,106.13,25,35,2,4,124.00,0.00,0.75,0.00,0,8.00,3,830.41,3,3,9,org.apache.solr.schema.PrimitiveFieldType,0.08,11,3,7,0,11,2,0,9,183,1
"org.apache.solr.schema.SimilarityFactory",3,1.00,1.00,7,0.04,375.00,4,1,2,3,12,143.26,0,6,10,1,143.26,0.00,0.00,0.33,0,4.00,1,116.18,0,2,2,java.lang.Object,0.00,0,0,3,8,0,1,0,0,37,2
"org.apache.solr.schema.SortableDoubleFieldSource",6,0.20,1.00,19,0.22,4466.45,8,2,17,9,17,130.59,1,32,2,3,130.59,0.00,0.67,0.33,0,10.00,1,665.69,2,2,15,org.apache.lucene.queries.function.valuesource.FieldCacheSource,0.30,3,2,6,0,3,4,0,1,162,0
"org.apache.solr.schema.SortableDoubleFieldSource$StringIndexDocValues",9,0.88,1.22,22,0.28,4946.69,10,1,17,17,1,138.15,0,40,0,1,138.15,0.00,0.00,0.22,1,19.00,2,834.23,0,5,1,java.lang.Object,0.00,8,0,11,0,8,4,0,0,208,0
"org.apache.solr.schema.SortableDoubleFieldSource$StringIndexDocValues$ValueFiller",2,0.00,1.50,12,0.12,2655.21,3,1,17,6,3,117.29,0,17,0,1,117.29,0.00,0.00,1.00,0,0.00,2,374.53,0,1,3,java.lang.Object,0.00,4,0,3,0,4,1,0,0,85,0
"org.apache.solr.schema.SortableFloatFieldSource",6,0.20,1.00,17,0.19,3232.57,8,2,17,9,17,138.26,0,30,2,3,138.26,0.00,0.67,0.33,0,10.00,1,563.18,2,2,15,org.apache.lucene.queries.function.valuesource.FieldCacheSource,0.30,3,2,6,0,3,4,0,0,142,0
"org.apache.solr.schema.SortableFloatFieldSource$StringIndexDocValues",9,0.88,1.22,22,0.28,4946.69,10,1,17,17,1,138.15,0,40,0,1,138.15,0.00,0.00,0.22,1,19.00,2,834.23,0,5,1,java.lang.Object,0.00,8,0,11,0,8,4,0,0,208,0
"org.apache.solr.schema.SortableFloatFieldSource$StringIndexDocValues$ValueFiller",2,0.00,1.50,12,0.12,2655.21,3,1,17,6,3,117.29,0,17,0,1,117.29,0.00,0.00,1.00,0,0.00,2,374.53,0,1,3,java.lang.Object,0.00,4,0,3,0,4,1,0,0,85,0
"org.apache.solr.schema.SortableIntFieldSource",6,0.20,1.00,17,0.18,3234.51,8,2,17,8,16,138.26,0,30,1,3,138.26,0.00,0.67,0.33,0,10.00,1,541.50,2,2,15,org.apache.lucene.queries.function.valuesource.FieldCacheSource,0.30,2,2,6,0,2,4,0,0,138,0
"org.apache.solr.schema.SortableIntFieldSource$StringIndexDocValues",9,0.88,1.22,22,0.28,5118.64,10,1,17,17,1,138.03,0,40,0,1,138.03,0.00,0.00,0.22,1,19.00,2,845.65,0,5,1,java.lang.Object,0.00,8,0,11,0,8,4,0,0,210,0
"org.apache.solr.schema.SortableIntFieldSource$StringIndexDocValues$ValueFiller",2,0.00,1.50,12,0.13,2787.88,3,1,17,6,3,117.12,0,17,0,1,117.12,0.00,0.00,1.00,0,0.00,2,387.28,0,1,3,java.lang.Object,0.00,4,0,3,0,4,1,0,0,87,0
"org.apache.solr.schema.SortableLongFieldSource",6,0.20,1.00,17,0.18,3252.30,8,2,17,8,16,138.24,0,30,1,3,138.24,0.00,0.67,0.33,0,10.00,1,551.13,2,2,15,org.apache.lucene.queries.function.valuesource.FieldCacheSource,0.30,2,2,6,0,2,4,0,0,140,0
"org.apache.solr.schema.SortableLongFieldSource$StringIndexDocValues",9,0.88,1.22,22,0.28,5075.42,10,1,17,17,1,138.06,0,40,0,1,138.06,0.00,0.00,0.22,1,19.00,2,845.72,0,5,1,java.lang.Object,0.00,8,0,11,0,8,4,0,0,210,0
"org.apache.solr.schema.SortableLongFieldSource$StringIndexDocValues$ValueFiller",2,0.00,1.50,12,0.13,2787.88,3,1,17,6,3,117.12,0,17,0,1,117.12,0.00,0.00,1.00,0,0.00,2,387.28,0,1,3,java.lang.Object,0.00,4,0,3,0,4,1,0,0,87,0
"org.apache.solr.schema.SpatialDistanceQuery",7,0.11,1.86,36,0.77,23956.38,23,16,26,13,21,166.95,7,75,4,3,116.95,0.00,0.67,0.16,1,19.00,4,2321.46,2,3,17,org.apache.solr.search.ExtendedQueryBase,0.12,6,2,13,0,6,4,1,7,460,0
"org.apache.solr.schema.SpatialDistanceQuery$SpatialCollector",3,0.17,1.33,13,0.14,2329.51,6,3,26,8,2,125.72,0,20,0,3,125.72,0.00,0.67,0.44,0,1.00,2,405.80,1,0,2,org.apache.solr.search.DelegatingCollector,0.21,5,2,4,0,5,3,0,0,98,0
"org.apache.solr.schema.SpatialDistanceQuery$SpatialScorer",8,0.19,2.25,93,1.37,45170.55,31,23,26,21,9,152.42,12,110,0,3,102.42,0.00,0.67,0.21,3,0.00,5,4122.11,0,1,9,org.apache.lucene.search.Scorer,0.67,13,2,18,0,13,7,0,12,777,1
"org.apache.solr.schema.SpatialDistanceQuery$SpatialWeight",6,0.04,1.00,24,0.28,4904.38,11,5,26,11,9,125.61,0,37,0,2,125.61,0.00,0.50,0.17,1,10.00,1,832.31,0,3,9,org.apache.lucene.search.Weight,0.50,5,1,6,0,5,3,0,0,200,1
"org.apache.solr.schema.SpatialQueryable",1,0.00,1.00,2,0.01,54.79,1,0,3,1,7,113.86,6,3,4,1,146.08,0.00,0.00,0.00,0,1.00,1,36.53,0,1,3,,0.00,0,0,1,0,0,0,0,1,13,1
"org.apache.solr.schema.StrField",4,0.00,1.00,10,0.13,1785.97,4,0,7,10,19,138.90,3,19,10,4,138.90,0.33,0.60,0.00,0,4.00,1,383.65,1,3,9,org.apache.solr.schema.PrimitiveFieldType,0.08,6,3,4,1,6,1,0,1,96,1
"org.apache.solr.schema.StrFieldSource",5,1.00,1.00,12,0.12,1874.07,6,1,6,7,9,139.50,0,23,4,3,139.50,0.00,0.67,0.20,0,11.00,1,370.92,2,2,5,org.apache.lucene.queries.function.valuesource.FieldCacheSource,0.32,2,2,5,0,2,3,0,0,98,1
"org.apache.solr.schema.StrFieldSource$StringIndexDocValues",5,0.00,1.00,11,0.10,1397.68,5,0,6,9,0,140.51,0,21,0,1,140.51,0.00,0.00,0.00,0,5.00,1,306.09,0,3,0,java.lang.Object,0.00,4,0,5,0,4,2,0,0,86,0
"org.apache.solr.schema.TestBinaryField",3,0.30,6.00,120,1.58,172431.83,8,5,19,33,8,73.35,0,117,0,2,73.35,0.00,0.50,0.40,0,0.00,16,4746.64,2,0,8,org.apache.lucene.util.LuceneTestCase,0.00,30,1,18,0,30,3,0,0,805,1
"org.apache.solr.schema.TestBinaryField$Bean",0,0.00,0.00,3,0.02,388.55,2,2,19,0,0,171.00,0,7,0,1,171.00,0.00,0.00,0.00,0,0.00,0,74.01,0,0,0,java.lang.Object,0.00,0,0,0,0,0,0,0,0,20,2
"org.apache.solr.schema.TestCollationField",10,0.00,1.00,51,0.81,18025.04,10,0,10,28,2,119.52,47,106,0,3,119.29,0.00,0.67,0.00,1,10.00,1,2436.35,6,1,2,org.apache.solr.SolrTestCaseJ4,0.00,18,2,10,0,18,9,0,15,470,1
"org.apache.solr.schema.TestICUCollationField",9,0.00,1.00,49,0.78,17858.24,9,0,10,27,2,119.19,43,97,0,3,118.96,0.00,0.67,0.00,1,9.00,1,2352.95,6,1,2,org.apache.solr.SolrTestCaseJ4,0.00,18,2,9,0,18,8,0,14,450,1
"org.apache.solr.schema.TestICUCollationFieldOptions",6,0.00,1.00,25,0.39,6119.87,6,0,3,10,2,125.09,24,64,0,3,124.85,0.00,0.67,0.00,0,6.00,1,1160.42,5,0,2,org.apache.solr.SolrTestCaseJ4,0.00,4,2,6,0,4,6,0,7,240,1
"org.apache.solr.schema.TestOmitPositions",3,0.00,1.33,14,0.16,1917.07,3,0,2,5,1,166.27,6,29,0,3,126.38,0.00,0.67,0.00,0,3.00,2,472.95,7,0,1,org.apache.solr.SolrTestCaseJ4,0.00,2,2,4,0,2,3,0,6,106,1
"org.apache.solr.schema.TextField",13,0.42,3.77,166,2.36,325552.30,15,2,18,55,30,116.42,41,227,8,3,95.80,0.00,0.67,0.12,3,42.00,28,7067.92,2,7,22,org.apache.solr.schema.FieldType,0.05,42,2,49,0,42,6,0,22,1199,1
"org.apache.solr.schema.TrieDateField",19,0.00,1.11,43,0.57,10599.37,19,0,12,39,14,138.12,4,84,2,5,138.12,0.00,0.80,0.00,0,36.00,3,1699.16,0,14,13,org.apache.solr.schema.DateField,0.12,20,4,21,0,20,5,0,2,425,1
"org.apache.solr.schema.TrieDateField$TrieField",0,0.00,0.00,2,0.01,109.62,0,0,12,0,0,171.00,0,2,0,1,171.00,0.00,0.00,0.00,0,0.00,0,36.54,0,0,0,java.lang.Object,0.00,0,0,0,0,0,0,0,0,11,0
"org.apache.solr.schema.TrieDoubleField",0,0.00,0.00,2,0.02,163.12,0,0,0,0,1,171.00,16,5,0,5,171.00,0.00,0.80,0.00,0,0.00,0,46.60,0,0,1,org.apache.solr.schema.TrieField,0.00,0,4,0,0,0,0,0,1,13,1
"org.apache.solr.schema.TrieField",24,0.01,4.38,260,5.37,340745.15,32,8,27,111,50,140.55,49,444,17,4,100.66,1.33,0.38,0.14,5,38.00,18,16102.89,2,15,34,org.apache.solr.schema.PrimitiveFieldType,0.17,87,3,105,4,87,9,0,21,2809,1
"org.apache.solr.schema.TrieField$TrieDateFieldSource",5,0.00,1.00,11,0.11,1284.82,5,0,27,9,4,140.79,0,21,0,4,140.79,0.00,0.75,0.00,0,8.00,1,319.08,0,3,4,org.apache.lucene.queries.function.valuesource.LongFieldSource,0.43,4,3,5,0,4,2,0,0,87,0
"org.apache.solr.schema.TrieField$TrieTypes",0,0.00,0.00,2,0.01,42.79,0,0,27,0,0,171.00,0,7,0,1,171.00,0.00,0.00,0.00,0,0.00,0,28.53,0,0,0,java.lang.Object,0.00,0,0,0,0,0,0,0,0,9,1
"org.apache.solr.schema.TrieFloatField",0,0.00,0.00,2,0.02,163.12,0,0,0,0,1,171.00,16,5,0,5,171.00,0.00,0.80,0.00,0,0.00,0,46.60,0,0,1,org.apache.solr.schema.TrieField,0.00,0,4,0,0,0,0,0,1,13,1
"org.apache.solr.schema.TrieIntField",0,0.00,0.00,2,0.02,163.12,0,0,0,0,2,171.00,10,5,1,5,171.00,0.00,0.80,0.00,0,0.00,0,46.60,0,0,1,org.apache.solr.schema.TrieField,0.00,0,4,0,0,0,0,0,1,13,1
"org.apache.solr.schema.TrieLongField",0,0.00,0.00,2,0.02,163.12,0,0,0,0,2,171.00,10,5,1,5,171.00,0.00,0.80,0.00,0,0.00,0,46.60,0,0,1,org.apache.solr.schema.TrieField,0.00,0,4,0,0,0,0,0,1,13,1
"org.apache.solr.schema.UUIDField",6,0.40,1.33,21,0.38,10863.58,8,2,8,18,8,148.10,19,38,1,5,127.48,0.00,0.80,0.17,0,14.00,3,1145.05,3,4,7,org.apache.solr.schema.StrField,0.00,12,4,8,0,12,2,0,4,246,1
"org.apache.solr.schema.UUIDFieldTest",1,0.00,6.00,29,0.25,10088.52,1,0,2,4,2,84.51,0,41,0,2,84.51,0.00,0.50,0.00,0,1.00,6,760.51,0,0,2,org.apache.lucene.util.LuceneTestCase,0.00,3,1,6,0,3,1,0,0,155,1
"org.apache.lucene.benchmark.byTask.feeds.AbstractQueryMaker",7,0.06,1.29,29,0.29,7915.63,10,3,2,15,9,174.44,9,35,6,1,124.44,0.00,0.00,0.29,0,4.00,3,875.25,0,4,3,java.lang.Object,0.00,8,0,9,6,8,3,1,3,200,2
"org.apache.lucene.benchmark.byTask.feeds.ContentItemsSource",13,0.06,1.69,80,0.96,35178.84,25,12,7,28,4,135.44,49,89,2,1,114.82,0.00,0.00,0.14,4,78.00,6,2870.22,0,1,2,java.lang.Object,0.00,15,0,22,14,15,12,1,12,571,2
"org.apache.lucene.benchmark.byTask.feeds.ContentSource",1,0.00,1.00,2,0.02,158.75,1,0,1,1,15,104.88,12,3,12,2,142.44,11.00,0.08,0.00,0,1.00,1,56.19,0,1,3,org.apache.lucene.benchmark.byTask.feeds.ContentItemsSource,0.00,0,1,1,11,0,0,0,2,18,2
"org.apache.lucene.benchmark.byTask.feeds.DemoHTMLParser",1,0.00,6.00,26,0.51,29113.58,1,0,6,20,4,34.55,8,34,1,1,82.65,0.00,0.00,0.00,0,1.00,6,1526.77,0,1,3,java.lang.Object,0.00,19,0,6,0,19,0,1,6,251,1
"org.apache.lucene.benchmark.byTask.feeds.DirContentSource",0,0.00,0.00,3,0.04,681.48,0,0,13,0,2,171.00,13,3,0,3,171.00,0.00,0.67,0.00,0,0.00,0,108.42,0,0,2,org.apache.lucene.benchmark.byTask.feeds.ContentSource,0.00,0,2,0,0,0,0,0,2,26,1
"org.apache.lucene.benchmark.byTask.feeds.DirContentSource$DateFormatInfo",0,0.00,0.00,3,0.02,155.67,2,2,13,0,0,171.00,0,4,0,1,171.00,0.00,0.00,0.00,0,0.00,0,51.89,0,0,0,java.lang.Object,0.00,0,0,0,0,0,0,0,0,15,3
"org.apache.lucene.benchmark.byTask.feeds.DirContentSource$Iterator",14,0.03,1.64,100,1.14,39790.22,21,7,13,62,3,112.17,12,127,0,1,112.17,0.00,0.00,0.17,5,82.00,4,3405.90,2,4,3,java.lang.Object,0.00,48,0,23,0,48,10,1,11,693,2
"org.apache.lucene.benchmark.byTask.feeds.DirContentSource$Iterator$Comparator",1,0.00,5.00,13,0.16,9230.00,1,0,13,4,0,137.74,2,18,0,1,97.85,0.00,0.00,0.00,0,1.00,5,477.33,0,0,0,java.lang.Object,0.00,3,0,5,0,3,1,1,1,102,1
"org.apache.lucene.benchmark.byTask.feeds.DirContentSource$Iterator$FileFilter",1,0.00,1.00,3,0.02,173.90,1,0,13,2,0,135.56,0,4,0,1,135.56,0.00,0.00,0.00,0,1.00,1,52.97,0,0,0,java.lang.Object,0.00,1,0,1,0,1,1,0,0,17,0
"org.apache.lucene.benchmark.byTask.feeds.DirContentSource$Iterator$FileFilter_0",1,0.00,1.00,3,0.02,227.68,1,0,13,3,0,134.64,0,4,0,1,134.64,0.00,0.00,0.00,0,1.00,1,70.91,0,0,0,java.lang.Object,0.00,2,0,1,0,2,1,0,0,21,0
"org.apache.lucene.benchmark.byTask.feeds.DocData",14,0.03,1.07,43,0.27,3468.91,20,6,3,15,28,134.33,7,59,27,1,134.33,0.00,0.00,0.14,1,74.00,2,811.10,0,5,1,java.lang.Object,0.00,1,0,15,0,1,9,0,2,224,1
"org.apache.lucene.benchmark.byTask.feeds.DocMaker",11,0.14,3.45,197,3.23,269320.34,32,21,24,78,35,47.96,84,228,23,1,90.26,0.00,0.00,0.17,4,0.00,18,9703.55,0,4,12,java.lang.Object,0.00,67,0,38,8,67,7,1,29,1537,1
"org.apache.lucene.benchmark.byTask.feeds.DocMaker$DateUtil",1,2.00,1.00,6,0.07,1138.36,4,3,24,5,0,117.91,0,8,0,1,117.91,0.00,0.00,0.33,0,0.00,1,201.16,0,0,0,java.lang.Object,0.00,4,0,1,0,4,1,0,0,48,2
"org.apache.lucene.benchmark.byTask.feeds.DocMaker$DocState",3,0.40,4.33,51,0.60,22544.94,8,5,24,13,9,134.13,6,67,0,1,94.24,0.00,0.00,0.47,0,0.00,8,1794.89,0,2,9,java.lang.Object,0.00,10,0,13,0,10,1,0,2,351,1
"org.apache.lucene.benchmark.byTask.feeds.DocMaker$LeftOver",0,0.00,0.00,3,0.02,124.57,2,2,24,0,1,171.00,0,4,0,1,171.00,0.00,0.00,0.00,0,0.00,0,49.83,0,0,1,java.lang.Object,0.00,0,0,0,0,0,0,0,0,15,2
"org.apache.lucene.benchmark.byTask.feeds.DocMakerTest",5,0.00,1.60,70,1.10,42320.23,5,0,20,41,17,117.83,17,82,0,3,97.21,0.00,0.67,0.00,1,5.00,3,3313.03,1,1,17,org.apache.lucene.benchmark.BenchmarkTestCase,0.00,36,2,8,0,36,4,0,17,648,1
"org.apache.lucene.benchmark.byTask.feeds.DocMakerTest$OneDocSource",2,1.00,1.50,14,0.14,3522.28,3,1,20,9,3,113.82,0,21,0,3,113.82,0.00,0.67,0.50,0,2.00,2,418.51,0,1,3,org.apache.lucene.benchmark.byTask.feeds.ContentSource,0.19,7,2,3,0,7,1,0,0,91,2
"org.apache.lucene.benchmark.byTask.feeds.EnwikiContentSource",5,0.12,1.60,46,0.68,19086.96,17,12,14,21,8,127.71,16,62,2,3,107.09,0.00,0.67,0.18,0,12.00,2,2040.86,2,1,6,org.apache.lucene.benchmark.byTask.feeds.ContentSource,0.32,16,2,8,0,16,4,0,4,407,1
"org.apache.lucene.benchmark.byTask.feeds.EnwikiContentSource$Parser",6,0.27,5.00,109,1.32,67658.36,15,9,14,34,4,131.78,17,159,0,2,91.90,0.00,0.50,0.33,0,10.00,11,3953.15,0,2,4,org.xml.sax.helpers.DefaultHandler,0.00,28,1,30,0,28,4,1,17,718,1
"org.apache.lucene.benchmark.byTask.feeds.EnwikiQueryMaker",3,1.00,3.00,34,0.84,30978.19,4,1,16,22,15,100.53,14,74,0,2,100.29,0.00,0.50,0.33,2,4.00,6,2509.97,0,3,15,org.apache.lucene.benchmark.byTask.feeds.AbstractQueryMaker,0.20,19,1,9,0,19,0,1,5,436,1
"org.apache.lucene.benchmark.byTask.feeds.FacetSource",2,0.00,1.00,6,0.05,569.42,2,0,2,2,5,116.00,10,9,2,2,133.87,1.00,0.33,0.00,0,2.00,1,152.19,4,1,3,org.apache.lucene.benchmark.byTask.feeds.ContentItemsSource,0.13,0,1,2,1,0,1,0,3,42,2
"org.apache.lucene.benchmark.byTask.feeds.FileBasedQueryMaker",1,0.00,8.00,33,0.60,40411.15,1,0,9,23,9,114.64,30,48,1,2,77.60,0.00,0.50,0.00,0,0.00,8,1811.46,0,1,8,org.apache.lucene.benchmark.byTask.feeds.AbstractQueryMaker,0.25,22,1,8,0,22,0,1,3,282,1
"org.apache.lucene.benchmark.byTask.feeds.HTMLParser",1,0.00,1.00,2,0.03,202.63,1,0,4,1,4,150.74,17,3,3,1,141.61,0.00,0.00,0.00,0,1.00,1,91.40,0,1,1,,0.00,0,0,1,0,0,0,0,2,24,1
"org.apache.lucene.benchmark.byTask.feeds.LineDocSource",0,0.00,0.00,4,0.03,377.77,0,0,11,0,5,171.00,29,4,1,3,171.00,0.00,0.67,0.00,0,0.00,0,89.95,0,0,4,org.apache.lucene.benchmark.byTask.feeds.ContentSource,0.00,0,2,0,0,0,0,0,4,26,1
"org.apache.lucene.benchmark.byTask.feeds.LineDocSource$HeaderLineParser",9,0.06,4.44,116,1.48,67794.85,15,6,11,49,5,149.87,9,157,0,2,99.87,0.00,0.50,0.22,3,30.00,8,4427.71,2,2,5,org.apache.lucene.benchmark.byTask.feeds.LineParser,0.00,40,1,40,0,40,7,0,9,844,2
"org.apache.lucene.benchmark.byTask.feeds.LineDocSource$HeaderLineParser$FieldName",0,0.00,0.00,2,0.01,42.79,0,0,11,0,0,171.00,0,1,0,1,171.00,0.00,0.00,0.00,0,0.00,0,28.53,0,0,0,java.lang.Object,0.00,0,0,0,0,0,0,0,0,9,1
"org.apache.lucene.benchmark.byTask.feeds.LineDocSource$LineParser",2,1.00,1.00,5,0.04,512.27,3,1,11,2,1,180.69,4,7,0,1,140.80,0.00,0.00,0.00,0,2.00,1,124.80,0,0,1,java.lang.Object,0.00,0,0,2,0,0,2,0,2,36,3
"org.apache.lucene.benchmark.byTask.feeds.LineDocSource$SimpleLineParser",2,0.00,2.50,19,0.26,13083.89,2,0,11,8,2,105.15,1,25,0,2,105.15,0.00,0.50,0.00,0,2.00,4,772.62,0,0,2,org.apache.lucene.benchmark.byTask.feeds.LineParser,0.00,6,1,5,0,6,2,0,1,158,2
"org.apache.lucene.benchmark.byTask.feeds.LineDocSourceTest",14,1.00,1.93,128,1.78,75993.50,15,1,25,55,17,155.84,20,156,0,3,105.84,0.00,0.67,0.07,6,26.00,6,5354.51,1,0,17,org.apache.lucene.benchmark.BenchmarkTestCase,0.00,41,2,27,0,41,14,0,20,1004,1
"org.apache.lucene.benchmark.byTask.feeds.LongToEnglishContentSource",3,0.00,1.33,20,0.25,8241.89,5,2,4,12,3,154.71,7,30,0,3,114.83,0.00,0.67,0.50,0,1.00,2,736.26,0,1,3,org.apache.lucene.benchmark.byTask.feeds.ContentSource,0.35,9,2,4,0,9,2,0,4,151,1
"org.apache.lucene.benchmark.byTask.feeds.LongToEnglishQueryMaker",6,0.00,1.17,19,0.25,4365.46,9,3,9,14,8,130.63,5,28,0,1,130.63,0.00,0.00,0.33,1,10.00,2,758.55,0,3,8,java.lang.Object,0.00,8,0,7,0,8,3,1,2,174,1
"org.apache.lucene.benchmark.byTask.feeds.NoMoreDataException",0,0.00,0.00,1,0.01,31.02,0,0,0,0,20,171.00,21,2,20,2,171.00,0.00,0.50,0.00,0,0.00,0,15.51,0,0,0,java.lang.Exception,0.00,0,1,0,0,0,0,0,2,6,1
"org.apache.lucene.benchmark.byTask.feeds.QueryMaker",5,0.00,1.00,6,0.04,200.25,5,0,2,5,15,198.27,13,7,13,1,158.38,0.00,0.00,0.00,0,5.00,1,107.93,0,3,2,,0.00,0,0,5,0,0,2,0,6,39,1
"org.apache.lucene.benchmark.byTask.feeds.RandomFacetSource",3,0.62,2.00,33,0.38,15743.92,7,4,5,14,5,84.83,16,37,0,3,102.70,0.00,0.67,0.67,0,1.00,4,1137.27,3,1,5,org.apache.lucene.benchmark.byTask.feeds.FacetSource,0.17,11,2,6,0,11,2,0,5,225,1
"org.apache.lucene.benchmark.byTask.feeds.ReutersContentSource",6,0.08,2.00,68,0.90,40315.98,11,5,11,42,4,141.74,16,88,0,3,101.86,0.00,0.67,0.27,2,14.00,4,2703.34,4,3,4,org.apache.lucene.benchmark.byTask.feeds.ContentSource,0.30,36,2,12,0,36,3,0,7,509,1
"org.apache.lucene.benchmark.byTask.feeds.ReutersContentSource$DateFormatInfo",0,0.00,0.00,3,0.02,155.67,2,2,11,0,0,171.00,0,4,0,1,171.00,0.00,0.00,0.00,0,0.00,0,51.89,0,0,0,java.lang.Object,0.00,0,0,0,0,0,0,0,0,15,3
"org.apache.lucene.benchmark.byTask.feeds.ReutersQueryMaker",3,1.00,2.67,32,0.60,24831.06,4,1,14,20,14,84.75,16,53,1,2,102.62,0.00,0.50,0.33,2,4.00,6,1801.99,0,3,13,org.apache.lucene.benchmark.byTask.feeds.AbstractQueryMaker,0.20,17,1,8,0,17,0,1,7,339,1
"org.apache.lucene.benchmark.byTask.feeds.SimpleQueryMaker",1,0.00,1.00,21,0.40,18404.74,1,0,10,12,11,43.97,11,25,1,2,88.09,1.00,0.33,0.00,0,0.00,1,1197.62,0,1,10,org.apache.lucene.benchmark.byTask.feeds.AbstractQueryMaker,0.25,11,1,1,1,11,0,1,3,211,1
"org.apache.lucene.benchmark.byTask.feeds.SimpleSloppyPhraseQueryMaker",1,0.00,9.00,48,0.58,63006.25,1,0,5,12,6,21.51,10,44,0,3,69.99,0.00,0.67,0.00,0,1.00,9,1728.51,0,1,6,org.apache.lucene.benchmark.byTask.feeds.SimpleQueryMaker,0.33,11,2,9,0,11,0,0,6,296,1
"org.apache.lucene.benchmark.byTask.feeds.SingleDocSource",4,0.17,1.25,18,0.23,4448.28,6,2,1,9,5,106.63,20,40,2,3,124.50,0.50,0.50,0.38,1,6.00,2,675.18,2,1,3,org.apache.lucene.benchmark.byTask.feeds.ContentSource,0.33,5,2,5,1,5,3,0,3,150,1
"org.apache.lucene.benchmark.byTask.feeds.SortableSingleDocSource",3,0.50,1.33,25,0.92,20100.17,6,3,3,11,4,107.35,13,68,0,4,107.12,0.00,0.75,0.67,1,0.00,2,2762.25,2,1,4,org.apache.lucene.benchmark.byTask.feeds.SingleDocSource,0.00,8,3,4,0,8,2,0,4,415,1
"org.apache.lucene.benchmark.byTask.feeds.TrecContentSource",11,0.11,3.64,164,2.14,85501.88,31,20,17,62,17,79.44,64,223,9,3,97.31,0.50,0.50,0.15,5,58.00,7,6422.85,5,5,10,org.apache.lucene.benchmark.byTask.feeds.ContentSource,0.24,51,2,40,1,51,6,0,38,1158,1
"org.apache.lucene.benchmark.byTask.feeds.TrecContentSource$DateFormatInfo",0,0.00,0.00,3,0.02,200.76,2,2,17,0,0,171.00,0,4,0,1,171.00,0.00,0.00,0.00,0,0.00,0,57.36,0,0,0,java.lang.Object,0.00,0,0,0,0,0,0,0,0,16,3
"org.apache.lucene.benchmark.byTask.feeds.TrecContentSourceTest",8,0.00,2.12,95,2.21,68199.57,8,0,14,41,7,151.03,14,300,0,2,101.03,0.00,0.50,0.00,2,8.00,8,6638.13,0,0,7,org.apache.lucene.util.LuceneTestCase,0.00,33,1,17,0,33,8,0,11,1110,1
"org.apache.lucene.benchmark.byTask.feeds.TrecContentSourceTest$StringableTrecSource",3,1.00,1.67,13,0.12,2154.78,4,1,14,7,4,125.93,0,21,0,4,125.93,0.00,0.75,0.33,0,5.00,3,361.62,0,0,4,org.apache.lucene.benchmark.byTask.feeds.TrecContentSource,0.14,4,3,5,0,4,3,0,0,89,2
"org.apache.lucene.benchmark.byTask.feeds.TrecDocParser",5,0.19,2.60,45,0.65,32585.64,9,4,5,17,8,57.04,40,59,7,1,105.15,0.00,0.00,0.10,1,8.00,6,1940.85,0,5,7,java.lang.Object,0.00,12,0,13,6,12,0,0,13,411,2
"org.apache.lucene.benchmark.byTask.feeds.TrecDocParser$ParsePathType",0,0.00,0.00,2,0.01,42.79,0,0,5,0,0,171.00,0,1,0,1,171.00,0.00,0.00,0.00,0,0.00,0,28.53,0,0,0,java.lang.Object,0.00,0,0,0,0,0,0,0,0,9,1
"org.apache.lucene.benchmark.byTask.feeds.TrecFBISParser",1,0.00,3.00,26,0.39,12783.45,8,7,2,10,3,43.34,7,32,0,2,85.63,0.00,0.50,1.00,0,0.00,3,1155.46,2,1,3,org.apache.lucene.benchmark.byTask.feeds.TrecDocParser,0.00,9,1,3,0,9,0,0,5,212,1
"org.apache.lucene.benchmark.byTask.feeds.TrecFR94Parser",1,0.00,3.00,23,0.36,11675.41,7,6,2,10,3,39.82,8,33,0,2,87.92,0.00,0.50,1.00,0,0.00,3,1081.22,2,1,3,org.apache.lucene.benchmark.byTask.feeds.TrecDocParser,0.00,9,1,3,0,9,0,0,6,199,1
"org.apache.lucene.benchmark.byTask.feeds.TrecFTParser",1,0.00,2.00,18,0.26,7214.73,5,4,2,8,3,61.41,6,23,0,2,93.63,0.00,0.50,1.00,0,0.00,2,779.11,2,1,3,org.apache.lucene.benchmark.byTask.feeds.TrecDocParser,0.00,7,1,2,0,7,0,0,4,149,1
"org.apache.lucene.benchmark.byTask.feeds.TrecGov2Parser",1,0.00,3.00,19,0.31,9733.84,6,5,3,9,4,73.77,5,25,1,2,91.64,0.00,0.50,1.00,0,0.00,3,932.57,1,1,4,org.apache.lucene.benchmark.byTask.feeds.TrecDocParser,0.00,8,1,3,0,8,0,0,3,174,1
"org.apache.lucene.benchmark.byTask.feeds.TrecLATimesParser",1,0.00,5.00,29,0.46,19859.17,8,7,2,12,3,34.13,8,37,0,2,82.23,0.00,0.50,1.00,0,0.00,5,1394.97,2,1,3,org.apache.lucene.benchmark.byTask.feeds.TrecDocParser,0.00,11,1,5,0,11,0,0,6,251,1
"org.apache.lucene.benchmark.byTask.feeds.TrecParserByPath",1,0.00,1.00,3,0.06,1062.64,1,0,1,3,4,129.61,4,7,1,2,129.37,0.00,0.50,0.00,0,0.00,1,180.57,0,1,3,org.apache.lucene.benchmark.byTask.feeds.TrecDocParser,0.00,2,1,1,0,2,0,0,1,42,1
"org.apache.lucene.analysis.phonetic.BeiderMorseFilter",4,0.20,2.00,37,0.50,16101.97,14,10,11,20,9,74.64,27,49,4,4,106.86,0.00,0.75,0.25,0,4.00,5,1496.35,1,0,5,org.apache.lucene.analysis.TokenFilter,0.50,16,3,8,0,16,4,0,9,298,2
"org.apache.lucene.analysis.phonetic.DoubleMetaphoneFilter",3,0.25,4.67,48,0.64,39774.44,9,6,7,23,10,113.88,9,61,6,4,93.27,0.00,0.75,0.33,0,1.00,12,1916.27,0,0,4,org.apache.lucene.analysis.TokenFilter,0.53,20,3,14,0,20,3,0,7,359,2
"org.apache.lucene.analysis.phonetic.DoubleMetaphoneFilterTest",8,0.00,1.00,37,0.50,8397.94,8,0,11,14,9,124.75,1,46,0,3,124.75,0.00,0.67,0.00,0,8.00,1,1500.44,3,0,9,org.apache.lucene.analysis.BaseTokenStreamTestCase,0.00,6,2,8,0,6,8,0,1,329,1
"org.apache.lucene.analysis.phonetic.DoubleMetaphoneFilterTest$Analyzer",1,0.00,1.00,4,0.06,1111.23,1,0,11,4,3,124.56,0,6,0,1,124.56,0.00,0.00,0.00,0,1.00,1,170.85,0,1,3,java.lang.Object,0.00,3,0,1,0,3,0,0,0,40,0
"org.apache.lucene.analysis.phonetic.DoubleMetaphoneFilterTest$Analyzer_0",1,0.00,1.00,4,0.06,1051.87,1,0,11,4,3,124.74,0,6,0,1,124.74,0.00,0.00,0.00,0,1.00,1,173.06,0,1,3,java.lang.Object,0.00,3,0,1,0,3,0,0,0,40,0
"org.apache.lucene.analysis.phonetic.DoubleMetaphoneFilterTest$Analyzer_1",1,0.00,1.00,4,0.06,978.91,1,0,11,5,3,124.99,0,6,0,1,124.99,0.00,0.00,0.00,0,1.00,1,166.32,0,1,3,java.lang.Object,0.00,4,0,1,0,4,0,0,0,39,0
"org.apache.lucene.analysis.phonetic.PhoneticFilter",3,0.30,3.33,35,0.44,18920.39,8,5,6,16,9,122.57,11,45,5,4,101.95,0.00,0.75,0.40,0,1.00,8,1324.20,0,0,4,org.apache.lucene.analysis.TokenFilter,0.53,13,3,10,0,13,3,0,8,258,2
"org.apache.lucene.analysis.phonetic.TestBeiderMorseFilter",5,0.00,1.00,29,0.40,10961.90,5,0,13,9,5,118.62,4,42,0,3,118.62,0.00,0.67,0.00,0,5.00,1,1193.00,3,0,5,org.apache.lucene.analysis.BaseTokenStreamTestCase,0.00,4,2,5,0,4,5,0,4,258,1
"org.apache.lucene.analysis.phonetic.TestBeiderMorseFilter$Analyzer",1,0.00,1.00,4,0.07,1264.44,1,0,13,5,3,124.12,0,7,0,1,124.12,0.00,0.00,0.00,0,1.00,1,219.52,0,1,3,java.lang.Object,0.00,4,0,1,0,4,0,0,0,48,0
"org.apache.lucene.analysis.phonetic.TestBeiderMorseFilter$Analyzer_0",1,0.00,1.00,4,0.08,1290.86,1,0,13,5,3,124.04,0,8,0,1,124.04,0.00,0.00,0.00,0,1.00,1,226.61,0,1,3,java.lang.Object,0.00,4,0,1,0,4,0,0,0,49,0
"org.apache.lucene.analysis.phonetic.TestBeiderMorseFilter$Analyzer_1",1,0.00,1.00,4,0.07,1106.93,1,0,13,5,3,124.57,0,6,0,1,124.57,0.00,0.00,0.00,0,1.00,1,196.02,0,1,3,java.lang.Object,0.00,4,0,1,0,4,0,0,0,44,0
"org.apache.lucene.analysis.phonetic.TestBeiderMorseFilter$HashSet<String>",0,0.00,0.00,4,0.02,286.80,0,0,13,0,0,171.00,0,2,0,1,171.00,0.00,0.00,0.00,0,0.00,0,71.70,0,0,0,java.lang.Object,0.00,0,0,0,0,0,0,0,0,20,0
"org.apache.lucene.analysis.phonetic.TestPhoneticFilter",4,0.00,1.50,30,0.60,16247.82,4,0,15,14,7,160.96,4,52,0,3,110.96,0.00,0.67,0.00,1,4.00,2,1789.99,3,0,7,org.apache.lucene.analysis.BaseTokenStreamTestCase,0.00,10,2,6,0,10,4,0,2,348,1
"org.apache.lucene.analysis.phonetic.TestPhoneticFilter$Analyzer",1,0.00,1.00,4,0.06,1111.23,1,0,15,4,3,124.56,0,6,0,1,124.56,0.00,0.00,0.00,0,1.00,1,170.85,0,1,3,java.lang.Object,0.00,3,0,1,0,3,0,0,0,40,0
"org.apache.lucene.analysis.phonetic.TestPhoneticFilter$Analyzer_0",1,0.00,1.00,4,0.06,1111.23,1,0,15,4,3,124.56,0,6,0,1,124.56,0.00,0.00,0.00,0,1.00,1,170.85,0,1,3,java.lang.Object,0.00,3,0,1,0,3,0,0,0,40,0
"org.apache.lucene.analysis.phonetic.TestPhoneticFilter$Analyzer_1",1,0.00,1.00,4,0.06,978.91,1,0,15,5,3,124.99,0,6,0,1,124.99,0.00,0.00,0.00,0,1.00,1,166.32,0,1,3,java.lang.Object,0.00,4,0,1,0,4,0,0,0,39,0
"org.apache.lucene.analysis.ga.IrishAnalyzer",5,0.12,1.20,27,0.41,11618.07,9,4,16,20,14,68.38,47,45,1,3,118.38,0.00,0.67,0.15,0,8.00,2,1237.06,0,2,13,org.apache.lucene.analysis.util.StopwordAnalyzerBase,0.00,15,2,6,0,15,3,0,9,257,2
"org.apache.lucene.analysis.ga.IrishAnalyzer$DefaultSetHolder",0,0.00,0.00,6,0.05,732.71,1,1,16,0,2,171.00,2,11,0,1,171.00,0.00,0.00,0.00,0,0.00,0,149.07,0,0,2,java.lang.Object,0.00,0,0,0,0,0,0,0,2,37,2
"org.apache.lucene.analysis.ga.IrishLowerCaseFilter",3,1.00,2.33,32,0.41,27029.24,4,1,4,10,7,142.25,8,47,4,4,102.36,0.00,0.75,0.33,0,4.00,5,1216.04,0,0,3,org.apache.lucene.analysis.TokenFilter,0.27,7,3,7,0,7,3,0,3,235,2
"org.apache.lucene.analysis.ga.TestIrishAnalyzer",6,0.00,1.00,22,0.24,3502.79,6,0,4,9,4,181.42,9,32,0,3,131.42,0.00,0.67,0.00,0,6.00,1,727.94,3,0,4,org.apache.lucene.analysis.BaseTokenStreamTestCase,0.00,3,2,6,0,3,6,0,8,170,1
"org.apache.lucene.analysis.ga.TestIrishLowerCaseFilter",2,0.00,1.00,8,0.09,1344.95,2,0,9,6,7,146.89,6,13,0,3,126.27,0.00,0.67,0.00,0,2.00,1,271.14,2,0,7,org.apache.lucene.analysis.BaseTokenStreamTestCase,0.00,4,2,2,0,4,2,0,2,64,1
"org.apache.lucene.analysis.ga.TestIrishLowerCaseFilter$Analyzer",1,0.00,1.00,4,0.05,753.46,1,0,9,4,3,125.89,0,6,0,1,125.89,0.00,0.00,0.00,0,1.00,1,135.44,0,1,3,java.lang.Object,0.00,3,0,1,0,3,0,0,0,34,0
"org.apache.lucene.queryparser.surround.query.AndQuery",2,0.00,1.00,5,0.07,830.62,2,0,3,3,6,139.15,1,10,1,3,139.15,0.00,0.67,0.00,0,2.00,1,206.43,1,1,5,org.apache.lucene.queryparser.surround.query.ComposedQuery,0.00,1,2,2,0,1,1,0,1,52,1
"org.apache.lucene.queryparser.surround.query.BasicQueryFactory",11,0.20,1.27,31,0.26,4553.41,13,2,3,18,22,139.11,3,46,18,1,139.11,0.00,0.00,0.32,3,24.00,2,786.12,0,3,4,java.lang.Object,0.00,7,0,14,0,7,8,0,1,207,1
"org.apache.lucene.queryparser.surround.query.BooleanQueryTst",3,0.14,1.33,31,0.33,7463.79,10,7,9,13,12,106.89,2,42,2,1,106.89,0.00,0.00,0.24,0,4.00,2,990.00,0,0,10,java.lang.Object,0.00,10,0,4,0,10,3,0,2,204,1
"org.apache.lucene.queryparser.surround.query.BooleanQueryTst$TestCollector",6,0.10,1.50,32,0.34,14447.55,10,4,9,9,3,118.20,2,43,0,2,118.20,0.00,0.50,0.33,0,6.00,4,1029.55,0,0,3,org.apache.lucene.search.Collector,0.40,3,1,9,0,3,6,0,2,219,0
"org.apache.lucene.queryparser.surround.query.ComposedQuery",15,0.24,1.60,68,0.68,17512.27,18,3,4,29,7,124.28,6,78,4,2,124.28,4.00,0.17,0.11,9,68.00,3,2051.83,1,8,3,org.apache.lucene.queryparser.surround.query.SrndQuery,0.14,14,1,24,4,14,7,0,6,472,2
"org.apache.lucene.queryparser.surround.query.DistanceQuery",7,0.42,2.14,45,0.59,21739.41,9,2,7,22,11,114.30,4,70,2,3,114.30,0.00,0.67,0.14,1,17.00,5,1755.16,1,3,10,org.apache.lucene.queryparser.surround.query.ComposedQuery,0.00,15,2,15,0,15,4,1,4,350,1
"org.apache.lucene.queryparser.surround.query.DistanceRewriteQuery",2,0.00,1.00,5,0.06,636.39,2,0,3,2,5,140.06,0,12,1,3,140.06,0.00,0.67,0.00,0,2.00,1,176.59,0,1,5,org.apache.lucene.queryparser.surround.query.RewriteQuery,0.00,0,2,2,0,0,1,0,0,47,0
"org.apache.lucene.queryparser.surround.query.DistanceSubQuery",2,0.00,1.00,3,0.01,59.00,2,0,1,2,4,199.31,5,4,3,1,159.43,0.00,0.00,0.00,0,2.00,1,42.00,0,1,1,,0.00,0,0,2,0,0,1,0,1,17,1
"org.apache.lucene.queryparser.surround.query.ExceptionQueryTst",3,0.25,2.67,29,0.31,9145.35,5,2,2,12,6,107.74,0,38,3,1,107.74,0.00,0.00,0.33,0,4.00,5,942.73,0,1,3,java.lang.Object,0.00,9,0,8,0,9,2,0,0,196,1
"org.apache.lucene.queryparser.surround.query.FieldsQuery",9,0.03,1.33,47,0.56,14389.54,13,4,4,29,6,119.63,7,61,2,2,119.63,0.00,0.50,0.22,4,24.00,3,1694.63,0,4,4,org.apache.lucene.queryparser.surround.query.SrndQuery,0.17,20,1,12,0,20,5,0,7,361,1
"org.apache.lucene.queryparser.surround.query.NotQuery",2,0.00,1.00,9,0.14,3231.20,2,0,4,8,7,173.28,3,13,1,3,123.28,0.00,0.67,0.00,0,2.00,1,429.03,1,1,6,org.apache.lucene.queryparser.surround.query.ComposedQuery,0.00,6,2,2,0,6,1,0,3,91,1
"org.apache.lucene.queryparser.surround.query.OrQuery",4,0.00,2.00,20,0.23,5493.08,4,0,5,9,10,120.06,1,31,2,3,120.06,0.00,0.67,0.00,0,4.00,4,677.93,2,2,8,org.apache.lucene.queryparser.surround.query.ComposedQuery,0.00,5,2,8,0,5,2,1,1,155,1
"org.apache.lucene.queryparser.surround.query.RewriteQuery",7,0.11,1.43,22,0.34,8623.59,10,3,3,20,6,128.78,1,50,3,2,128.78,2.00,0.25,0.43,1,10.00,3,1009.68,0,4,3,org.apache.lucene.search.Query,0.35,13,1,10,2,13,3,0,1,240,1
"org.apache.lucene.queryparser.surround.query.SimpleTerm",12,0.91,1.17,32,0.29,5525.18,13,1,4,21,12,138.76,5,47,5,2,138.76,3.00,0.20,0.17,5,28.00,3,855.23,1,6,8,org.apache.lucene.queryparser.surround.query.SrndQuery,0.08,9,1,14,3,9,6,2,3,222,2
"org.apache.lucene.queryparser.surround.query.SimpleTerm$MatchingTermVisitor",1,0.00,1.00,2,0.01,51.00,1,0,4,1,1,146.32,0,4,0,1,146.32,0.00,0.00,0.00,0,1.00,1,34.00,0,0,1,,0.00,0,0,1,0,0,1,0,0,13,1
"org.apache.lucene.queryparser.surround.query.SimpleTerm$MatchingTermVisitor_0",1,0.00,1.00,3,0.02,230.45,1,0,4,2,1,134.60,0,4,0,1,134.60,0.00,0.00,0.00,0,1.00,1,72.73,0,0,1,java.lang.Object,0.00,1,0,1,0,1,1,0,0,21,0
"org.apache.lucene.queryparser.surround.query.SimpleTermRewriteQuery",2,0.00,2.00,7,0.15,4481.90,2,0,7,8,9,176.66,2,18,1,3,126.66,0.00,0.67,0.00,0,2.00,3,454.16,0,1,9,org.apache.lucene.queryparser.surround.query.RewriteQuery,0.00,6,2,4,0,6,1,0,2,95,0
"org.apache.lucene.queryparser.surround.query.SimpleTermRewriteQuery$SimpleTerm.MatchingTermVisitor",1,0.00,1.00,3,0.03,278.46,1,0,7,3,1,133.95,0,4,0,1,133.95,0.00,0.00,0.00,0,1.00,1,89.74,0,0,1,java.lang.Object,0.00,2,0,1,0,2,1,0,0,25,0
"org.apache.lucene.queryparser.surround.query.SingleFieldTestDb",4,0.22,1.50,25,0.25,7168.00,7,3,10,15,11,116.26,0,26,3,1,116.26,0.00,0.00,0.50,0,0.00,3,742.59,0,3,8,java.lang.Object,0.00,11,0,6,0,11,1,0,0,152,1
"org.apache.lucene.queryparser.surround.query.SpanNearClauseFactory",10,0.06,1.50,40,0.48,13491.16,14,4,10,27,13,123.80,2,50,4,1,123.80,0.00,0.00,0.20,2,46.00,3,1448.59,0,3,9,java.lang.Object,0.00,17,0,15,0,17,7,0,2,324,1
"org.apache.lucene.queryparser.surround.query.SrndBooleanQuery",2,0.00,2.00,13,0.17,5395.85,2,0,4,8,7,114.80,0,20,4,1,114.80,0.00,0.00,0.00,1,2.00,2,511.02,0,1,3,java.lang.Object,0.00,6,0,4,0,6,1,0,0,107,0
"org.apache.lucene.queryparser.surround.query.SrndPrefixQuery",7,0.17,2.00,41,0.49,19768.76,10,3,8,19,9,117.59,2,54,1,3,117.59,0.00,0.67,0.19,3,23.00,8,1461.94,0,3,8,org.apache.lucene.queryparser.surround.query.SimpleTerm,0.18,12,2,14,0,12,4,0,2,294,1
"org.apache.lucene.queryparser.surround.query.SrndQuery",14,0.38,1.36,40,0.35,6489.67,16,2,3,24,15,188.71,17,53,11,1,138.71,0.00,0.00,0.14,6,42.00,3,1060.00,1,6,4,java.lang.Object,0.00,10,0,19,10,10,8,1,7,273,2
"org.apache.lucene.queryparser.surround.query.SrndQuery$BooleanQuery",3,0.00,1.00,7,0.07,810.47,3,0,3,4,2,140.62,1,13,0,1,140.62,0.00,0.00,0.00,0,3.00,1,196.67,0,0,2,java.lang.Object,0.00,1,0,3,0,1,3,0,1,53,0
"org.apache.lucene.queryparser.surround.query.SrndQueryTest",2,0.00,1.00,13,0.14,2354.47,2,0,6,6,4,138.41,6,17,0,2,117.79,0.00,0.50,0.00,1,2.00,1,427.56,0,0,4,org.apache.lucene.util.LuceneTestCase,0.00,4,1,2,0,4,2,0,3,97,1
"org.apache.lucene.queryparser.surround.query.SrndTermQuery",5,1.00,1.40,18,0.20,4353.31,6,1,7,11,8,129.97,1,28,1,3,129.97,0.00,0.67,0.20,2,8.00,3,612.22,0,3,7,org.apache.lucene.queryparser.surround.query.SimpleTerm,0.10,6,2,7,0,6,2,0,1,139,1
"org.apache.lucene.queryparser.surround.query.SrndTruncQuery",7,0.14,2.43,57,0.71,26288.70,13,6,10,27,9,108.96,1,81,1,3,108.96,0.00,0.67,0.29,3,20.00,7,2127.69,0,2,8,org.apache.lucene.queryparser.surround.query.SimpleTerm,0.09,20,2,17,0,20,5,0,1,421,1
"org.apache.lucene.queryparser.surround.query.Test01Exceptions",2,0.00,1.50,10,0.16,2333.90,5,3,3,7,2,170.68,2,39,1,2,120.68,0.00,0.50,0.33,0,2.00,2,492.60,0,0,1,org.apache.lucene.util.LuceneTestCase,0.00,5,1,3,0,5,2,0,2,102,1
"org.apache.lucene.queryparser.surround.query.Test02Boolean",25,0.18,1.00,81,0.76,9785.11,30,5,3,32,4,132.79,0,91,1,2,132.79,0.00,0.50,0.03,1,48.00,1,2272.19,0,0,3,org.apache.lucene.util.LuceneTestCase,0.00,7,1,25,0,7,25,0,0,555,1
"org.apache.lucene.queryparser.surround.query.Test03Distance",47,0.08,1.02,150,1.44,19721.91,57,10,3,57,5,132.54,2,188,1,2,132.54,0.00,0.50,0.02,4,268.00,2,4325.31,0,0,4,org.apache.lucene.util.LuceneTestCase,0.00,10,1,48,0,10,47,0,2,1041,1
"org.apache.lucene.queryparser.surround.query.TooManyBasicQueries",1,0.00,1.00,3,0.02,172.28,1,0,1,1,1,185.59,1,5,1,2,135.59,0.00,0.50,0.00,0,1.00,1,63.94,0,0,0,java.io.IOException,0.00,0,1,1,0,0,1,0,1,20,1
"org.apache.lucene.search.suggest.tst.TSTAutocomplete",3,0.00,7.67,68,0.97,114411.29,3,0,1,13,2,55.00,41,89,1,1,84.38,0.00,0.00,0.00,1,3.00,14,2924.05,0,1,1,java.lang.Object,0.00,10,0,23,0,10,2,0,3,551,1
"org.apache.lucene.search.suggest.tst.TSTLookup",9,0.20,4.11,114,1.65,68489.62,16,7,14,52,12,99.85,8,144,3,2,99.85,0.00,0.50,0.32,3,1.00,11,4939.78,0,2,9,org.apache.lucene.search.suggest.Lookup,0.00,43,1,37,0,43,7,0,8,938,1
"org.apache.lucene.search.suggest.tst.TernaryTreeNode",0,0.00,0.00,7,0.04,287.07,6,6,0,0,2,171.00,30,8,2,1,171.00,0.00,0.00,0.00,0,0.00,0,110.41,0,0,0,java.lang.Object,0.00,0,0,0,0,0,0,0,7,29,1
"org.apache.lucene.benchmark.quality.trec.QueryDriver",1,0.00,6.00,37,0.81,46083.52,1,0,12,27,12,26.89,10,40,0,1,75.37,0.00,0.00,0.00,0,1.00,6,2440.26,0,0,12,java.lang.Object,0.00,26,0,6,0,26,1,0,8,367,1
"org.apache.lucene.benchmark.quality.trec.Trec1MQReader",2,1.00,2.00,24,0.33,18607.38,3,1,6,15,1,69.95,26,31,0,1,99.33,0.00,0.00,0.50,0,2.00,3,989.63,0,1,1,java.lang.Object,0.00,13,0,4,0,13,1,0,8,183,1
"org.apache.lucene.benchmark.quality.trec.TrecJudge",4,0.00,4.50,65,0.89,61782.16,5,1,8,29,4,74.88,23,79,2,1,92.75,0.00,0.00,1.00,0,0.00,9,2660.52,0,0,2,java.lang.Object,0.00,25,0,18,0,25,4,1,7,484,1
"org.apache.lucene.benchmark.quality.trec.TrecJudge$QRelJudgement",4,0.00,1.00,12,0.09,1269.02,6,2,8,8,0,133.50,0,17,0,1,133.50,0.00,0.00,0.50,0,0.00,1,278.01,0,0,0,java.lang.Object,0.00,4,0,4,0,4,4,0,0,78,2
"org.apache.lucene.benchmark.quality.trec.TrecTopicsReader",3,1.00,5.33,55,0.86,63008.04,4,1,6,22,3,52.19,37,71,2,1,89.75,0.00,0.00,0.33,1,4.00,8,2570.43,0,1,1,java.lang.Object,0.00,19,0,16,0,19,2,0,11,442,1
"org.apache.lucene.facet.search.cache.CategoryListCache",3,0.50,1.00,9,0.11,1759.64,4,1,6,7,11,82.93,30,15,6,1,131.40,0.00,0.00,0.67,1,1.00,1,325.85,0,1,5,java.lang.Object,0.00,4,0,3,0,4,2,0,5,82,1
"org.apache.lucene.facet.search.cache.CategoryListData",3,0.50,3.33,36,0.48,26242.16,4,1,7,16,10,89.07,47,38,4,1,99.43,0.00,0.00,0.67,0,1.00,8,1427.50,0,1,6,java.lang.Object,0.00,13,0,10,0,13,2,0,7,258,1
"org.apache.lucene.facet.search.cache.CategoryListData$RAMCategoryListIterator",4,0.58,1.50,20,0.23,6126.34,8,4,7,4,1,119.75,0,27,0,1,119.75,0.00,0.00,0.69,0,0.00,2,694.81,0,0,1,java.lang.Object,0.00,0,0,6,0,0,4,1,0,160,2
"org.apache.lucene.analysis.uima.an.SampleEntityAnnotator",1,0.00,4.00,20,0.35,10354.94,6,5,8,14,0,90.77,4,25,0,2,90.53,0.00,0.50,1.00,0,0.00,4,1050.57,0,0,0,org.apache.uima.analysis_component.JCasAnnotator_ImplBase,0.00,13,1,4,0,13,1,0,2,196,1
"org.apache.lucene.analysis.uima.an.SamplePoSTagger",2,0.50,2.00,18,0.21,4107.41,6,4,6,9,0,159.16,3,24,0,2,109.16,0.00,0.50,0.50,1,2.00,2,641.72,0,1,0,org.apache.uima.analysis_component.JCasAnnotator_ImplBase,0.00,7,1,4,0,7,1,0,1,137,1
"org.apache.lucene.analysis.uima.an.SampleWSTokenizerAnnotator",1,2.00,3.00,21,0.32,11652.76,5,4,5,8,0,71.53,5,24,0,2,89.40,0.00,0.50,0.50,0,0.00,3,967.68,0,0,0,org.apache.uima.analysis_component.JCasAnnotator_ImplBase,0.00,7,1,3,0,7,1,0,3,186,1
"org.apache.solr.search.grouping.distributed.shardresultserializer.SearchGroupsResultTransformer",4,1.00,4.25,57,1.09,70122.77,5,1,13,32,14,134.38,9,65,2,1,94.50,0.00,0.00,0.25,0,6.00,8,3261.84,0,3,12,java.lang.Object,0.00,28,0,17,0,28,1,1,3,581,1
"org.apache.solr.search.grouping.distributed.shardresultserializer.ShardResultTransformer",2,0.00,1.00,3,0.04,302.75,2,0,3,2,5,116.27,24,4,3,1,153.83,0.00,0.00,0.00,0,2.00,1,117.42,0,1,2,,0.00,0,0,2,0,0,1,0,3,34,1
"org.apache.solr.search.grouping.distributed.shardresultserializer.TopGroupsResultTransformer",6,0.40,7.00,172,3.69,348091.52,7,1,25,68,23,129.06,10,195,2,1,79.06,0.00,0.00,0.67,1,0.00,13,11084.12,0,5,21,java.lang.Object,0.00,62,0,42,0,62,1,1,3,1721,1
"org.apache.lucene.queryparser.flexible.core.messages.QueryParserMessages",1,19.00,1.00,23,0.23,6661.89,20,19,1,2,28,47.80,7,26,27,2,90.09,0.00,0.50,0.00,0,1.00,1,695.74,0,0,1,org.apache.lucene.queryparser.flexible.messages.NLS,0.00,1,1,1,0,1,1,0,5,143,1
"org.apache.lucene.analysis.fr.Deprecated",3,0.00,2.33,18,0.22,5952.76,6,3,7,11,7,65.81,27,27,0,4,115.81,0.00,0.75,0.33,0,4.00,4,660.39,0,0,7,org.apache.lucene.analysis.TokenFilter,0.27,8,3,7,0,8,3,0,6,144,2
"org.apache.lucene.analysis.fr.ElisionFilter",3,0.12,2.67,32,0.45,24646.52,7,4,7,12,11,70.42,20,40,7,4,102.65,0.00,0.75,0.33,0,5.00,6,1358.06,0,0,4,org.apache.lucene.analysis.TokenFilter,0.27,9,3,8,0,9,3,0,6,258,2
"org.apache.lucene.analysis.fr.FrenchAnalyzer",5,0.33,2.00,34,1.13,30702.66,8,3,18,20,18,91.84,71,75,1,3,111.98,0.00,0.67,0.07,0,8.00,5,3385.43,0,2,17,org.apache.lucene.analysis.util.StopwordAnalyzerBase,0.00,15,2,10,0,15,3,0,10,527,2
"org.apache.lucene.analysis.fr.FrenchAnalyzer$DefaultSetHolder",0,0.00,0.00,7,0.11,2212.55,2,2,18,3,4,171.00,3,15,0,1,171.00,0.00,0.00,0.00,0,0.00,0,334.55,0,0,4,java.lang.Object,0.00,3,0,0,0,3,0,0,3,73,2
"org.apache.lucene.analysis.fr.FrenchLightStemFilter",2,0.33,2.00,14,0.16,3794.18,5,3,6,9,10,113.74,9,20,4,4,113.50,0.00,0.75,0.50,0,2.00,3,481.98,0,0,6,org.apache.lucene.analysis.TokenFilter,0.29,7,3,4,0,7,2,0,1,107,2
"org.apache.lucene.analysis.fr.FrenchLightStemmer",2,0.00,26.00,128,2.30,401621.10,2,0,1,3,1,61.35,8,168,1,1,61.12,0.00,0.00,0.00,1,2.00,34,6906.75,0,0,0,java.lang.Object,0.00,1,0,52,0,1,2,0,2,1138,1
"org.apache.lucene.analysis.fr.FrenchMinimalStemFilter",2,0.33,2.00,14,0.16,3794.18,5,3,6,9,9,113.74,9,20,3,4,113.50,0.00,0.75,0.50,0,2.00,3,481.98,0,0,6,org.apache.lucene.analysis.TokenFilter,0.29,7,3,4,0,7,2,0,1,107,2
"org.apache.lucene.analysis.fr.FrenchMinimalStemmer",1,0.00,9.00,12,0.21,12910.63,1,0,0,1,1,60.99,56,17,1,1,97.87,0.00,0.00,0.00,0,1.00,9,621.36,0,0,0,java.lang.Object,0.00,0,0,9,0,0,1,0,4,129,1
"org.apache.lucene.analysis.fr.TestElision",3,0.00,1.33,19,0.26,6674.01,3,0,13,14,9,165.55,3,24,0,3,115.55,0.00,0.67,0.00,1,3.00,2,783.98,1,1,9,org.apache.lucene.analysis.BaseTokenStreamTestCase,0.00,11,2,4,0,11,2,0,1,162,1
"org.apache.lucene.analysis.fr.TestElision$Analyzer",1,0.00,1.00,4,0.05,771.22,1,0,13,4,3,125.81,0,6,0,1,125.81,0.00,0.00,0.00,0,1.00,1,141.98,0,1,3,java.lang.Object,0.00,3,0,1,0,3,0,0,0,35,0
"org.apache.lucene.analysis.fr.TestFrenchAnalyzer",8,0.00,1.00,51,0.95,23139.63,8,0,4,11,3,96.84,40,163,0,3,114.72,0.00,0.67,0.00,0,8.00,1,2862.40,3,0,3,org.apache.lucene.analysis.BaseTokenStreamTestCase,0.00,3,2,8,0,3,8,0,25,542,1
"org.apache.lucene.analysis.fr.TestFrenchLightStemFilter",4,0.00,1.00,81,1.03,21498.11,4,0,8,7,5,132.98,10,87,0,3,93.09,0.00,0.67,0.00,0,4.00,1,3089.87,3,0,5,org.apache.lucene.analysis.BaseTokenStreamTestCase,0.00,3,2,4,0,3,4,0,8,490,1
"org.apache.lucene.analysis.fr.TestFrenchLightStemFilter$Analyzer",1,0.00,1.00,4,0.05,1009.20,1,0,8,4,3,124.89,0,7,0,1,124.89,0.00,0.00,0.00,0,1.00,1,159.62,0,1,3,java.lang.Object,0.00,3,0,1,0,3,0,0,0,38,0
"org.apache.lucene.analysis.fr.TestFrenchLightStemFilter$Analyzer_0",1,0.00,1.00,4,0.05,753.46,1,0,8,4,3,125.89,0,6,0,1,125.89,0.00,0.00,0.00,0,1.00,1,135.44,0,1,3,java.lang.Object,0.00,3,0,1,0,3,0,0,0,34,0
"org.apache.lucene.analysis.fr.TestFrenchMinimalStemFilter",4,0.00,1.00,19,0.16,2206.91,4,0,8,7,5,176.95,6,25,0,3,126.95,0.00,0.67,0.00,0,4.00,1,476.31,3,0,5,org.apache.lucene.analysis.BaseTokenStreamTestCase,0.00,3,2,4,0,3,4,0,4,118,1
"org.apache.lucene.analysis.fr.TestFrenchMinimalStemFilter$Analyzer",1,0.00,1.00,4,0.05,1009.20,1,0,8,4,3,124.89,0,7,0,1,124.89,0.00,0.00,0.00,0,1.00,1,159.62,0,1,3,java.lang.Object,0.00,3,0,1,0,3,0,0,0,38,0
"org.apache.lucene.analysis.fr.TestFrenchMinimalStemFilter$Analyzer_0",1,0.00,1.00,4,0.05,753.46,1,0,8,4,3,125.89,0,6,0,1,125.89,0.00,0.00,0.00,0,1.00,1,135.44,0,1,3,java.lang.Object,0.00,3,0,1,0,3,0,0,0,34,0
"org.apache.lucene.analysis.core.Ignore",1,0.00,1.00,980,32.56,1609032.85,1,0,3,1,2,-23.23,997,1960,0,3,10.55,0.00,0.67,0.00,0,1.00,1,97687.95,1,0,2,org.apache.lucene.analysis.BaseTokenStreamTestCase,0.00,0,2,1,0,0,1,0,979,9756,1
"org.apache.lucene.analysis.core.KeywordAnalyzer",2,0.00,1.00,4,0.04,567.13,2,0,2,4,5,180.34,4,8,3,2,140.46,0.00,0.50,0.00,0,2.00,1,119.65,0,1,2,org.apache.lucene.analysis.Analyzer,0.00,2,1,2,0,2,1,0,1,34,2
"org.apache.lucene.analysis.core.KeywordTokenizer",7,0.10,1.57,38,0.43,16141.03,12,5,6,13,151,118.34,5,52,147,4,118.34,0.00,0.75,0.29,0,9.00,5,1285.71,2,0,4,org.apache.lucene.analysis.Tokenizer,0.38,6,3,11,0,6,7,0,3,277,2
"org.apache.lucene.analysis.core.LetterTokenizer",4,0.00,1.00,9,0.08,752.92,4,0,5,5,14,104.30,50,15,11,5,141.86,0.25,0.67,0.00,0,4.00,1,238.14,0,0,3,org.apache.lucene.analysis.util.CharTokenizer,0.19,1,4,4,1,1,4,0,5,68,1
"org.apache.lucene.analysis.core.LowerCaseFilter",2,0.50,2.00,17,0.19,6215.68,4,2,6,9,56,67.36,15,22,52,4,109.65,0.00,0.75,0.75,0,0.00,3,565.02,0,0,4,org.apache.lucene.analysis.TokenFilter,0.29,7,3,4,0,7,2,0,2,120,2
"org.apache.lucene.analysis.core.LowerCaseTokenizer",4,0.00,1.00,9,0.08,810.03,4,0,5,5,11,112.23,53,15,7,6,141.61,0.00,0.83,0.00,0,4.00,1,240.46,0,0,4,org.apache.lucene.analysis.core.LetterTokenizer,0.20,1,5,4,0,1,4,0,5,69,2
"org.apache.lucene.analysis.core.SimpleAnalyzer",2,1.00,1.00,6,0.06,859.98,3,1,4,4,7,84.36,16,11,4,2,132.46,0.00,0.50,0.50,0,2.00,1,182.93,0,1,3,org.apache.lucene.analysis.Analyzer,0.00,2,1,2,0,2,1,0,2,49,2
"org.apache.lucene.analysis.core.StopAnalyzer",5,1.00,1.00,17,0.27,3963.87,6,1,10,8,18,88.08,37,34,12,3,130.37,0.00,0.67,0.20,0,11.00,1,804.46,0,1,6,org.apache.lucene.analysis.util.StopwordAnalyzerBase,0.00,3,2,5,0,3,4,0,7,176,2
"org.apache.lucene.analysis.core.StopFilter",6,0.40,1.33,20,0.26,5487.85,8,2,8,13,56,81.34,64,28,52,5,129.82,0.00,0.80,0.17,1,10.00,2,784.43,0,4,4,org.apache.lucene.analysis.util.FilteringTokenFilter,0.21,7,4,8,0,7,2,0,7,185,2
"org.apache.lucene.analysis.core.TestAnalyzers",14,0.00,1.14,100,1.37,32971.45,14,0,9,35,11,162.89,23,148,0,3,112.89,0.00,0.67,0.00,1,14.00,3,4124.94,3,0,11,org.apache.lucene.analysis.BaseTokenStreamTestCase,0.00,21,2,16,0,21,14,0,17,866,1
"org.apache.lucene.analysis.core.TestAnalyzers$LowerCaseWhitespaceAnalyzer",1,0.00,1.00,4,0.05,878.94,1,0,9,4,3,125.36,0,7,0,2,125.36,0.00,0.50,0.00,0,1.00,1,157.95,0,1,3,org.apache.lucene.index.Analyzer,0.00,3,1,1,0,3,0,0,0,39,2
"org.apache.lucene.analysis.core.TestAnalyzers$PayloadSetter",2,0.67,1.50,13,0.13,2688.71,5,3,9,5,2,117.24,1,17,0,2,117.24,0.00,0.50,0.67,0,0.00,2,387.78,0,0,2,org.apache.lucene.index.TokenFilter,0.00,3,1,3,0,3,2,0,1,89,1
"org.apache.lucene.analysis.core.TestClassicAnalyzer",29,0.29,1.07,149,2.13,61032.13,30,1,18,56,15,168.74,57,196,0,3,118.74,0.00,0.67,0.72,0,0.00,2,6395.48,2,0,15,org.apache.lucene.analysis.BaseTokenStreamTestCase,0.00,27,2,31,0,27,29,0,41,1329,1
"org.apache.lucene.analysis.core.TestDuelingAnalyzers",9,0.25,2.11,106,1.36,42713.25,10,1,17,44,14,142.92,18,111,0,2,103.03,0.00,0.50,0.78,1,0.00,3,4089.48,1,1,14,org.apache.lucene.util.LuceneTestCase,0.00,35,1,19,0,35,8,0,12,788,1
"org.apache.lucene.analysis.core.TestDuelingAnalyzers$Analyzer",1,0.00,1.00,4,0.04,704.03,1,0,17,3,2,126.12,0,6,0,1,126.12,0.00,0.00,0.00,0,1.00,1,126.94,0,1,2,java.lang.Object,0.00,2,0,1,0,2,0,0,0,32,0
"org.apache.lucene.analysis.core.TestDuelingAnalyzers$Analyzer_0",1,0.00,1.00,4,0.04,704.03,1,0,17,3,2,126.12,0,6,0,1,126.12,0.00,0.00,0.00,0,1.00,1,126.94,0,1,2,java.lang.Object,0.00,2,0,1,0,2,0,0,0,32,0
"org.apache.lucene.analysis.core.TestDuelingAnalyzers$Analyzer_1",1,0.00,1.00,4,0.04,704.03,1,0,17,3,2,126.12,0,6,0,1,126.12,0.00,0.00,0.00,0,1.00,1,126.94,0,1,2,java.lang.Object,0.00,2,0,1,0,2,0,0,0,32,0
"org.apache.lucene.analysis.core.TestDuelingAnalyzers$Analyzer_2",1,0.00,1.00,4,0.04,704.03,1,0,17,3,2,126.12,0,6,0,1,126.12,0.00,0.00,0.00,0,1.00,1,126.94,0,1,2,java.lang.Object,0.00,2,0,1,0,2,0,0,0,32,0
"org.apache.lucene.analysis.core.TestDuelingAnalyzers$Analyzer_3",1,0.00,1.00,4,0.04,704.03,1,0,17,3,2,126.12,0,6,0,1,126.12,0.00,0.00,0.00,0,1.00,1,126.94,0,1,2,java.lang.Object,0.00,2,0,1,0,2,0,0,0,32,0
"org.apache.lucene.analysis.core.TestDuelingAnalyzers$Analyzer_4",1,0.00,1.00,4,0.04,704.03,1,0,17,3,2,126.12,0,6,0,1,126.12,0.00,0.00,0.00,0,1.00,1,126.94,0,1,2,java.lang.Object,0.00,2,0,1,0,2,0,0,0,32,0
"org.apache.lucene.analysis.core.TestKeywordAnalyzer",5,0.00,1.00,43,0.64,14779.01,8,3,19,32,20,130.60,16,64,0,3,109.98,0.00,0.67,0.33,0,7.00,1,1928.66,3,0,20,org.apache.lucene.analysis.BaseTokenStreamTestCase,0.00,27,2,5,0,27,5,0,3,378,1
"org.apache.lucene.analysis.core.TestStandardAnalyzer",31,0.00,1.00,102,1.74,30009.24,31,0,10,43,5,179.69,44,160,0,3,129.69,0.00,0.67,0.00,0,31.00,1,5217.83,2,0,5,org.apache.lucene.analysis.BaseTokenStreamTestCase,0.00,12,2,31,0,12,31,0,23,1129,1
"org.apache.lucene.analysis.core.TestStandardAnalyzer$Analyzer",1,0.00,1.00,4,0.04,637.60,1,0,10,3,2,126.46,0,7,0,1,126.46,0.00,0.00,0.00,0,1.00,1,122.69,0,1,2,java.lang.Object,0.00,2,0,1,0,2,0,0,0,31,0
"org.apache.lucene.analysis.core.TestStopAnalyzer",4,0.17,2.25,41,0.63,16168.75,6,2,11,23,6,105.11,0,51,0,3,105.11,0.00,0.67,0.38,0,4.00,3,1903.59,1,0,6,org.apache.lucene.analysis.BaseTokenStreamTestCase,0.00,19,2,9,0,19,4,0,0,362,1
"org.apache.lucene.analysis.core.TestStopFilter",6,0.00,3.00,91,1.43,104543.52,6,0,16,34,11,143.48,11,83,0,3,93.48,0.00,0.67,0.00,2,6.00,8,4286.50,2,0,11,org.apache.lucene.analysis.BaseTokenStreamTestCase,0.00,28,2,18,0,28,6,0,9,746,1
"org.apache.lucene.analysis.core.TestStopFilter$Analyzer",1,0.00,1.00,7,0.10,1929.89,1,0,16,6,5,113.60,0,9,0,1,113.60,0.00,0.00,0.00,0,1.00,1,287.69,0,1,5,java.lang.Object,0.00,5,0,1,0,5,0,0,0,61,0
"org.apache.lucene.analysis.core.TestStopFilter$MockSynonymFilter",3,0.17,2.00,22,0.20,4197.86,6,3,16,10,4,114.54,0,30,0,4,114.54,0.00,0.75,0.44,0,1.00,4,599.49,1,0,4,org.apache.lucene.analysis.TokenFilter,0.53,7,3,6,0,7,3,0,0,133,1
"org.apache.lucene.analysis.core.TestTypeTokenFilter",5,0.00,2.00,45,0.69,24943.92,5,0,11,26,8,156.12,6,53,0,3,106.12,0.00,0.67,0.00,2,5.00,3,2063.90,1,0,8,org.apache.lucene.analysis.BaseTokenStreamTestCase,0.00,21,2,10,0,21,5,0,4,391,1
"org.apache.lucene.analysis.core.TestUAX29URLEmailAnalyzer",32,0.06,1.00,106,1.89,32610.29,33,1,6,38,3,179.51,32,182,0,3,129.51,0.00,0.67,0.94,0,0.00,1,5665.21,2,0,3,org.apache.lucene.analysis.BaseTokenStreamTestCase,0.00,6,2,32,0,6,32,0,26,1214,1
"org.apache.lucene.analysis.core.TestUAX29URLEmailTokenizer",35,0.00,1.43,199,3.22,114842.04,35,0,17,60,8,167.16,51,318,0,3,117.16,0.00,0.67,0.00,0,35.00,6,9650.31,2,0,8,org.apache.lucene.analysis.BaseTokenStreamTestCase,0.00,25,2,50,0,25,35,0,30,1888,1
"org.apache.lucene.analysis.core.TestUAX29URLEmailTokenizer$Analyzer",1,0.00,1.00,4,0.04,637.60,1,0,17,3,2,126.46,0,7,0,1,126.46,0.00,0.00,0.00,0,1.00,1,122.69,0,1,2,java.lang.Object,0.00,2,0,1,0,2,0,0,0,31,0
"org.apache.lucene.analysis.core.TestUAX29URLEmailTokenizer$Analyzer_0",1,0.00,1.00,6,0.07,1391.23,1,0,17,5,2,167.22,1,8,0,1,117.22,0.00,0.00,0.00,0,1.00,1,212.33,0,1,2,java.lang.Object,0.00,4,0,1,0,4,0,0,1,48,0
"org.apache.lucene.analysis.core.TestUAX29URLEmailTokenizer$Analyzer_1",1,0.00,1.00,5,0.06,985.07,1,0,17,4,2,121.35,0,7,0,1,121.35,0.00,0.00,0.00,0,1.00,1,166.12,0,1,2,java.lang.Object,0.00,3,0,1,0,3,0,0,0,40,0
"org.apache.lucene.analysis.core.TestUAX29URLEmailTokenizer$Analyzer_2",1,0.00,1.00,4,0.05,776.26,1,0,17,3,2,125.78,0,7,0,1,125.78,0.00,0.00,0.00,0,1.00,1,135.38,0,1,2,java.lang.Object,0.00,2,0,1,0,2,0,0,0,33,0
"org.apache.lucene.analysis.core.TestUAX29URLEmailTokenizer$EmailFilter",2,1.00,2.00,11,0.12,3072.71,3,1,17,3,4,119.67,0,17,0,4,119.67,0.00,0.75,0.50,0,2.00,3,348.78,0,0,4,org.apache.lucene.analysis.TokenFilter,0.29,1,3,4,0,1,2,0,0,79,1
"org.apache.lucene.analysis.core.TestUAX29URLEmailTokenizer$URLFilter",2,1.00,2.00,11,0.12,3072.71,3,1,17,3,4,119.67,0,17,0,4,119.67,0.00,0.75,0.50,0,2.00,3,348.78,0,0,4,org.apache.lucene.analysis.TokenFilter,0.29,1,3,4,0,1,2,0,0,79,1
"org.apache.lucene.analysis.core.TypeTokenFilter",3,0.00,1.00,12,0.15,2710.57,6,3,5,5,5,165.15,7,17,2,5,125.26,0.00,0.80,0.33,0,4.00,1,459.29,0,0,3,org.apache.lucene.analysis.util.FilteringTokenFilter,0.24,2,4,3,0,2,3,0,2,108,2
"org.apache.lucene.analysis.core.WhitespaceAnalyzer",2,1.00,1.00,6,0.06,859.98,3,1,4,4,14,84.36,16,11,11,2,132.46,0.00,0.50,0.50,0,2.00,1,182.93,0,1,3,org.apache.lucene.analysis.Analyzer,0.00,2,1,2,0,2,1,0,2,49,2
"org.apache.lucene.analysis.core.WhitespaceTokenizer",4,0.00,1.00,9,0.08,841.43,4,0,5,5,23,97.35,44,15,20,5,141.48,0.00,0.80,0.00,0,4.00,1,247.88,0,0,3,org.apache.lucene.analysis.util.CharTokenizer,0.19,1,4,4,0,1,4,0,5,70,2
"org.apache.lucene.demo.xmlparser.FormBasedXmlQueryDemo",3,0.62,4.00,61,1.07,45361.16,7,4,32,43,18,89.47,12,76,0,2,89.24,0.00,0.50,0.67,1,0.00,7,3216.87,1,0,18,javax.servlet.http.HttpServlet,0.00,40,1,12,0,40,3,0,12,539,1
"org.apache.lucene.analysis.uima.ae.AEProvider",1,0.00,1.00,2,0.01,51.30,1,0,2,1,4,96.31,9,3,4,1,146.30,0.00,0.00,0.00,0,1.00,1,27.65,0,1,0,,0.00,0,0,1,0,0,0,0,2,11,1
"org.apache.lucene.analysis.uima.ae.AEProviderFactory",5,0.38,2.00,19,0.28,12898.92,7,2,2,15,6,146.79,19,31,3,1,126.18,0.00,0.00,0.20,1,11.00,5,853.31,0,1,3,java.lang.Object,0.00,10,0,10,0,10,4,0,5,187,1
"org.apache.lucene.analysis.uima.ae.BasicAEProvider",4,0.33,2.50,28,0.30,12553.44,6,2,7,14,5,161.73,7,45,3,1,111.73,0.00,0.00,0.25,1,8.00,6,897.17,0,2,2,java.lang.Object,0.00,10,0,10,1,10,2,1,4,185,1
"org.apache.lucene.analysis.uima.ae.BasicAEProviderTest",1,0.00,1.00,5,0.05,753.20,1,0,3,4,2,142.89,3,8,0,1,122.27,0.00,0.00,0.00,0,1.00,1,139.77,0,0,2,java.lang.Object,0.00,3,0,1,0,3,1,0,1,34,1
"org.apache.lucene.analysis.uima.ae.OverridingParamsAEProvider",3,1.00,3.00,24,0.33,9190.72,4,1,2,16,3,149.49,7,33,2,2,109.61,0.00,0.50,0.33,1,4.00,6,995.07,0,1,1,org.apache.lucene.analysis.uima.ae.BasicAEProvider,0.00,13,1,9,0,13,2,0,3,206,1
"org.apache.lucene.analysis.uima.ae.OverridingParamsAEProviderTest",3,0.00,1.33,17,0.22,4595.17,3,0,6,11,2,169.78,4,26,0,1,119.78,0.00,0.00,0.00,0,3.00,2,659.87,0,0,2,java.lang.Object,0.00,8,0,4,0,8,3,0,2,138,1
"org.apache.lucene.facet.search.results.FacetResult",6,3.00,1.33,27,0.29,10374.20,9,3,1,10,40,80.69,47,39,38,1,122.98,0.00,0.00,0.00,1,6.00,3,874.17,0,3,2,java.lang.Object,0.00,4,0,8,1,4,3,0,9,206,1
"org.apache.lucene.facet.search.results.FacetResultNode",9,0.00,1.00,10,0.06,338.07,9,0,6,9,36,110.49,78,11,32,1,158.60,0.00,0.00,0.00,0,9.00,1,165.54,0,3,5,,0.00,0,0,9,0,0,6,0,11,62,1
"org.apache.lucene.facet.search.results.IntermediateFacetResult",1,0.00,1.00,2,0.01,23.00,1,0,2,1,9,186.08,30,3,8,1,149.05,0.00,0.00,0.00,0,1.00,1,18.00,0,1,2,,0.00,0,0,1,0,0,0,0,3,9,1
"org.apache.lucene.facet.search.results.MutableFacetResultNode",25,0.04,1.68,107,1.19,44569.95,31,6,5,45,8,90.60,151,146,5,1,122.82,0.00,0.00,0.13,5,184.00,4,3563.04,0,6,3,java.lang.Object,0.00,20,0,42,0,20,19,1,25,799,1
"org.apache.lucene.analysis.icu.GenerateHTMLStripCharFilterSupplementaryMacros",3,0.12,3.33,50,0.92,43532.27,7,4,5,24,1,143.03,4,72,1,1,93.03,0.00,0.00,0.33,2,5.00,8,2761.74,0,0,0,java.lang.Object,0.00,21,0,10,0,21,3,0,4,498,1
"org.apache.lucene.analysis.icu.GenerateJFlexSupplementaryMacros",3,0.12,2.67,53,0.88,30932.28,7,4,8,21,1,143.27,4,74,1,1,93.27,0.00,0.00,0.33,2,5.00,6,2632.09,0,0,0,java.lang.Object,0.00,18,0,8,0,18,3,0,4,481,1
"org.apache.lucene.analysis.icu.ICUFoldingFilter",1,0.00,1.00,4,0.06,1088.65,2,1,2,3,5,90.92,42,8,3,5,124.63,0.00,0.80,1.00,0,0.00,1,175.42,0,0,2,org.apache.lucene.analysis.icu.ICUNormalizer2Filter,0.00,2,4,1,0,2,1,0,2,43,2
"org.apache.lucene.analysis.icu.ICUNormalizer2Filter",3,0.00,1.67,18,0.20,3972.84,6,3,6,11,12,73.14,35,25,9,4,117.27,0.33,0.60,0.33,0,4.00,3,590.01,0,0,3,org.apache.lucene.analysis.TokenFilter,0.27,8,3,5,1,8,3,0,3,133,1
"org.apache.lucene.analysis.icu.ICUTransformFilter",2,0.50,2.50,24,0.31,9169.08,6,4,8,12,7,148.97,47,31,4,4,101.70,0.00,0.75,0.50,0,2.00,3,937.17,0,0,3,org.apache.lucene.analysis.TokenFilter,0.29,10,3,5,0,10,2,0,9,192,2
"org.apache.lucene.analysis.icu.ICUTransformFilter$ReplaceableTermAttribute",10,0.15,1.20,37,0.46,13376.22,13,3,8,18,1,128.54,7,51,0,1,128.54,0.00,0.00,0.47,3,0.00,3,1371.29,0,0,1,java.lang.Object,0.00,8,0,12,0,8,10,1,7,322,1
"org.apache.lucene.analysis.icu.RBBIRuleCompiler",3,0.00,3.00,37,0.56,23611.59,3,0,9,27,0,100.05,13,46,0,1,99.81,0.00,0.00,0.00,2,3.00,4,1693.62,0,1,0,java.lang.Object,0.00,24,0,9,0,24,2,0,3,311,1
"org.apache.lucene.analysis.icu.RBBIRuleCompiler$FilenameFilter",1,0.00,1.00,3,0.02,217.60,1,0,9,2,0,134.79,0,3,0,1,134.79,0.00,0.00,0.00,0,1.00,1,68.92,0,0,0,java.lang.Object,0.00,1,0,1,0,1,1,0,0,20,0
"org.apache.lucene.analysis.icu.TestICUFoldingFilter",3,0.00,1.00,22,0.31,6551.83,3,0,4,5,2,95.31,17,27,0,3,113.18,0.00,0.67,0.00,0,3.00,1,933.09,3,0,2,org.apache.lucene.analysis.BaseTokenStreamTestCase,0.00,2,2,3,0,2,3,0,15,190,1
"org.apache.lucene.analysis.icu.TestICUFoldingFilter$Analyzer",1,0.00,1.00,4,0.05,1009.20,1,0,4,4,3,124.89,0,6,0,1,124.89,0.00,0.00,0.00,0,1.00,1,159.62,0,1,3,java.lang.Object,0.00,3,0,1,0,3,0,0,0,38,0
"org.apache.lucene.analysis.icu.TestICUFoldingFilter$Analyzer_0",1,0.00,1.00,4,0.05,753.46,1,0,4,4,3,125.89,0,6,0,1,125.89,0.00,0.00,0.00,0,1.00,1,135.44,0,1,3,java.lang.Object,0.00,3,0,1,0,3,0,0,0,34,0
"org.apache.lucene.analysis.icu.TestICUNormalizer2Filter",4,0.00,1.00,19,0.22,3617.25,4,0,5,6,2,165.15,11,25,0,3,125.26,0.00,0.67,0.00,0,4.00,1,651.85,3,0,2,org.apache.lucene.analysis.BaseTokenStreamTestCase,0.00,2,2,4,0,2,4,0,9,149,1
"org.apache.lucene.analysis.icu.TestICUNormalizer2Filter$Analyzer",1,0.00,1.00,4,0.05,1009.20,1,0,5,4,3,124.89,0,6,0,1,124.89,0.00,0.00,0.00,0,1.00,1,159.62,0,1,3,java.lang.Object,0.00,3,0,1,0,3,0,0,0,38,0
"org.apache.lucene.analysis.icu.TestICUNormalizer2Filter$Analyzer_0",1,0.00,1.00,4,0.07,1344.14,1,0,5,5,3,173.91,1,8,0,1,123.91,0.00,0.00,0.00,0,1.00,1,224.33,0,1,3,java.lang.Object,0.00,4,0,1,0,4,0,0,1,49,0
"org.apache.lucene.analysis.icu.TestICUNormalizer2Filter$Analyzer_1",1,0.00,1.00,4,0.05,753.46,1,0,5,4,3,125.89,0,6,0,1,125.89,0.00,0.00,0.00,0,1.00,1,135.44,0,1,3,java.lang.Object,0.00,3,0,1,0,3,0,0,0,34,0
"org.apache.lucene.analysis.icu.TestICUTransformFilter",9,0.00,1.00,38,0.53,8335.21,9,0,11,20,7,125.18,8,55,0,3,125.18,0.00,0.67,0.00,1,9.00,1,1582.67,3,0,7,org.apache.lucene.analysis.BaseTokenStreamTestCase,0.00,11,2,9,0,11,9,0,6,346,1
"org.apache.lucene.analysis.icu.TestICUTransformFilter$Analyzer",1,0.00,1.00,4,0.06,1029.80,1,0,11,4,3,124.82,0,6,0,1,124.82,0.00,0.00,0.00,0,1.00,1,166.32,0,1,3,java.lang.Object,0.00,3,0,1,0,3,0,0,0,39,0
"org.apache.lucene.analysis.icu.TestICUTransformFilter$Analyzer_0",1,0.00,1.00,4,0.06,978.91,1,0,11,5,3,124.99,0,6,0,1,124.99,0.00,0.00,0.00,0,1.00,1,166.32,0,1,3,java.lang.Object,0.00,4,0,1,0,4,0,0,0,39,0
"org.apache.solr.search.grouping.distributed.command.QueryCommand",6,0.12,1.33,32,0.34,7627.69,14,8,11,14,14,120.42,3,40,1,1,120.42,0.00,0.00,0.23,0,14.00,2,1020.69,0,5,13,java.lang.Object,0.00,8,0,8,0,8,1,1,1,226,1
"org.apache.solr.search.grouping.distributed.command.QueryCommand$Builder",8,0.02,1.12,32,0.28,4795.21,14,6,11,13,7,166.53,16,42,0,1,126.64,0.00,0.00,0.15,2,16.00,2,840.24,0,8,7,java.lang.Object,0.00,5,0,9,0,5,0,0,2,209,2
"org.apache.solr.search.grouping.distributed.command.QueryCommandResult",3,0.25,1.00,10,0.06,680.40,5,2,1,3,5,184.65,3,14,4,1,134.65,0.00,0.00,0.33,0,5.00,1,175.05,0,1,1,java.lang.Object,0.00,0,0,3,0,0,2,0,1,52,1
"org.apache.solr.search.grouping.distributed.command.SearchGroupsFieldCommand",6,0.05,1.00,21,0.20,3058.84,10,4,11,10,9,131.88,3,28,2,1,131.88,0.00,0.00,0.29,0,10.00,1,604.53,0,5,7,java.lang.Object,0.00,4,0,6,0,4,1,1,1,148,1
"org.apache.solr.search.grouping.distributed.command.SearchGroupsFieldCommand$Builder",4,0.11,1.25,17,0.13,2389.73,7,3,11,6,3,126.63,0,23,0,1,126.63,0.00,0.00,0.25,0,6.00,2,383.69,0,3,3,java.lang.Object,0.00,2,0,5,0,2,1,0,0,101,2
"org.apache.solr.search.grouping.distributed.command.TopGroupsFieldCommand",6,0.18,1.33,41,0.47,12164.65,16,10,13,14,11,115.87,3,59,2,1,115.87,0.00,0.00,0.25,0,10.00,2,1397.04,0,5,9,java.lang.Object,0.00,8,0,8,0,8,1,1,1,298,1
"org.apache.solr.search.grouping.distributed.command.TopGroupsFieldCommand$Builder",9,0.02,1.11,37,0.32,6215.21,17,8,13,11,4,126.16,0,49,0,1,126.16,0.00,0.00,0.11,0,16.00,2,965.52,0,8,4,java.lang.Object,0.00,2,0,10,0,2,1,0,0,237,2
"org.apache.lucene.analysis.ja.util.BinaryDictionaryWriter",12,0.05,3.75,211,3.20,346043.94,20,8,14,56,8,129.56,24,230,2,1,89.68,0.00,0.00,0.17,8,60.00,19,9593.26,0,2,6,java.lang.Object,0.00,44,0,45,2,44,10,0,16,1634,2
"org.apache.lucene.analysis.ja.util.CSVUtil",4,0.17,3.25,46,0.55,28958.43,8,4,3,19,5,101.72,16,56,5,1,101.49,0.00,0.00,0.38,0,2.00,5,1658.81,0,3,0,java.lang.Object,0.00,15,0,13,0,15,1,0,7,327,2
"org.apache.lucene.analysis.ja.util.CharacterDefinitionWriter",4,0.33,2.00,31,0.49,18364.60,7,3,10,19,5,131.09,15,41,1,1,110.48,0.00,0.00,0.58,0,0.00,4,1481.98,0,0,4,java.lang.Object,0.00,15,0,8,0,15,4,0,7,285,2
"org.apache.lucene.analysis.ja.util.ConnectionCostsBuilder",2,0.00,1.50,23,0.40,23630.22,2,0,7,14,2,99.99,0,29,1,1,99.99,0.00,0.00,0.00,0,2.00,2,1214.01,0,0,1,java.lang.Object,0.00,12,0,3,0,12,2,0,0,210,1
"org.apache.lucene.analysis.ja.util.ConnectionCostsWriter",3,0.00,1.67,33,0.46,27334.43,6,3,9,14,6,150.86,4,38,2,1,100.86,0.00,0.00,0.33,0,4.00,3,1387.57,0,0,4,java.lang.Object,0.00,11,0,5,0,11,3,0,2,258,2
"org.apache.lucene.analysis.ja.util.DictionaryBuilder",3,0.00,1.67,44,0.64,24717.64,3,0,2,17,7,97.29,0,53,1,1,97.29,0.00,0.00,0.00,0,3.00,3,1918.23,0,0,6,java.lang.Object,0.00,14,0,5,0,14,3,0,0,349,1
"org.apache.lucene.analysis.ja.util.DictionaryBuilder$DictionaryFormat",0,0.00,0.00,2,0.01,39.30,0,0,2,0,0,171.00,0,1,0,1,171.00,0.00,0.00,0.00,0,0.00,0,19.65,0,0,0,java.lang.Object,0.00,0,0,0,0,0,0,0,0,7,1
"org.apache.lucene.analysis.ja.util.TestToStringUtil",2,0.00,1.00,9,0.09,1128.93,2,0,1,5,1,126.87,0,12,0,2,126.87,0.00,0.50,0.00,0,2.00,1,281.80,0,0,1,org.apache.lucene.util.LuceneTestCase,0.00,3,1,2,0,3,2,0,0,70,1
"org.apache.lucene.analysis.ja.util.ToStringUtil",5,0.17,29.40,789,12.25,1404567.75,8,3,2,13,6,45.64,24,986,6,1,45.40,0.00,0.00,0.20,1,14.00,142,36756.96,0,4,0,java.lang.Object,0.00,8,0,147,0,8,1,0,11,4667,1
"org.apache.lucene.analysis.ja.util.TokenInfoDictionaryBuilder",4,0.00,4.50,105,1.70,125517.38,9,5,20,42,7,34.36,35,116,1,1,82.46,0.00,0.00,0.20,2,6.00,11,5096.51,0,3,6,java.lang.Object,0.00,38,0,18,0,38,1,0,11,821,1
"org.apache.lucene.analysis.ja.util.TokenInfoDictionaryBuilder$Comparator<String",1,0.00,1.00,3,0.04,532.69,1,0,20,2,0,131.73,0,4,0,1,131.73,0.00,0.00,0.00,0,1.00,1,107.76,0,0,0,java.lang.Object,0.00,1,0,1,0,1,1,0,0,30,0
"org.apache.lucene.analysis.ja.util.TokenInfoDictionaryBuilder$FilenameFilter",1,0.00,1.00,3,0.03,337.11,1,0,20,2,0,133.30,0,5,0,1,133.30,0.00,0.00,0.00,0,1.00,1,84.00,0,0,0,java.lang.Object,0.00,1,0,1,0,1,1,0,0,23,0
"org.apache.lucene.analysis.ja.util.TokenInfoDictionaryWriter",4,1.00,1.00,13,0.14,2061.08,5,1,4,8,5,131.85,0,19,2,2,131.85,0.00,0.50,0.25,1,6.00,1,408.32,2,0,3,org.apache.lucene.analysis.ja.util.BinaryDictionaryWriter,0.00,4,1,4,0,4,4,0,0,102,1
"org.apache.lucene.analysis.ja.util.UnknownDictionaryBuilder",5,0.25,2.40,61,0.98,60835.08,7,2,13,28,4,148.37,9,74,1,1,98.37,0.00,0.00,0.30,2,10.00,6,2928.22,0,3,3,java.lang.Object,0.00,23,0,12,0,23,2,0,9,514,1
"org.apache.lucene.analysis.ja.util.UnknownDictionaryBuilder$Comparator<String",1,0.00,1.00,5,0.06,1524.79,1,0,13,2,1,119.86,0,6,0,1,119.86,0.00,0.00,0.00,0,1.00,1,185.42,0,0,1,java.lang.Object,0.00,1,0,1,0,1,1,0,0,46,0
"org.apache.lucene.analysis.ja.util.UnknownDictionaryWriter",5,0.50,1.00,17,0.19,3269.26,6,1,3,11,7,181.03,9,25,3,2,131.03,0.00,0.50,0.60,0,5.00,1,556.27,3,0,4,org.apache.lucene.analysis.ja.util.BinaryDictionaryWriter,0.00,6,1,5,0,6,5,0,4,138,1
"org.apache.lucene.analysis.ru.Deprecated",2,0.00,1.00,9,0.12,2023.94,2,0,4,4,1,164.76,4,15,0,3,124.88,0.00,0.67,0.00,0,2.00,1,366.29,1,0,1,org.apache.lucene.analysis.BaseTokenStreamTestCase,0.00,2,2,2,0,2,2,0,1,83,1
"org.apache.lucene.analysis.ru.RussianAnalyzer",5,0.33,1.80,30,0.73,22764.51,8,3,17,18,15,64.55,53,57,1,3,113.03,0.00,0.67,0.07,0,8.00,4,2204.26,0,2,14,org.apache.lucene.analysis.util.StopwordAnalyzerBase,0.00,13,2,9,0,13,3,0,7,391,2
"org.apache.lucene.analysis.ru.RussianAnalyzer$DefaultSetHolder",0,0.00,0.00,7,0.11,2307.42,2,2,17,3,4,171.00,3,15,0,1,171.00,0.00,0.00,0.00,0,0.00,0,339.19,0,0,4,java.lang.Object,0.00,3,0,0,0,3,0,0,3,74,2
"org.apache.lucene.analysis.ru.RussianLightStemFilter",2,0.33,2.00,14,0.16,3794.18,5,3,6,9,9,113.74,9,20,3,4,113.50,0.00,0.75,0.50,0,2.00,3,481.98,0,0,6,org.apache.lucene.analysis.TokenFilter,0.29,7,3,4,0,7,2,0,1,107,2
"org.apache.lucene.analysis.ru.RussianLightStemmer",3,0.00,3.67,16,0.90,58382.96,3,0,1,4,1,150.74,7,83,1,1,110.85,0.00,0.00,0.00,1,3.00,6,2714.52,0,0,0,java.lang.Object,0.00,1,0,11,0,1,3,0,1,454,1
"org.apache.lucene.analysis.ru.TestRussianAnalyzer",5,0.00,1.00,19,0.30,4740.66,5,0,5,9,4,179.76,6,32,0,3,129.76,0.00,0.67,0.00,0,5.00,1,894.51,3,0,4,org.apache.lucene.analysis.BaseTokenStreamTestCase,0.00,4,2,5,0,4,5,0,4,191,1
"org.apache.lucene.analysis.ru.TestRussianLightStemFilter",3,0.00,1.00,10,0.08,885.78,3,0,8,6,5,183.75,5,15,0,3,133.75,0.00,0.67,0.00,0,3.00,1,234.73,2,0,5,org.apache.lucene.analysis.BaseTokenStreamTestCase,0.00,3,2,3,0,3,3,0,3,63,1
"org.apache.lucene.analysis.ru.TestRussianLightStemFilter$Analyzer",1,0.00,1.00,4,0.05,1009.20,1,0,8,4,3,124.89,0,7,0,1,124.89,0.00,0.00,0.00,0,1.00,1,159.62,0,1,3,java.lang.Object,0.00,3,0,1,0,3,0,0,0,38,0
"org.apache.lucene.analysis.ru.TestRussianLightStemFilter$Analyzer_0",1,0.00,1.00,4,0.05,753.46,1,0,8,4,3,125.89,0,6,0,1,125.89,0.00,0.00,0.00,0,1.00,1,135.44,0,1,3,java.lang.Object,0.00,3,0,1,0,3,0,0,0,34,0
"org.apache.solr.client.solrj.impl.BinaryRequestWriter",5,0.00,1.80,27,0.33,11727.34,5,0,9,17,9,158.14,10,44,4,2,118.25,0.00,0.50,0.00,0,5.00,3,987.11,2,4,5,org.apache.solr.client.solrj.request.RequestWriter,0.17,12,1,9,0,12,1,0,2,213,1
"org.apache.solr.client.solrj.impl.BinaryRequestWriter$BAOS",1,0.00,1.00,3,0.02,120.56,1,0,9,1,0,136.81,0,6,0,2,136.81,0.00,0.50,0.00,0,1.00,1,47.15,0,0,0,java.io.ByteArrayOutputStream,0.00,0,1,1,0,0,1,0,0,16,0
"org.apache.solr.client.solrj.impl.BinaryRequestWriter$ContentStream",6,0.00,1.00,13,0.09,945.01,6,0,9,11,0,142.47,1,20,0,1,142.47,0.00,0.00,0.00,0,6.00,1,259.04,0,6,0,java.lang.Object,0.00,5,0,6,0,5,0,0,1,76,0
"org.apache.solr.client.solrj.impl.BinaryResponseParser",4,0.00,1.25,11,0.13,2782.32,4,0,7,8,11,187.34,4,22,7,2,137.34,1.00,0.33,0.00,0,4.00,2,399.44,0,4,4,org.apache.solr.client.solrj.ResponseParser,0.50,4,1,5,1,4,0,0,1,95,1
"org.apache.solr.client.solrj.impl.CloudSolrServer",10,0.04,2.60,80,1.14,52466.49,18,8,28,45,17,147.69,28,112,1,2,107.80,0.00,0.50,0.16,1,26.00,8,3407.99,0,3,16,org.apache.solr.client.solrj.SolrServer,0.00,35,1,26,0,35,7,0,17,621,1
"org.apache.solr.client.solrj.impl.CommonsHttpSolrServer",33,0.01,2.42,233,3.73,324896.95,46,13,36,129,52,89.95,192,339,36,2,107.83,1.00,0.33,0.07,7,373.00,40,11175.40,0,10,16,org.apache.solr.client.solrj.SolrServer,0.00,96,1,80,1,96,23,0,62,1808,1
"org.apache.solr.client.solrj.impl.CommonsHttpSolrServer$Iterator<SolrInputDocument>",3,0.00,1.33,9,0.07,1088.73,3,0,36,8,1,132.98,0,12,0,1,132.98,0.00,0.00,0.00,0,3.00,2,203.06,0,1,1,java.lang.Object,0.00,5,0,4,0,5,2,0,0,57,0
"org.apache.solr.client.solrj.impl.CommonsHttpSolrServer$PartSource",3,0.00,1.00,7,0.05,616.70,3,0,36,6,0,141.56,0,12,0,1,141.56,0.00,0.00,0.00,0,3.00,1,155.65,0,2,0,java.lang.Object,0.00,3,0,3,0,3,1,0,0,45,0
"org.apache.solr.client.solrj.impl.CommonsHttpSolrServer$RequestEntity",4,0.00,1.00,9,0.07,700.55,4,0,36,6,1,142.10,0,13,0,1,142.10,0.00,0.00,0.00,0,4.00,1,195.43,0,1,1,java.lang.Object,0.00,2,0,4,0,2,3,0,0,56,0
"org.apache.solr.client.solrj.impl.LBHttpSolrServer",24,0.00,3.00,206,2.80,219122.37,35,11,17,79,15,88.00,122,292,6,2,105.87,0.00,0.50,0.09,7,268.00,20,8401.96,1,9,9,org.apache.solr.client.solrj.SolrServer,0.00,55,1,72,0,55,15,0,50,1577,1
"org.apache.solr.client.solrj.impl.LBHttpSolrServer$Req",5,0.17,1.00,16,0.12,1740.20,8,3,17,6,1,133.19,3,22,0,1,133.19,0.00,0.00,0.20,0,14.00,1,353.83,0,2,1,java.lang.Object,0.00,1,0,5,0,1,3,0,2,95,2
"org.apache.solr.client.solrj.impl.LBHttpSolrServer$Rsp",2,0.00,1.00,7,0.04,467.32,4,2,17,2,1,184.55,2,10,0,1,134.55,0.00,0.00,0.50,0,2.00,1,130.59,0,2,1,java.lang.Object,0.00,0,0,2,0,0,0,0,2,37,2
"org.apache.solr.client.solrj.impl.LBHttpSolrServer$Runnable",1,0.00,3.00,7,0.07,1705.89,1,0,17,3,1,113.77,0,9,0,1,113.77,0.00,0.00,0.00,0,1.00,3,202.51,0,0,1,java.lang.Object,0.00,2,0,3,0,2,1,0,0,47,0
"org.apache.solr.client.solrj.impl.LBHttpSolrServer$ServerWrapper",5,0.15,1.40,18,0.17,3194.93,10,5,17,9,1,181.03,5,27,0,1,131.03,0.00,0.00,0.08,1,7.00,3,508.24,0,2,1,java.lang.Object,0.00,4,0,7,0,4,3,0,5,128,2
"org.apache.solr.client.solrj.impl.StreamingBinaryResponseParser",2,1.00,1.50,9,0.11,2707.03,3,1,10,5,9,144.40,7,17,1,3,123.79,0.00,0.67,0.00,0,2.00,2,325.76,0,1,8,org.apache.solr.client.solrj.impl.BinaryResponseParser,0.00,3,2,3,0,3,1,0,1,73,1
"org.apache.solr.client.solrj.impl.StreamingBinaryResponseParser$JavaBinCodec",2,0.00,2.00,22,0.31,13189.69,2,0,10,14,3,151.92,2,28,0,1,101.92,0.00,0.00,0.00,0,0.00,3,920.45,1,2,3,java.lang.Object,0.00,12,0,4,0,12,0,0,2,172,0
"org.apache.solr.client.solrj.impl.StreamingUpdateSolrServer",7,0.19,3.43,85,1.07,56565.48,14,7,26,40,12,67.47,45,118,4,3,99.69,0.00,0.67,0.31,1,1.00,11,3213.56,2,1,8,org.apache.solr.client.solrj.impl.CommonsHttpSolrServer,0.05,33,2,24,0,33,6,0,23,592,1
"org.apache.solr.client.solrj.impl.StreamingUpdateSolrServer$Runner",1,0.00,9.00,37,0.64,35637.20,2,1,26,27,1,33.86,7,54,0,1,76.15,0.00,0.00,1.00,0,0.00,9,1930.38,0,0,1,java.lang.Object,0.00,26,0,9,0,26,1,1,7,298,0
"org.apache.solr.client.solrj.impl.StreamingUpdateSolrServer$Runner$RequestEntity",4,0.00,3.25,31,0.44,19238.18,4,0,26,14,3,110.21,3,39,0,1,110.21,0.00,0.00,0.00,0,6.00,10,1307.98,0,1,3,java.lang.Object,0.00,10,0,13,0,10,3,0,3,237,0
"org.apache.solr.client.solrj.impl.XMLResponseParser",5,0.25,3.00,48,0.62,29561.45,8,3,20,14,13,126.07,19,82,5,2,105.45,0.00,0.50,0.13,1,7.00,9,1860.24,0,4,8,org.apache.solr.client.solrj.ResponseParser,0.22,9,1,15,0,9,1,0,13,359,1
"org.apache.solr.client.solrj.impl.XMLResponseParser$KnownType",15,1.00,4.13,207,3.19,703742.07,16,1,20,60,5,142.34,27,240,0,1,92.34,0.00,0.00,0.00,0,15.00,47,9555.28,0,14,5,java.lang.Object,0.00,45,0,62,0,45,1,0,19,1487,1
"org.apache.lucene.analysis.fi.FinnishAnalyzer",5,0.50,1.20,21,0.26,6053.81,7,2,17,16,15,76.12,42,31,1,3,124.22,0.00,0.67,0.10,0,8.00,2,777.74,0,2,14,org.apache.lucene.analysis.util.StopwordAnalyzerBase,0.00,11,2,6,0,11,3,0,8,177,2
"org.apache.lucene.analysis.fi.FinnishAnalyzer$DefaultSetHolder",0,0.00,0.00,6,0.07,1089.77,1,1,17,0,4,171.00,2,11,0,1,171.00,0.00,0.00,0.00,0,0.00,0,202.05,0,0,4,java.lang.Object,0.00,0,0,0,0,0,0,0,2,47,2
"org.apache.lucene.analysis.fi.FinnishLightStemFilter",2,0.33,2.00,14,0.16,3794.18,5,3,6,9,9,113.74,9,20,3,4,113.50,0.00,0.75,0.50,0,2.00,3,481.98,0,0,6,org.apache.lucene.analysis.TokenFilter,0.29,7,3,4,0,7,2,0,1,107,2
"org.apache.lucene.analysis.fi.FinnishLightStemmer",7,0.00,7.57,87,1.54,105769.25,7,0,1,8,1,147.37,8,162,1,1,97.37,0.00,0.00,0.00,0,7.00,20,4626.21,0,0,0,java.lang.Object,0.00,1,0,53,0,1,7,0,2,880,1
"org.apache.lucene.analysis.fi.TestFinnishAnalyzer",4,0.00,1.00,15,0.16,2494.63,4,0,4,7,4,181.19,7,21,0,3,131.19,0.00,0.67,0.00,0,4.00,1,481.49,3,0,4,org.apache.lucene.analysis.BaseTokenStreamTestCase,0.00,3,2,4,0,3,4,0,6,114,1
"org.apache.lucene.analysis.fi.TestFinnishLightStemFilter",3,0.00,1.00,10,0.08,885.78,3,0,8,6,5,183.75,5,15,0,3,133.75,0.00,0.67,0.00,0,3.00,1,234.73,2,0,5,org.apache.lucene.analysis.BaseTokenStreamTestCase,0.00,3,2,3,0,3,3,0,3,63,1
"org.apache.lucene.analysis.fi.TestFinnishLightStemFilter$Analyzer",1,0.00,1.00,4,0.05,1009.20,1,0,8,4,3,124.89,0,7,0,1,124.89,0.00,0.00,0.00,0,1.00,1,159.62,0,1,3,java.lang.Object,0.00,3,0,1,0,3,0,0,0,38,0
"org.apache.lucene.analysis.fi.TestFinnishLightStemFilter$Analyzer_0",1,0.00,1.00,4,0.05,753.46,1,0,8,4,3,125.89,0,6,0,1,125.89,0.00,0.00,0.00,0,1.00,1,135.44,0,1,3,java.lang.Object,0.00,3,0,1,0,3,0,0,0,34,0
"org.apache.lucene.benchmark.BenchmarkTestCase",9,0.17,1.44,49,0.55,15840.21,12,3,11,30,12,119.28,7,63,10,2,119.28,10.00,0.08,0.19,3,25.00,3,1656.98,0,5,2,org.apache.lucene.util.LuceneTestCase,0.00,21,1,13,10,21,4,0,7,366,2
"org.apache.lucene.benchmark.Constants",0,0.00,0.00,6,0.09,2063.23,5,5,0,0,0,171.00,18,8,0,1,171.00,0.00,0.00,0.00,0,0.00,0,275.10,0,0,0,java.lang.Object,0.00,0,0,0,0,0,0,0,2,60,1
"org.apache.solr.client.solrj.response.AnalysisResponseBase",2,0.00,2.50,24,0.40,15593.81,2,0,4,11,6,126.12,64,27,4,3,99.89,1.00,0.40,0.00,1,2.00,3,1185.45,0,1,2,org.apache.solr.client.solrj.response.SolrResponseBase,0.00,9,2,5,2,9,1,0,6,234,1
"org.apache.solr.client.solrj.response.AnalysisResponseBase$AnalysisPhase",4,0.17,1.00,11,0.08,1212.46,6,2,4,6,0,180.11,10,16,0,1,140.23,0.00,0.00,0.38,0,6.00,1,252.34,0,2,0,java.lang.Object,0.00,2,0,4,0,2,2,0,2,69,2
"org.apache.solr.client.solrj.response.AnalysisResponseBase$TokenInfo",8,0.02,1.00,30,0.20,3164.09,15,7,4,8,0,100.53,51,39,0,1,132.75,0.00,0.00,0.12,0,50.00,1,605.15,0,3,0,java.lang.Object,0.00,0,0,8,0,0,5,0,8,162,2
"org.apache.solr.client.solrj.response.CoreAdminResponse",4,0.00,1.50,15,0.17,3749.11,4,0,2,6,5,179.71,5,28,3,3,129.71,0.00,0.67,0.00,1,4.00,2,522.91,1,4,2,org.apache.solr.client.solrj.response.SolrResponseBase,0.00,2,2,6,0,2,0,0,1,125,1
"org.apache.solr.client.solrj.response.DocumentAnalysisResponse",4,0.00,2.00,33,0.72,43088.71,5,1,5,23,4,55.40,37,46,2,4,105.40,0.00,0.75,1.00,0,0.00,5,2172.86,2,1,2,org.apache.solr.client.solrj.response.AnalysisResponseBase,0.00,19,3,8,0,19,3,1,8,403,1
"org.apache.solr.client.solrj.response.DocumentAnalysisResponse$DocumentAnalysis",6,0.10,1.00,15,0.16,3192.78,8,2,5,13,0,178.19,15,22,0,1,138.30,0.00,0.00,0.42,0,2.00,1,479.96,0,2,0,java.lang.Object,0.00,7,0,6,0,7,4,1,3,124,2
"org.apache.solr.client.solrj.response.DocumentAnalysisResponse$FieldAnalysis",10,0.07,1.10,24,0.26,4328.00,13,3,5,16,0,139.22,43,35,0,1,138.99,0.00,0.00,0.27,0,30.00,2,767.08,0,1,0,java.lang.Object,0.00,6,0,11,0,6,9,0,7,197,2
"org.apache.solr.client.solrj.response.DocumentAnalysisResponseTest",2,0.00,1.00,83,1.23,71205.11,2,0,5,24,3,42.78,12,87,0,2,75.00,0.00,0.50,0.00,1,2.00,1,3698.68,0,1,3,org.apache.lucene.util.LuceneTestCase,0.00,22,1,2,0,22,1,0,5,649,1
"org.apache.solr.client.solrj.response.DocumentAnalysisResponseTest$DocumentAnalysisResponse",1,0.00,1.00,3,0.04,562.00,1,0,5,1,1,131.55,0,5,0,1,131.55,0.00,0.00,0.00,0,1.00,1,108.00,0,1,1,java.lang.Object,0.00,0,0,1,0,0,0,0,0,29,0
"org.apache.solr.client.solrj.response.FacetField",11,0.10,1.64,41,0.41,10016.23,15,4,6,16,5,169.67,23,66,4,1,129.79,0.00,0.00,0.34,0,6.00,4,1236.12,0,6,1,java.lang.Object,0.00,5,0,18,0,5,5,1,6,291,1
"org.apache.solr.client.solrj.response.FacetField$Count",8,0.19,1.12,24,0.19,2351.93,11,3,6,11,2,133.74,1,42,0,1,133.74,0.00,0.00,0.50,0,0.00,2,562.63,0,3,2,java.lang.Object,0.00,3,0,9,0,3,5,1,1,149,2
"org.apache.solr.client.solrj.response.FacetFieldTest",1,0.00,1.00,7,0.08,1342.39,1,0,1,7,1,114.84,0,9,0,2,114.84,0.00,0.50,0.00,0,1.00,1,227.28,0,0,1,org.apache.lucene.util.LuceneTestCase,0.00,6,1,1,0,6,1,0,0,55,1
"org.apache.solr.client.solrj.response.FieldAnalysisResponse",8,0.00,1.38,34,0.61,23960.90,10,2,4,19,3,88.87,49,48,1,4,121.09,0.00,0.75,0.50,0,2.00,3,1840.22,1,0,2,org.apache.solr.client.solrj.response.AnalysisResponseBase,0.00,11,3,11,0,11,8,0,10,393,1
"org.apache.solr.client.solrj.response.FieldAnalysisResponse$Analysis",7,0.25,1.14,16,0.13,1892.96,9,2,4,8,0,140.82,29,24,0,1,140.59,0.00,0.00,0.29,0,19.00,2,392.19,0,0,0,java.lang.Object,0.00,1,0,8,0,1,7,0,5,108,2
"org.apache.solr.client.solrj.response.FieldStatsInfo",11,0.16,2.73,85,1.17,64040.11,21,10,6,28,3,109.60,6,117,2,1,109.60,0.00,0.00,0.25,0,38.00,13,3506.96,0,10,1,java.lang.Object,0.00,17,0,30,0,17,1,1,1,646,1
"org.apache.solr.client.solrj.response.Group",3,0.25,1.00,10,0.06,537.50,5,2,2,3,3,85.46,27,14,2,1,135.46,0.00,0.00,0.67,0,0.00,1,171.97,0,2,1,java.lang.Object,0.00,0,0,3,0,0,1,1,4,50,1
"org.apache.solr.client.solrj.response.GroupCommand",7,0.17,1.00,23,0.17,2191.57,11,4,3,9,3,85.44,62,31,2,1,133.55,0.00,0.00,0.39,0,10.00,1,496.55,0,3,1,java.lang.Object,0.00,2,0,7,0,2,4,1,8,130,1
"org.apache.solr.client.solrj.response.GroupResponse",2,0.00,1.00,6,0.06,926.50,3,1,3,4,2,83.73,21,9,1,1,132.21,0.00,0.00,1.00,0,0.00,1,172.98,0,1,1,java.lang.Object,0.00,2,0,2,0,2,1,1,3,46,1
"org.apache.solr.client.solrj.response.LukeResponse",10,0.07,2.00,51,0.72,39048.49,13,3,4,23,5,166.48,10,68,2,3,116.48,0.00,0.67,0.40,0,6.00,7,2148.72,1,9,3,org.apache.solr.client.solrj.response.SolrResponseBase,0.00,13,2,20,0,13,1,0,5,441,1
"org.apache.solr.client.solrj.response.LukeResponse$FieldInfo",11,0.06,1.91,55,0.61,22289.17,19,8,4,18,2,118.74,0,69,0,1,118.74,0.00,0.00,0.18,0,69.00,9,1828.57,0,6,2,java.lang.Object,0.00,7,0,21,0,7,5,1,0,381,2
"org.apache.solr.client.solrj.response.LukeResponse$FieldTypeInfo",7,0.10,1.71,32,0.38,14455.64,12,5,4,14,1,162.20,20,59,0,1,122.31,0.00,0.00,0.29,0,18.00,6,1132.28,0,4,1,java.lang.Object,0.00,7,0,12,0,7,3,1,1,236,2
"org.apache.solr.client.solrj.response.PivotField",7,0.38,1.43,31,0.27,5207.21,11,4,3,10,1,125.85,0,43,1,1,125.85,0.00,0.00,0.57,0,0.00,4,802.63,0,4,0,java.lang.Object,0.00,3,0,10,0,3,3,1,0,185,1
"org.apache.solr.client.solrj.response.QueryResponseTest",3,0.00,2.33,156,3.81,317735.07,3,0,11,45,8,87.84,9,164,0,2,67.22,0.00,0.50,0.00,0,3.00,4,11426.49,0,0,8,org.apache.lucene.util.LuceneTestCase,0.00,42,1,7,0,42,3,0,5,1728,1
"org.apache.solr.client.solrj.response.RangeFacet",9,0.02,1.00,34,0.32,8189.08,16,7,2,12,4,129.90,3,44,4,1,129.90,0.00,0.00,0.13,0,61.00,1,946.94,0,4,0,java.lang.Object,0.00,3,0,9,2,3,5,0,1,223,2
"org.apache.solr.client.solrj.response.RangeFacet$Count",4,0.11,1.00,14,0.09,1126.13,7,3,2,4,1,133.91,0,19,0,1,133.91,0.00,0.00,0.25,0,10.00,1,266.18,0,1,1,java.lang.Object,0.00,0,0,4,0,0,3,0,0,75,2
"org.apache.solr.client.solrj.response.RangeFacet$Date",1,0.00,1.00,3,0.06,940.86,1,0,2,1,1,129.79,0,5,0,2,129.79,0.00,0.50,0.00,0,1.00,1,190.39,0,0,1,org.apache.solr.client.solrj.response.RangeFacet,0.00,0,1,1,0,0,1,0,0,48,2
"org.apache.solr.client.solrj.response.RangeFacet$Numeric",1,0.00,1.00,3,0.04,551.26,1,0,2,1,1,131.61,0,5,0,2,131.61,0.00,0.50,0.00,0,1.00,1,131.73,0,0,1,org.apache.solr.client.solrj.response.RangeFacet,0.00,0,1,1,0,0,1,0,0,36,2
"org.apache.solr.client.solrj.response.SolrPingResponse",0,0.00,0.00,1,0.01,31.02,0,0,0,0,3,171.00,6,3,2,3,171.00,0.00,0.67,0.00,0,0.00,0,15.51,0,0,1,org.apache.solr.client.solrj.response.SolrResponseBase,0.00,0,2,0,0,0,0,0,2,6,1
"org.apache.solr.client.solrj.response.SolrResponseBase",10,0.19,1.20,32,0.26,4091.12,13,3,2,12,8,132.59,6,52,6,2,132.59,7.00,0.11,0.17,1,38.00,2,779.28,0,4,2,org.apache.solr.client.solrj.SolrResponse,0.31,2,1,12,7,2,6,0,2,199,1
"org.apache.solr.client.solrj.response.SpellCheckResponse",8,0.11,2.38,66,0.95,57698.83,12,4,5,35,5,146.62,20,82,4,1,106.73,0.00,0.00,0.34,0,12.00,10,2841.62,0,5,1,java.lang.Object,0.00,27,0,19,0,27,3,0,4,518,1
"org.apache.solr.client.solrj.response.SpellCheckResponse$Collation",6,0.20,1.00,18,0.13,1704.59,9,3,5,8,0,133.88,0,25,0,1,133.88,0.00,0.00,0.17,0,18.00,1,378.18,0,4,0,java.lang.Object,0.00,2,0,6,0,2,2,0,0,103,1
"org.apache.solr.client.solrj.response.SpellCheckResponse$Correction",5,0.38,1.00,14,0.08,1093.10,7,2,5,5,0,141.35,0,20,0,1,141.35,0.00,0.00,0.20,0,11.00,1,251.51,0,2,0,java.lang.Object,0.00,0,0,5,0,0,3,0,0,76,1
"org.apache.solr.client.solrj.response.SpellCheckResponse$Suggestion",10,0.08,1.80,53,0.65,35278.51,17,7,5,19,1,116.86,5,69,0,1,116.86,0.00,0.00,0.21,0,50.00,9,1948.45,0,5,1,java.lang.Object,0.00,9,0,18,0,9,5,0,5,384,2
"org.apache.solr.client.solrj.response.SuppressWarnings",4,0.00,1.50,56,0.82,30313.70,4,0,5,27,2,118.22,13,62,0,2,97.60,0.00,0.50,0.00,1,4.00,2,2447.72,0,1,2,org.apache.lucene.util.LuceneTestCase,0.00,23,1,6,0,23,3,0,4,463,1
"org.apache.solr.client.solrj.response.SuppressWarnings$AnalysisResponseBase",1,0.00,1.00,3,0.02,175.12,1,0,5,1,1,135.54,0,5,0,1,135.54,0.00,0.00,0.00,0,1.00,1,54.60,0,1,1,java.lang.Object,0.00,0,0,1,0,0,0,0,0,17,0
"org.apache.solr.client.solrj.response.SuppressWarnings$FieldAnalysisResponse",1,0.00,1.00,3,0.04,562.00,1,0,6,1,1,131.55,0,5,0,1,131.55,0.00,0.00,0.00,0,1.00,1,108.00,0,1,1,java.lang.Object,0.00,0,0,1,0,0,0,0,0,29,0
"org.apache.solr.client.solrj.response.TermsResponse",3,0.00,1.67,22,0.28,8799.73,4,1,5,14,3,151.94,8,22,2,1,112.05,0.00,0.00,1.00,0,0.00,3,830.24,0,2,1,java.lang.Object,0.00,11,0,5,0,11,1,0,2,177,1
"org.apache.solr.client.solrj.response.TermsResponse$Term",6,0.40,1.00,16,0.10,1236.68,8,2,5,6,0,141.55,0,23,0,1,141.55,0.00,0.00,0.17,0,14.00,1,306.51,0,1,0,java.lang.Object,0.00,0,0,6,0,0,5,0,0,90,2
"org.apache.solr.client.solrj.response.TermsResponseTest",3,0.00,1.00,29,0.40,11230.21,3,0,11,25,5,157.27,3,37,0,4,107.27,0.00,0.75,0.00,0,3.00,1,1207.50,7,0,5,org.apache.solr.SolrJettyTestBase,0.05,22,3,3,0,22,3,0,1,228,1
"org.apache.solr.client.solrj.response.TestSpellCheckResponse",4,0.67,2.50,112,2.09,136332.16,5,1,13,44,8,101.73,13,131,0,4,81.11,0.00,0.75,0.50,0,0.00,7,6269.12,2,0,8,org.apache.solr.SolrJettyTestBase,0.00,40,3,10,0,40,4,0,8,997,1
"org.apache.solr.client.solrj.response.UpdateResponse",0,0.00,0.00,1,0.01,31.02,0,0,0,0,10,171.00,7,3,9,3,171.00,0.00,0.67,0.00,0,0.00,0,15.51,0,0,1,org.apache.solr.client.solrj.response.SolrResponseBase,0.00,0,2,0,0,0,0,0,2,6,1
"org.apache.lucene.search.suggest.Average",3,0.25,1.33,17,0.19,9141.51,5,2,2,7,2,117.66,12,29,2,1,117.43,0.00,0.00,0.33,0,4.00,2,566.20,0,2,0,java.lang.Object,0.00,4,0,4,0,4,1,0,4,131,1
"org.apache.lucene.search.suggest.BufferingTermFreqIteratorWrapper",4,0.27,1.75,24,0.29,8249.07,9,5,5,12,5,165.74,5,34,1,1,115.74,0.00,0.00,0.40,0,0.00,3,867.34,0,2,4,java.lang.Object,0.00,8,0,7,1,8,2,1,2,184,1
"org.apache.lucene.search.suggest.BytesRefList",9,0.20,1.56,51,0.58,21173.78,14,5,10,25,10,86.05,56,65,3,1,118.28,0.00,0.00,0.38,1,7.00,3,1744.64,0,3,7,java.lang.Object,0.00,16,0,14,0,16,6,0,10,379,2
"org.apache.lucene.search.suggest.BytesRefList$BytesRefIterator",2,1.00,2.00,8,0.08,2020.82,3,1,10,3,1,124.72,0,13,0,1,124.72,0.00,0.00,0.50,0,2.00,3,247.15,0,2,1,java.lang.Object,0.00,1,0,4,0,1,0,0,0,60,0
"org.apache.lucene.search.suggest.BytesRefList$SorterTemplate",4,0.11,1.00,15,0.21,4910.09,7,3,10,7,1,128.88,0,24,0,1,128.88,0.00,0.00,0.42,0,2.00,1,617.35,0,0,1,java.lang.Object,0.00,3,0,4,0,3,4,0,0,149,0
"org.apache.lucene.search.suggest.FileDictionary",3,0.17,1.00,11,0.09,950.52,6,3,6,6,5,154.12,11,15,1,1,133.51,0.00,0.00,0.22,0,1.00,1,257.22,0,1,4,java.lang.Object,0.00,3,0,3,0,3,2,1,2,68,1
"org.apache.lucene.search.suggest.FileDictionary$FileIterator",3,0.00,2.33,26,0.26,9276.40,5,2,6,8,3,109.63,1,37,0,1,109.63,0.00,0.00,0.50,0,1.00,5,789.41,0,2,3,java.lang.Object,0.00,5,0,7,0,5,1,1,1,158,1
"org.apache.lucene.search.suggest.Ignore",10,0.07,2.10,86,1.54,57448.54,20,10,19,52,8,107.77,40,122,0,2,107.54,0.00,0.50,0.16,3,54.00,4,4616.63,0,2,8,org.apache.lucene.util.LuceneTestCase,0.00,42,1,21,0,42,8,0,14,840,1
"org.apache.lucene.search.suggest.Ignore$BenchmarkResult",1,1.00,1.00,4,0.06,840.13,2,1,19,4,1,175.51,1,6,0,1,125.51,0.00,0.00,0.00,0,1.00,1,172.70,0,0,1,java.lang.Object,0.00,3,0,1,0,3,1,0,1,42,2
"org.apache.lucene.search.suggest.Ignore$Callable<Integer>",1,0.00,1.00,4,0.04,507.82,1,0,19,3,1,127.23,0,5,0,1,127.23,0.00,0.00,0.00,0,0.00,1,111.39,0,1,1,java.lang.Object,0.00,2,0,1,0,2,0,0,0,29,0
"org.apache.lucene.search.suggest.Ignore$Callable<Integer>_0",1,0.00,2.00,7,0.06,1203.30,1,0,19,3,0,115.06,0,8,0,1,115.06,0.00,0.00,0.00,0,0.00,2,180.13,0,1,0,java.lang.Object,0.00,2,0,2,0,2,0,0,0,42,0
"org.apache.lucene.search.suggest.Lookup",5,1.00,1.20,17,0.20,5458.53,6,1,9,8,12,81.13,43,21,8,1,129.24,0.00,0.00,0.00,1,5.00,2,601.69,0,1,4,java.lang.Object,0.00,3,0,6,4,3,4,0,9,143,2
"org.apache.lucene.search.suggest.Lookup$CharSequenceComparator",1,0.00,3.00,13,0.15,8114.20,1,0,9,4,0,148.41,1,15,0,1,98.41,0.00,0.00,0.00,0,1.00,3,449.37,0,0,0,java.lang.Object,0.00,3,0,3,0,3,1,1,1,94,2
"org.apache.lucene.search.suggest.Lookup$LookupPriorityQueue",3,0.00,1.33,14,0.12,3542.33,3,0,9,3,1,174.28,5,17,0,2,124.28,0.00,0.50,0.00,0,3.00,2,356.54,0,1,1,org.apache.lucene.util.PriorityQueue,0.00,0,1,4,0,0,2,0,2,89,3
"org.apache.lucene.search.suggest.Lookup$LookupResult",3,0.00,1.00,10,0.09,1335.40,5,2,9,3,0,132.35,1,15,0,1,132.35,0.00,0.00,0.50,0,1.00,1,279.97,0,1,0,java.lang.Object,0.00,0,0,3,0,0,2,1,1,75,3
"org.apache.lucene.search.suggest.PersistenceTest",4,1.00,2.00,33,0.56,29359.10,5,1,11,20,7,156.71,4,52,0,2,106.71,0.00,0.50,0.00,1,4.00,5,1665.27,0,0,7,org.apache.lucene.util.LuceneTestCase,0.00,16,1,8,0,16,4,0,4,294,1
"org.apache.lucene.search.suggest.SortedTermFreqIteratorWrapper",9,0.05,2.00,78,0.95,36282.95,17,8,12,36,9,108.76,6,105,2,1,108.76,0.00,0.00,0.17,2,32.00,4,2851.71,0,3,7,java.lang.Object,0.00,27,0,18,1,27,6,1,3,564,1
"org.apache.lucene.search.suggest.SortedTermFreqIteratorWrapper$BytesOnlyComparator",3,0.00,1.00,14,0.16,4069.34,6,3,12,5,1,123.87,0,19,0,1,123.87,0.00,0.00,0.33,1,4.00,1,480.76,0,0,1,java.lang.Object,0.00,2,0,3,0,2,3,1,0,119,3
"org.apache.lucene.search.suggest.TermFreq",2,2.00,1.00,8,0.06,719.90,4,2,1,3,7,80.31,16,11,6,1,128.41,0.00,0.00,0.00,0,2.00,1,185.53,0,0,1,java.lang.Object,0.00,1,0,2,0,1,2,0,1,53,2
"org.apache.lucene.search.suggest.TermFreqArrayIterator",6,0.13,1.17,20,0.18,3307.86,9,3,6,12,8,131.58,3,30,5,1,131.58,0.00,0.00,0.22,0,10.00,2,554.40,0,2,3,java.lang.Object,0.00,6,0,7,0,6,4,1,1,139,2
"org.apache.lucene.search.suggest.TestBytesRefList",2,0.00,6.50,70,0.85,52504.25,2,0,9,26,4,78.17,1,68,0,2,78.17,0.00,0.50,0.00,0,2.00,8,2537.78,0,0,4,org.apache.lucene.util.LuceneTestCase,0.00,24,1,13,0,24,2,0,1,439,1
"org.apache.lucene.search.suggest.TestHighFrequencyDictionary",1,0.00,1.00,12,0.15,2505.69,1,0,9,13,8,103.98,0,14,0,2,103.98,0.00,0.50,0.00,0,1.00,1,453.10,0,0,8,org.apache.lucene.util.LuceneTestCase,0.00,12,1,1,0,12,1,0,0,90,1
"org.apache.lucene.search.suggest.TestTermFreqIterator",5,0.00,2.40,79,1.36,88273.41,5,0,11,41,10,93.48,4,84,0,2,93.48,0.00,0.50,0.00,2,5.00,5,4081.34,0,0,10,org.apache.lucene.util.LuceneTestCase,0.00,36,1,12,0,36,5,0,4,708,1
"org.apache.lucene.search.suggest.UnsortedTermFreqIteratorWrapper",3,0.33,2.00,27,0.28,10536.86,6,3,4,6,5,147.21,6,30,2,2,107.32,0.00,0.50,0.56,0,0.00,3,828.70,0,1,3,org.apache.lucene.search.suggest.BufferingTermFreqIteratorWrapper,0.57,3,1,6,0,3,2,0,2,179,1
"org.apache.lucene.analysis.ro.RomanianAnalyzer",5,0.33,1.20,22,0.27,6314.16,8,3,15,16,13,74.08,46,32,1,3,124.08,0.00,0.67,0.07,0,8.00,2,820.31,0,2,12,org.apache.lucene.analysis.util.StopwordAnalyzerBase,0.00,11,2,6,0,11,3,0,9,186,2
"org.apache.lucene.analysis.ro.RomanianAnalyzer$DefaultSetHolder",0,0.00,0.00,6,0.05,732.71,1,1,15,0,2,171.00,2,11,0,1,171.00,0.00,0.00,0.00,0,0.00,0,149.07,0,0,2,java.lang.Object,0.00,0,0,0,0,0,0,0,2,37,2
"org.apache.lucene.analysis.ro.TestRomanianAnalyzer",4,0.00,1.00,15,0.16,2494.63,4,0,4,7,4,181.19,7,21,0,3,131.19,0.00,0.67,0.00,0,4.00,1,481.49,3,0,4,org.apache.lucene.analysis.BaseTokenStreamTestCase,0.00,3,2,4,0,3,4,0,6,114,1
"org.apache.solr.uima.processor.an.DummyEntityAnnotator",1,0.00,4.00,15,0.22,7339.99,1,0,6,13,1,105.50,17,20,0,2,96.37,0.00,0.50,0.00,0,1.00,4,658.06,0,0,1,org.apache.uima.analysis_component.JCasAnnotator_ImplBase,0.00,12,1,4,0,12,1,0,2,123,1
"org.apache.solr.uima.processor.an.DummyExceptionAnnotator",1,0.00,1.00,3,0.03,376.22,1,0,3,2,0,132.45,16,6,0,2,132.92,0.00,0.50,0.00,0,1.00,1,80.23,0,0,0,org.apache.uima.analysis_component.JCasAnnotator_ImplBase,0.00,1,1,1,0,1,1,0,1,23,1
"org.apache.solr.uima.processor.an.DummySentimentAnnotator",2,0.00,3.00,21,0.30,8520.49,4,2,7,14,1,56.76,16,28,0,2,104.86,0.00,0.50,0.50,1,2.00,5,907.38,0,1,1,org.apache.uima.analysis_component.JCasAnnotator_ImplBase,0.00,12,1,6,0,12,1,0,1,183,1
"org.apache.solr.search.BitDocSet",20,0.05,1.45,73,0.75,19549.21,22,2,11,40,24,150.19,63,112,12,2,129.57,0.00,0.50,0.55,0,0.00,3,2256.94,1,4,13,org.apache.solr.search.DocSetBase,0.61,20,1,29,0,20,16,0,19,541,1
"org.apache.solr.search.BitDocSet$DocIterator",5,0.12,1.00,15,0.10,1323.44,7,2,11,7,2,134.12,0,20,0,1,134.12,0.00,0.00,0.40,1,2.00,1,299.93,0,1,2,java.lang.Object,0.00,2,0,5,0,2,4,0,0,85,0
"org.apache.solr.search.BitDocSet$Filter",1,0.00,4.00,11,0.16,7201.05,1,0,11,6,4,141.34,2,13,0,1,101.46,0.00,0.00,0.00,0,1.00,4,487.27,0,1,4,java.lang.Object,0.00,5,0,4,0,5,0,0,2,96,0
"org.apache.solr.search.BitDocSet$Filter$DocIdSet",3,0.00,1.00,7,0.04,512.27,3,0,11,5,1,142.19,0,13,0,1,142.19,0.00,0.00,0.00,0,3.00,1,127.57,0,2,1,java.lang.Object,0.00,2,0,3,0,2,1,0,0,39,0
"org.apache.solr.search.BitDocSet$Filter$DocIdSet$Bits",2,0.00,1.00,5,0.04,529.03,2,0,11,3,0,140.69,0,9,0,1,140.69,0.00,0.00,0.00,0,2.00,1,120.54,0,0,0,java.lang.Object,0.00,1,0,2,0,1,2,0,0,34,0
"org.apache.solr.search.BitDocSet$Filter$DocIdSet$DocIdSetIterator",3,0.50,2.00,12,0.18,6584.46,5,2,11,4,0,122.07,0,18,0,1,122.07,0.00,0.00,0.83,0,0.00,3,540.55,0,0,0,java.lang.Object,0.00,1,0,6,0,1,3,0,0,119,0
"org.apache.solr.search.BoostQParserPlugin",2,2.00,1.00,6,0.06,623.72,4,2,9,3,11,115.69,11,10,1,2,133.56,0.00,0.50,0.00,0,2.00,1,175.41,0,1,11,org.apache.solr.search.QParserPlugin,0.00,1,1,2,0,1,1,0,1,47,1
"org.apache.solr.search.BoostQParserPlugin$QParser",4,0.44,1.50,23,0.27,7806.90,7,3,9,15,10,118.92,1,32,0,1,118.92,0.00,0.00,0.67,0,0.00,3,823.62,0,3,10,java.lang.Object,0.00,11,0,6,0,11,1,0,1,178,0
"org.apache.solr.search.CacheConfig",8,0.06,1.75,52,0.67,23272.83,15,7,8,24,7,164.57,10,62,2,1,114.57,0.00,0.00,0.09,1,16.00,4,1999.70,0,4,6,java.lang.Object,0.00,16,0,14,0,16,4,0,4,413,1
"org.apache.solr.search.CacheRegenerator",1,0.00,1.00,2,0.02,168.99,1,0,1,1,10,168.51,19,3,10,1,142.23,0.00,0.00,0.00,0,1.00,1,74.42,0,0,2,,0.00,0,0,1,0,0,1,0,2,21,1
"org.apache.solr.search.DelegatingCollector",7,0.03,1.14,30,0.24,4383.76,12,5,5,12,14,126.49,3,38,10,2,126.49,2.00,0.25,0.17,0,0.00,2,713.45,0,1,4,org.apache.lucene.search.Collector,0.36,5,1,8,2,5,6,0,3,181,1
"org.apache.solr.search.DisMaxQParser",13,0.00,2.62,116,1.84,69855.55,20,7,15,59,17,128.33,41,153,2,2,107.72,0.00,0.50,0.14,6,61.00,9,5529.76,3,8,15,org.apache.solr.search.QParser,0.17,46,1,34,0,46,5,0,15,1036,1
"org.apache.solr.search.DisMaxQParserPlugin",2,1.00,1.00,5,0.06,769.03,3,1,3,3,6,97.92,89,9,1,2,139.42,0.00,0.50,0.00,0,2.00,1,174.09,0,1,6,org.apache.solr.search.QParserPlugin,0.00,1,1,2,0,1,1,0,1,46,1
"org.apache.solr.search.DocIterator",2,0.00,1.00,3,0.02,120.42,2,0,1,2,22,127.61,27,4,22,1,156.99,0.00,0.00,0.00,0,2.00,1,51.75,0,0,0,,0.00,0,0,2,0,0,2,0,5,19,1
"org.apache.solr.search.DocList",7,0.00,1.00,8,0.04,184.11,7,0,0,7,31,127.60,48,9,30,2,159.82,0.00,0.50,0.00,0,7.00,1,112.17,0,2,1,,0.17,0,1,7,0,0,5,0,15,45,1
"org.apache.solr.search.DocListAndSet",0,0.00,0.00,3,0.02,124.57,2,2,0,0,12,171.00,13,4,10,1,171.00,0.00,0.00,0.00,0,0.00,0,49.83,0,0,2,java.lang.Object,0.00,0,0,0,0,0,0,0,1,15,2
"org.apache.solr.search.DocSet",16,1.00,1.00,18,0.11,887.20,17,1,3,17,37,125.05,96,19,33,1,157.27,0.00,0.00,0.00,0,16.00,1,341.88,0,6,5,,0.00,1,0,16,0,1,10,0,18,121,1
"org.apache.solr.search.DocSetBase",13,0.00,1.77,57,0.66,18879.30,13,0,10,33,15,173.51,25,76,4,1,123.51,0.00,0.00,0.00,3,13.00,6,1968.28,0,5,12,java.lang.Object,0.00,20,0,23,4,20,8,1,17,458,1
"org.apache.solr.search.DocSetBase$Filter",1,0.00,4.00,11,0.16,7122.90,1,0,10,6,4,141.38,2,13,0,1,101.50,0.00,0.00,0.00,0,1.00,4,482.06,0,1,4,java.lang.Object,0.00,5,0,4,0,5,0,0,2,95,0
"org.apache.solr.search.DocSetBase$Filter$DocIdSet",3,0.00,1.00,7,0.04,526.39,3,0,10,4,1,142.10,1,13,0,1,142.10,0.00,0.00,0.00,0,3.00,1,132.66,0,2,1,java.lang.Object,0.00,1,0,3,0,1,1,0,1,40,0
"org.apache.solr.search.DocSetBase$Filter$DocIdSet$DocIdSetIterator",3,0.50,2.00,12,0.18,6584.46,5,2,10,4,0,122.07,0,18,0,1,122.07,0.00,0.00,0.83,0,0.00,3,540.55,0,0,0,java.lang.Object,0.00,1,0,6,0,1,3,0,0,119,0
"org.apache.solr.search.DocSetCollector",6,0.07,1.67,34,0.31,9379.89,12,6,6,10,12,159.54,17,43,4,2,119.66,1.00,0.33,0.22,0,10.00,3,937.22,0,0,8,org.apache.lucene.search.Collector,0.40,4,1,10,1,4,6,0,15,214,1
"org.apache.solr.search.DocSetDelegateCollector",5,0.50,1.80,29,0.29,9377.88,6,1,6,12,12,158.90,14,37,3,3,119.02,0.00,0.67,0.60,0,1.00,3,855.64,0,0,9,org.apache.solr.search.DocSetCollector,0.40,7,2,9,0,7,5,0,12,190,1
"org.apache.solr.search.DocSetPerf",3,0.60,10.00,117,1.80,203744.46,8,5,6,33,4,123.07,5,118,0,1,73.07,0.00,0.00,0.60,2,1.00,24,5402.83,0,0,4,java.lang.Object,0.00,30,0,30,0,30,3,0,4,848,1
"org.apache.solr.search.DocSlice",14,0.12,1.71,63,0.69,24046.77,20,6,1,25,13,172.94,24,80,8,2,122.94,0.00,0.50,0.27,0,38.00,4,2081.31,1,3,5,org.apache.solr.search.DocSetBase,0.22,11,1,24,0,11,11,1,11,474,1
"org.apache.solr.search.DocSlice$DocIterator",5,0.12,1.00,13,0.08,905.91,7,2,1,6,0,141.99,3,18,0,1,141.99,0.00,0.00,0.40,1,2.00,1,251.84,0,1,0,java.lang.Object,0.00,1,0,5,0,1,4,0,1,73,0
"org.apache.solr.search.ExtendedDismaxQParser",11,0.08,11.00,400,7.16,962181.33,22,11,25,100,21,44.10,144,514,1,2,73.48,0.00,0.50,0.17,4,47.00,50,21480.65,6,7,20,org.apache.solr.search.QParser,0.18,89,1,121,0,89,4,0,91,3210,0
"org.apache.solr.search.ExtendedDismaxQParser$Clause",1,6.00,1.00,11,0.06,569.90,9,8,25,1,0,131.07,3,13,0,1,110.45,0.00,0.00,0.25,0,0.00,1,191.02,0,0,0,java.lang.Object,0.00,0,0,1,0,0,1,0,3,49,1
"org.apache.solr.search.ExtendedDismaxQParser$DMP",0,0.00,0.00,2,0.02,222.03,1,1,25,0,0,171.00,3,3,0,2,171.00,0.00,0.50,0.00,0,0.00,0,55.51,0,0,0,,0.00,0,1,0,0,0,0,0,1,15,2
"org.apache.solr.search.ExtendedDismaxQParser$ExtendedSolrQueryParser",20,0.00,3.05,207,2.62,126931.70,36,16,25,59,14,124.11,72,264,0,4,103.50,0.00,0.75,0.06,7,122.00,10,7870.38,9,13,14,org.apache.solr.search.SolrQueryParser,0.00,39,3,61,0,39,7,0,41,1509,1
"org.apache.solr.search.ExtendedDismaxQParser$ExtendedSolrQueryParser$Alias",0,0.00,0.00,3,0.02,239.86,2,2,25,0,0,171.00,0,4,0,1,171.00,0.00,0.00,0.00,0,0.00,0,68.53,0,0,0,java.lang.Object,0.00,0,0,0,0,0,0,0,0,18,1
"org.apache.solr.search.ExtendedDismaxQParser$ExtendedSolrQueryParser$DynamicField",4,0.39,2.50,26,0.32,7646.86,10,6,25,10,0,155.81,10,38,0,1,115.92,0.00,0.00,0.46,0,6.00,4,959.09,0,1,0,java.lang.Object,0.00,6,0,10,0,6,3,1,2,211,1
"org.apache.solr.search.ExtendedDismaxQParser$ExtendedSolrQueryParser$UserFields",5,0.00,2.80,30,0.47,16611.29,8,3,25,19,0,134.62,15,45,0,1,114.01,0.00,0.00,0.33,1,2.00,5,1418.48,0,2,0,java.lang.Object,0.00,14,0,14,0,14,3,0,6,295,1
"org.apache.solr.search.ExtendedDismaxQParser$QType",0,0.00,0.00,2,0.01,28.53,0,0,25,0,0,171.00,0,8,0,1,171.00,0.00,0.00,0.00,0,0.00,0,28.53,0,0,0,java.lang.Object,0.00,0,0,0,0,0,0,0,0,9,0
"org.apache.solr.search.ExtendedDismaxQParser$U",0,0.00,0.00,1,0.01,49.13,0,0,25,0,1,171.00,1,2,0,2,171.00,0.00,0.50,0.00,0,0.00,0,19.65,0,0,1,org.apache.solr.util.SolrPluginUtils,0.00,0,1,0,0,0,0,0,1,7,2
"org.apache.solr.search.ExtendedDismaxQParserPlugin",2,1.00,1.00,5,0.06,815.39,3,1,25,3,17,179.10,4,9,1,2,139.22,0.00,0.50,0.00,0,2.00,1,179.41,0,1,17,org.apache.solr.search.QParserPlugin,0.00,1,1,2,0,1,1,0,1,47,1
"org.apache.solr.search.ExtendedQuery",6,0.00,1.00,7,0.03,152.68,6,0,0,6,5,209.93,9,8,5,1,159.93,0.00,0.00,0.00,0,6.00,1,101.78,0,0,0,,0.00,0,0,6,0,0,6,0,4,40,1
"org.apache.solr.search.ExtendedQueryBase",8,0.10,1.25,29,0.24,5276.11,11,3,1,11,4,130.95,0,45,2,2,130.95,2.00,0.25,0.25,1,20.00,3,718.76,0,2,2,org.apache.lucene.search.Query,0.00,3,1,10,2,3,6,1,0,181,1
"org.apache.solr.search.FastLRUCache",20,0.02,2.20,153,2.27,139825.36,29,9,12,65,12,159.02,25,184,3,2,109.02,0.00,0.50,0.13,0,114.00,11,6807.15,0,12,9,org.apache.solr.search.SolrCacheBase,0.00,45,1,44,0,45,8,1,13,1193,1
"org.apache.solr.search.FieldQParserPlugin",2,1.00,1.00,5,0.05,464.34,3,1,7,3,8,161.76,7,9,1,2,141.14,0.00,0.50,0.00,0,2.00,1,141.84,0,1,8,org.apache.solr.search.QParserPlugin,0.00,1,1,2,0,1,1,0,1,39,1
"org.apache.solr.search.FieldQParserPlugin$QParser",1,0.00,1.00,7,0.11,2014.08,1,0,7,6,5,113.46,0,9,0,1,113.46,0.00,0.00,0.00,0,1.00,1,326.21,0,1,5,java.lang.Object,0.00,5,0,1,0,5,0,0,0,69,0
"org.apache.solr.search.FooQParser",2,0.00,1.00,5,0.07,1084.82,2,0,7,5,10,138.24,0,9,1,2,138.24,0.00,0.50,0.00,0,2.00,1,220.22,0,1,9,org.apache.solr.search.QParser,0.08,3,1,2,0,3,1,0,0,56,0
"org.apache.solr.search.FooQParserPlugin",2,0.00,1.00,4,0.05,624.38,2,0,7,3,11,140.13,0,8,1,2,140.13,0.00,0.50,0.00,0,2.00,1,139.41,0,1,10,org.apache.solr.search.QParserPlugin,0.00,1,1,2,0,1,1,0,0,38,1
"org.apache.solr.search.FunctionQParser",18,0.07,3.00,179,2.27,126747.57,22,4,12,61,72,86.98,104,223,59,2,104.85,0.00,0.50,0.18,5,94.00,14,6824.24,3,8,15,org.apache.solr.search.QParser,0.05,43,1,54,0,43,10,0,28,1224,1
"org.apache.solr.search.FunctionQParserPlugin",2,1.00,1.00,5,0.06,769.03,3,1,3,3,14,179.30,5,9,9,2,139.42,0.00,0.50,0.00,0,2.00,1,174.09,0,1,6,org.apache.solr.search.QParserPlugin,0.00,1,1,2,0,1,1,0,1,46,1
"org.apache.solr.search.FunctionRangeQParserPlugin",2,1.00,1.00,5,0.05,464.34,3,1,15,3,13,123.27,10,9,1,2,141.14,0.00,0.50,0.00,0,2.00,1,141.84,0,1,13,org.apache.solr.search.QParserPlugin,0.00,1,1,2,0,1,1,0,1,39,1
"org.apache.solr.search.FunctionRangeQParserPlugin$QParser",1,0.00,2.00,17,0.25,7853.76,3,2,15,9,9,144.27,1,20,0,1,94.27,0.00,0.00,1.00,0,0.00,2,742.29,0,1,9,java.lang.Object,0.00,8,0,2,0,8,0,0,1,138,0
"org.apache.solr.search.FunctionRangeQuery",2,1.00,1.00,9,0.08,1090.56,3,1,9,4,12,126.99,1,13,2,4,126.99,0.00,0.75,0.00,0,2.00,1,232.09,0,0,10,org.apache.solr.search.SolrConstantScoreQuery,0.00,2,3,2,0,2,2,1,1,59,1
"org.apache.solr.search.FunctionRangeQuery$FunctionRangeCollector",3,0.33,1.33,14,0.19,3381.02,6,3,9,9,4,124.44,0,21,0,3,124.44,0.00,0.67,0.56,0,1.00,2,569.80,1,0,4,org.apache.solr.search.DelegatingCollector,0.21,6,2,4,0,6,3,0,0,128,0
"org.apache.solr.search.Grouping",18,0.08,3.33,258,3.75,239037.10,48,30,32,84,45,95.74,85,314,3,1,95.50,0.00,0.00,0.11,2,66.00,29,11246.43,0,9,42,java.lang.Object,0.00,66,0,60,0,66,9,0,28,1836,1
"org.apache.solr.search.Grouping$Command",11,0.01,2.36,88,1.17,64219.68,23,12,32,26,10,89.58,55,101,0,1,107.46,0.00,0.00,0.08,2,34.00,8,3501.32,0,7,10,java.lang.Object,0.00,15,0,26,0,15,4,0,19,644,2
"org.apache.solr.search.Grouping$CommandField",7,0.19,3.71,73,0.96,36974.65,13,6,32,32,16,104.32,29,94,0,2,104.08,0.00,0.50,0.33,0,2.00,8,2870.70,0,4,16,org.apache.solr.search.Command,0.00,25,1,26,0,25,3,0,15,530,1
"org.apache.solr.search.Grouping$CommandFunc",7,0.24,3.57,69,0.87,31058.16,14,7,32,29,14,127.01,23,89,0,2,106.39,0.00,0.50,0.35,0,2.00,7,2610.20,0,4,14,org.apache.solr.search.Command,0.00,22,1,25,0,22,3,0,11,499,1
"org.apache.solr.search.Grouping$CommandQuery",5,0.08,1.40,28,0.33,7047.97,8,3,32,17,11,159.94,12,36,0,2,120.05,0.00,0.50,0.40,0,0.00,2,999.54,0,2,11,org.apache.solr.search.Command,0.00,12,1,7,0,12,3,0,4,212,1
"org.apache.solr.search.Grouping$Format",0,0.00,0.00,2,0.01,39.30,0,0,32,0,0,171.00,3,4,0,1,171.00,0.00,0.00,0.00,0,0.00,0,19.65,0,0,0,java.lang.Object,0.00,0,0,0,0,0,0,0,1,7,2
"org.apache.solr.search.Grouping$TotalCount",0,0.00,0.00,2,0.01,39.30,0,0,32,0,0,171.00,3,4,0,1,171.00,0.00,0.00,0.00,0,0.00,0,19.65,0,0,0,java.lang.Object,0.00,0,0,0,0,0,0,0,1,7,2
"org.apache.solr.search.HashDocSet",14,0.02,3.64,154,1.81,192123.18,19,5,1,24,10,139.16,40,162,6,2,99.27,0.00,0.50,0.21,2,18.00,8,5427.43,0,2,4,org.apache.solr.search.DocSetBase,0.37,10,1,51,0,10,12,0,29,1077,2
"org.apache.solr.search.HashDocSet$DocIterator",6,0.40,1.17,18,0.11,1566.92,8,2,1,6,0,134.13,1,24,0,1,134.13,0.00,0.00,0.17,2,10.00,2,331.31,0,1,0,java.lang.Object,0.00,0,0,7,0,0,5,0,1,94,0
"org.apache.solr.search.JoinQParserPlugin",2,1.00,1.00,5,0.04,363.78,3,1,25,3,19,141.98,0,8,1,2,141.98,0.00,0.50,0.00,0,2.00,1,126.95,0,0,19,org.apache.solr.search.QParserPlugin,0.00,1,1,2,0,1,2,0,0,36,1
"org.apache.solr.search.JoinQParserPlugin$QParser",1,0.00,1.00,10,0.12,2461.11,1,0,25,6,4,106.99,0,11,0,1,106.99,0.00,0.00,0.00,0,1.00,1,359.00,0,1,4,java.lang.Object,0.00,5,0,1,0,5,0,0,0,75,0
"org.apache.solr.search.JoinQuery",8,0.07,1.38,35,0.48,16282.33,12,4,25,16,25,122.41,0,52,3,2,122.41,0.00,0.50,0.31,1,0.00,2,1454.11,2,4,22,org.apache.lucene.search.Query,0.11,8,1,11,0,8,4,0,0,333,0
"org.apache.solr.search.JoinQuery$JoinQueryWeight",7,0.22,8.29,248,4.16,580428.19,27,20,25,83,31,74.42,29,292,0,2,74.18,0.00,0.50,0.24,0,13.00,40,12474.03,0,3,31,org.apache.lucene.search.Weight,0.46,76,1,58,0,76,4,0,29,1848,1
"org.apache.solr.search.JoinQuery$JoinQueryWeight$Closeable",1,0.00,1.00,3,0.02,238.65,1,0,25,2,0,134.48,0,5,0,1,134.48,0.00,0.00,0.00,0,1.00,1,63.51,0,0,0,java.lang.Object,0.00,1,0,1,0,1,1,0,0,19,0
"org.apache.solr.search.JoinQuery$JoinQueryWeight$Closeable_0",1,0.00,1.00,3,0.02,275.49,1,0,25,2,0,133.99,0,5,0,1,133.99,0.00,0.00,0.00,0,1.00,1,61.77,0,0,0,java.lang.Object,0.00,1,0,1,0,1,1,0,0,19,0
"org.apache.solr.search.JoinQuery$JoinScorer",5,0.08,1.20,16,0.17,3095.65,8,3,25,9,2,131.18,0,27,0,3,131.18,0.00,0.67,0.27,0,5.00,2,503.84,0,0,2,org.apache.lucene.search.Scorer,0.80,4,2,6,0,4,5,0,0,125,2
"org.apache.solr.search.LFUCache",20,0.03,2.35,159,2.42,158644.18,30,10,12,64,10,158.57,28,190,2,1,108.57,0.00,0.00,0.13,0,114.00,13,7257.29,0,12,8,java.lang.Object,0.00,44,0,47,0,44,8,1,14,1259,1
"org.apache.solr.search.LRUCache",20,0.05,1.85,134,1.63,77793.24,32,12,8,45,12,163.56,26,163,4,2,113.56,0.00,0.50,0.13,0,122.00,8,4898.08,0,12,8,org.apache.solr.search.SolrCacheBase,0.00,25,1,37,0,25,8,1,18,943,1
"org.apache.solr.search.LRUCache$CumulativeStats",0,0.00,0.00,5,0.05,1253.89,4,4,8,1,0,171.00,0,6,0,1,171.00,0.00,0.00,0.00,0,0.00,0,144.68,0,0,0,java.lang.Object,0.00,1,0,0,0,1,0,0,0,38,2
"org.apache.solr.search.LRUCache$LinkedHashMap<K,V>",1,0.00,2.00,7,0.07,1008.55,1,0,8,3,0,136.28,3,10,0,1,115.66,0.00,0.00,0.00,0,0.00,2,196.38,0,0,0,java.lang.Object,0.00,2,0,2,0,2,1,0,3,46,0
"org.apache.solr.search.LuceneQParser",3,0.25,2.00,17,0.22,5908.20,5,2,10,10,14,118.83,0,25,2,2,118.83,1.00,0.33,0.33,0,1.00,3,660.92,3,2,12,org.apache.solr.search.QParser,0.16,7,1,6,1,7,1,0,0,145,0
"org.apache.solr.search.LuceneQParserPlugin",2,1.00,1.00,5,0.06,769.03,3,1,10,3,12,139.65,8,9,1,2,139.42,0.00,0.50,0.00,0,2.00,1,174.09,0,1,12,org.apache.solr.search.QParserPlugin,0.00,1,1,2,0,1,1,0,1,46,1
"org.apache.solr.search.LuceneQueryOptimizer",2,0.00,4.00,31,0.45,30133.79,4,2,4,16,8,103.04,35,49,1,1,93.91,0.00,0.00,0.50,0,2.00,7,1349.87,0,1,8,java.lang.Object,0.00,14,0,8,0,14,1,0,18,240,0
"org.apache.solr.search.LuceneQueryOptimizer$LinkedHashMap",1,0.00,1.00,3,0.03,353.48,1,0,4,2,0,183.13,1,5,0,1,133.13,0.00,0.00,0.00,0,1.00,1,91.65,0,0,0,java.lang.Object,0.00,1,0,1,0,1,1,0,1,25,0
"org.apache.solr.search.MissingStringLastComparatorSource",3,1.00,1.00,8,0.08,1122.92,4,1,9,4,10,179.39,6,13,1,2,139.51,0.00,0.50,0.33,0,4.00,1,236.06,0,1,9,org.apache.lucene.search.FieldComparatorSource,0.00,1,1,3,0,1,2,0,1,62,1
"org.apache.solr.search.NestedQParserPlugin",2,1.00,1.00,5,0.05,464.34,3,1,6,3,8,141.38,9,9,1,2,141.14,0.00,0.50,0.00,0,2.00,1,141.84,0,1,8,org.apache.solr.search.QParserPlugin,0.00,1,1,2,0,1,1,0,1,39,1
"org.apache.solr.search.NestedQParserPlugin$QParser",4,0.00,1.00,13,0.13,1923.01,7,3,6,9,6,132.08,1,21,0,1,132.08,0.00,0.00,0.33,0,0.00,1,394.54,0,3,6,java.lang.Object,0.00,5,0,4,0,5,1,0,1,100,0
"org.apache.solr.search.OldLuceneQParser",3,0.50,3.33,26,0.38,15042.25,4,1,10,11,13,157.90,3,38,1,3,107.90,0.00,0.67,0.67,0,1.00,6,1129.70,5,2,12,org.apache.solr.search.LuceneQParser,0.21,8,2,10,0,8,1,0,3,223,0
"org.apache.solr.search.OldLuceneQParserPlugin",2,1.00,1.00,5,0.06,769.03,3,1,3,3,6,179.30,5,9,1,2,139.42,0.00,0.50,0.00,0,2.00,1,174.09,0,1,6,org.apache.solr.search.QParserPlugin,0.00,1,1,2,0,1,1,0,1,46,1
"org.apache.solr.search.PostFilter",1,0.00,1.00,2,0.01,60.50,1,0,1,1,5,189.68,22,3,3,2,145.74,0.00,0.50,0.00,0,1.00,1,35.16,0,1,2,,0.00,0,1,1,0,0,0,0,2,13,1
"org.apache.solr.search.PrefixQParserPlugin",2,1.00,1.00,5,0.05,464.34,3,1,7,3,9,161.76,7,9,1,2,141.14,0.00,0.50,0.00,0,2.00,1,141.84,0,1,9,org.apache.solr.search.QParserPlugin,0.00,1,1,2,0,1,1,0,1,39,1
"org.apache.solr.search.PrefixQParserPlugin$QParser",1,0.00,1.00,3,0.05,884.67,1,0,7,4,5,130.00,0,5,0,1,130.00,0.00,0.00,0.00,0,1.00,1,162.30,0,1,5,java.lang.Object,0.00,3,0,1,0,3,0,0,0,40,0
"org.apache.solr.search.QParser",22,0.03,2.45,156,1.94,101109.60,31,9,11,60,90,131.04,79,204,77,1,110.43,0.00,0.00,0.08,5,158.00,10,5823.50,0,13,15,java.lang.Object,0.00,38,0,54,8,38,9,0,28,1143,2
"org.apache.solr.search.QParserPlugin",1,2.00,1.00,4,0.23,8494.84,3,2,3,1,26,138.22,3,22,22,1,117.60,0.00,0.00,0.00,0,1.00,1,677.56,0,1,20,java.lang.Object,0.00,0,0,1,17,0,0,1,3,137,2
"org.apache.solr.search.QueryParsing",12,0.05,7.58,303,4.78,485345.78,22,10,33,97,56,34.00,104,375,27,1,82.11,0.00,0.00,0.06,4,48.00,30,14340.62,0,7,31,java.lang.Object,0.00,85,0,91,0,85,5,0,47,2323,1
"org.apache.solr.search.QueryParsing$StrParser",21,0.37,3.24,205,2.35,120921.35,24,3,33,40,1,105.52,18,260,0,1,105.52,0.00,0.00,0.68,4,0.00,15,7061.60,0,8,1,java.lang.Object,0.00,19,0,68,0,19,13,0,11,1351,2
"org.apache.solr.search.QueryParsingTest",3,0.00,3.00,106,1.89,165110.50,3,0,8,14,7,27.71,25,125,0,3,75.82,0.00,0.67,0.00,0,1.00,7,5677.59,1,0,7,org.apache.solr.SolrTestCaseJ4,0.00,11,2,9,0,11,3,0,22,974,1
"org.apache.solr.search.QueryResultKey",4,0.00,4.50,45,0.58,32921.22,11,7,5,9,6,140.86,11,50,3,1,100.97,0.00,0.00,0.14,1,4.00,9,1748.92,0,0,3,java.lang.Object,0.00,5,0,18,0,5,4,0,9,348,2
"org.apache.solr.search.QueryUtils",4,0.00,4.50,43,0.56,32010.14,4,0,5,19,10,70.39,26,51,5,1,102.61,0.00,0.00,0.00,3,4.00,9,1670.21,0,3,5,java.lang.Object,0.00,15,0,18,0,15,1,0,11,326,1
"org.apache.solr.search.RawQParserPlugin",2,1.00,1.00,5,0.05,464.34,3,1,7,3,9,123.27,10,9,1,2,141.14,0.00,0.50,0.00,0,2.00,1,141.84,0,1,9,org.apache.solr.search.QParserPlugin,0.00,1,1,2,0,1,1,0,1,39,1
"org.apache.solr.search.RawQParserPlugin$QParser",1,0.00,1.00,3,0.05,884.67,1,0,7,4,5,130.00,0,5,0,1,130.00,0.00,0.00,0.00,0,1.00,1,162.30,0,1,5,java.lang.Object,0.00,3,0,1,0,3,0,0,0,40,0
"org.apache.solr.search.ReturnFields",13,0.14,4.46,199,2.94,321517.19,21,8,21,75,36,92.43,52,259,15,1,92.19,0.00,0.00,0.25,4,0.00,27,8818.02,0,3,21,java.lang.Object,0.00,62,0,58,0,62,10,0,47,1444,1
"org.apache.solr.search.ReturnFieldsTest",10,2.00,1.00,180,2.50,136960.00,12,2,4,21,4,141.60,10,203,0,3,91.60,0.00,0.67,0.00,0,10.00,1,7489.30,5,0,4,org.apache.solr.SolrTestCaseJ4,0.00,11,2,10,0,11,10,0,6,1499,1
"org.apache.solr.search.SolrCache",10,1.00,1.00,13,0.12,1410.84,11,1,5,11,17,111.78,72,14,16,2,154.07,0.00,0.50,0.00,0,10.00,1,345.38,0,3,3,,0.00,1,1,10,0,1,7,0,22,102,1
"org.apache.solr.search.SolrCache$State",0,0.00,0.00,2,0.01,36.00,0,0,5,0,0,171.00,1,6,0,1,171.00,0.00,0.00,0.00,0,0.00,0,24.00,0,0,0,java.lang.Object,0.00,0,0,0,0,0,0,0,1,8,1
"org.apache.solr.search.SolrCacheBase",0,0.00,0.00,2,0.01,70.18,0,0,0,0,2,171.00,6,3,2,1,171.00,0.00,0.00,0.00,0,0.00,0,28.07,0,0,0,java.lang.Object,0.00,0,0,0,2,0,0,0,2,10,2
"org.apache.solr.search.SolrCacheBase$AutoWarmCountRef",4,0.40,2.25,27,0.34,14166.47,9,5,0,12,0,113.84,1,38,0,1,113.84,0.00,0.00,0.50,0,0.00,5,1006.71,0,1,0,java.lang.Object,0.00,8,0,9,0,8,3,0,1,204,2
"org.apache.solr.search.SolrConstantScoreQuery",14,0.46,1.29,36,0.39,8085.91,16,2,9,21,15,177.85,32,66,5,3,137.97,0.50,0.50,0.07,0,62.00,3,1180.89,1,4,10,org.apache.lucene.search.ConstantScoreQuery,0.18,7,2,18,1,7,10,1,11,294,1
"org.apache.solr.search.SolrConstantScoreQuery$ConstantScorer",5,0.00,1.60,26,0.29,9414.58,9,4,9,12,5,119.03,0,39,0,3,119.03,0.00,0.67,0.25,0,0.00,4,878.03,0,0,5,org.apache.lucene.search.Scorer,0.80,7,2,8,0,7,5,0,0,193,1
"org.apache.solr.search.SolrConstantScoreQuery$ConstantWeight",6,0.00,1.33,32,0.44,12700.00,9,3,9,19,10,118.67,0,49,0,2,118.67,0.00,0.50,0.33,0,2.00,2,1313.24,0,3,10,org.apache.lucene.search.Weight,0.50,13,1,8,0,13,3,0,0,271,1
"org.apache.solr.search.SolrFieldCacheMBean",8,1.00,1.25,34,0.30,10588.42,9,1,9,17,6,173.91,12,34,1,1,123.91,0.00,0.00,0.12,0,14.00,3,896.61,0,8,6,java.lang.Object,0.00,9,0,10,0,9,0,1,2,203,1
"org.apache.solr.search.SolrFilter",3,0.00,1.00,5,0.07,714.60,3,0,8,3,7,192.17,7,8,1,2,152.28,1.00,0.33,0.00,1,3.00,1,199.97,0,2,6,org.apache.lucene.search.Filter,0.00,0,1,3,1,0,1,0,2,54,2
"org.apache.solr.search.SolrIndexSearcher",64,0.01,4.09,878,14.37,1337711.62,102,38,41,268,152,52.81,451,1094,83,2,95.10,0.00,0.50,0.03,13,1960.00,25,43105.92,5,24,76,org.apache.lucene.search.IndexSearcher,0.04,204,1,262,0,204,40,2,164,7178,1
"org.apache.solr.search.SolrIndexSearcher$CacheRegenerator",1,0.00,2.00,5,0.06,1022.98,1,0,41,2,3,121.07,0,7,0,1,121.07,0.00,0.00,0.00,0,1.00,2,168.47,0,0,3,java.lang.Object,0.00,1,0,2,0,1,1,0,0,39,0
"org.apache.solr.search.SolrIndexSearcher$CacheRegenerator_0",1,0.00,1.00,4,0.05,605.72,1,0,41,2,3,126.63,0,5,0,1,126.63,0.00,0.00,0.00,0,1.00,1,143.71,0,0,3,java.lang.Object,0.00,1,0,1,0,1,1,0,0,34,0
"org.apache.solr.search.SolrIndexSearcher$CacheRegenerator_1",1,0.00,2.00,14,0.25,7825.80,1,0,41,13,4,65.21,6,21,0,1,97.43,0.00,0.00,0.00,0,0.00,2,757.15,0,0,4,java.lang.Object,0.00,12,0,2,0,12,1,0,6,133,0
"org.apache.solr.search.SolrIndexSearcher$Collector",4,0.00,1.00,7,0.07,697.19,4,0,41,4,2,153.35,0,15,0,1,153.35,0.00,0.00,0.00,0,4.00,1,195.57,0,0,2,java.lang.Object,0.00,0,0,4,0,0,4,0,0,56,0
"org.apache.solr.search.SolrIndexSearcher$Collector_2",4,1.00,1.25,11,0.12,2365.67,5,1,41,5,2,137.89,0,19,0,1,137.89,0.00,0.00,0.25,0,6.00,2,347.87,0,0,2,java.lang.Object,0.00,1,0,5,0,1,4,0,0,88,0
"org.apache.solr.search.SolrIndexSearcher$Collector_3",4,1.00,1.25,10,0.11,1961.36,5,1,41,5,2,138.53,0,18,0,1,138.53,0.00,0.00,0.25,0,6.00,2,320.81,0,0,2,java.lang.Object,0.00,1,0,5,0,1,4,0,0,83,0
"org.apache.solr.search.SolrIndexSearcher$Comparator<Query>",1,0.00,1.00,3,0.05,861.13,1,0,41,2,2,130.09,0,5,0,1,130.09,0.00,0.00,0.00,0,1.00,1,135.65,0,0,2,java.lang.Object,0.00,1,0,1,0,1,1,0,0,36,0
"org.apache.solr.search.SolrIndexSearcher$DocsEnumState",0,0.00,0.00,7,0.05,487.88,6,6,41,0,3,171.00,1,8,0,1,171.00,0.00,0.00,0.00,0,0.00,0,150.12,0,0,3,java.lang.Object,0.00,0,0,0,0,0,0,0,1,36,2
"org.apache.solr.search.SolrIndexSearcher$FilterImpl",2,0.00,2.50,15,0.20,5460.31,5,3,41,6,5,112.21,0,19,0,2,112.21,0.00,0.50,0.33,0,2.00,3,591.85,0,1,5,org.apache.lucene.util.Filter,0.00,4,1,5,0,4,1,0,0,129,0
"org.apache.solr.search.SolrIndexSearcher$FilterImpl$DualFilterIterator",4,0.17,2.50,28,0.23,9619.82,6,2,41,7,0,112.64,0,32,0,2,112.64,0.00,0.50,0.62,0,0.00,4,681.55,0,0,0,org.apache.lucene.util.DocIdSetIterator,0.00,3,1,10,0,3,4,0,0,166,2
"org.apache.solr.search.SolrIndexSearcher$FilterImpl$FilterIterator",5,0.12,1.80,32,0.26,10886.80,7,2,41,8,0,115.55,1,38,0,2,115.55,0.00,0.50,0.40,1,5.00,5,766.25,0,0,0,org.apache.lucene.util.DocIdSetIterator,0.00,3,1,9,0,3,5,0,1,177,2
"org.apache.solr.search.SolrIndexSearcher$FilterImpl$FilterSet",3,0.25,3.33,23,0.36,21358.68,5,2,41,14,4,108.86,1,30,0,2,108.86,0.00,0.50,0.33,0,4.00,8,1067.31,0,2,4,org.apache.lucene.search.DocIdSet,0.00,11,1,10,0,11,1,0,1,209,1
"org.apache.solr.search.SolrIndexSearcher$LocalSolrQueryRequest",2,0.00,1.00,4,0.03,319.26,2,0,41,2,1,142.42,0,3,0,1,142.42,0.00,0.00,0.00,0,2.00,1,82.94,0,0,1,java.lang.Object,0.00,0,0,2,0,0,2,0,0,27,0
"org.apache.solr.search.SolrIndexSearcher$ProcessedFilter",0,0.00,0.00,4,0.02,179.25,3,3,41,0,2,171.00,1,5,0,1,171.00,0.00,0.00,0.00,0,0.00,0,71.70,0,0,2,java.lang.Object,0.00,0,0,0,0,0,0,0,1,20,2
"org.apache.solr.search.SolrIndexSearcher$QueryCommand",25,0.04,1.20,82,0.57,10428.11,35,10,41,28,4,132.53,13,96,0,1,132.53,0.00,0.00,0.06,0,338.00,3,1719.15,0,17,4,java.lang.Object,0.00,3,0,30,0,3,8,0,6,440,2
"org.apache.solr.search.SolrIndexSearcher$QueryResult",8,0.05,1.25,24,0.16,2104.41,11,3,41,9,3,134.09,1,23,0,1,134.09,0.00,0.00,0.29,0,0.00,2,474.33,0,0,3,java.lang.Object,0.00,1,0,10,0,1,8,0,1,130,2
"org.apache.solr.search.SolrIndexSearcher$SetNonLazyFieldSelector",8,0.14,1.12,43,0.62,11889.14,11,3,41,25,13,119.92,0,60,0,2,119.92,0.00,0.50,0.46,0,0.00,2,1854.61,0,1,13,org.apache.lucene.index.StoredFieldVisitor,0.00,17,1,9,0,17,7,0,0,396,1
"org.apache.solr.search.SolrQueryParser",0,0.00,0.00,5,0.04,544.18,3,3,20,0,20,171.00,19,5,5,3,171.00,1.00,0.40,0.00,0,0.00,0,120.93,0,0,15,org.apache.lucene.queryparser.classic.QueryParser,0.00,0,2,0,2,0,0,0,2,29,1
"org.apache.solr.search.SolrQueryParser$MagicFieldName",3,0.00,6.00,95,1.87,247934.44,7,4,20,46,17,58.36,16,132,0,1,76.24,0.00,0.00,0.25,0,5.00,16,5618.70,1,2,17,java.lang.Object,0.00,43,0,18,0,43,1,0,16,828,2
"org.apache.solr.search.SolrQueryParser$MagicFieldName$AutomatonQuery",1,0.00,2.00,9,0.11,3322.03,1,0,20,9,1,157.51,1,12,0,1,107.52,0.00,0.00,0.00,0,1.00,2,325.74,0,1,1,java.lang.Object,0.00,8,0,2,0,8,0,0,1,72,0
"org.apache.solr.search.SolrSortField",1,0.00,1.00,2,0.01,69.06,1,0,3,1,2,165.90,3,3,0,1,145.29,0.00,0.00,0.00,0,1.00,1,36.53,0,1,2,,0.00,0,0,1,0,0,0,0,1,13,1
"org.apache.solr.search.SortSpec",9,0.04,1.44,28,0.22,3619.46,12,3,2,10,9,182.61,16,35,7,1,132.61,0.00,0.00,0.30,1,19.00,4,671.78,0,2,2,java.lang.Object,0.00,1,0,13,0,1,7,0,4,176,1
"org.apache.solr.search.SortedIntDocSet",24,0.20,5.21,381,4.23,564690.67,27,3,10,34,19,112.94,84,434,8,2,92.32,0.00,0.50,0.14,8,64.00,15,12686.58,0,4,12,org.apache.solr.search.DocSetBase,0.32,10,1,125,0,10,20,0,76,2475,1
"org.apache.solr.search.SortedIntDocSet$DocIterator",5,0.75,1.00,12,0.07,608.05,6,1,10,6,0,143.35,3,17,0,1,143.35,0.00,0.00,0.40,1,7.00,1,203.48,0,1,0,java.lang.Object,0.00,1,0,5,0,1,4,0,1,62,0
"org.apache.solr.search.SortedIntDocSet$Filter",1,0.00,5.00,20,0.35,29858.04,2,1,10,8,4,38.38,10,23,0,1,86.86,0.00,0.00,1.00,0,0.00,5,1042.98,0,1,4,java.lang.Object,0.00,7,0,5,0,7,0,0,10,187,0
"org.apache.solr.search.SortedIntDocSet$Filter$DocIdSet",3,0.00,1.00,7,0.04,526.39,3,0,10,4,1,142.10,1,13,0,1,142.10,0.00,0.00,0.00,0,3.00,1,132.66,0,2,1,java.lang.Object,0.00,1,0,3,0,1,1,0,1,40,0
"org.apache.solr.search.SortedIntDocSet$Filter$DocIdSet$DocIdSetIterator",3,0.50,3.33,27,0.32,34532.41,5,2,10,3,0,153.15,4,38,0,1,103.15,0.00,0.00,0.83,0,0.00,7,969.19,0,0,0,java.lang.Object,0.00,0,0,10,0,0,3,0,4,199,0
"org.apache.solr.search.Sorting",1,0.00,5.00,9,0.15,6687.41,2,1,1,3,5,104.44,16,14,2,1,104.91,0.00,0.00,1.00,0,0.00,5,446.83,0,1,3,java.lang.Object,0.00,2,0,5,0,2,0,0,2,100,1
"org.apache.solr.search.SpatialBoxQParserPlugin",2,1.00,1.00,5,0.06,831.58,3,1,3,3,7,139.15,0,11,1,3,139.15,0.00,0.67,0.00,0,2.00,1,192.33,0,1,6,org.apache.solr.search.SpatialFilterQParserPlugin,0.00,1,2,2,0,1,1,0,0,50,1
"org.apache.solr.search.SpatialFilterQParser",2,1.00,4.50,33,0.61,39073.00,3,1,11,12,13,41.95,19,44,2,2,91.95,0.00,0.50,0.50,0,2.00,8,1835.41,1,1,11,org.apache.solr.search.QParser,0.08,10,1,9,0,10,1,0,10,305,1
"org.apache.solr.search.SpatialFilterQParserPlugin",2,1.00,1.00,5,0.06,784.98,3,1,3,3,7,119.20,28,10,2,2,139.35,1.00,0.33,0.00,0,2.00,1,180.29,0,1,6,org.apache.solr.search.QParserPlugin,0.00,1,1,2,1,1,1,0,1,47,1
"org.apache.solr.search.SpatialFilterTest",7,0.00,1.71,88,1.55,62259.11,7,0,3,11,2,99.76,30,108,0,3,99.52,0.00,0.67,0.00,2,7.00,6,4647.37,7,0,2,org.apache.solr.SolrTestCaseJ4,0.00,4,2,12,0,4,7,0,27,816,1
"org.apache.solr.search.SpatialOptions",3,7.00,1.00,18,0.16,2277.28,10,7,2,3,6,159.18,8,22,5,1,119.29,0.00,0.00,0.00,0,3.00,1,494.34,0,0,1,java.lang.Object,0.00,0,0,3,0,0,3,0,2,120,1
"org.apache.solr.search.SurroundQParser",2,0.17,3.50,30,0.49,22201.78,8,6,11,12,14,144.98,3,45,1,2,94.98,0.00,0.50,0.25,0,2.00,6,1470.22,2,1,13,org.apache.solr.search.QParser,0.08,10,1,7,0,10,1,0,3,265,0
"org.apache.solr.search.SurroundQParserPlugin",2,1.00,1.00,5,0.06,815.63,3,1,11,3,10,106.99,13,11,1,2,139.21,0.00,0.50,0.00,0,2.00,1,186.14,0,1,10,org.apache.solr.search.QParserPlugin,0.00,1,1,2,0,1,1,0,1,49,1
"org.apache.solr.search.TermOrdValComparator_SML",9,0.09,2.00,60,0.76,27053.63,17,8,9,22,15,164.43,9,83,7,2,114.43,0.00,0.50,0.04,0,16.00,7,2277.49,0,3,8,org.apache.lucene.search.FieldComparator,0.59,13,1,18,0,13,6,0,9,465,0
"org.apache.solr.search.TermOrdValComparator_SML$AnyOrdComparator",3,0.50,3.00,30,0.33,13590.50,4,1,9,6,1,144.54,6,40,0,2,104.65,0.00,0.50,0.67,0,1.00,5,1001.65,0,0,1,org.apache.solr.search.PerSegmentComparator,0.00,3,1,9,0,3,3,0,6,207,3
"org.apache.solr.search.TermOrdValComparator_SML$ByteOrdComparator",3,0.50,3.00,30,0.33,14432.42,4,1,9,5,1,144.33,6,40,0,2,104.45,0.00,0.50,0.67,0,1.00,5,982.65,0,0,1,org.apache.solr.search.PerSegmentComparator,0.00,2,1,9,0,2,3,0,6,201,3
"org.apache.solr.search.TermOrdValComparator_SML$IntOrdComparator",3,0.50,3.00,30,0.32,13394.05,4,1,9,5,1,144.59,6,40,0,2,104.70,0.00,0.50,0.67,0,1.00,5,948.29,0,0,1,org.apache.solr.search.PerSegmentComparator,0.00,2,1,9,0,2,3,0,6,197,3
"org.apache.solr.search.TermOrdValComparator_SML$PerSegmentComparator",5,0.43,2.80,63,0.67,27563.56,16,11,9,10,3,101.05,2,80,0,2,101.05,0.00,0.50,0.44,0,0.00,5,2023.48,0,2,3,org.apache.lucene.search.FieldComparator,0.46,5,1,14,0,5,3,0,2,411,3
"org.apache.solr.search.TermOrdValComparator_SML$ShortOrdComparator",3,0.50,3.00,30,0.33,14432.42,4,1,9,5,1,144.33,6,40,0,2,104.45,0.00,0.50,0.67,0,1.00,5,982.65,0,0,1,org.apache.solr.search.PerSegmentComparator,0.00,2,1,9,0,2,3,0,6,201,3
"org.apache.solr.search.TermQParserPlugin",2,1.00,1.00,5,0.05,464.34,3,1,9,3,11,98.85,15,9,1,2,141.14,0.00,0.50,0.00,0,2.00,1,141.84,0,1,11,org.apache.solr.search.QParserPlugin,0.00,1,1,2,0,1,1,0,1,39,1
"org.apache.solr.search.TermQParserPlugin$QParser",1,0.00,2.00,11,0.15,4548.04,1,0,9,9,6,103.19,0,14,0,1,103.19,0.00,0.00,0.00,0,1.00,2,451.18,0,1,6,java.lang.Object,0.00,8,0,2,0,8,0,0,0,90,0
"org.apache.solr.search.TestDocSet",18,0.10,2.67,231,2.65,134591.70,22,4,19,59,21,57.72,135,215,0,2,100.01,0.00,0.50,0.15,10,34.00,8,7953.77,0,10,21,org.apache.lucene.util.LuceneTestCase,0.00,41,1,48,0,41,8,0,23,1551,1
"org.apache.solr.search.TestDocSet$AtomicReader",11,0.00,1.00,21,0.15,1630.50,11,0,19,12,4,153.90,0,43,0,1,153.90,0.00,0.00,0.00,0,11.00,1,436.00,0,6,4,java.lang.Object,0.00,1,0,11,0,1,5,0,0,131,0
"org.apache.solr.search.TestExtendedDismaxParser",9,0.00,1.56,132,2.90,103239.98,9,0,3,15,2,63.96,55,303,0,3,96.18,0.00,0.67,0.00,0,16.00,6,8711.26,7,2,2,org.apache.solr.util.AbstractSolrTestCase,0.29,6,2,14,0,6,7,0,38,1487,1
"org.apache.solr.search.TestFastLRUCache",14,0.00,2.50,280,4.53,221433.18,14,0,9,70,6,109.81,49,277,0,2,89.19,0.00,0.50,0.00,4,14.00,6,13591.68,0,1,6,org.apache.lucene.util.LuceneTestCase,0.00,56,1,35,0,56,13,0,13,2321,1
"org.apache.solr.search.TestFastLRUCache$CacheRegenerator",1,0.00,1.00,4,0.04,577.51,1,0,9,2,2,126.80,0,6,0,1,126.80,0.00,0.00,0.00,0,1.00,1,124.69,0,0,2,java.lang.Object,0.00,1,0,1,0,1,1,0,0,31,0
"org.apache.solr.search.TestFastLRUCache$Thread",1,0.00,1.00,4,0.04,539.08,1,0,9,3,0,127.03,0,6,0,1,127.03,0.00,0.00,0.00,0,1.00,1,122.20,0,0,0,java.lang.Object,0.00,2,0,1,0,2,1,0,0,30,0
"org.apache.solr.search.TestFiltering",5,0.50,10.20,190,3.14,320868.51,6,1,7,36,5,73.92,24,219,0,3,73.68,0.00,0.67,0.60,2,2.00,25,9428.16,7,2,5,org.apache.solr.SolrTestCaseJ4,0.00,31,2,51,0,31,3,0,24,1485,1
"org.apache.solr.search.TestFiltering$Model",1,0.00,1.00,12,0.08,1505.96,5,4,7,3,1,105.72,0,14,0,1,105.72,0.00,0.00,1.00,0,0.00,1,246.16,0,0,1,java.lang.Object,0.00,2,0,1,0,2,1,0,0,66,0
"org.apache.solr.search.TestFoldingMultitermQuery",20,0.00,1.50,139,2.35,112582.99,20,0,3,24,1,162.35,28,257,0,3,112.35,0.00,0.67,0.00,0,20.00,5,7041.46,8,1,1,org.apache.solr.SolrTestCaseJ4,0.00,4,2,30,0,4,19,0,28,1317,1
"org.apache.solr.search.TestIndexSearcher",4,0.00,1.00,65,1.19,59687.23,4,0,11,24,8,133.10,10,72,0,3,93.22,0.00,0.67,0.00,1,4.00,1,3561.97,9,1,8,org.apache.solr.SolrTestCaseJ4,0.04,20,2,4,0,20,3,0,10,608,1
"org.apache.solr.search.TestLFUCache",9,0.00,4.00,281,3.86,332882.51,9,0,9,45,6,97.21,168,271,0,3,79.08,0.00,0.67,0.00,3,26.00,8,11593.64,1,0,6,org.apache.solr.SolrTestCaseJ4,0.00,36,2,36,0,36,9,0,162,1953,1
"org.apache.solr.search.TestLFUCache$LFURegenerator",1,0.00,1.00,4,0.04,596.53,1,0,9,2,3,126.68,0,8,0,1,126.68,0.00,0.00,0.00,0,1.00,1,132.20,0,0,3,java.lang.Object,0.00,1,0,1,0,1,1,1,0,33,1
"org.apache.solr.search.TestLRUCache",5,0.00,2.00,94,1.60,76574.94,5,0,6,19,3,141.06,6,91,0,2,91.06,0.00,0.50,0.00,2,5.00,4,4786.32,0,1,3,org.apache.lucene.util.LuceneTestCase,0.00,14,1,10,0,14,4,0,4,820,1
"org.apache.solr.search.TestLRUCache$CacheRegenerator",1,0.00,1.00,4,0.05,759.90,1,0,6,2,2,125.86,0,7,0,1,125.86,0.00,0.00,0.00,0,1.00,1,148.23,0,0,2,java.lang.Object,0.00,1,0,1,0,1,1,0,0,35,0
"org.apache.solr.search.TestPseudoReturnFields",14,2.00,1.29,78,1.74,45196.92,16,2,8,27,1,117.24,8,340,0,3,117.24,0.00,0.67,0.00,0,14.00,3,5232.60,5,0,1,org.apache.solr.SolrTestCaseJ4,0.00,13,2,18,0,13,14,0,4,1014,1
"org.apache.solr.search.TestQueryTypes",6,0.00,1.83,91,2.17,162926.91,6,0,2,8,2,59.85,36,253,0,3,92.07,0.00,0.67,0.00,0,6.00,6,6513.11,7,3,2,org.apache.solr.util.AbstractSolrTestCase,0.31,2,2,11,0,2,3,0,36,899,1
"org.apache.solr.search.TestQueryUtils",7,0.00,1.43,83,1.54,54731.21,7,0,7,19,7,141.30,19,222,0,3,101.41,0.00,0.67,0.00,2,7.00,4,4634.40,6,2,7,org.apache.solr.util.AbstractSolrTestCase,0.30,12,2,10,0,12,5,0,17,749,1
"org.apache.solr.search.TestRangeQuery",7,0.83,4.00,168,3.98,534850.62,8,1,9,32,8,120.63,19,194,0,3,80.74,0.00,0.67,0.29,2,13.00,14,11951.97,8,0,8,org.apache.solr.SolrTestCaseJ4,0.04,25,2,28,0,25,7,0,19,1827,1
"org.apache.solr.search.TestRangeQuery$DocProcessor",1,0.00,1.00,2,0.01,34.23,1,0,9,1,1,147.69,0,3,0,1,147.69,0.00,0.00,0.00,0,1.00,1,24.41,0,0,1,,0.00,0,0,1,0,0,1,0,0,10,0
"org.apache.solr.search.TestRangeQuery$DocProcessor_0",1,0.00,1.00,3,0.02,124.93,1,0,9,2,1,136.69,0,4,0,1,136.69,0.00,0.00,0.00,0,1.00,1,58.19,0,0,1,java.lang.Object,0.00,1,0,1,0,1,1,0,0,18,0
"org.apache.solr.search.TestRealTimeGet",11,0.01,4.82,355,5.56,428464.12,21,10,29,78,34,28.35,102,410,10,3,78.34,0.00,0.67,0.09,1,48.00,15,16682.42,15,1,24,org.apache.solr.SolrTestCaseJ4,0.00,67,2,53,0,67,10,0,71,2700,1
"org.apache.solr.search.TestRealTimeGet$DocInfo",2,0.00,1.00,8,0.06,731.77,4,2,29,2,0,128.36,0,12,0,1,128.36,0.00,0.00,0.50,0,2.00,1,167.40,0,1,0,java.lang.Object,0.00,0,0,2,0,0,1,0,0,49,1
"org.apache.solr.search.TestRealTimeGet$Thread",1,0.00,18.00,65,0.98,82547.11,2,1,29,22,3,15.51,10,87,0,1,63.99,0.00,0.00,1.00,0,0.00,18,2945.86,0,0,3,java.lang.Object,0.00,21,0,18,0,21,1,0,10,444,0
"org.apache.solr.search.TestRealTimeGet$Thread_0",1,0.00,9.00,34,0.67,40021.14,2,1,29,19,3,59.25,5,47,0,1,77.13,0.00,0.00,1.00,0,0.00,9,2011.15,0,0,3,java.lang.Object,0.00,18,0,9,0,18,1,0,5,310,0
"org.apache.solr.search.TestRealTimeGet$Thread_1",1,0.00,16.00,70,1.15,115227.40,2,1,29,24,3,51.32,15,92,0,1,61.68,0.00,0.00,1.00,0,0.00,16,3439.93,0,0,3,java.lang.Object,0.00,23,0,16,0,23,1,0,15,517,0
"org.apache.solr.search.TestRealTimeGet$Thread_2",1,0.00,9.00,34,0.67,40021.14,2,1,29,19,3,59.25,5,47,0,1,77.13,0.00,0.00,1.00,0,0.00,9,2011.15,0,0,3,java.lang.Object,0.00,18,0,9,0,18,1,0,5,310,0
"org.apache.solr.search.TestRealTimeGet$Thread_3",1,0.00,19.00,69,1.14,107078.24,2,1,29,26,3,41.98,14,92,0,1,62.12,0.00,0.00,1.00,0,0.00,19,3431.68,0,0,3,java.lang.Object,0.00,25,0,19,0,25,1,0,14,512,0
"org.apache.solr.search.TestRealTimeGet$Thread_4",1,0.00,9.00,34,0.67,40021.14,2,1,29,19,3,59.25,5,47,0,1,77.13,0.00,0.00,1.00,0,0.00,9,2011.15,0,0,3,java.lang.Object,0.00,18,0,9,0,18,1,0,5,310,0
"org.apache.solr.search.TestRealTimeGet$Thread_5",1,0.00,20.00,73,1.24,108662.28,3,2,29,28,3,70.28,17,97,0,1,61.15,0.00,0.00,1.00,0,0.00,20,3709.06,0,0,3,java.lang.Object,0.00,27,0,20,0,27,1,0,17,546,0
"org.apache.solr.search.TestRealTimeGet$Thread_6",1,0.00,10.00,37,0.73,43360.08,2,1,29,21,3,33.17,7,51,0,1,75.46,0.00,0.00,1.00,0,0.00,10,2183.67,0,0,3,java.lang.Object,0.00,20,0,10,0,20,1,0,7,332,0
"org.apache.solr.search.TestRealTimeGet$Thread_7",1,0.00,23.00,96,1.71,252154.03,2,1,29,31,6,80.08,19,119,0,1,53.80,0.00,0.00,1.00,0,0.00,23,5119.37,0,0,6,java.lang.Object,0.00,30,0,23,0,30,1,0,19,744,0
"org.apache.solr.search.TestRealTimeGet$Thread_8",1,0.00,10.00,37,0.61,45027.21,2,1,29,19,5,33.04,7,51,0,1,75.33,0.00,0.00,1.00,0,0.00,10,1841.51,0,0,5,java.lang.Object,0.00,18,0,10,0,18,1,0,7,294,0
"org.apache.solr.search.TestRecovery",14,0.27,2.07,419,7.80,582718.97,16,2,19,69,7,62.03,72,491,0,3,79.91,0.00,0.67,0.25,3,26.00,7,23401.36,19,1,7,org.apache.solr.SolrTestCaseJ4,0.00,55,2,29,0,55,13,0,72,3631,1
"org.apache.solr.search.TestRecovery$Runnable",1,0.00,2.00,5,0.05,844.43,1,0,19,4,0,121.72,0,9,0,1,121.72,0.00,0.00,0.00,0,0.00,2,150.70,0,0,0,java.lang.Object,0.00,3,0,2,0,3,1,0,0,36,0
"org.apache.solr.search.TestRecovery$Runnable_0",1,0.00,1.00,3,0.02,173.90,1,0,19,2,0,135.56,0,5,0,1,135.56,0.00,0.00,0.00,0,1.00,1,52.97,0,0,0,java.lang.Object,0.00,1,0,1,0,1,1,0,0,17,0
"org.apache.solr.search.TestRecovery$Runnable_1",1,0.00,2.00,5,0.05,844.43,1,0,19,4,0,121.72,0,9,0,1,121.72,0.00,0.00,0.00,0,0.00,2,150.70,0,0,0,java.lang.Object,0.00,3,0,2,0,3,1,0,0,36,0
"org.apache.solr.search.TestRecovery$Runnable_10",1,0.00,1.00,3,0.02,173.90,1,0,19,2,0,135.56,0,5,0,1,135.56,0.00,0.00,0.00,0,1.00,1,52.97,0,0,0,java.lang.Object,0.00,1,0,1,0,1,1,0,0,17,0
"org.apache.solr.search.TestRecovery$Runnable_11",1,0.00,2.00,5,0.05,844.43,1,0,19,4,0,121.72,0,9,0,1,121.72,0.00,0.00,0.00,0,0.00,2,150.70,0,0,0,java.lang.Object,0.00,3,0,2,0,3,1,0,0,36,0
"org.apache.solr.search.TestRecovery$Runnable_12",1,0.00,1.00,3,0.02,173.90,1,0,19,2,0,135.56,0,5,0,1,135.56,0.00,0.00,0.00,0,1.00,1,52.97,0,0,0,java.lang.Object,0.00,1,0,1,0,1,1,0,0,17,0
"org.apache.solr.search.TestRecovery$Runnable_2",1,0.00,1.00,3,0.02,173.90,1,0,19,2,0,135.56,0,5,0,1,135.56,0.00,0.00,0.00,0,1.00,1,52.97,0,0,0,java.lang.Object,0.00,1,0,1,0,1,1,0,0,17,0
"org.apache.solr.search.TestRecovery$Runnable_3",1,0.00,2.00,5,0.05,844.43,1,0,19,4,0,121.72,0,9,0,1,121.72,0.00,0.00,0.00,0,0.00,2,150.70,0,0,0,java.lang.Object,0.00,3,0,2,0,3,1,0,0,36,0
"org.apache.solr.search.TestRecovery$Runnable_4",1,0.00,1.00,3,0.02,173.90,1,0,19,2,0,135.56,0,5,0,1,135.56,0.00,0.00,0.00,0,1.00,1,52.97,0,0,0,java.lang.Object,0.00,1,0,1,0,1,1,0,0,17,0
"org.apache.solr.search.TestRecovery$Runnable_5",1,0.00,2.00,5,0.05,844.43,1,0,19,4,0,121.72,0,9,0,1,121.72,0.00,0.00,0.00,0,0.00,2,150.70,0,0,0,java.lang.Object,0.00,3,0,2,0,3,1,0,0,36,0
"org.apache.solr.search.TestRecovery$Runnable_6",1,0.00,1.00,3,0.02,173.90,1,0,19,2,0,135.56,0,5,0,1,135.56,0.00,0.00,0.00,0,1.00,1,52.97,0,0,0,java.lang.Object,0.00,1,0,1,0,1,1,0,0,17,0
"org.apache.solr.search.TestRecovery$Runnable_7",1,0.00,2.00,5,0.05,844.43,1,0,19,4,0,121.72,0,9,0,1,121.72,0.00,0.00,0.00,0,0.00,2,150.70,0,0,0,java.lang.Object,0.00,3,0,2,0,3,1,0,0,36,0
"org.apache.solr.search.TestRecovery$Runnable_8",1,0.00,1.00,3,0.02,173.90,1,0,19,2,0,135.56,0,5,0,1,135.56,0.00,0.00,0.00,0,1.00,1,52.97,0,0,0,java.lang.Object,0.00,1,0,1,0,1,1,0,0,17,0
"org.apache.solr.search.TestRecovery$Runnable_9",1,0.00,2.00,5,0.05,844.43,1,0,19,4,0,121.72,0,9,0,1,121.72,0.00,0.00,0.00,0,0.00,2,150.70,0,0,0,java.lang.Object,0.00,3,0,2,0,3,1,0,0,36,0
"org.apache.solr.search.TestSearchPerf",13,0.46,2.00,144,2.17,83391.69,15,2,11,52,16,152.01,19,156,0,3,102.01,0.00,0.67,0.08,5,35.00,9,6517.44,6,3,16,org.apache.solr.util.AbstractSolrTestCase,0.26,39,2,26,0,39,10,0,17,1139,1
"org.apache.solr.search.TestSolrQueryParser",3,0.00,1.00,14,0.13,1811.98,3,0,4,3,2,126.64,2,24,0,3,126.64,0.00,0.67,0.00,1,3.00,1,394.35,6,0,2,org.apache.solr.SolrTestCaseJ4,0.00,0,2,3,0,0,3,0,2,97,1
"org.apache.solr.search.TestSort",4,0.11,7.25,157,3.08,286329.70,10,6,20,72,29,122.96,7,176,0,3,72.96,0.00,0.67,0.25,0,0.00,14,9242.95,1,1,29,org.apache.solr.SolrTestCaseJ4,0.00,68,2,29,0,68,3,0,7,1346,1
"org.apache.solr.search.TestSort$Collector",4,0.67,1.00,12,0.12,2014.05,5,1,20,9,2,131.92,0,20,0,1,131.92,0.00,0.00,0.50,0,4.00,1,359.24,0,0,2,java.lang.Object,0.00,5,0,4,0,5,4,0,0,93,0
"org.apache.solr.search.TestSort$Comparator<MyDoc>",1,0.00,10.00,14,0.23,13794.09,1,0,20,2,0,95.12,0,16,0,1,95.12,0.00,0.00,0.00,0,1.00,10,680.47,0,0,0,java.lang.Object,0.00,1,0,10,0,1,1,0,0,138,0
"org.apache.solr.search.TestSort$Filter",1,0.00,1.00,3,0.05,660.71,1,0,20,5,4,131.00,0,5,0,1,131.00,0.00,0.00,0.00,0,1.00,1,139.77,0,1,4,java.lang.Object,0.00,4,0,1,0,4,0,0,0,34,0
"org.apache.solr.search.TestSort$MyDoc",1,0.00,1.00,6,0.05,493.71,4,3,20,1,0,120.76,0,9,0,1,120.76,0.00,0.00,1.00,0,0.00,1,150.48,0,1,0,java.lang.Object,0.00,0,0,1,0,0,0,0,0,40,1
"org.apache.solr.search.TestSurroundQueryParser",5,0.00,1.00,31,0.35,8703.96,5,0,1,5,1,156.34,10,43,0,3,116.45,0.00,0.67,0.00,0,5.00,1,1035.81,7,2,1,org.apache.solr.util.AbstractSolrTestCase,0.32,0,2,5,0,0,3,0,10,218,1
"org.apache.solr.search.TestValueSourceCache",6,0.80,1.83,61,0.87,28842.43,7,1,6,16,7,154.56,7,88,0,3,104.56,0.00,0.67,0.33,3,10.00,4,2609.17,1,1,7,org.apache.solr.SolrTestCaseJ4,0.00,10,2,11,0,10,5,0,7,502,1
"org.apache.solr.search.ValueSourceParser",8,0.71,2.12,144,1.63,80841.52,9,1,28,35,35,113.08,27,154,8,1,92.47,0.00,0.00,0.38,3,14.00,5,4886.64,0,3,29,java.lang.Object,0.00,27,0,17,4,27,5,1,13,895,2
"org.apache.solr.search.ValueSourceParser$DateValueSourceParser",4,1.00,4.50,32,0.58,38428.96,5,1,28,20,9,126.22,12,46,0,2,105.60,0.00,0.50,0.25,1,6.00,11,1743.66,0,3,9,org.apache.solr.search.ValueSourceParser,0.17,16,1,18,0,16,1,0,12,341,0
"org.apache.solr.search.ValueSourceParser$DateValueSourceParser$DualFloatFunction_70",2,0.00,1.00,5,0.05,945.09,2,0,28,3,1,138.71,0,9,0,1,138.71,0.00,0.00,0.00,0,2.00,1,162.41,0,1,1,java.lang.Object,0.00,1,0,2,0,1,1,0,0,44,0
"org.apache.solr.search.ValueSourceParser$DateValueSourceParser$LongConstValueSource",2,0.00,1.00,5,0.05,697.38,2,0,28,3,1,139.75,0,9,0,1,139.75,0.00,0.00,0.00,0,2.00,1,147.96,0,1,1,java.lang.Object,0.00,1,0,2,0,1,1,0,0,40,0
"org.apache.solr.search.ValueSourceParser$DateValueSourceParser$LongConstValueSource_69",2,0.00,1.00,5,0.05,691.53,2,0,28,3,1,139.78,0,9,0,1,139.78,0.00,0.00,0.00,0,2.00,1,144.06,0,1,1,java.lang.Object,0.00,1,0,2,0,1,1,0,0,39,0
"org.apache.solr.search.ValueSourceParser$Double2Parser",1,0.00,1.00,3,0.05,733.88,1,0,28,3,1,130.64,0,5,0,1,130.64,0.00,0.00,0.00,0,1.00,1,136.71,0,0,1,java.lang.Object,0.00,2,0,1,0,2,1,0,0,35,0
"org.apache.solr.search.ValueSourceParser$Double2Parser_40",1,0.00,1.00,3,0.05,733.88,1,0,28,3,1,130.64,0,5,0,1,130.64,0.00,0.00,0.00,0,1.00,1,136.71,0,0,1,java.lang.Object,0.00,2,0,1,0,2,1,0,0,35,0
"org.apache.solr.search.ValueSourceParser$Double2Parser_41",1,0.00,1.00,3,0.05,733.88,1,0,28,3,1,130.64,0,5,0,1,130.64,0.00,0.00,0.00,0,1.00,1,136.71,0,0,1,java.lang.Object,0.00,2,0,1,0,2,1,0,0,35,0
"org.apache.solr.search.ValueSourceParser$DoubleParser",1,0.00,1.00,3,0.04,516.14,1,0,28,2,2,131.84,0,5,0,1,131.84,0.00,0.00,0.00,0,1.00,1,107.52,0,0,2,java.lang.Object,0.00,1,0,1,0,1,1,0,0,28,0
"org.apache.solr.search.ValueSourceParser$DoubleParser_22",1,0.00,1.00,3,0.04,516.14,1,0,28,2,2,131.84,0,5,0,1,131.84,0.00,0.00,0.00,0,1.00,1,107.52,0,0,2,java.lang.Object,0.00,1,0,1,0,1,1,0,0,28,0
"org.apache.solr.search.ValueSourceParser$DoubleParser_23",1,0.00,1.00,3,0.04,445.17,1,0,28,3,1,132.35,0,5,0,1,132.35,0.00,0.00,0.00,0,1.00,1,105.62,0,0,1,java.lang.Object,0.00,2,0,1,0,2,1,0,0,28,0
"org.apache.solr.search.ValueSourceParser$DoubleParser_24",1,0.00,1.00,3,0.04,445.17,1,0,28,3,1,132.35,0,5,0,1,132.35,0.00,0.00,0.00,0,1.00,1,105.62,0,0,1,java.lang.Object,0.00,2,0,1,0,2,1,0,0,28,0
"org.apache.solr.search.ValueSourceParser$DoubleParser_25",1,0.00,1.00,3,0.04,445.17,1,0,28,3,1,132.35,0,5,0,1,132.35,0.00,0.00,0.00,0,1.00,1,105.62,0,0,1,java.lang.Object,0.00,2,0,1,0,2,1,0,0,28,0
"org.apache.solr.search.ValueSourceParser$DoubleParser_26",1,0.00,1.00,3,0.04,445.17,1,0,28,3,1,132.35,0,5,0,1,132.35,0.00,0.00,0.00,0,1.00,1,105.62,0,0,1,java.lang.Object,0.00,2,0,1,0,2,1,0,0,28,0
"org.apache.solr.search.ValueSourceParser$DoubleParser_27",1,0.00,1.00,3,0.04,445.17,1,0,28,3,1,132.35,0,5,0,1,132.35,0.00,0.00,0.00,0,1.00,1,105.62,0,0,1,java.lang.Object,0.00,2,0,1,0,2,1,0,0,28,0
"org.apache.solr.search.ValueSourceParser$DoubleParser_28",1,0.00,1.00,3,0.04,445.17,1,0,28,3,1,132.35,0,5,0,1,132.35,0.00,0.00,0.00,0,1.00,1,105.62,0,0,1,java.lang.Object,0.00,2,0,1,0,2,1,0,0,28,0
"org.apache.solr.search.ValueSourceParser$DoubleParser_29",1,0.00,1.00,3,0.04,445.17,1,0,28,3,1,132.35,0,5,0,1,132.35,0.00,0.00,0.00,0,1.00,1,105.62,0,0,1,java.lang.Object,0.00,2,0,1,0,2,1,0,0,28,0
"org.apache.solr.search.ValueSourceParser$DoubleParser_30",1,0.00,1.00,3,0.04,445.17,1,0,28,3,1,132.35,0,5,0,1,132.35,0.00,0.00,0.00,0,1.00,1,105.62,0,0,1,java.lang.Object,0.00,2,0,1,0,2,1,0,0,28,0
"org.apache.solr.search.ValueSourceParser$DoubleParser_31",1,0.00,1.00,3,0.04,445.17,1,0,28,3,1,132.35,0,5,0,1,132.35,0.00,0.00,0.00,0,1.00,1,105.62,0,0,1,java.lang.Object,0.00,2,0,1,0,2,1,0,0,28,0
"org.apache.solr.search.ValueSourceParser$DoubleParser_32",1,0.00,1.00,3,0.04,445.17,1,0,28,3,1,132.35,0,5,0,1,132.35,0.00,0.00,0.00,0,1.00,1,105.62,0,0,1,java.lang.Object,0.00,2,0,1,0,2,1,0,0,28,0
"org.apache.solr.search.ValueSourceParser$DoubleParser_33",1,0.00,1.00,3,0.04,445.17,1,0,28,3,1,132.35,0,5,0,1,132.35,0.00,0.00,0.00,0,1.00,1,105.62,0,0,1,java.lang.Object,0.00,2,0,1,0,2,1,0,0,28,0
"org.apache.solr.search.ValueSourceParser$DoubleParser_34",1,0.00,1.00,3,0.04,445.17,1,0,28,3,1,132.35,0,5,0,1,132.35,0.00,0.00,0.00,0,1.00,1,105.62,0,0,1,java.lang.Object,0.00,2,0,1,0,2,1,0,0,28,0
"org.apache.solr.search.ValueSourceParser$DoubleParser_35",1,0.00,1.00,3,0.04,445.17,1,0,28,3,1,132.35,0,5,0,1,132.35,0.00,0.00,0.00,0,1.00,1,105.62,0,0,1,java.lang.Object,0.00,2,0,1,0,2,1,0,0,28,0
"org.apache.solr.search.ValueSourceParser$DoubleParser_36",1,0.00,1.00,3,0.04,445.17,1,0,28,3,1,132.35,0,5,0,1,132.35,0.00,0.00,0.00,0,1.00,1,105.62,0,0,1,java.lang.Object,0.00,2,0,1,0,2,1,0,0,28,0
"org.apache.solr.search.ValueSourceParser$DoubleParser_37",1,0.00,1.00,3,0.04,445.17,1,0,28,3,1,132.35,0,5,0,1,132.35,0.00,0.00,0.00,0,1.00,1,105.62,0,0,1,java.lang.Object,0.00,2,0,1,0,2,1,0,0,28,0
"org.apache.solr.search.ValueSourceParser$DoubleParser_38",1,0.00,1.00,3,0.04,445.17,1,0,28,3,1,132.35,0,5,0,1,132.35,0.00,0.00,0.00,0,1.00,1,105.62,0,0,1,java.lang.Object,0.00,2,0,1,0,2,1,0,0,28,0
"org.apache.solr.search.ValueSourceParser$DoubleParser_39",1,0.00,1.00,3,0.04,445.17,1,0,28,3,1,132.35,0,5,0,1,132.35,0.00,0.00,0.00,0,1.00,1,105.62,0,0,1,java.lang.Object,0.00,2,0,1,0,2,1,0,0,28,0
"org.apache.solr.search.ValueSourceParser$DoubleParser_72",3,0.00,1.00,8,0.07,753.60,3,0,28,5,4,140.87,0,12,0,2,140.87,0.00,0.50,0.00,0,3.00,1,202.94,0,1,4,org.apache.solr.search.NamedParser,0.00,2,1,3,0,2,2,0,0,58,1
"org.apache.solr.search.ValueSourceParser$DoubleParser_72$Double2Parser_73",3,0.00,1.00,9,0.08,1025.70,3,0,28,5,4,133.25,0,13,0,2,133.25,0.00,0.50,0.00,0,3.00,1,246.35,0,1,4,org.apache.solr.search.NamedParser,0.00,2,1,3,0,2,2,0,0,68,1
"org.apache.solr.search.ValueSourceParser$DoubleParser_72$Double2Parser_73$BoolConstValueSource",11,0.30,1.64,26,0.25,4199.65,12,1,28,13,4,139.33,0,48,0,3,139.33,0.00,0.67,0.73,0,0.00,2,745.20,0,3,4,org.apache.lucene.queries.function.valuesource.ConstNumberSource,0.96,2,2,18,0,2,8,0,0,193,0
"org.apache.solr.search.ValueSourceParser$DoubleParser_72$Double2Parser_73$BoolConstValueSource$BoolDocValues",1,0.00,1.00,3,0.02,180.53,1,0,28,1,0,135.43,0,5,0,1,135.43,0.00,0.00,0.00,0,0.00,1,58.21,0,0,0,java.lang.Object,0.00,0,0,1,0,0,1,0,0,18,0
"org.apache.solr.search.ValueSourceParser$DoubleParser_72$Double2Parser_73$Function_74",6,0.00,1.17,24,0.33,9844.33,8,2,28,13,5,123.19,4,37,0,2,123.19,0.00,0.50,0.50,1,6.00,2,980.87,0,2,5,org.apache.lucene.queries.function.ValueSource,0.29,7,1,7,0,7,4,0,1,231,0
"org.apache.solr.search.ValueSourceParser$DoubleParser_72$Double2Parser_73$Function_74$DoubleDocValues_75",2,0.00,1.00,5,0.07,1051.02,2,0,28,6,0,138.35,0,9,0,1,138.35,0.00,0.00,0.00,0,2.00,1,212.27,0,1,0,java.lang.Object,0.00,4,0,2,0,4,1,0,0,54,0
"org.apache.solr.search.ValueSourceParser$DoubleParser_72$Double2Parser_73$TestValueSource",7,0.50,1.29,19,0.28,7098.64,8,1,28,17,7,136.04,0,34,0,2,136.04,0.00,0.50,0.57,0,3.00,3,832.10,1,3,7,org.apache.lucene.queries.function.ValueSource,0.40,10,1,9,0,10,4,0,0,194,0
"org.apache.solr.search.ValueSourceParser$DoubleParser_72$Function",3,0.00,1.00,8,0.07,1248.67,3,0,28,6,5,139.14,0,14,0,3,139.14,0.00,0.67,0.00,0,4.00,1,215.66,0,2,5,org.apache.lucene.queries.function.valuesource.SingleFunction,0.18,3,2,3,0,3,1,0,0,58,0
"org.apache.solr.search.ValueSourceParser$DoubleParser_72$Function$DoubleDocValues",2,0.00,1.00,5,0.06,768.98,2,0,28,5,0,139.42,0,9,0,1,139.42,0.00,0.00,0.00,0,2.00,1,168.92,0,1,0,java.lang.Object,0.00,3,0,2,0,3,1,0,0,45,0
"org.apache.solr.search.ValueSourceParser$LongConstValueSource_71",11,0.10,1.09,30,0.26,4430.50,14,3,28,13,4,139.24,0,52,0,3,139.24,0.00,0.67,0.24,0,23.00,2,771.85,0,3,4,org.apache.lucene.queries.function.valuesource.ConstNumberSource,0.96,2,2,12,0,2,8,0,0,206,0
"org.apache.solr.search.ValueSourceParser$LongConstValueSource_71$LongDocValues",5,0.00,1.00,11,0.08,931.50,5,0,28,6,0,141.89,0,21,0,1,141.89,0.00,0.00,0.00,0,13.00,1,253.50,0,1,0,java.lang.Object,0.00,1,0,5,0,1,4,0,0,73,0
"org.apache.solr.search.ValueSourceParser$MVResult",0,0.00,0.00,3,0.01,138.68,2,2,28,0,1,171.00,0,4,0,1,171.00,0.00,0.00,0.00,0,0.00,0,44.38,0,0,1,java.lang.Object,0.00,0,0,0,0,0,0,0,0,14,2
"org.apache.solr.search.ValueSourceParser$NamedParser",2,1.00,1.00,6,0.03,408.90,3,1,28,2,1,135.01,0,9,0,2,135.01,0.00,0.50,0.50,0,2.00,1,103.84,0,1,1,org.apache.solr.search.ValueSourceParser,0.00,0,1,2,0,0,1,0,0,32,1
"org.apache.solr.search.ValueSourceParser$TInfo",0,0.00,0.00,5,0.03,253.51,4,4,28,0,0,171.00,0,6,0,1,171.00,0.00,0.00,0.00,0,0.00,0,78.87,0,0,0,java.lang.Object,0.00,0,0,0,0,0,0,0,0,22,2
"org.apache.solr.search.ValueSourceParser$ValueSourceParser",1,0.00,1.00,4,0.04,939.05,1,0,28,3,3,125.13,0,6,0,1,125.13,0.00,0.00,0.00,0,1.00,1,124.69,0,1,3,java.lang.Object,0.00,2,0,1,0,2,0,0,0,31,0
"org.apache.solr.search.ValueSourceParser$ValueSourceParser_0",1,0.00,1.00,4,0.04,742.41,1,0,28,3,4,125.94,0,6,0,1,125.94,0.00,0.00,0.00,0,1.00,1,120.37,0,1,4,java.lang.Object,0.00,2,0,1,0,2,0,0,0,30,0
"org.apache.solr.search.ValueSourceParser$ValueSourceParser_1",1,0.00,1.00,3,0.03,494.83,1,0,28,3,4,131.98,0,5,0,1,131.98,0.00,0.00,0.00,0,1.00,1,93.84,0,1,4,java.lang.Object,0.00,2,0,1,0,2,0,0,0,25,0
"org.apache.solr.search.ValueSourceParser$ValueSourceParser_10",1,0.00,1.00,4,0.06,1777.83,1,0,28,5,4,122.95,0,6,0,1,122.95,0.00,0.00,0.00,0,1.00,1,189.11,0,1,4,java.lang.Object,0.00,4,0,1,0,4,0,0,0,43,0
"org.apache.solr.search.ValueSourceParser$ValueSourceParser_11",1,0.00,1.00,4,0.06,1777.83,1,0,28,5,4,122.95,0,6,0,1,122.95,0.00,0.00,0.00,0,1.00,1,189.11,0,1,4,java.lang.Object,0.00,4,0,1,0,4,0,0,0,43,0
"org.apache.solr.search.ValueSourceParser$ValueSourceParser_12",1,0.00,1.00,5,0.04,950.23,1,0,28,3,3,121.48,0,7,0,1,121.48,0.00,0.00,0.00,0,1.00,1,133.10,0,1,3,java.lang.Object,0.00,2,0,1,0,2,0,0,0,34,0
"org.apache.solr.search.ValueSourceParser$ValueSourceParser_12$DualFloatFunction",2,0.00,1.00,5,0.05,945.09,2,0,28,3,1,138.71,0,9,0,1,138.71,0.00,0.00,0.00,0,2.00,1,162.41,0,1,1,java.lang.Object,0.00,1,0,2,0,1,1,0,0,44,0
"org.apache.solr.search.ValueSourceParser$ValueSourceParser_13",1,0.00,1.00,3,0.03,494.83,1,0,28,3,4,131.98,0,5,0,1,131.98,0.00,0.00,0.00,0,1.00,1,93.84,0,1,4,java.lang.Object,0.00,2,0,1,0,2,0,0,0,25,0
"org.apache.solr.search.ValueSourceParser$ValueSourceParser_14",1,0.00,2.00,7,0.07,1756.18,1,0,28,5,5,163.77,1,10,0,1,113.77,0.00,0.00,0.00,0,1.00,2,224.22,0,1,5,java.lang.Object,0.00,4,0,2,0,4,0,0,1,50,0
"org.apache.solr.search.ValueSourceParser$ValueSourceParser_15",1,0.00,1.00,6,0.07,1578.53,1,0,28,5,6,116.79,0,8,0,1,116.79,0.00,0.00,0.00,0,1.00,1,212.33,0,1,6,java.lang.Object,0.00,4,0,1,0,4,0,0,0,48,0
"org.apache.solr.search.ValueSourceParser$ValueSourceParser_16",1,0.00,1.00,5,0.05,1269.80,1,0,28,3,4,120.49,0,7,0,1,120.49,0.00,0.00,0.00,0,1.00,1,161.73,0,1,4,java.lang.Object,0.00,2,0,1,0,2,0,0,0,39,0
"org.apache.solr.search.ValueSourceParser$ValueSourceParser_17",1,0.00,3.00,26,0.36,23083.17,1,0,28,11,7,123.49,2,31,0,1,83.61,0.00,0.00,0.00,0,1.00,3,1068.74,0,1,7,java.lang.Object,0.00,10,0,3,0,10,0,0,2,191,0
"org.apache.solr.search.ValueSourceParser$ValueSourceParser_18",1,0.00,1.00,6,0.07,1772.71,1,0,28,4,4,116.39,0,8,0,1,116.39,0.00,0.00,0.00,0,1.00,1,207.04,0,1,4,java.lang.Object,0.00,3,0,1,0,3,0,0,0,48,0
"org.apache.solr.search.ValueSourceParser$ValueSourceParser_19",1,0.00,1.00,5,0.05,1373.41,1,0,28,3,4,120.22,0,7,0,1,120.22,0.00,0.00,0.00,0,1.00,1,159.27,0,1,4,java.lang.Object,0.00,2,0,1,0,2,0,0,0,39,0
"org.apache.solr.search.ValueSourceParser$ValueSourceParser_2",1,0.00,1.00,4,0.04,742.41,1,0,28,3,4,125.94,0,6,0,1,125.94,0.00,0.00,0.00,0,1.00,1,120.37,0,1,4,java.lang.Object,0.00,2,0,1,0,2,0,0,0,30,0
"org.apache.solr.search.ValueSourceParser$ValueSourceParser_20",1,0.00,5.00,18,0.24,7908.39,1,0,28,13,8,93.11,0,22,0,1,93.11,0.00,0.00,0.00,0,1.00,5,734.10,0,1,8,java.lang.Object,0.00,12,0,5,0,12,0,0,0,137,0
"org.apache.solr.search.ValueSourceParser$ValueSourceParser_21",1,0.00,1.00,5,0.07,1393.84,1,0,28,7,4,120.17,0,7,0,1,120.17,0.00,0.00,0.00,0,1.00,1,221.62,0,1,4,java.lang.Object,0.00,6,0,1,0,6,0,0,0,50,0
"org.apache.solr.search.ValueSourceParser$ValueSourceParser_3",1,0.00,1.00,4,0.03,646.58,1,0,28,2,3,176.41,1,6,0,1,126.41,0.00,0.00,0.00,0,1.00,1,102.01,0,1,3,java.lang.Object,0.00,1,0,1,0,1,0,0,1,27,0
"org.apache.solr.search.ValueSourceParser$ValueSourceParser_4",1,0.00,1.00,6,0.07,1772.71,1,0,28,4,4,116.39,0,8,0,1,116.39,0.00,0.00,0.00,0,1.00,1,207.04,0,1,4,java.lang.Object,0.00,3,0,1,0,3,0,0,0,48,0
"org.apache.solr.search.ValueSourceParser$ValueSourceParser_42",1,0.00,1.00,4,0.06,1777.83,1,0,28,5,4,122.95,0,6,0,1,122.95,0.00,0.00,0.00,0,1.00,1,189.11,0,1,4,java.lang.Object,0.00,4,0,1,0,4,0,0,0,43,0
"org.apache.solr.search.ValueSourceParser$ValueSourceParser_43",1,0.00,1.00,4,0.06,1777.83,1,0,28,5,4,122.95,0,6,0,1,122.95,0.00,0.00,0.00,0,1.00,1,189.11,0,1,4,java.lang.Object,0.00,4,0,1,0,4,0,0,0,43,0
"org.apache.solr.search.ValueSourceParser$ValueSourceParser_44",1,0.00,1.00,5,0.07,1649.58,1,0,28,4,4,119.59,0,7,0,1,119.59,0.00,0.00,0.00,0,1.00,1,202.95,0,1,4,java.lang.Object,0.00,3,0,1,0,3,0,0,0,45,0
"org.apache.solr.search.ValueSourceParser$ValueSourceParser_45",1,0.00,1.00,6,0.08,2138.32,1,0,28,5,4,115.75,0,8,0,1,115.75,0.00,0.00,0.00,0,1.00,1,253.34,0,1,4,java.lang.Object,0.00,4,0,1,0,4,0,0,0,54,0
"org.apache.solr.search.ValueSourceParser$ValueSourceParser_46",1,0.00,1.00,3,0.03,428.99,1,0,28,2,4,132.47,0,5,0,1,132.47,0.00,0.00,0.00,0,1.00,1,91.40,0,1,4,java.lang.Object,0.00,1,0,1,0,1,0,0,0,24,0
"org.apache.solr.search.ValueSourceParser$ValueSourceParser_47",1,0.00,1.00,3,0.03,428.99,1,0,28,2,4,132.47,0,5,0,1,132.47,0.00,0.00,0.00,0,1.00,1,91.40,0,1,4,java.lang.Object,0.00,1,0,1,0,1,0,0,0,24,0
"org.apache.solr.search.ValueSourceParser$ValueSourceParser_48",1,0.00,1.00,4,0.06,1190.99,1,0,28,3,4,124.32,0,6,0,1,124.32,0.00,0.00,0.00,0,1.00,1,173.06,0,1,4,java.lang.Object,0.00,2,0,1,0,2,0,0,0,40,0
"org.apache.solr.search.ValueSourceParser$ValueSourceParser_49",1,0.00,1.00,4,0.06,1190.99,1,0,28,3,4,124.32,0,6,0,1,124.32,0.00,0.00,0.00,0,1.00,1,173.06,0,1,4,java.lang.Object,0.00,2,0,1,0,2,0,0,0,40,0
"org.apache.solr.search.ValueSourceParser$ValueSourceParser_5",1,0.00,1.00,7,0.08,2442.03,1,0,28,4,4,112.80,0,9,0,1,112.80,0.00,0.00,0.00,0,1.00,1,251.00,0,1,4,java.lang.Object,0.00,3,0,1,0,3,0,0,0,57,0
"org.apache.solr.search.ValueSourceParser$ValueSourceParser_50",1,0.00,1.00,4,0.04,742.41,1,0,28,3,4,125.94,0,6,0,1,125.94,0.00,0.00,0.00,0,1.00,1,120.37,0,1,4,java.lang.Object,0.00,2,0,1,0,2,0,0,0,30,0
"org.apache.solr.search.ValueSourceParser$ValueSourceParser_51",1,0.00,1.00,4,0.06,1190.99,1,0,28,3,4,124.32,0,6,0,1,124.32,0.00,0.00,0.00,0,1.00,1,173.06,0,1,4,java.lang.Object,0.00,2,0,1,0,2,0,0,0,40,0
"org.apache.solr.search.ValueSourceParser$ValueSourceParser_52",1,0.00,1.00,4,0.06,1190.99,1,0,28,3,4,124.32,0,6,0,1,124.32,0.00,0.00,0.00,0,1.00,1,173.06,0,1,4,java.lang.Object,0.00,2,0,1,0,2,0,0,0,40,0
"org.apache.solr.search.ValueSourceParser$ValueSourceParser_53",1,0.00,1.00,4,0.06,1190.99,1,0,28,3,4,124.32,0,6,0,1,124.32,0.00,0.00,0.00,0,1.00,1,173.06,0,1,4,java.lang.Object,0.00,2,0,1,0,2,0,0,0,40,0
"org.apache.solr.search.ValueSourceParser$ValueSourceParser_54",1,0.00,1.00,4,0.04,742.41,1,0,28,3,4,125.94,0,6,0,1,125.94,0.00,0.00,0.00,0,1.00,1,120.37,0,1,4,java.lang.Object,0.00,2,0,1,0,2,0,0,0,30,0
"org.apache.solr.search.ValueSourceParser$ValueSourceParser_55",1,0.00,1.00,3,0.02,315.62,1,0,28,2,4,133.52,0,5,0,1,133.52,0.00,0.00,0.00,0,1.00,1,74.42,0,1,4,java.lang.Object,0.00,1,0,1,0,1,0,0,0,21,0
"org.apache.solr.search.ValueSourceParser$ValueSourceParser_56",1,0.00,1.00,3,0.02,315.62,1,0,28,2,4,133.52,0,5,0,1,133.52,0.00,0.00,0.00,0,1.00,1,74.42,0,1,4,java.lang.Object,0.00,1,0,1,0,1,0,0,0,21,0
"org.apache.solr.search.ValueSourceParser$ValueSourceParser_57",1,0.00,1.00,3,0.03,336.00,1,0,28,2,3,133.31,0,5,0,1,133.31,0.00,0.00,0.00,0,1.00,1,80.00,0,1,3,java.lang.Object,0.00,1,0,1,0,1,0,0,0,22,0
"org.apache.solr.search.ValueSourceParser$ValueSourceParser_58",1,0.00,1.00,3,0.03,336.00,1,0,28,2,3,133.31,0,5,0,1,133.31,0.00,0.00,0.00,0,1.00,1,80.00,0,1,3,java.lang.Object,0.00,1,0,1,0,1,0,0,0,22,0
"org.apache.solr.search.ValueSourceParser$ValueSourceParser_59",1,0.00,1.00,4,0.03,568.41,1,0,28,3,3,126.85,0,6,0,1,126.85,0.00,0.00,0.00,0,1.00,1,97.92,0,1,3,java.lang.Object,0.00,2,0,1,0,2,0,0,0,26,0
"org.apache.solr.search.ValueSourceParser$ValueSourceParser_59$SimpleBoolFunction",2,0.00,1.00,5,0.04,511.68,2,0,28,3,1,140.81,0,9,0,1,140.81,0.00,0.00,0.00,0,2.00,1,122.38,0,1,1,java.lang.Object,0.00,1,0,2,0,1,1,0,0,35,0
"org.apache.solr.search.ValueSourceParser$ValueSourceParser_6",1,0.00,1.00,6,0.07,1772.71,1,0,28,4,4,116.39,0,8,0,1,116.39,0.00,0.00,0.00,0,1.00,1,207.04,0,1,4,java.lang.Object,0.00,3,0,1,0,3,0,0,0,48,0
"org.apache.solr.search.ValueSourceParser$ValueSourceParser_60",1,0.00,1.00,4,0.03,568.41,1,0,28,3,3,126.85,0,6,0,1,126.85,0.00,0.00,0.00,0,1.00,1,97.92,0,1,3,java.lang.Object,0.00,2,0,1,0,2,0,0,0,26,0
"org.apache.solr.search.ValueSourceParser$ValueSourceParser_60$SimpleBoolFunction_61",2,0.00,1.00,5,0.04,594.44,2,0,28,3,1,140.30,0,9,0,1,140.30,0.00,0.00,0.00,0,2.00,1,128.15,0,1,1,java.lang.Object,0.00,1,0,2,0,1,1,0,0,36,0
"org.apache.solr.search.ValueSourceParser$ValueSourceParser_62",1,0.00,1.00,4,0.04,804.35,1,0,28,3,3,125.66,0,6,0,1,125.66,0.00,0.00,0.00,0,1.00,1,116.05,0,1,3,java.lang.Object,0.00,2,0,1,0,2,0,0,0,29,0
"org.apache.solr.search.ValueSourceParser$ValueSourceParser_62$MultiBoolFunction",2,0.00,2.00,6,0.07,1457.23,2,0,28,3,1,130.50,0,11,0,1,130.50,0.00,0.00,0.00,0,2.00,3,197.43,0,1,1,java.lang.Object,0.00,1,0,4,0,1,1,0,0,49,0
"org.apache.solr.search.ValueSourceParser$ValueSourceParser_63",1,0.00,1.00,4,0.04,804.35,1,0,28,3,3,125.66,0,6,0,1,125.66,0.00,0.00,0.00,0,1.00,1,116.05,0,1,3,java.lang.Object,0.00,2,0,1,0,2,0,0,0,29,0
"org.apache.solr.search.ValueSourceParser$ValueSourceParser_63$MultiBoolFunction_64",2,0.00,2.00,6,0.06,1296.06,2,0,28,3,1,130.90,0,11,0,1,130.90,0.00,0.00,0.00,0,2.00,3,190.85,0,1,1,java.lang.Object,0.00,1,0,4,0,1,1,0,0,48,0
"org.apache.solr.search.ValueSourceParser$ValueSourceParser_65",1,0.00,1.00,4,0.04,804.35,1,0,28,3,3,125.66,0,6,0,1,125.66,0.00,0.00,0.00,0,1.00,1,116.05,0,1,3,java.lang.Object,0.00,2,0,1,0,2,0,0,0,29,0
"org.apache.solr.search.ValueSourceParser$ValueSourceParser_65$MultiBoolFunction_66",2,0.00,2.00,9,0.10,4240.70,2,0,28,3,1,122.19,0,14,0,1,122.19,0.00,0.00,0.00,0,2.00,3,293.33,0,1,1,java.lang.Object,0.00,1,0,4,0,1,1,0,0,67,0
"org.apache.solr.search.ValueSourceParser$ValueSourceParser_67",1,0.00,1.00,6,0.07,2032.47,1,0,28,3,4,115.92,0,8,0,1,115.92,0.00,0.00,0.00,0,1.00,1,201.26,0,1,4,java.lang.Object,0.00,2,0,1,0,2,0,0,0,48,0
"org.apache.solr.search.ValueSourceParser$ValueSourceParser_68",1,0.00,1.00,3,0.03,494.83,1,0,28,3,4,131.98,0,5,0,1,131.98,0.00,0.00,0.00,0,1.00,1,93.84,0,1,4,java.lang.Object,0.00,2,0,1,0,2,0,0,0,25,0
"org.apache.solr.search.ValueSourceParser$ValueSourceParser_7",1,0.00,1.00,5,0.05,1373.41,1,0,28,3,4,120.22,0,7,0,1,120.22,0.00,0.00,0.00,0,1.00,1,159.27,0,1,4,java.lang.Object,0.00,2,0,1,0,2,0,0,0,39,0
"org.apache.solr.search.ValueSourceParser$ValueSourceParser_8",1,0.00,2.00,8,0.12,4074.91,1,0,28,5,4,108.72,0,10,0,1,108.72,0.00,0.00,0.00,0,1.00,2,346.58,0,1,4,java.lang.Object,0.00,4,0,2,0,4,0,0,0,73,0
"org.apache.solr.search.ValueSourceParser$ValueSourceParser_9",1,0.00,1.00,4,0.03,568.41,1,0,28,3,3,126.85,0,6,0,1,126.85,0.00,0.00,0.00,0,1.00,1,97.92,0,1,3,java.lang.Object,0.00,2,0,1,0,2,0,0,0,26,0
"org.apache.solr.search.ValueSourceParser$ValueSourceParser_9$SimpleFloatFunction",2,0.00,1.00,5,0.05,582.20,2,0,28,4,1,140.37,0,9,0,1,140.37,0.00,0.00,0.00,0,2.00,1,142.16,0,1,1,java.lang.Object,0.00,2,0,2,0,2,1,0,0,39,0
"org.apache.solr.search.WrappedQuery",12,0.18,1.08,30,0.29,5417.31,13,1,7,21,10,138.85,2,53,4,3,138.85,0.00,0.67,0.83,1,0.00,2,873.87,2,5,6,org.apache.solr.search.ExtendedQueryBase,0.40,9,2,13,0,9,7,0,2,233,1
"org.apache.lucene.codecs.mockintblock.MockFixedIntBlockPostingsFormat",7,0.50,1.57,52,0.61,23393.29,8,1,27,22,27,111.62,6,94,2,2,111.62,0.00,0.50,0.57,0,3.00,3,1824.24,1,4,25,org.apache.lucene.codecs.PostingsFormat,0.13,15,1,11,0,15,3,0,2,370,1
"org.apache.lucene.codecs.mockintblock.MockFixedIntBlockPostingsFormat$MockIntFactory",3,1.00,1.33,15,0.15,3359.04,4,1,27,7,9,120.85,0,25,0,2,120.85,0.00,0.50,0.00,0,3.00,2,447.57,0,2,9,org.apache.lucene.codecs.sep.IntStreamFactory,0.00,4,1,4,0,4,1,0,0,100,2
"org.apache.lucene.codecs.mockintblock.MockFixedIntBlockPostingsFormat$MockIntFactory$FixedIntBlockIndexInput",1,0.00,1.00,3,0.04,456.56,1,0,27,2,1,132.26,0,5,0,1,132.26,0.00,0.00,0.00,0,1.00,1,109.36,0,1,1,java.lang.Object,0.00,1,0,1,0,1,0,0,0,29,0
"org.apache.lucene.codecs.mockintblock.MockFixedIntBlockPostingsFormat$MockIntFactory$FixedIntBlockIndexInput$BlockReader",2,0.00,1.50,8,0.06,1123.74,2,0,27,3,0,126.80,0,7,0,1,126.80,0.00,0.00,0.00,0,2.00,2,168.21,0,0,0,java.lang.Object,0.00,1,0,3,0,1,2,0,0,43,0
"org.apache.lucene.codecs.mockintblock.MockFixedIntBlockPostingsFormat$MockIntFactory$FixedIntBlockIndexOutput",1,0.00,2.00,7,0.06,1365.53,1,0,27,2,0,114.63,0,7,0,1,114.63,0.00,0.00,0.00,0,1.00,2,169.31,0,0,0,java.lang.Object,0.00,1,0,2,0,1,1,0,0,40,0
"org.apache.lucene.codecs.mockintblock.MockVariableIntBlockPostingsFormat",6,0.60,1.67,50,0.59,23958.58,7,1,30,21,29,158.84,6,91,1,2,108.84,0.00,0.50,0.50,0,6.00,3,1778.25,1,3,28,org.apache.lucene.codecs.PostingsFormat,0.14,15,1,10,0,15,3,0,1,359,1
"org.apache.lucene.codecs.mockintblock.MockVariableIntBlockPostingsFormat$MockIntFactory",3,1.00,1.33,18,0.20,4969.98,4,1,30,10,10,116.56,0,28,0,2,116.56,0.00,0.50,0.33,0,4.00,2,593.81,0,2,10,org.apache.lucene.codecs.sep.IntStreamFactory,0.00,7,1,4,0,7,1,0,0,127,2
"org.apache.lucene.codecs.mockintblock.MockVariableIntBlockPostingsFormat$MockIntFactory$VariableIntBlockIndexInput",1,0.00,1.00,3,0.03,410.58,1,0,30,2,1,132.62,0,5,0,1,132.62,0.00,0.00,0.00,0,1.00,1,89.27,0,0,1,java.lang.Object,0.00,1,0,1,0,1,1,0,0,24,0
"org.apache.lucene.codecs.mockintblock.MockVariableIntBlockPostingsFormat$MockIntFactory$VariableIntBlockIndexInput$BlockReader",2,0.00,2.00,12,0.15,10824.07,2,0,30,3,0,112.41,0,11,0,1,112.41,0.00,0.00,0.00,0,2.00,3,460.04,0,0,0,java.lang.Object,0.00,1,0,4,0,1,2,0,0,94,0
"org.apache.lucene.codecs.mockintblock.MockVariableIntBlockPostingsFormat$MockIntFactory$VariableIntBlockIndexOutput",1,0.00,4.00,17,0.19,12824.35,3,2,30,2,0,92.67,4,18,0,1,92.43,0.00,0.00,1.00,0,0.00,4,558.07,0,0,0,java.lang.Object,0.00,1,0,4,0,1,1,0,4,113,0
"org.apache.lucene.analysis.fa.PersianAnalyzer",5,2.00,1.40,22,0.26,6173.59,7,2,14,15,13,79.99,58,34,1,3,124.12,0.00,0.67,0.00,0,7.00,2,782.51,0,3,12,org.apache.lucene.analysis.util.StopwordAnalyzerBase,0.00,10,2,7,0,10,2,0,11,176,2
"org.apache.lucene.analysis.fa.PersianAnalyzer$DefaultSetHolder",0,0.00,0.00,6,0.05,732.71,1,1,14,0,2,171.00,2,10,0,1,171.00,0.00,0.00,0.00,0,0.00,0,149.07,0,0,2,java.lang.Object,0.00,0,0,0,0,0,0,0,2,37,2
"org.apache.lucene.analysis.fa.PersianCharFilter",2,0.00,2.50,11,0.13,7537.45,2,0,3,2,4,156.44,4,18,2,4,116.55,0.00,0.75,0.00,0,2.00,4,385.51,1,0,2,org.apache.lucene.analysis.charfilter.CharFilter,0.36,0,3,5,0,0,2,0,1,84,1
"org.apache.lucene.analysis.fa.PersianNormalizationFilter",2,0.00,1.50,11,0.12,2515.75,4,2,4,8,8,160.31,5,17,4,4,120.42,0.00,0.75,0.50,0,2.00,2,367.15,0,0,4,org.apache.lucene.analysis.TokenFilter,0.29,6,3,3,0,6,2,0,1,85,2
"org.apache.lucene.analysis.fa.PersianNormalizer",1,0.00,7.00,27,0.29,9206.88,10,9,1,1,1,125.24,21,35,1,1,85.94,0.00,0.00,1.00,0,0.00,7,859.17,0,0,0,java.lang.Object,0.00,0,0,7,0,0,1,0,3,176,1
"org.apache.lucene.analysis.fa.TestPersianAnalyzer",8,0.00,1.00,83,1.40,59671.30,8,0,3,10,4,65.64,100,94,0,3,103.20,0.00,0.67,0.00,0,8.00,1,4209.88,3,0,4,org.apache.lucene.analysis.BaseTokenStreamTestCase,0.00,2,2,8,0,2,8,0,69,797,1
"org.apache.lucene.analysis.fa.TestPersianNormalizationFilter",8,0.00,1.00,20,0.17,2257.86,8,0,8,12,5,140.47,4,31,0,3,140.47,0.00,0.67,0.00,1,8.00,1,514.79,2,0,5,org.apache.lucene.analysis.BaseTokenStreamTestCase,0.00,4,2,8,0,4,8,0,1,137,1
"org.apache.lucene.analysis.fa.TestPersianNormalizationFilter$Analyzer",1,0.00,1.00,4,0.05,753.46,1,0,8,4,3,125.89,0,6,0,1,125.89,0.00,0.00,0.00,0,1.00,1,135.44,0,1,3,java.lang.Object,0.00,3,0,1,0,3,0,0,0,34,0
"org.apache.solr.common.luke.FieldFlag",4,0.33,1.50,23,0.28,6383.04,6,2,0,7,5,101.74,21,40,5,1,119.61,0.00,0.00,0.25,0,8.00,3,849.76,0,2,0,java.lang.Object,0.00,3,0,6,0,3,2,0,3,175,1
"org.apache.solr.highlight.BreakIteratorBoundaryScanner",5,0.00,3.20,29,0.54,37158.40,5,0,7,15,6,164.18,5,48,0,3,114.18,0.00,0.67,0.00,0,5.00,12,1620.68,0,5,6,org.apache.solr.highlight.SolrBoundaryScanner,0.75,10,2,16,0,10,0,0,5,297,1
"org.apache.solr.highlight.DefaultEncoder",5,0.00,1.00,11,0.09,964.94,5,0,2,6,5,191.77,7,22,0,2,141.77,0.00,0.50,0.00,0,5.00,1,272.12,0,5,5,org.apache.solr.highlight.HighlightingPluginBase,0.57,1,1,5,0,1,0,1,4,76,1
"org.apache.solr.highlight.DefaultSolrHighlighter",23,0.29,3.35,272,4.90,325349.40,26,3,41,117,54,81.32,117,366,2,2,99.19,0.00,0.50,0.06,10,160.00,20,14687.73,1,12,52,org.apache.solr.highlight.SolrHighlighter,0.00,94,1,77,0,94,11,1,42,2514,1
"org.apache.solr.highlight.DefaultSolrHighlighter$Comparator<TextFragment>",1,0.00,1.00,3,0.04,541.40,1,0,41,3,1,131.68,0,4,0,1,131.68,0.00,0.00,0.00,0,1.00,1,113.42,0,0,1,java.lang.Object,0.00,2,0,1,0,2,1,0,0,31,0
"org.apache.solr.highlight.DummyHighlighter",2,0.00,1.00,6,0.08,1642.07,2,0,7,4,7,130.25,1,12,0,2,130.25,0.00,0.50,0.00,0,2.00,1,240.42,0,1,7,org.apache.solr.highlight.SolrHighlighter,0.00,2,1,2,0,2,1,0,1,55,1
"org.apache.solr.highlight.FastVectorHighlighterTest",3,0.00,1.00,38,0.58,16892.78,3,0,6,14,7,151.21,3,51,0,3,101.21,0.00,0.67,0.00,0,1.00,1,1731.29,6,0,7,org.apache.solr.SolrTestCaseJ4,0.00,11,2,3,0,11,3,0,3,321,1
"org.apache.solr.highlight.GapFragmenter",5,0.00,1.20,14,0.14,2611.77,5,0,8,9,12,138.33,3,26,1,2,138.33,0.00,0.50,0.00,0,8.00,2,410.60,0,5,11,org.apache.solr.highlight.HighlightingPluginBase,0.57,4,1,6,0,4,0,1,3,101,1
"org.apache.solr.highlight.HighlighterConfigTest",5,0.00,1.00,22,0.27,5082.97,5,0,4,13,4,174.86,6,31,0,3,124.86,0.00,0.67,0.00,0,8.00,1,811.79,7,2,4,org.apache.solr.util.AbstractSolrTestCase,0.32,8,2,5,0,8,3,0,6,166,1
"org.apache.solr.highlight.HighlighterTest",29,0.89,1.07,347,5.82,166802.89,30,1,15,56,11,152.53,48,641,0,3,102.53,0.00,0.67,0.14,0,0.00,3,17460.62,9,0,11,org.apache.solr.SolrTestCaseJ4,0.03,27,2,31,0,27,29,0,45,3114,1
"org.apache.solr.highlight.HighlightingPluginBase",9,0.44,1.22,22,0.18,3167.53,11,2,5,15,13,139.67,6,32,9,1,139.67,0.00,0.00,0.11,0,23.00,3,535.74,0,7,4,java.lang.Object,0.00,6,0,11,13,6,2,1,3,144,2
"org.apache.solr.highlight.HtmlEncoder",5,0.00,1.00,11,0.07,763.54,5,0,3,6,5,192.57,7,21,0,2,142.57,0.00,0.50,0.00,0,5.00,1,221.97,0,5,5,org.apache.solr.highlight.HighlightingPluginBase,0.57,1,1,5,0,1,0,1,4,66,1
"org.apache.solr.highlight.HtmlFormatter",5,0.00,1.00,13,0.12,2044.81,5,0,4,8,7,189.20,6,27,1,2,139.20,0.00,0.50,0.00,0,8.00,1,374.49,0,5,6,org.apache.solr.highlight.HighlightingPluginBase,0.57,3,1,5,0,3,0,1,4,96,1
"org.apache.solr.highlight.LuceneGapFragmenter",4,0.25,1.25,18,0.18,3868.90,8,4,8,7,9,164.87,10,28,1,2,124.98,0.00,0.50,0.44,0,4.00,2,539.03,0,0,8,org.apache.lucene.search.highlight.SimpleFragmenter,0.20,3,1,5,0,3,4,0,3,125,0
"org.apache.solr.highlight.LuceneRegexFragmenter",7,0.17,2.57,84,1.01,62990.57,24,17,12,21,9,81.52,37,114,1,1,99.39,0.00,0.00,0.20,1,25.00,10,3035.65,0,0,8,java.lang.Object,0.00,14,0,18,0,14,7,1,33,584,0
"org.apache.solr.highlight.OrderedToken",0,0.00,0.00,3,0.01,54.00,2,2,41,0,28,171.00,0,4,1,1,171.00,0.00,0.00,0.00,0,0.00,0,36.00,0,0,27,java.lang.Object,0.00,0,0,0,0,0,0,0,0,12,0
"org.apache.solr.highlight.RegexFragmenter",6,0.10,1.50,29,0.41,12658.98,8,2,12,14,11,142.89,20,45,0,2,122.27,0.00,0.50,0.42,0,6.00,3,1216.44,1,5,11,org.apache.solr.highlight.HighlightingPluginBase,0.53,8,1,9,0,8,1,1,4,247,1
"org.apache.solr.highlight.ScoreOrderFragmentsBuilder",5,0.00,1.00,13,0.15,3068.21,5,0,3,7,6,137.82,3,26,1,3,137.82,0.00,0.67,0.00,0,5.00,1,448.30,1,5,5,org.apache.solr.highlight.SolrFragmentsBuilder,0.60,2,2,5,0,2,0,0,3,109,1
"org.apache.solr.highlight.SimpleBoundaryScanner",5,0.00,1.20,19,0.22,6146.05,5,0,3,10,6,128.83,3,28,1,3,128.83,0.00,0.67,0.00,0,5.00,2,668.55,0,5,5,org.apache.solr.highlight.SolrBoundaryScanner,0.75,5,2,6,0,5,0,0,3,144,1
"org.apache.solr.highlight.SimpleFragListBuilder",5,0.00,1.00,12,0.09,1032.91,5,0,2,6,6,191.54,6,23,1,2,141.54,0.00,0.50,0.00,0,8.00,1,276.36,0,5,5,org.apache.solr.highlight.HighlightingPluginBase,0.57,1,1,5,0,1,0,1,6,77,1
"org.apache.solr.highlight.SimpleFragmentsBuilder",5,0.00,1.00,13,0.15,3068.21,5,0,3,7,5,137.82,3,26,0,3,137.82,0.00,0.67,0.00,0,5.00,1,448.30,1,5,5,org.apache.solr.highlight.SolrFragmentsBuilder,0.60,2,2,5,0,2,0,0,3,109,1
"org.apache.solr.highlight.SingleFragListBuilder",5,0.00,1.00,12,0.09,1032.91,5,0,2,6,5,191.54,6,23,0,2,141.54,0.00,0.50,0.00,0,8.00,1,276.36,0,5,5,org.apache.solr.highlight.HighlightingPluginBase,0.57,1,1,5,0,1,0,1,6,77,1
"org.apache.solr.highlight.SolrBoundaryScanner",2,0.00,1.00,6,0.06,841.62,2,0,4,3,10,132.54,0,9,5,2,132.54,2.00,0.25,0.00,1,2.00,1,179.03,0,2,5,org.apache.solr.highlight.HighlightingPluginBase,0.00,1,1,2,2,1,0,2,0,47,2
"org.apache.solr.highlight.SolrEncoder",2,0.00,1.00,3,0.02,111.57,2,0,5,2,9,125.02,12,4,4,3,157.25,0.00,0.67,0.00,0,2.00,1,67.83,0,1,5,,0.00,0,2,2,0,0,1,0,2,23,1
"org.apache.solr.highlight.SolrFormatter",2,0.00,1.00,3,0.02,111.57,2,0,5,2,9,125.02,12,4,4,3,157.25,0.00,0.67,0.00,0,2.00,1,67.83,0,1,5,,0.00,0,2,2,0,0,1,0,2,23,1
"org.apache.solr.highlight.SolrFragListBuilder",2,0.00,1.00,3,0.02,98.26,2,0,5,2,10,139.81,11,4,5,3,157.68,0.00,0.67,0.00,0,2.00,1,58.95,0,1,5,,0.00,0,2,2,0,0,1,0,2,21,1
"org.apache.solr.highlight.SolrFragmenter",2,0.00,1.00,3,0.02,111.57,2,0,5,2,10,125.02,12,4,5,3,157.25,0.00,0.67,0.00,0,2.00,1,67.83,0,1,5,,0.00,0,2,2,0,0,1,0,2,23,1
"org.apache.solr.highlight.SolrFragmentsBuilder",6,0.40,1.50,28,0.41,12623.46,8,2,7,14,13,172.28,6,39,5,2,122.28,2.00,0.25,0.17,2,18.00,3,1235.68,0,5,8,org.apache.solr.highlight.HighlightingPluginBase,0.00,8,1,9,2,8,1,2,1,266,2
"org.apache.solr.highlight.SolrHighlighter",5,7.00,2.40,36,0.68,30749.19,12,7,16,23,21,67.15,35,54,8,1,109.44,0.00,0.00,0.00,1,5.00,8,2046.13,0,2,14,java.lang.Object,0.00,18,0,12,2,18,3,0,13,396,2
"org.apache.solr.highlight.TermOffsetsTokenStream",2,0.57,1.00,17,0.12,1629.29,9,7,41,4,29,114.39,0,20,2,1,114.39,0.00,0.00,0.43,0,0.00,1,373.96,0,1,27,java.lang.Object,0.00,2,0,2,0,2,1,0,0,89,0
"org.apache.solr.highlight.TermOffsetsTokenStream$MultiValuedStream",2,0.00,3.50,22,0.25,13732.59,4,2,41,6,2,101.65,0,32,0,3,101.65,0.00,0.67,0.50,0,0.00,6,736.62,0,0,2,org.apache.lucene.analysis.TokenStream,0.30,4,2,7,0,4,2,0,0,150,1
"org.apache.solr.highlight.TokenOrderingFilter",2,0.25,3.50,27,0.34,14724.18,6,4,41,14,29,138.59,5,36,1,4,98.71,0.00,0.75,0.38,0,2.00,6,1013.98,0,0,28,org.apache.lucene.analysis.TokenFilter,0.29,12,3,7,0,12,2,0,5,197,1
"org.apache.lucene.search.payloads.AveragePayloadFunction",5,0.00,2.00,21,0.28,7688.97,5,0,1,10,7,123.52,22,35,5,2,123.29,0.00,0.50,0.00,0,5.00,4,829.05,0,1,2,org.apache.lucene.search.payloads.PayloadFunction,0.40,5,1,10,0,5,4,0,2,189,1
"org.apache.lucene.search.payloads.MaxPayloadFunction",5,0.00,2.20,24,0.29,7912.90,5,0,1,11,5,123.40,22,39,3,2,123.17,0.00,0.50,0.00,0,5.00,4,872.56,0,1,2,org.apache.lucene.search.payloads.PayloadFunction,0.40,6,1,11,0,6,4,0,2,197,1
"org.apache.lucene.search.payloads.MinPayloadFunction",5,0.00,2.20,24,0.29,7912.90,5,0,1,11,4,123.40,20,39,2,2,123.17,0.00,0.50,0.00,0,5.00,4,872.56,0,1,2,org.apache.lucene.search.payloads.PayloadFunction,0.40,6,1,11,0,6,4,0,2,197,1
"org.apache.lucene.search.payloads.PayloadFunction",5,0.00,1.00,10,0.12,1473.66,5,0,1,8,8,108.10,31,14,7,1,140.32,0.00,0.00,0.00,0,5.00,1,348.43,0,1,1,java.lang.Object,0.00,3,0,5,3,3,4,0,3,93,2
"org.apache.lucene.search.payloads.PayloadHelper",2,0.43,1.50,30,0.48,15664.42,9,7,20,18,16,54.08,15,32,2,1,96.37,0.00,0.00,0.36,0,0.00,2,1435.53,0,1,14,java.lang.Object,0.00,16,0,3,0,16,1,0,5,264,1
"org.apache.lucene.search.payloads.PayloadHelper$PayloadAnalyzer",2,0.00,1.00,6,0.07,1204.68,2,0,20,6,1,131.31,0,10,0,2,131.31,0.00,0.50,0.00,0,2.00,1,205.73,0,1,1,org.apache.lucene.index.Analyzer,0.00,4,1,2,0,4,1,0,0,52,2
"org.apache.lucene.search.payloads.PayloadHelper$PayloadFilter",3,0.17,2.33,23,0.23,5744.56,6,3,20,7,2,113.44,0,33,0,2,113.44,0.00,0.50,0.44,0,1.00,5,703.55,1,0,2,org.apache.lucene.index.TokenFilter,0.00,4,1,7,0,4,3,0,0,153,2
"org.apache.lucene.search.payloads.PayloadNearQuery",7,0.08,3.00,58,0.75,31015.19,9,2,22,28,22,148.23,15,80,2,4,108.34,0.00,0.75,0.43,0,8.00,10,2236.58,3,3,20,org.apache.lucene.search.spans.SpanNearQuery,0.24,21,3,21,0,21,4,0,2,469,1
"org.apache.lucene.search.payloads.PayloadNearQuery$PayloadNearSpanScorer",5,0.25,2.40,47,0.66,31669.27,9,4,22,17,7,145.15,13,62,0,4,105.27,0.00,0.75,0.45,2,2.00,6,1974.94,1,0,7,org.apache.lucene.search.spans.SpanScorer,0.36,12,3,12,0,12,5,0,4,396,1
"org.apache.lucene.search.payloads.PayloadNearQuery$PayloadNearSpanWeight",3,0.00,1.67,25,0.48,20193.26,3,0,22,22,7,107.05,2,36,0,3,107.05,0.00,0.67,0.00,0,1.00,3,1436.85,0,2,7,org.apache.lucene.search.spans.SpanWeight,0.00,19,2,5,0,19,1,0,2,258,1
"org.apache.lucene.search.payloads.PayloadSpanUtil",4,1.00,7.25,108,1.67,189858.64,5,1,26,39,20,62.45,21,115,2,1,80.33,0.00,0.00,0.25,2,6.00,21,5003.20,0,1,18,java.lang.Object,0.00,35,0,29,0,35,3,0,3,804,1
"org.apache.lucene.search.payloads.PayloadTermQuery",3,2.00,1.00,12,0.10,1313.27,5,2,18,4,22,127.98,13,17,5,4,127.74,0.00,0.75,0.00,0,3.00,1,311.96,0,1,17,org.apache.lucene.search.spans.SpanTermQuery,0.00,1,3,3,0,1,2,0,1,81,1
"org.apache.lucene.search.payloads.PayloadTermQuery$PayloadTermWeight",5,0.00,3.40,49,0.81,39030.44,5,0,18,26,8,154.47,7,71,0,3,104.47,0.00,0.67,0.00,0,1.00,8,2421.06,2,2,8,org.apache.lucene.search.spans.SpanWeight,0.00,21,2,17,0,21,3,0,7,452,1
"org.apache.lucene.search.payloads.PayloadTermQuery$PayloadTermWeight$PayloadTermSpanScorer",6,0.15,1.83,37,0.48,15393.99,10,4,18,16,6,115.22,24,55,0,4,114.99,0.00,0.75,0.38,1,10.00,3,1431.41,1,0,6,org.apache.lucene.search.spans.SpanScorer,0.35,10,3,11,0,10,6,0,6,296,1
"org.apache.lucene.search.payloads.TestPayloadExplanations",6,1.00,1.67,35,0.44,10677.90,7,1,6,14,11,169.21,6,47,0,3,119.21,0.00,0.67,0.00,1,14.00,2,1318.02,2,1,11,org.apache.lucene.search.TestExplanations,0.00,8,2,10,0,8,5,0,4,287,1
"org.apache.lucene.search.payloads.TestPayloadExplanations$DefaultSimilarity",1,0.00,1.00,3,0.04,723.56,1,0,6,2,0,130.68,0,5,0,1,130.68,0.00,0.00,0.00,0,1.00,1,126.59,0,0,0,java.lang.Object,0.00,1,0,1,0,1,1,0,0,31,0
"org.apache.lucene.search.payloads.TestPayloadNearQuery",12,0.03,1.83,177,2.61,107182.90,18,6,30,44,30,136.88,28,176,0,2,96.99,0.00,0.50,0.19,1,0.00,5,7836.60,0,3,30,org.apache.lucene.util.LuceneTestCase,0.00,32,1,22,0,32,9,0,22,1410,1
"org.apache.lucene.search.payloads.TestPayloadNearQuery$BoostingSimilarity",7,0.00,1.00,15,0.15,1979.50,7,0,30,11,5,140.47,5,28,0,2,140.47,0.00,0.50,0.00,0,7.00,1,460.25,0,1,5,org.apache.lucene.search.DefaultSimilarity,0.00,4,1,7,0,4,6,0,5,122,1
"org.apache.lucene.search.payloads.TestPayloadNearQuery$PayloadAnalyzer",1,0.00,1.00,4,0.06,1129.68,1,0,30,4,1,124.50,0,7,0,2,124.50,0.00,0.50,0.00,0,1.00,1,175.73,0,1,1,org.apache.lucene.index.Analyzer,0.00,3,1,1,0,3,0,0,0,42,2
"org.apache.lucene.search.payloads.TestPayloadNearQuery$PayloadFilter",3,0.00,1.67,21,0.20,4812.06,6,3,30,6,2,114.12,0,29,0,2,114.12,0.00,0.50,0.33,0,1.00,3,593.80,1,0,2,org.apache.lucene.index.TokenFilter,0.00,3,1,5,0,3,3,0,0,133,2
"org.apache.lucene.search.payloads.TestPayloadTermQuery",8,0.10,2.00,129,2.25,103548.19,15,7,31,46,29,114.16,29,145,0,2,93.54,0.00,0.50,0.23,0,0.00,4,6751.64,0,0,29,org.apache.lucene.util.LuceneTestCase,0.00,38,1,16,0,38,8,0,22,1181,1
"org.apache.lucene.search.payloads.TestPayloadTermQuery$BoostingSimilarity",7,0.00,1.14,15,0.15,2161.78,7,0,31,10,2,140.13,5,28,0,2,140.13,0.00,0.50,0.00,0,7.00,2,463.26,0,0,2,org.apache.lucene.search.DefaultSimilarity,0.00,3,1,8,0,3,7,0,5,123,1
"org.apache.lucene.search.payloads.TestPayloadTermQuery$FullSimilarity",1,0.00,1.00,3,0.03,383.82,1,0,31,1,0,182.85,1,5,0,2,132.85,0.00,0.50,0.00,0,1.00,1,99.51,0,0,0,org.apache.lucene.search.DefaultSimilarity,0.00,0,1,1,0,0,1,0,1,27,1
"org.apache.lucene.search.payloads.TestPayloadTermQuery$PayloadAnalyzer",2,0.00,1.00,6,0.07,1204.68,2,0,31,6,1,131.31,0,10,0,2,131.31,0.00,0.50,0.00,0,2.00,1,205.73,0,1,1,org.apache.lucene.index.Analyzer,0.00,4,1,2,0,4,1,0,0,52,2
"org.apache.lucene.search.payloads.TestPayloadTermQuery$PayloadFilter",3,0.17,2.33,25,0.25,6790.30,6,3,31,7,2,110.70,0,35,0,2,110.70,0.00,0.50,0.44,0,1.00,5,746.33,1,0,2,org.apache.lucene.index.TokenFilter,0.00,4,1,7,0,4,3,0,0,160,2
"org.apache.lucene.analysis.util.CharArrayIterator",17,0.05,1.47,73,0.52,10060.58,23,6,3,20,3,176.62,23,101,3,1,126.62,0.00,0.00,0.22,1,96.00,2,1554.39,1,3,0,java.lang.Object,0.00,3,0,25,0,3,14,1,6,389,2
"org.apache.lucene.analysis.util.CharArrayIterator$CharArrayIterator",1,0.00,2.00,3,0.03,916.28,1,0,3,1,0,150.33,3,5,0,1,129.72,0.00,0.00,0.00,0,1.00,2,103.91,0,0,0,java.lang.Object,0.00,0,0,2,0,0,1,0,3,27,0
"org.apache.lucene.analysis.util.CharArrayIterator$CharArrayIterator_0",1,0.00,1.00,3,0.02,238.72,1,0,3,1,0,184.48,1,5,0,1,134.48,0.00,0.00,0.00,0,1.00,1,51.19,0,0,0,java.lang.Object,0.00,0,0,1,0,0,1,0,1,17,0
"org.apache.lucene.analysis.util.CharArrayIterator$CharArrayIterator_1",1,0.00,2.00,3,0.03,916.28,1,0,3,1,0,169.60,2,5,0,1,129.72,0.00,0.00,0.00,0,1.00,2,103.91,0,0,0,java.lang.Object,0.00,0,0,2,0,0,1,0,2,27,0
"org.apache.lucene.analysis.util.CharArrayIterator$CharArrayIterator_2",1,0.00,1.00,3,0.02,238.72,1,0,3,1,0,184.48,1,5,0,1,134.48,0.00,0.00,0.00,0,1.00,1,51.19,0,0,0,java.lang.Object,0.00,0,0,1,0,0,1,0,1,17,0
"org.apache.lucene.analysis.util.CharArrayMap",31,0.00,2.45,241,3.09,185486.94,41,10,8,57,15,130.14,111,294,14,2,109.53,1.00,0.33,0.10,6,382.00,7,9266.57,1,5,2,java.util.AbstractMap,0.00,26,1,76,1,26,26,0,31,1870,1
"org.apache.lucene.analysis.util.CharArrayMap$CharArraySet",4,0.00,1.00,9,0.08,991.38,4,0,8,5,0,140.92,0,17,0,1,140.92,0.00,0.00,0.00,0,4.00,1,245.53,0,0,0,java.lang.Object,0.00,1,0,4,0,1,4,0,0,68,0
"org.apache.lucene.analysis.util.CharArrayMap$EmptyCharArrayMap<V>",7,0.00,1.86,21,0.25,4872.12,7,0,8,9,1,130.67,0,41,0,2,130.67,0.00,0.50,0.00,0,7.00,2,746.00,0,0,1,org.apache.lucene.analysis.util.UnmodifiableCharArrayMap,0.00,2,1,13,0,2,7,0,0,180,3
"org.apache.lucene.analysis.util.CharArrayMap$EntryIterator",9,0.00,1.22,30,0.25,4799.82,12,3,8,12,0,131.68,5,41,0,1,131.68,0.00,0.00,0.33,2,7.00,2,744.63,0,2,0,java.lang.Object,0.00,3,0,11,0,3,7,1,5,188,1
"org.apache.lucene.analysis.util.CharArrayMap$EntrySet",6,0.80,1.50,20,0.27,9784.06,7,1,8,13,1,127.81,0,35,0,2,127.81,0.00,0.50,0.33,0,14.00,3,823.40,0,1,1,java.util.AbstractSet,0.00,7,1,9,0,7,5,0,0,185,2
"org.apache.lucene.analysis.util.CharArrayMap$MapEntry",5,0.00,1.40,17,0.20,4496.74,7,2,8,9,1,129.86,2,27,0,1,129.86,0.00,0.00,0.50,0,0.00,2,595.55,0,2,1,java.lang.Object,0.00,4,0,7,0,4,3,1,2,144,2
"org.apache.lucene.analysis.util.CharArrayMap$UnmodifiableCharArrayMap",8,0.00,1.00,17,0.16,2137.62,8,0,8,10,1,140.66,0,33,0,3,140.66,0.00,0.67,0.00,0,8.00,1,489.24,0,1,1,org.apache.lucene.analysis.util.CharArrayMap,0.23,2,2,8,0,2,7,0,0,135,1
"org.apache.lucene.analysis.util.CharArraySet",16,0.00,1.62,52,0.67,21768.19,19,3,5,34,142,96.19,98,80,142,2,128.41,0.00,0.50,0.33,0,0.00,4,2024.16,0,4,1,java.util.AbstractSet,0.00,18,1,26,0,18,12,0,14,470,1
"org.apache.lucene.analysis.util.CharTokenizer",8,0.16,2.12,65,0.80,49522.64,18,10,9,22,6,63.15,90,85,1,4,107.28,1.33,0.38,0.24,2,8.00,10,2388.93,2,0,5,org.apache.lucene.analysis.Tokenizer,0.36,14,3,17,4,14,8,0,20,458,2
"org.apache.lucene.analysis.util.CharacterUtils",6,0.40,1.33,16,0.21,4861.89,8,2,3,11,10,163.08,114,20,10,1,136.80,0.00,0.00,0.17,0,10.00,2,621.83,0,1,0,java.lang.Object,0.00,5,0,8,2,5,5,0,8,156,2
"org.apache.lucene.analysis.util.CharacterUtils$CharacterBuffer",5,0.06,1.00,19,0.11,1654.61,9,4,3,5,0,133.60,22,25,0,1,133.36,0.00,0.00,0.30,0,9.00,1,344.44,0,0,0,java.lang.Object,0.00,0,0,5,0,0,5,0,6,97,3
"org.apache.lucene.analysis.util.CharacterUtils$Java4CharacterUtils",5,0.00,1.40,15,0.20,5267.68,5,0,3,8,1,129.32,0,27,0,2,129.32,0.00,0.50,0.00,0,5.00,2,591.90,0,0,1,org.apache.lucene.analysis.util.CharacterUtils,0.36,3,1,7,0,3,5,0,0,139,3
"org.apache.lucene.analysis.util.CharacterUtils$Java5CharacterUtils",5,0.00,2.00,35,0.49,61646.81,5,0,3,8,1,157.10,5,56,0,2,107.10,0.00,0.50,0.00,0,5.00,6,1475.86,0,0,1,org.apache.lucene.analysis.util.CharacterUtils,0.36,3,1,10,0,3,5,0,5,297,3
"org.apache.lucene.analysis.util.FilteringTokenFilter",6,0.07,2.33,33,0.30,11451.02,9,3,4,8,4,101.02,30,49,1,4,118.90,1.67,0.33,0.28,1,10.00,9,888.34,1,0,3,org.apache.lucene.analysis.TokenFilter,0.44,2,3,14,5,2,6,0,8,199,2
"org.apache.lucene.analysis.util.OpenStringBuilder",30,0.16,1.10,80,0.69,10625.27,32,2,0,38,2,139.67,20,96,2,1,139.67,0.00,0.00,0.35,6,106.00,2,2064.05,0,2,0,java.lang.Object,0.00,8,0,33,1,8,28,2,3,541,1
"org.apache.lucene.analysis.util.StemmerUtil",5,0.00,3.20,26,0.44,20467.53,5,0,0,8,2,72.09,59,39,2,1,116.21,0.00,0.00,0.00,0,5.00,4,1307.85,0,0,0,java.lang.Object,0.00,3,0,16,0,3,5,0,8,274,1
"org.apache.lucene.analysis.util.StopwordAnalyzerBase",6,0.40,1.33,26,0.34,9155.52,8,2,6,13,24,85.84,73,44,20,2,123.41,36.00,0.03,0.17,0,14.00,2,1029.60,0,4,4,org.apache.lucene.analysis.Analyzer,0.00,7,1,8,36,7,2,0,9,223,2
"org.apache.lucene.analysis.util.TestCharArrayIterator",6,0.00,1.67,75,1.06,76162.98,6,0,6,28,3,56.02,42,79,0,2,98.31,0.00,0.50,0.00,2,6.00,2,3183.45,0,0,3,org.apache.lucene.util.LuceneTestCase,0.00,22,1,10,0,22,6,0,18,596,1
"org.apache.lucene.analysis.util.TestCharArrayMap",5,0.00,4.20,165,2.65,224233.94,5,0,4,49,2,117.28,11,185,0,2,77.39,0.00,0.50,0.00,1,5.00,9,7950.59,0,0,2,org.apache.lucene.util.LuceneTestCase,0.00,44,1,21,0,44,5,0,11,1360,1
"org.apache.lucene.analysis.util.TestCharArraySet",17,0.38,3.82,347,5.02,299505.97,18,1,3,54,1,128.61,49,385,0,2,88.72,0.00,0.50,0.65,0,0.00,10,15048.01,0,0,1,org.apache.lucene.util.LuceneTestCase,0.00,37,1,65,0,37,17,0,32,2786,1
"org.apache.lucene.analysis.util.TestCharTokenizers",6,0.00,3.00,91,1.22,46118.28,6,0,11,30,8,96.51,25,83,0,3,96.28,0.00,0.67,0.00,0,6.00,4,3667.79,2,0,8,org.apache.lucene.analysis.BaseTokenStreamTestCase,0.00,24,2,18,0,24,6,0,11,664,1
"org.apache.lucene.analysis.util.TestCharTokenizers$Analyzer",1,0.00,1.00,4,0.03,555.18,1,0,11,3,1,126.93,0,6,0,1,126.93,0.00,0.00,0.00,0,1.00,1,102.01,0,1,1,java.lang.Object,0.00,2,0,1,0,2,0,0,0,27,0
"org.apache.lucene.analysis.util.TestCharTokenizers$Analyzer$LetterTokenizer",1,0.00,2.00,6,0.04,726.50,1,0,11,1,0,119.28,0,9,0,1,119.28,0.00,0.00,0.00,0,1.00,2,109.28,0,0,0,java.lang.Object,0.00,0,0,2,0,0,1,0,0,30,0
"org.apache.lucene.analysis.util.TestCharTokenizers$Analyzer_0",1,0.00,1.00,4,0.03,555.18,1,0,11,3,1,126.93,0,6,0,1,126.93,0.00,0.00,0.00,0,1.00,1,102.01,0,1,1,java.lang.Object,0.00,2,0,1,0,2,0,0,0,27,0
"org.apache.lucene.analysis.util.TestCharTokenizers$Analyzer_0$LetterTokenizer_1",1,0.00,2.00,6,0.04,726.50,1,0,11,1,0,119.28,0,9,0,1,119.28,0.00,0.00,0.00,0,1.00,2,109.28,0,0,0,java.lang.Object,0.00,0,0,2,0,0,1,0,0,30,0
"org.apache.lucene.analysis.util.TestCharacterUtils",7,0.00,1.86,111,1.87,72341.81,7,0,7,22,1,95.38,3,146,0,2,95.38,0.00,0.50,0.00,0,7.00,3,5601.65,0,0,1,org.apache.lucene.util.LuceneTestCase,0.00,15,1,13,0,15,7,0,1,1062,1
"org.apache.lucene.analysis.util.TestWordlistLoader",4,0.00,1.00,30,0.41,7710.25,4,0,5,13,2,134.22,14,44,0,2,113.61,0.00,0.50,0.00,1,4.00,1,1215.58,0,0,2,org.apache.lucene.util.LuceneTestCase,0.00,9,1,4,0,9,4,0,12,253,1
"org.apache.lucene.analysis.util.WordlistLoader",8,0.71,2.12,51,0.73,30394.10,9,1,5,19,17,65.13,86,78,14,1,113.61,0.00,0.00,0.38,2,14.00,5,2192.02,0,8,3,java.lang.Object,0.00,11,0,17,0,11,0,0,8,442,1
"org.apache.lucene.analysis.query.QueryAutoStopWordAnalyzer",9,0.06,1.89,49,0.78,23744.72,13,4,15,34,13,67.84,82,87,1,3,117.84,0.00,0.67,0.19,0,27.00,5,2338.31,0,4,12,org.apache.lucene.analysis.AnalyzerWrapper,0.00,25,2,17,0,25,5,0,10,475,2
"org.apache.lucene.analysis.query.QueryAutoStopWordAnalyzerTest",9,0.33,1.11,71,1.16,31778.40,15,6,11,26,10,161.51,9,83,0,3,111.51,0.00,0.67,0.46,0,0.00,2,3465.86,3,0,10,org.apache.lucene.analysis.BaseTokenStreamTestCase,0.00,17,2,10,0,17,9,0,9,682,1
"org.apache.lucene.search.grouping.function.FunctionAllGroupHeadsCollector",5,0.16,3.00,54,0.64,19819.93,13,8,13,19,12,125.73,19,57,3,3,105.11,0.00,0.67,0.25,0,1.00,5,1926.80,0,1,9,org.apache.lucene.search.grouping.AbstractAllGroupHeadsCollector,0.35,14,2,15,0,14,4,0,4,384,1
"org.apache.lucene.search.grouping.function.FunctionAllGroupHeadsCollector$GroupHead",3,0.50,2.00,24,0.30,10095.73,4,1,13,12,4,109.38,0,25,0,2,109.38,0.00,0.50,0.67,0,1.00,3,907.44,0,0,4,AbstractAllGroupHeadsCollector.GroupHead,0.00,9,1,6,0,9,3,0,0,185,0
"org.apache.lucene.search.grouping.function.FunctionAllGroupsCollector",4,0.27,1.75,19,0.22,4401.61,9,5,10,12,9,92.24,24,25,4,3,124.46,0.00,0.67,0.40,0,2.00,3,674.18,0,1,5,org.apache.lucene.search.grouping.AbstractAllGroupsCollector,0.50,8,2,7,0,8,3,0,4,154,1
"org.apache.lucene.search.grouping.function.FunctionDistinctValuesCollector",4,0.42,2.00,33,0.43,11553.36,12,8,8,16,7,159.90,5,39,1,3,109.90,0.00,0.67,0.44,0,0.00,4,1292.84,0,1,6,org.apache.lucene.search.grouping.AbstractDistinctValuesCollector,0.55,12,2,8,0,12,3,0,1,275,1
"org.apache.lucene.search.grouping.function.FunctionDistinctValuesCollector$GroupCount",1,0.00,1.00,3,0.02,233.40,1,0,8,1,1,134.55,0,5,0,2,134.55,0.00,0.50,0.00,0,1.00,1,65.13,0,0,1,AbstractDistinctValuesCollector.GroupCount,0.00,0,1,1,0,0,1,0,0,21,1
"org.apache.lucene.search.grouping.function.FunctionFirstPassGroupingCollector",4,0.17,1.75,22,0.24,4823.49,8,4,8,10,10,102.66,20,31,4,3,120.53,0.00,0.67,0.38,0,4.00,3,722.76,1,2,6,org.apache.lucene.search.grouping.AbstractFirstPassGroupingCollector,0.18,6,2,7,0,6,2,0,2,166,1
"org.apache.lucene.search.grouping.function.FunctionSecondPassGroupingCollector",3,0.38,1.67,17,0.24,4710.04,7,4,11,8,11,71.54,26,21,3,3,119.64,0.00,0.67,0.50,0,1.00,3,724.40,1,0,8,org.apache.lucene.search.grouping.AbstractSecondPassGroupingCollector,0.21,5,2,5,0,5,3,0,4,157,1
"org.apache.solr.util.plugin.AbstractPluginLoader",8,0.00,3.12,77,1.30,95111.10,12,4,11,21,7,54.57,82,117,3,1,103.05,0.00,0.00,0.25,3,16.00,12,3887.48,0,1,4,java.lang.Object,0.00,13,0,25,3,13,7,0,15,672,2
"org.apache.solr.util.plugin.AbstractPluginLoader$PluginInitInfo",1,2.00,1.00,6,0.04,417.53,3,2,11,1,0,121.34,0,10,0,1,121.34,0.00,0.00,0.00,0,1.00,1,112.24,0,0,0,java.lang.Object,0.00,0,0,1,0,0,1,0,0,33,1
"org.apache.solr.util.plugin.MapInitializedPlugin",1,0.00,1.00,2,0.01,91.08,1,0,1,1,0,112.12,6,3,0,1,144.34,0.00,0.00,0.00,0,1.00,1,41.70,0,0,0,,0.00,0,0,1,0,0,1,0,1,15,1
"org.apache.solr.util.plugin.MapPluginLoader",3,0.50,1.33,12,0.16,3231.29,4,1,3,7,2,174.60,5,21,0,2,124.60,0.00,0.50,0.67,0,1.00,2,486.73,0,0,2,org.apache.solr.util.plugin.AbstractPluginLoader,0.00,4,1,4,0,4,3,0,1,113,1
"org.apache.solr.util.plugin.NamedListInitializedPlugin",1,0.00,1.00,2,0.01,30.51,1,0,1,1,7,115.86,6,3,6,1,148.08,0.00,0.00,0.00,0,1.00,1,25.51,0,0,1,,0.00,0,0,1,0,0,1,0,1,11,1
"org.apache.solr.util.plugin.NamedListPluginLoader",3,0.50,1.33,11,0.14,2483.99,4,1,3,6,2,180.16,4,20,0,2,130.16,0.00,0.50,0.67,0,1.00,2,406.22,0,0,2,org.apache.solr.util.plugin.AbstractPluginLoader,0.00,3,1,4,0,3,3,0,1,99,1
"org.apache.solr.util.plugin.PluginInfoInitialized",1,0.00,1.00,2,0.01,41.48,1,0,1,1,7,114.81,6,3,6,1,147.03,0.00,0.00,0.00,0,1.00,1,27.65,0,0,1,,0.00,0,0,1,0,0,1,0,1,11,1
"org.apache.solr.util.plugin.ResourceLoaderAware",1,0.00,1.00,2,0.01,30.51,1,0,1,1,21,168.70,3,4,20,1,148.08,0.00,0.00,0.00,0,1.00,1,25.51,0,0,1,,0.00,0,0,1,0,0,1,0,1,11,1
"org.apache.solr.util.plugin.SolrCoreAware",1,0.00,1.00,2,0.01,30.51,1,0,1,1,12,168.70,3,4,11,1,148.08,0.00,0.00,0.00,0,1.00,1,25.51,0,0,1,,0.00,0,0,1,0,0,1,0,1,11,1
"org.apache.lucene.analysis.eu.BasqueAnalyzer",5,0.50,1.20,21,0.26,6053.81,7,2,15,16,13,76.12,42,31,1,3,124.22,0.00,0.67,0.10,0,8.00,2,777.74,0,2,12,org.apache.lucene.analysis.util.StopwordAnalyzerBase,0.00,11,2,6,0,11,3,0,8,177,2
"org.apache.lucene.analysis.eu.BasqueAnalyzer$DefaultSetHolder",0,0.00,0.00,6,0.05,732.71,1,1,15,0,2,171.00,2,11,0,1,171.00,0.00,0.00,0.00,0,0.00,0,149.07,0,0,2,java.lang.Object,0.00,0,0,0,0,0,0,0,2,37,2
"org.apache.lucene.analysis.eu.TestBasqueAnalyzer",4,0.00,1.00,15,0.16,2547.55,4,0,4,7,4,181.12,7,21,0,3,131.12,0.00,0.67,0.00,0,4.00,1,479.07,3,0,4,org.apache.lucene.analysis.BaseTokenStreamTestCase,0.00,3,2,4,0,3,4,0,6,114,1
"org.apache.solr.response.BinaryQueryResponseWriter",1,0.00,1.00,2,0.02,127.23,1,0,3,1,8,94.72,10,3,6,2,143.20,0.00,0.50,0.00,0,1.00,1,63.62,0,0,2,,0.00,0,1,1,0,0,1,0,2,19,1
"org.apache.solr.response.BinaryResponseWriter",5,2.00,1.40,48,0.73,18912.38,7,2,18,21,37,147.04,14,59,2,1,107.15,0.00,0.00,0.00,0,5.00,2,2181.11,0,2,35,java.lang.Object,0.00,16,0,7,0,16,3,1,4,440,1
"org.apache.solr.response.BinaryResponseWriter$Resolver",6,0.24,5.00,111,1.55,74378.24,11,5,18,49,15,131.46,12,137,0,1,91.57,0.00,0.00,0.40,3,0.00,9,4642.44,0,3,15,java.lang.Object,0.00,43,0,30,0,43,3,1,12,824,2
"org.apache.solr.response.CSVResponseWriter",3,0.00,1.00,9,0.08,1391.15,3,0,20,6,18,182.21,4,15,1,1,132.21,0.00,0.00,0.00,0,4.00,1,245.55,0,1,17,java.lang.Object,0.00,3,0,3,0,3,2,1,2,62,1
"org.apache.solr.response.CSVWriter",18,0.03,3.72,203,3.70,377415.96,41,23,20,75,18,147.82,23,269,1,2,97.82,0.00,0.50,0.07,2,0.00,40,11101.82,4,0,17,org.apache.solr.response.TextResponseWriter,0.07,57,1,67,0,57,18,0,23,1763,0
"org.apache.solr.response.CSVWriter$CSVField",0,0.00,0.00,6,0.05,785.16,5,5,20,1,2,171.00,3,7,0,1,171.00,0.00,0.00,0.00,0,0.00,0,162.85,0,0,2,java.lang.Object,0.00,1,0,0,0,1,0,0,3,36,1
"org.apache.solr.response.CSVWriter$CSVSharedBufPrinter",2,0.00,1.00,7,0.05,531.50,2,0,20,2,0,134.11,1,10,0,2,134.11,0.00,0.50,0.00,0,0.00,1,146.86,0,0,0,org.apache.solr.internal.csv.CSVPrinter,0.00,0,1,2,0,0,2,0,1,41,0
"org.apache.solr.response.CSVWriter$OpenCharArrayWriter",1,0.00,1.00,3,0.01,116.61,1,0,20,1,0,136.93,0,3,0,2,136.93,0.00,0.50,0.00,0,1.00,1,44.04,0,0,0,java.io.CharArrayWriter,0.00,0,1,1,0,0,1,0,0,15,1
"org.apache.solr.response.CSVWriter$ResettableFastWriter",5,0.17,1.20,22,0.15,2374.10,8,3,20,9,1,127.42,0,25,0,3,127.42,0.00,0.67,0.47,0,0.00,2,446.17,1,0,1,org.apache.solr.common.util.FastWriter,0.00,4,2,6,0,4,5,0,0,114,1
"org.apache.solr.response.JSONResponseWriter",3,0.50,1.33,14,0.14,2487.35,5,2,16,7,13,175.49,3,21,2,1,125.49,0.00,0.00,0.17,0,4.00,2,411.64,0,1,11,java.lang.Object,0.00,4,0,4,0,4,2,1,1,99,1
"org.apache.solr.response.JSONWriter",29,0.07,2.79,322,3.45,157415.26,38,9,16,55,14,152.51,56,379,4,2,102.51,3.00,0.20,0.05,17,114.00,12,10338.33,4,0,10,org.apache.solr.response.TextResponseWriter,0.03,26,1,81,3,26,29,0,41,1959,0
"org.apache.solr.response.JSONWriter$MultiValueField",1,2.00,1.00,7,0.07,1209.86,3,2,16,3,2,115.20,0,10,0,1,115.20,0.00,0.00,0.00,0,1.00,1,206.14,0,0,2,java.lang.Object,0.00,2,0,1,0,2,1,0,0,51,2
"org.apache.solr.response.JSONWriter$NaNFloatWriter",5,0.00,2.20,21,0.25,5797.95,5,0,16,12,3,124.23,0,31,0,3,124.23,0.00,0.67,0.00,4,7.00,4,748.07,0,2,3,org.apache.solr.response.JSONWriter,0.00,7,2,11,0,7,3,0,0,168,1
"org.apache.solr.response.PHPResponseWriter",3,1.00,1.00,10,0.09,1523.24,4,1,4,6,5,131.90,1,16,0,1,131.90,0.00,0.00,0.00,0,4.00,1,276.65,0,1,5,java.lang.Object,0.00,3,0,3,0,3,2,1,1,69,1
"org.apache.solr.response.PHPSerializedResponseWriter",3,1.00,1.00,10,0.09,1523.24,4,1,14,6,13,181.90,4,16,2,1,131.90,0.00,0.00,0.00,0,4.00,1,276.65,0,1,11,java.lang.Object,0.00,3,0,3,0,3,2,1,1,69,1
"org.apache.solr.response.PHPSerializedWriter",24,1.00,1.58,110,1.38,49433.09,25,1,14,46,11,122.34,10,164,1,3,122.34,0.00,0.67,0.04,13,122.00,7,4145.79,2,0,10,org.apache.solr.response.JSONWriter,0.27,22,2,38,0,22,24,0,10,875,0
"org.apache.solr.response.PHPWriter",9,0.00,1.33,37,0.40,14774.77,9,0,4,11,5,123.16,0,55,1,3,123.16,0.00,0.67,0.00,1,0.00,4,1189.42,1,0,4,org.apache.solr.response.JSONWriter,0.16,2,2,12,0,2,9,0,0,267,0
"org.apache.solr.response.PageTool",7,0.27,1.86,40,0.50,20436.55,12,5,6,19,8,117.50,6,54,1,1,117.50,0.00,0.00,0.43,0,0.00,7,1494.67,0,1,7,java.lang.Object,0.00,12,0,13,0,12,6,0,2,291,1
"org.apache.solr.response.PythonResponseWriter",3,1.00,1.00,10,0.09,1523.24,4,1,4,6,6,131.90,1,16,1,1,131.90,0.00,0.00,0.00,0,4.00,1,276.65,0,1,5,java.lang.Object,0.00,3,0,3,0,3,2,1,1,69,1
"org.apache.solr.response.PythonWriter",7,0.00,2.29,46,0.52,32276.11,7,0,4,14,4,95.06,37,53,1,2,112.93,0.00,0.50,0.00,1,7.00,9,1546.80,0,2,3,org.apache.solr.response.NaNFloatWriter,0.00,7,1,16,0,7,5,0,6,300,0
"org.apache.solr.response.QueryResponseWriter",3,3.00,1.00,7,0.07,681.82,6,3,5,3,27,130.86,47,8,23,2,141.21,0.00,0.50,0.00,0,3.00,1,216.29,0,1,4,,0.00,0,1,3,0,0,2,0,4,59,1
"org.apache.solr.response.RawResponseWriter",5,0.00,2.00,35,0.46,13332.00,7,2,8,19,8,94.47,26,56,2,1,112.34,0.00,0.00,0.50,1,4.00,3,1377.00,0,2,6,java.lang.Object,0.00,14,0,10,0,14,3,1,6,283,1
"org.apache.solr.response.ResultContext",0,0.00,0.00,3,0.01,88.76,2,2,2,0,10,171.00,5,4,8,1,171.00,0.00,0.00,0.00,0,0.00,0,44.38,0,0,2,java.lang.Object,0.00,0,0,0,0,0,0,0,1,14,1
"org.apache.solr.response.RubyResponseWriter",3,1.00,1.00,10,0.09,1523.24,4,1,4,6,6,131.90,1,16,1,1,131.90,0.00,0.00,0.00,0,4.00,1,276.65,0,1,5,java.lang.Object,0.00,3,0,3,0,3,2,1,1,69,1
"org.apache.solr.response.RubyWriter",6,0.00,1.50,27,0.27,8675.30,6,0,4,8,4,173.56,6,35,1,2,123.56,0.00,0.50,0.00,1,6.00,4,805.98,0,2,3,org.apache.solr.response.NaNFloatWriter,0.00,2,1,9,0,2,4,0,6,181,0
"org.apache.solr.response.SolrParamResourceLoader",5,0.75,1.80,20,0.29,7147.32,6,1,11,17,3,123.56,4,34,1,2,123.56,0.00,0.50,0.40,0,7.00,3,875.26,0,1,2,org.apache.velocity.runtime.resource.loader.ResourceLoader,0.00,12,1,9,0,12,4,0,4,187,1
"org.apache.solr.response.SolrQueryResponse",16,0.06,1.19,45,0.36,5981.57,22,6,4,21,147,97.18,119,64,144,1,139.47,0.00,0.00,0.11,1,134.00,2,1081.57,0,5,3,java.lang.Object,0.00,5,0,19,0,5,11,0,23,284,1
"org.apache.solr.response.SolrVelocityResourceLoader",5,1.00,1.00,12,0.10,1109.88,6,1,6,6,2,141.29,1,22,1,2,141.29,0.00,0.50,0.20,0,8.00,1,289.34,0,1,1,org.apache.velocity.runtime.resource.loader.ResourceLoader,0.00,1,1,5,0,1,4,0,1,81,1
"org.apache.solr.response.TestCSVResponseWriter",3,0.00,1.33,72,1.69,122056.41,3,0,8,21,9,50.93,18,94,0,3,83.15,0.00,0.67,0.00,1,4.00,2,5064.05,5,0,9,org.apache.solr.SolrTestCaseJ4,0.00,18,2,4,0,18,3,0,18,739,1
"org.apache.solr.response.TestPHPSerializedResponseWriter",3,0.00,1.00,40,0.55,15510.26,3,0,14,18,8,120.82,10,49,0,3,100.20,0.00,0.67,0.00,0,3.00,1,1640.39,1,0,8,org.apache.solr.SolrTestCaseJ4,0.00,15,2,3,0,15,3,0,7,295,1
"org.apache.solr.response.TextResponseWriter",36,0.06,2.08,197,2.89,145598.96,45,9,19,94,45,166.35,44,225,29,1,116.35,0.00,0.00,0.05,19,354.00,27,8657.74,0,2,18,java.lang.Object,0.00,58,0,75,6,58,34,0,41,1617,2
"org.apache.solr.response.VelocityResponseWriter",6,0.00,3.17,88,1.43,78009.38,6,0,12,48,11,95.82,25,117,1,1,95.59,0.00,0.00,0.00,3,6.00,6,4304.04,0,4,10,java.lang.Object,0.00,42,0,19,0,42,2,1,25,736,1
"org.apache.solr.response.XMLResponseWriter",3,0.00,1.00,9,0.08,1391.15,3,0,4,6,6,182.21,4,15,1,1,132.21,0.00,0.00,0.00,0,4.00,1,245.55,0,1,5,java.lang.Object,0.00,3,0,3,0,3,2,1,2,62,1
"org.apache.solr.response.XMLWriter",24,0.14,2.38,166,2.13,60146.13,30,6,13,60,14,165.01,34,228,5,2,115.01,0.00,0.50,0.03,6,86.00,7,6402.65,4,0,9,org.apache.solr.response.TextResponseWriter,0.03,36,1,57,0,36,24,0,17,1283,1
"org.apache.solr.response.XSLTResponseWriter",4,0.21,2.75,51,0.78,26610.36,12,8,19,33,9,100.64,17,65,0,1,100.41,0.00,0.00,0.28,1,6.00,5,2325.79,0,2,9,java.lang.Object,0.00,29,0,11,0,29,2,1,11,438,1
"org.apache.lucene.analysis.es.SpanishAnalyzer",5,0.50,1.40,24,0.30,7762.08,7,2,17,18,16,73.34,49,35,1,3,123.34,0.00,0.67,0.10,0,8.00,3,894.00,0,2,15,org.apache.lucene.analysis.util.StopwordAnalyzerBase,0.00,13,2,7,0,13,3,0,8,196,2
"org.apache.lucene.analysis.es.SpanishAnalyzer$DefaultSetHolder",0,0.00,0.00,6,0.07,1089.77,1,1,17,0,4,171.00,2,11,0,1,171.00,0.00,0.00,0.00,0,0.00,0,202.05,0,0,4,java.lang.Object,0.00,0,0,0,0,0,0,0,2,47,2
"org.apache.lucene.analysis.es.SpanishLightStemFilter",2,0.33,2.00,14,0.16,3794.18,5,3,6,9,10,113.74,9,20,4,4,113.50,0.00,0.75,0.50,0,2.00,3,481.98,0,0,6,org.apache.lucene.analysis.TokenFilter,0.29,7,3,4,0,7,2,0,1,107,2
"org.apache.lucene.analysis.es.SpanishLightStemmer",1,0.00,13.00,25,0.50,37209.13,1,0,0,1,1,45.40,56,44,1,1,82.27,0.00,0.00,0.00,0,1.00,13,1513.96,0,0,0,java.lang.Object,0.00,0,0,13,0,0,1,0,4,260,1
"org.apache.lucene.analysis.es.TestSpanishAnalyzer",4,0.00,1.00,15,0.16,2494.63,4,0,4,7,4,181.19,7,21,0,3,131.19,0.00,0.67,0.00,0,4.00,1,481.49,3,0,4,org.apache.lucene.analysis.BaseTokenStreamTestCase,0.00,3,2,4,0,3,4,0,6,114,1
"org.apache.lucene.analysis.es.TestSpanishLightStemFilter",3,0.00,1.00,10,0.08,885.78,3,0,8,6,5,183.75,5,15,0,3,133.75,0.00,0.67,0.00,0,3.00,1,234.73,2,0,5,org.apache.lucene.analysis.BaseTokenStreamTestCase,0.00,3,2,3,0,3,3,0,3,63,1
"org.apache.lucene.analysis.es.TestSpanishLightStemFilter$Analyzer",1,0.00,1.00,4,0.05,1009.20,1,0,8,4,3,124.89,0,7,0,1,124.89,0.00,0.00,0.00,0,1.00,1,159.62,0,1,3,java.lang.Object,0.00,3,0,1,0,3,0,0,0,38,0
"org.apache.lucene.analysis.es.TestSpanishLightStemFilter$Analyzer_0",1,0.00,1.00,4,0.05,753.46,1,0,8,4,3,125.89,0,6,0,1,125.89,0.00,0.00,0.00,0,1.00,1,135.44,0,1,3,java.lang.Object,0.00,3,0,1,0,3,0,0,0,34,0
"org.apache.lucene.analysis.compound.CompoundWordTokenFilterBase",6,0.11,1.67,50,0.62,17708.10,19,13,11,17,13,92.00,31,62,6,4,109.87,0.67,0.50,0.17,1,14.00,5,1865.89,1,0,7,org.apache.lucene.analysis.TokenFilter,0.44,11,3,10,2,11,6,0,11,368,2
"org.apache.lucene.analysis.compound.CompoundWordTokenFilterBase$CompoundToken",1,3.00,2.00,14,0.18,9502.41,4,3,11,5,1,97.00,4,17,0,1,96.76,0.00,0.00,0.00,0,1.00,2,536.43,0,0,1,java.lang.Object,0.00,4,0,2,0,4,1,0,4,117,1
"org.apache.lucene.analysis.compound.DictionaryCompoundWordTokenFilter",3,0.00,3.67,29,0.34,24498.94,3,0,5,9,9,103.83,49,37,5,5,104.30,0.00,0.80,0.00,0,4.00,9,1008.54,0,0,4,org.apache.lucene.analysis.compound.CompoundWordTokenFilterBase,0.24,6,4,11,0,6,3,0,3,200,1
"org.apache.lucene.analysis.compound.HyphenationCompoundWordTokenFilter",8,1.00,2.75,60,0.82,86787.33,9,1,8,21,10,69.90,99,91,4,5,107.47,0.00,0.80,0.12,1,22.00,15,2446.56,0,3,6,org.apache.lucene.analysis.compound.CompoundWordTokenFilterBase,0.19,13,4,22,0,13,5,0,19,474,1
"org.apache.lucene.analysis.compound.TestCompoundWordTokenFilter",13,0.00,1.08,102,2.48,57002.67,13,0,21,39,19,160.78,14,212,0,3,110.78,0.00,0.67,0.00,1,13.00,2,7437.38,4,1,19,org.apache.lucene.analysis.BaseTokenStreamTestCase,0.00,26,2,14,0,26,12,0,11,1308,1
"org.apache.lucene.analysis.compound.TestCompoundWordTokenFilter$Analyzer",2,0.00,1.00,7,0.09,1698.33,2,0,21,7,6,130.14,0,11,0,1,130.14,0.00,0.00,0.00,0,2.00,1,284.72,0,2,6,java.lang.Object,0.00,5,0,2,0,5,0,0,0,66,0
"org.apache.lucene.analysis.compound.TestCompoundWordTokenFilter$Analyzer_0",1,0.00,1.00,4,0.06,1051.87,1,0,21,4,3,124.74,0,6,0,1,124.74,0.00,0.00,0.00,0,1.00,1,173.06,0,1,3,java.lang.Object,0.00,3,0,1,0,3,0,0,0,40,0
"org.apache.lucene.analysis.compound.TestCompoundWordTokenFilter$Analyzer_1",1,0.00,1.00,5,0.07,1236.33,1,0,21,4,4,120.58,0,7,0,1,120.58,0.00,0.00,0.00,0,1.00,1,200.72,0,1,4,java.lang.Object,0.00,3,0,1,0,3,0,0,0,45,0
"org.apache.lucene.analysis.compound.TestCompoundWordTokenFilter$Analyzer_2",1,0.00,1.00,4,0.05,790.45,1,0,21,4,3,125.72,0,6,0,1,125.72,0.00,0.00,0.00,0,1.00,1,148.55,0,1,3,java.lang.Object,0.00,3,0,1,0,3,0,0,0,36,0
"org.apache.lucene.analysis.compound.TestCompoundWordTokenFilter$Analyzer_3",1,0.00,1.00,5,0.06,949.28,1,0,21,4,4,121.48,0,7,0,1,121.48,0.00,0.00,0.00,0,1.00,1,175.37,0,1,4,java.lang.Object,0.00,3,0,1,0,3,0,0,0,41,0
"org.apache.lucene.analysis.compound.TestCompoundWordTokenFilter$MockRetainAttribute",2,0.00,1.00,3,0.02,79.66,2,0,21,2,0,158.40,0,4,0,2,158.40,0.00,0.50,0.00,0,2.00,1,45.97,0,0,0,,0.00,0,1,2,0,0,2,0,0,18,2
"org.apache.lucene.analysis.compound.TestCompoundWordTokenFilter$MockRetainAttributeFilter",2,1.00,1.50,10,0.08,1295.35,3,1,21,4,2,122.69,0,15,0,4,122.69,0.00,0.75,0.50,0,2.00,2,225.48,0,0,2,org.apache.lucene.analysis.TokenFilter,0.29,2,3,3,0,2,2,0,0,58,2
"org.apache.lucene.analysis.compound.TestCompoundWordTokenFilter$MockRetainAttributeImpl",4,0.33,1.00,11,0.09,1203.44,5,1,21,5,1,140.25,0,18,0,2,140.25,0.00,0.50,0.75,0,0.00,1,270.49,0,0,1,org.apache.lucene.util.AttributeImpl,0.22,1,1,4,0,1,4,1,0,73,3
"org.apache.lucene.facet.enhancements.params.DefaultEnhancementsIndexingParams",6,0.60,2.67,34,0.33,11792.60,7,1,6,14,9,100.89,30,50,4,3,118.77,0.00,0.67,0.50,2,6.00,7,989.00,0,2,5,org.apache.lucene.facet.index.params.PerDimensionIndexingParams,0.00,8,2,16,0,8,4,1,4,225,1
"org.apache.lucene.facet.enhancements.params.DefaultEnhancementsIndexingParamsTest",1,0.00,2.00,14,0.23,8307.61,1,0,10,15,7,115.36,18,25,0,2,97.22,0.00,0.50,0.00,0,1.00,2,696.88,0,0,7,org.apache.lucene.util.LuceneTestCase,0.00,14,1,2,0,14,1,0,3,128,1
"org.apache.lucene.facet.enhancements.params.EnhancementsIndexingParams",3,0.00,1.00,4,0.04,296.42,3,0,6,3,16,144.93,46,5,13,2,155.29,0.00,0.50,0.00,0,3.00,1,108.48,0,2,5,,0.00,0,1,3,0,0,1,0,5,35,1
"org.tartarus.snowball.Among",1,6.00,3.00,20,0.25,8587.16,8,7,1,6,1,59.02,6,27,1,1,91.24,0.00,0.00,0.14,0,0.00,3,757.94,0,0,1,java.lang.Object,0.00,5,0,3,0,5,1,0,6,152,1
"org.tartarus.snowball.SnowballProgram",29,0.24,3.34,264,3.09,256392.72,36,7,3,42,32,124.66,88,336,30,1,104.05,0.00,0.00,0.37,6,0.00,18,9258.94,0,1,3,java.lang.Object,0.00,13,0,97,23,13,28,0,29,1777,2
"org.tartarus.snowball.TestApp",2,0.00,5.50,46,0.69,53937.48,2,0,10,27,1,84.92,0,56,0,1,84.92,0.00,0.00,0.00,1,2.00,10,2080.49,0,0,1,java.lang.Object,0.00,25,0,11,0,25,2,0,0,328,1
"org.apache.lucene.analysis.en.EnglishAnalyzer",5,1.00,1.40,21,0.27,6907.33,6,1,13,17,15,75.63,42,32,2,3,123.73,0.00,0.67,0.20,0,8.00,3,816.68,0,2,13,org.apache.lucene.analysis.util.StopwordAnalyzerBase,0.00,12,2,7,0,12,3,0,8,182,2
"org.apache.lucene.analysis.en.EnglishAnalyzer$DefaultSetHolder",0,0.00,0.00,2,0.02,222.03,1,1,13,0,2,171.00,0,3,0,1,171.00,0.00,0.00,0.00,0,0.00,0,55.51,0,0,2,java.lang.Object,0.00,0,0,0,0,0,0,0,0,15,2
"org.apache.lucene.analysis.en.EnglishMinimalStemFilter",2,0.33,2.00,14,0.16,3794.18,5,3,6,9,9,113.74,9,20,3,4,113.50,0.00,0.75,0.50,0,2.00,3,481.98,0,0,6,org.apache.lucene.analysis.TokenFilter,0.29,7,3,4,0,7,2,0,1,107,2
"org.apache.lucene.analysis.en.EnglishMinimalStemmer",1,0.00,4.00,10,0.24,22653.59,1,0,0,1,1,148.36,24,19,1,1,99.08,0.00,0.00,0.00,0,1.00,4,711.28,0,0,0,java.lang.Object,0.00,0,0,4,0,0,1,0,3,139,1
"org.apache.lucene.analysis.en.EnglishPossessiveFilter",3,0.25,1.67,17,0.27,11184.24,5,2,5,8,6,98.81,15,27,3,4,116.68,0.00,0.75,0.33,0,4.00,3,819.66,0,0,3,org.apache.lucene.analysis.TokenFilter,0.27,5,3,5,0,5,3,0,3,167,2
"org.apache.lucene.analysis.en.KStemData1",1,1.00,1.00,3,13.79,124057.50,2,1,0,1,1,133.71,3,706,1,1,113.09,0.00,0.00,0.00,0,1.00,1,41356.50,0,0,0,java.lang.Object,0.00,0,0,1,0,0,1,0,2,3515,0
"org.apache.lucene.analysis.en.KStemData2",1,1.00,1.00,3,13.79,124057.50,2,1,0,1,1,152.98,2,706,1,1,113.09,0.00,0.00,0.00,0,1.00,1,41356.50,0,0,0,java.lang.Object,0.00,0,0,1,0,0,1,0,1,3515,0
"org.apache.lucene.analysis.en.KStemData3",1,1.00,1.00,3,13.79,124057.50,2,1,0,1,1,152.98,2,706,1,1,113.09,0.00,0.00,0.00,0,1.00,1,41356.50,0,0,0,java.lang.Object,0.00,0,0,1,0,0,1,0,1,3515,0
"org.apache.lucene.analysis.en.KStemData4",1,1.00,1.00,3,13.79,124057.50,2,1,0,1,1,152.98,2,706,1,1,113.09,0.00,0.00,0.00,0,1.00,1,41356.50,0,0,0,java.lang.Object,0.00,0,0,1,0,0,1,0,1,3515,0
"org.apache.lucene.analysis.en.KStemData5",1,1.00,1.00,3,13.79,124057.50,2,1,0,1,1,152.98,2,706,1,1,113.09,0.00,0.00,0.00,0,1.00,1,41356.50,0,0,0,java.lang.Object,0.00,0,0,1,0,0,1,0,1,3515,0
"org.apache.lucene.analysis.en.KStemData6",1,1.00,1.00,3,13.79,124057.50,2,1,0,1,1,152.98,2,706,1,1,113.09,0.00,0.00,0.00,0,1.00,1,41356.50,0,0,0,java.lang.Object,0.00,0,0,1,0,0,1,0,1,3515,0
"org.apache.lucene.analysis.en.KStemData7",1,1.00,1.00,3,13.79,124057.50,2,1,0,1,1,152.98,2,706,1,1,113.09,0.00,0.00,0.00,0,1.00,1,41356.50,0,0,0,java.lang.Object,0.00,0,0,1,0,0,1,0,1,3515,0
"org.apache.lucene.analysis.en.KStemData8",1,1.00,1.00,3,11.58,104193.97,2,1,0,1,1,153.57,2,605,1,1,113.69,0.00,0.00,0.00,0,1.00,1,34735.32,0,0,0,java.lang.Object,0.00,0,0,1,0,0,1,0,1,3010,0
"org.apache.lucene.analysis.en.KStemFilter",2,0.33,2.00,13,0.18,4480.96,5,3,5,11,8,83.21,13,19,3,4,115.43,0.00,0.75,0.50,0,2.00,3,553.15,0,0,5,org.apache.lucene.analysis.TokenFilter,0.29,9,3,4,0,9,2,0,2,119,2
"org.apache.lucene.analysis.en.KStemmer",43,0.09,5.26,729,11.56,864438.22,59,16,3,65,11,43.71,383,973,1,1,91.81,0.00,0.00,0.15,29,0.00,27,34678.02,0,6,10,java.lang.Object,0.00,22,0,226,0,22,37,0,204,5722,1
"org.apache.lucene.analysis.en.KStemmer$DictEntry",1,2.00,1.00,6,0.04,350.01,3,2,3,1,0,121.94,0,8,0,1,121.94,0.00,0.00,0.00,0,1.00,1,109.32,0,0,0,java.lang.Object,0.00,0,0,1,0,0,1,0,0,32,1
"org.apache.lucene.analysis.en.PorterStemFilter",2,0.33,2.00,10,0.17,3936.19,5,3,5,11,14,81.27,24,16,9,4,118.83,0.00,0.75,0.50,0,2.00,3,501.61,0,0,5,org.apache.lucene.analysis.TokenFilter,0.29,9,3,4,0,9,2,0,1,111,2
"org.apache.lucene.analysis.en.PorterStemmer",27,0.15,6.96,291,3.24,141694.34,34,7,5,46,3,104.19,116,333,2,1,103.96,0.00,0.00,0.29,14,0.00,52,9717.31,0,2,1,java.lang.Object,0.00,19,0,188,0,19,25,0,33,1867,0
"org.apache.lucene.analysis.en.TestEnglishAnalyzer",4,0.00,1.00,18,0.19,3518.31,4,0,4,7,4,165.24,8,24,0,3,125.36,0.00,0.67,0.00,0,4.00,1,569.01,3,0,4,org.apache.lucene.analysis.BaseTokenStreamTestCase,0.00,3,2,4,0,3,4,0,7,132,1
"org.apache.lucene.analysis.en.TestEnglishMinimalStemFilter",3,0.00,1.00,18,0.15,2182.23,3,0,7,5,5,169.44,5,23,0,3,119.44,0.00,0.67,0.00,0,3.00,1,458.91,3,0,5,org.apache.lucene.analysis.BaseTokenStreamTestCase,0.00,2,2,3,0,2,3,0,3,109,1
"org.apache.lucene.analysis.en.TestEnglishMinimalStemFilter$Analyzer",1,0.00,1.00,4,0.05,1009.20,1,0,7,4,3,124.89,0,7,0,1,124.89,0.00,0.00,0.00,0,1.00,1,159.62,0,1,3,java.lang.Object,0.00,3,0,1,0,3,0,0,0,38,0
"org.apache.lucene.analysis.en.TestEnglishMinimalStemFilter$Analyzer_0",1,0.00,1.00,4,0.05,753.46,1,0,7,4,3,125.89,0,6,0,1,125.89,0.00,0.00,0.00,0,1.00,1,135.44,0,1,3,java.lang.Object,0.00,3,0,1,0,3,0,0,0,34,0
"org.apache.lucene.analysis.en.TestKStemmer",3,0.00,1.00,10,0.08,839.54,3,0,8,6,5,96.37,36,15,0,3,133.93,0.00,0.67,0.00,0,3.00,1,232.88,2,0,5,org.apache.lucene.analysis.BaseTokenStreamTestCase,0.00,3,2,3,0,3,3,0,4,63,1
"org.apache.lucene.analysis.en.TestKStemmer$Analyzer",1,0.00,1.00,4,0.05,1009.20,1,0,8,4,3,124.89,0,6,0,1,124.89,0.00,0.00,0.00,0,1.00,1,159.62,0,1,3,java.lang.Object,0.00,3,0,1,0,3,0,0,0,38,0
"org.apache.lucene.analysis.en.TestKStemmer$Analyzer_0",1,0.00,1.00,4,0.05,753.46,1,0,8,4,3,125.89,0,6,0,1,125.89,0.00,0.00,0.00,0,1.00,1,135.44,0,1,3,java.lang.Object,0.00,3,0,1,0,3,0,0,0,34,0
"org.apache.lucene.analysis.en.TestPorterStemFilter",4,0.00,1.00,16,0.18,2612.30,4,0,12,13,9,166.26,8,22,0,3,126.37,0.00,0.67,0.00,0,4.00,1,540.96,3,0,9,org.apache.lucene.analysis.BaseTokenStreamTestCase,0.00,9,2,4,0,9,4,0,3,124,1
"org.apache.lucene.analysis.en.TestPorterStemFilter$Analyzer",1,0.00,1.00,4,0.05,1009.20,1,0,12,4,3,124.89,0,7,0,1,124.89,0.00,0.00,0.00,0,1.00,1,159.62,0,1,3,java.lang.Object,0.00,3,0,1,0,3,0,0,0,38,0
"org.apache.lucene.analysis.en.TestPorterStemFilter$Analyzer_0",1,0.00,1.00,4,0.05,753.46,1,0,12,4,3,125.89,0,6,0,1,125.89,0.00,0.00,0.00,0,1.00,1,135.44,0,1,3,java.lang.Object,0.00,3,0,1,0,3,0,0,0,34,0
"org.apache.lucene.spatial.util.CachedDistanceValueSource",5,0.08,2.60,24,0.36,14912.91,8,3,8,13,7,170.96,5,35,2,2,120.96,0.00,0.50,0.40,0,5.00,7,1071.97,0,2,5,org.apache.lucene.queries.function.ValueSource,0.31,8,1,13,0,8,3,0,1,238,1
"org.apache.lucene.spatial.util.CachedDistanceValueSource$FunctionValues",3,0.00,1.67,16,0.20,6092.51,3,0,8,7,0,118.76,1,21,0,1,118.76,0.00,0.00,0.00,1,4.00,3,593.16,0,1,0,java.lang.Object,0.00,4,0,5,0,4,2,0,1,126,0
"org.apache.lucene.spatial.util.CachingDoubleValueSource",5,0.00,2.00,20,0.27,8560.20,7,2,6,12,5,122.92,0,31,2,2,122.92,0.00,0.50,0.50,0,0.00,5,797.01,0,2,3,org.apache.lucene.queries.function.ValueSource,0.31,7,1,10,0,7,3,0,0,182,1
"org.apache.lucene.spatial.util.CachingDoubleValueSource$FunctionValues",3,0.00,1.33,12,0.14,3518.62,3,0,6,7,0,124.31,0,19,0,1,124.31,0.00,0.00,0.00,1,4.00,2,426.92,0,1,0,java.lang.Object,0.00,4,0,4,0,4,2,0,0,99,0
"org.apache.lucene.spatial.util.NumericFieldInfo",2,0.67,2.00,14,0.16,3743.03,5,3,3,8,5,153.43,4,19,2,1,113.55,0.00,0.00,0.67,0,0.00,2,487.56,0,1,3,java.lang.Object,0.00,6,0,4,0,6,1,0,2,109,1
"org.apache.lucene.spatial.util.ShapeFieldCache",3,0.25,1.33,15,0.16,3791.31,5,2,3,5,2,120.44,0,19,2,2,120.44,0.00,0.50,0.67,0,0.00,2,466.49,0,1,0,Shape>,0.00,2,1,4,0,2,2,0,0,109,1
"org.apache.lucene.spatial.util.ShapeFieldCacheProvider",3,0.12,2.67,37,0.57,29636.45,7,4,7,17,8,99.06,1,45,1,2,99.06,1.00,0.33,0.33,1,4.00,6,1717.76,0,0,7,Shape>,0.00,14,1,8,1,14,3,0,1,307,2
"org.apache.lucene.spatial.util.StringListTokenizer",3,0.17,1.33,16,0.16,2908.27,6,3,4,8,2,171.34,3,23,0,3,121.34,0.00,0.67,0.44,0,1.00,2,484.86,1,0,2,org.apache.lucene.analysis.TokenStream,0.55,5,2,4,0,5,3,0,1,113,2
"org.apache.lucene.spatial.util.TruncateFilter",2,0.00,2.00,12,0.12,2326.47,4,2,4,5,3,117.67,0,18,0,4,117.67,0.00,0.75,0.50,0,2.00,3,345.65,0,0,3,org.apache.lucene.analysis.TokenFilter,0.29,3,3,4,0,3,2,0,0,82,1
"org.apache.lucene.spatial.util.ValueSourceFilter",2,0.25,1.50,15,0.15,3305.56,6,4,8,5,8,114.04,0,21,1,2,114.04,0.00,0.50,0.12,0,2.00,2,435.18,0,1,7,org.apache.lucene.search.Filter,0.00,3,1,3,0,3,1,0,0,101,1
"org.apache.lucene.spatial.util.ValueSourceFilter$FilteredDocIdSet",1,0.00,1.00,4,0.05,999.88,1,0,8,2,0,124.92,0,6,0,1,124.92,0.00,0.00,0.00,0,0.00,1,156.56,0,0,0,java.lang.Object,0.00,1,0,1,0,1,1,0,0,38,0
"org.apache.solr.uima.processor.exception.FieldMappingException",1,0.00,1.00,2,0.01,54.28,1,0,0,1,1,172.39,19,4,1,2,146.11,0.00,0.50,0.00,0,1.00,1,31.02,0,0,0,java.lang.Exception,0.00,0,1,1,0,0,1,0,2,12,1
"org.apache.lucene.analysis.el.GreekAnalyzer",4,1.00,1.50,16,0.20,5082.85,5,1,12,11,13,86.44,50,25,2,3,124.00,0.00,0.67,0.00,0,6.00,3,613.22,0,2,11,org.apache.lucene.analysis.util.StopwordAnalyzerBase,0.00,7,2,6,0,7,2,0,6,139,2
"org.apache.lucene.analysis.el.GreekAnalyzer$DefaultSetHolder",0,0.00,0.00,6,0.05,742.22,1,1,12,0,2,171.00,2,10,0,1,171.00,0.00,0.00,0.00,0,0.00,0,152.24,0,0,2,java.lang.Object,0.00,0,0,0,0,0,0,0,2,38,2
"org.apache.lucene.analysis.el.GreekAnalyzerTest",4,0.00,1.00,18,0.33,5318.84,4,0,3,5,3,75.84,33,36,0,3,123.94,0.00,0.67,0.00,0,4.00,1,999.94,3,0,3,org.apache.lucene.analysis.BaseTokenStreamTestCase,0.00,1,2,4,0,1,4,0,21,200,1
"org.apache.lucene.analysis.el.GreekLowerCaseFilter",3,0.25,1.67,30,0.39,8161.76,5,2,6,10,7,139.92,60,59,3,4,106.53,0.00,0.75,0.33,1,4.00,3,1168.71,0,0,4,org.apache.lucene.analysis.TokenFilter,0.27,7,3,5,0,7,3,0,36,230,2
"org.apache.lucene.analysis.el.GreekStemFilter",2,0.33,2.00,14,0.16,3794.18,5,3,6,9,9,71.21,14,20,3,4,113.50,0.00,0.75,0.50,0,2.00,3,481.98,0,0,6,org.apache.lucene.analysis.TokenFilter,0.29,7,3,4,0,7,2,0,1,107,2
"org.apache.lucene.analysis.el.GreekStemmer",27,0.03,4.74,286,8.53,459291.82,43,16,3,32,2,150.02,49,681,1,1,100.02,0.00,0.00,0.04,4,352.00,16,25590.34,0,0,1,java.lang.Object,0.00,5,0,128,0,5,27,0,26,4297,1
"org.apache.lucene.analysis.el.TestGreekStemmer",7,0.00,1.00,353,4.70,106666.15,8,1,6,9,5,24.69,63,361,0,3,74.69,0.00,0.67,1.00,0,0.00,1,14098.12,2,0,5,org.apache.lucene.analysis.BaseTokenStreamTestCase,0.00,2,2,7,0,2,7,0,63,2127,1
"org.apache.lucene.analysis.el.TestGreekStemmer$Analyzer",1,0.00,1.00,4,0.05,753.46,1,0,6,4,3,125.89,0,6,0,1,125.89,0.00,0.00,0.00,0,1.00,1,135.44,0,1,3,java.lang.Object,0.00,3,0,1,0,3,0,0,0,34,0
"org.apache.lucene.facet.taxonomy.directory.Consts",0,0.00,0.00,7,0.09,2023.68,5,5,5,1,6,171.00,34,8,3,1,171.00,0.00,0.00,0.00,0,0.00,0,266.27,0,0,3,java.lang.Object,0.00,1,0,0,0,1,0,0,5,56,1
"org.apache.lucene.facet.taxonomy.directory.Consts$LoadFullPathOnly",3,0.00,1.33,8,0.08,1224.29,4,1,5,3,2,139.15,0,13,0,2,139.15,0.00,0.50,1.00,0,0.00,2,237.52,0,2,2,org.apache.lucene.index.StoredFieldVisitor,0.00,0,1,4,0,0,1,0,0,61,3
"org.apache.lucene.facet.taxonomy.directory.DirectoryTaxonomyReader",22,0.06,2.36,213,2.43,111686.32,33,11,24,87,42,61.90,242,275,25,1,106.03,0.00,0.00,0.15,8,210.00,7,7296.00,0,6,17,java.lang.Object,0.00,65,0,52,1,65,16,1,148,1400,1
"org.apache.lucene.facet.taxonomy.directory.DirectoryTaxonomyReader$ChildrenArraysImpl",3,0.25,1.00,9,0.06,1000.49,5,2,24,3,0,133.33,0,13,0,1,133.33,0.00,0.00,0.33,0,5.00,1,191.43,0,0,0,java.lang.Object,0.00,0,0,3,0,0,3,1,0,55,3
"org.apache.lucene.facet.taxonomy.directory.DirectoryTaxonomyWriter",37,0.04,2.49,330,4.16,298765.70,52,15,48,110,67,68.77,455,429,31,1,106.34,0.00,0.00,0.10,15,414.00,17,12476.76,0,9,37,java.lang.Object,0.00,73,0,92,1,73,28,1,191,2327,1
"org.apache.lucene.facet.taxonomy.directory.DirectoryTaxonomyWriter$DiskOrdinalMap",5,0.08,1.80,33,0.35,12663.26,8,3,48,17,0,165.04,5,46,0,1,115.04,0.00,0.00,0.40,1,0.00,4,1043.23,0,0,0,java.lang.Object,0.00,12,0,9,0,12,5,1,5,226,3
"org.apache.lucene.facet.taxonomy.directory.DirectoryTaxonomyWriter$MemoryOrdinalMap",4,0.33,1.00,9,0.08,1207.55,5,1,48,4,0,140.24,1,17,0,1,140.24,0.00,0.00,0.75,0,0.00,1,247.42,0,0,0,java.lang.Object,0.00,0,0,4,0,0,4,1,1,69,3
"org.apache.lucene.facet.taxonomy.directory.DirectoryTaxonomyWriter$OrdinalMap",4,0.00,1.00,5,0.04,264.84,4,0,48,4,0,156.90,18,6,0,1,156.66,0.00,0.00,0.00,0,4.00,1,120.33,0,0,0,,0.00,0,0,4,0,0,4,0,3,40,2
"org.apache.lucene.facet.taxonomy.directory.DirectoryTaxonomyWriter$SinglePositionTokenStream",3,0.50,1.33,17,0.13,1737.34,6,3,48,6,3,123.34,12,23,0,3,123.10,0.00,0.67,0.67,0,0.00,2,393.16,0,0,3,org.apache.lucene.analysis.TokenStream,0.27,3,2,4,0,3,3,0,1,98,2
"org.apache.lucene.facet.taxonomy.directory.ParentArray",3,0.00,4.33,43,0.58,41753.48,4,1,9,14,11,143.11,81,61,2,1,95.28,0.00,0.00,1.00,0,0.00,10,1748.17,0,0,9,java.lang.Object,0.00,11,0,13,0,11,3,0,49,314,0
"org.apache.lucene.facet.taxonomy.directory.TestAddTaxonomies",4,0.00,6.25,190,2.87,329882.84,4,0,13,35,7,19.49,36,177,0,2,69.49,0.00,0.50,0.00,1,4.00,21,8624.40,0,0,7,org.apache.lucene.util.LuceneTestCase,0.00,31,1,25,0,31,4,0,21,1374,1
"org.apache.lucene.facet.taxonomy.directory.TestDirectoryTaxonomyReader",8,0.00,1.75,109,1.25,56469.81,8,0,14,35,10,119.63,31,128,0,2,99.01,0.00,0.50,0.00,1,8.00,6,3746.67,0,0,10,org.apache.lucene.util.LuceneTestCase,0.00,27,1,14,0,27,8,0,9,713,1
"org.apache.lucene.facet.taxonomy.directory.TestDirectoryTaxonomyWriter",7,0.00,1.43,85,1.15,36791.21,7,0,15,40,11,83.49,41,105,0,2,101.36,0.00,0.50,0.00,1,7.00,2,3457.69,0,0,11,org.apache.lucene.util.LuceneTestCase,0.00,33,1,10,0,33,7,0,26,664,1
"org.apache.lucene.facet.taxonomy.directory.TestDirectoryTaxonomyWriter$HashMap<String,String>",0,0.00,0.00,2,0.02,174.36,0,0,15,0,0,171.00,0,2,0,1,171.00,0.00,0.00,0.00,0,0.00,0,48.43,0,0,0,java.lang.Object,0.00,0,0,0,0,0,0,0,0,14,0
"org.apache.lucene.facet.taxonomy.directory.TestDirectoryTaxonomyWriter$HashMap<String,String>_0",0,0.00,0.00,2,0.02,174.36,0,0,15,0,0,171.00,0,2,0,1,171.00,0.00,0.00,0.00,0,0.00,0,48.43,0,0,0,java.lang.Object,0.00,0,0,0,0,0,0,0,0,14,0
"org.apache.lucene.facet.taxonomy.directory.TestDirectoryTaxonomyWriter$NoOpCache",7,0.00,1.00,13,0.08,714.81,7,0,15,7,2,155.18,0,10,0,1,155.18,0.00,0.00,0.00,1,7.00,1,251.43,0,0,2,java.lang.Object,0.00,0,0,7,0,0,7,1,0,77,2
"org.apache.lucene.facet.taxonomy.directory.TestIndexClose",1,0.00,3.00,43,0.52,36631.94,1,0,20,16,12,121.15,23,41,0,2,73.88,0.00,0.50,0.00,0,1.00,3,1559.56,0,0,12,org.apache.lucene.util.LuceneTestCase,0.00,15,1,3,0,15,1,0,2,284,1
"org.apache.lucene.facet.taxonomy.directory.TestIndexClose$LeakChecker",4,3.00,1.75,24,0.26,6478.67,7,3,20,11,6,116.57,0,30,0,1,116.57,0.00,0.00,0.00,0,4.00,4,773.22,0,2,6,java.lang.Object,0.00,7,0,7,0,7,2,0,0,166,2
"org.apache.lucene.facet.taxonomy.directory.TestIndexClose$LeakChecker$InstrumentedIndexWriter",2,0.00,1.50,11,0.11,1892.97,3,1,20,3,5,171.40,3,16,0,2,121.40,0.00,0.50,1.00,0,0.00,2,327.31,1,0,5,org.apache.lucene.index.IndexWriter,0.02,1,1,3,0,1,2,0,3,77,1
"org.apache.lucene.facet.taxonomy.directory.TestIndexClose$LeakChecker$InstrumentedTaxonomyReader",3,0.00,1.00,11,0.11,2154.63,3,0,20,3,6,130.71,0,17,0,2,130.71,0.00,0.50,0.00,0,1.00,1,335.84,3,1,6,org.apache.lucene.facet.taxonomy.directory.DirectoryTaxonomyReader,0.08,0,1,3,0,0,2,0,0,82,1
"org.apache.lucene.facet.taxonomy.directory.TestIndexClose$LeakChecker$InstrumentedTaxonomyWriter",5,0.00,1.20,15,0.19,3353.82,5,0,20,11,9,130.90,0,26,0,2,130.90,0.00,0.50,0.00,0,7.00,2,560.45,3,3,9,org.apache.lucene.facet.taxonomy.directory.DirectoryTaxonomyWriter,0.10,6,1,6,0,6,2,0,0,134,1
"org.apache.lucene.search.suggest.fst.BytesRefSorter",3,0.00,1.00,4,0.02,120.36,3,0,4,3,6,126.15,19,5,4,1,158.37,0.00,0.00,0.00,0,3.00,1,73.69,0,2,2,,0.00,0,0,3,0,0,1,0,3,27,1
"org.apache.lucene.search.suggest.fst.BytesRefSortersTest",3,0.00,2.00,24,0.31,13348.39,3,0,4,16,6,158.42,3,31,0,2,108.42,0.00,0.50,0.00,1,3.00,4,937.06,0,0,6,org.apache.lucene.util.LuceneTestCase,0.00,13,1,6,0,13,3,0,3,182,1
"org.apache.lucene.search.suggest.fst.ExternalRefSorter",6,0.15,1.83,32,0.35,7427.21,10,4,6,17,8,160.32,14,48,3,1,120.43,0.00,0.00,0.38,1,10.00,3,1052.01,0,2,5,java.lang.Object,0.00,11,0,11,0,11,4,2,4,239,1
"org.apache.lucene.search.suggest.fst.ExternalRefSorter$ByteSequenceIterator",3,0.00,2.00,26,0.25,9742.01,6,3,6,7,3,109.50,0,39,0,1,109.50,0.00,0.00,0.33,0,5.00,4,749.33,0,2,3,java.lang.Object,0.00,4,0,6,0,4,1,1,0,159,0
"org.apache.lucene.search.suggest.fst.FSTCompletion",13,0.01,3.23,129,1.86,102710.90,19,6,5,47,7,66.88,163,165,4,1,104.44,0.00,0.00,0.15,5,30.00,8,5588.38,0,5,3,java.lang.Object,0.00,34,0,42,0,34,8,0,57,1047,1
"org.apache.lucene.search.suggest.fst.FSTCompletion$Completion",3,0.25,1.00,10,0.10,1429.38,5,2,5,5,1,132.11,1,15,0,1,132.11,0.00,0.00,0.33,1,4.00,1,309.82,0,1,1,java.lang.Object,0.00,2,0,3,0,2,2,1,1,82,3
"org.apache.lucene.search.suggest.fst.FSTCompletionBuilder",5,0.08,2.60,45,0.67,28423.93,11,6,6,24,14,147.10,149,62,3,1,105.62,0.00,0.00,0.23,0,13.00,4,2004.78,0,1,11,java.lang.Object,0.00,19,0,13,0,19,4,0,13,389,1
"org.apache.lucene.search.suggest.fst.FSTCompletionLookup",9,0.04,2.11,99,1.62,119424.94,15,6,18,56,23,49.52,82,137,5,2,99.52,0.00,0.50,0.20,1,27.00,6,4872.05,0,2,18,org.apache.lucene.search.suggest.Lookup,0.00,47,1,19,0,47,7,0,16,840,1
"org.apache.lucene.search.suggest.fst.FSTCompletionTest",18,0.21,1.89,131,2.25,86771.97,20,2,5,72,6,110.33,14,185,0,2,110.33,0.00,0.50,0.31,3,42.00,6,6759.02,1,1,6,org.apache.lucene.util.LuceneTestCase,0.00,54,1,34,0,54,17,0,12,1289,1
"org.apache.lucene.search.suggest.fst.InMemorySorter",4,0.22,1.25,14,0.14,2462.96,7,3,4,8,6,181.18,5,22,2,1,131.19,0.00,0.00,0.50,0,2.00,2,428.78,0,2,4,java.lang.Object,0.00,4,0,5,0,4,2,1,1,105,2
"org.apache.lucene.search.suggest.fst.LargeInputFST",1,0.00,3.00,21,0.35,15053.37,1,0,2,17,5,88.76,4,27,0,1,88.53,0.00,0.00,0.00,0,1.00,3,1043.85,0,0,5,java.lang.Object,0.00,16,0,3,0,16,1,0,1,176,1
"org.apache.lucene.search.suggest.fst.Sort",10,0.05,2.90,138,1.94,104069.96,23,13,5,54,11,55.28,77,176,6,1,97.57,0.00,0.00,0.12,3,42.00,8,5811.86,0,4,5,java.lang.Object,0.00,44,0,29,0,44,6,0,32,1046,2
"org.apache.lucene.search.suggest.fst.Sort$BufferSize",3,1.00,1.67,18,0.23,8465.16,4,1,5,10,0,154.57,8,25,0,1,114.68,0.00,0.00,0.00,0,0.00,2,704.31,0,2,0,java.lang.Object,0.00,7,0,5,0,7,1,0,4,152,3
"org.apache.lucene.search.suggest.fst.Sort$ByteSequencesReader",5,0.50,1.60,28,0.27,7209.42,6,1,5,12,1,120.18,20,42,0,1,119.94,0.00,0.00,0.60,0,2.00,2,818.51,0,0,1,java.lang.Object,0.00,7,0,8,0,7,5,1,3,185,2
"org.apache.lucene.search.suggest.fst.Sort$ByteSequencesWriter",6,0.80,1.17,20,0.22,5579.06,7,1,5,12,1,129.79,3,31,0,1,129.79,0.00,0.00,0.33,1,10.00,2,674.72,0,0,1,java.lang.Object,0.00,6,0,7,0,6,6,1,1,165,2
"org.apache.lucene.search.suggest.fst.Sort$FileAndTop",1,2.00,1.00,6,0.05,588.02,3,2,5,2,1,120.16,0,8,0,1,120.16,0.00,0.00,0.00,0,1.00,1,136.37,0,0,1,java.lang.Object,0.00,1,0,1,0,1,1,0,0,37,1
"org.apache.lucene.search.suggest.fst.Sort$PriorityQueue<FileAndTop>",1,0.00,1.00,3,0.04,574.73,1,0,5,1,0,131.47,0,4,0,1,131.47,0.00,0.00,0.00,0,0.00,1,128.54,0,0,0,java.lang.Object,0.00,0,0,1,0,0,1,0,0,34,0
"org.apache.lucene.search.suggest.fst.Sort$SortInfo",1,0.00,1.00,11,0.13,1996.24,9,8,5,2,0,106.17,0,18,0,1,106.17,0.00,0.00,1.00,0,0.00,1,390.39,0,1,0,java.lang.Object,0.00,1,0,1,0,1,0,0,0,87,1
"org.apache.lucene.search.suggest.fst.TestSort",11,0.70,1.45,62,0.93,29629.17,12,1,9,37,2,167.83,14,87,0,2,117.83,0.00,0.50,0.36,3,23.00,3,2794.35,0,2,2,org.apache.lucene.util.LuceneTestCase,0.00,26,1,16,0,26,9,0,8,582,1
"org.apache.lucene.search.suggest.fst.TestSort$Comparator<",1,0.00,3.00,10,0.14,8489.42,1,0,9,2,0,102.51,0,10,0,1,102.51,0.00,0.00,0.00,0,1.00,3,411.64,0,0,0,java.lang.Object,0.00,1,0,3,0,1,1,0,0,87,0
"org.apache.lucene.search.suggest.fst.WFSTCompletionLookup",10,0.28,2.50,102,1.49,86620.25,12,2,28,49,20,102.72,45,132,3,2,102.48,0.00,0.50,0.25,1,18.00,7,4482.34,0,3,17,org.apache.lucene.search.suggest.Lookup,0.00,39,1,25,0,39,7,0,17,813,1
"org.apache.lucene.search.suggest.fst.WFSTCompletionLookup$Comparator<Long>",1,0.00,1.00,3,0.03,307.25,1,0,28,2,0,133.61,0,4,0,1,133.61,0.00,0.00,0.00,0,1.00,1,77.01,0,0,0,java.lang.Object,0.00,1,0,1,0,1,1,0,0,23,0
"org.apache.lucene.search.suggest.fst.WFSTCompletionLookup$WFSTTermFreqIteratorWrapper",3,0.00,1.33,16,0.26,7172.54,3,0,28,14,6,168.26,3,24,0,2,118.26,0.00,0.50,0.00,0,3.00,2,777.71,0,0,6,org.apache.lucene.search.suggest.SortedTermFreqIteratorWrapper,0.00,11,1,4,0,11,3,0,3,161,2
"org.apache.lucene.search.suggest.fst.WFSTCompletionTest",2,0.00,5.50,71,1.43,105872.70,2,0,12,34,4,57.94,10,77,0,2,75.81,0.00,0.50,0.00,0,2.00,10,4286.96,0,0,4,org.apache.lucene.util.LuceneTestCase,0.00,32,1,11,0,32,2,0,10,708,1
"org.apache.lucene.search.suggest.fst.WFSTCompletionTest$Comparator<LookupResult>",1,0.00,2.00,7,0.07,1821.12,1,0,12,3,0,113.64,0,9,0,1,113.64,0.00,0.00,0.00,0,1.00,2,196.85,0,0,0,java.lang.Object,0.00,2,0,2,0,2,1,0,0,48,0
"org.apache.lucene.util.automaton.Automaton",52,0.05,2.15,337,3.75,203729.36,61,9,10,105,44,95.63,271,394,40,1,113.50,0.00,0.00,0.06,9,990.00,9,11237.39,1,24,6,java.lang.Object,0.00,53,0,112,0,53,28,1,64,2282,1
"org.apache.lucene.util.automaton.AutomatonProvider",1,0.00,1.00,2,0.01,69.06,1,0,1,1,4,115.91,13,3,3,1,145.29,0.00,0.00,0.00,0,1.00,1,36.53,0,1,1,,0.00,0,0,1,0,0,0,0,2,13,1
"org.apache.lucene.util.automaton.AutomatonTestUtil",3,0.00,9.67,48,1.19,141486.95,3,0,12,9,16,88.99,13,73,11,1,88.76,0.00,0.00,0.00,1,3.00,18,3571.70,0,2,5,java.lang.Object,0.00,6,0,29,0,6,1,0,11,625,1
"org.apache.lucene.util.automaton.AutomatonTestUtil$RandomAcceptedStrings",9,0.38,5.00,143,2.35,187707.17,11,2,12,63,8,44.64,74,180,0,1,92.75,0.00,0.00,0.17,2,19.00,12,7035.05,0,0,8,java.lang.Object,0.00,54,0,45,0,54,9,0,26,1241,2
"org.apache.lucene.util.automaton.AutomatonTestUtil$RandomAcceptedStrings$ArrivingTransition",1,2.00,1.00,6,0.04,550.02,3,2,12,1,2,120.39,0,8,0,1,120.39,0.00,0.00,0.00,0,1.00,1,123.59,0,0,2,java.lang.Object,0.00,0,0,1,0,0,1,0,0,35,2
"org.apache.lucene.util.automaton.BasicAutomata",13,0.00,2.46,107,1.70,117780.11,13,0,2,34,26,106.18,61,135,22,1,105.94,0.00,0.00,0.00,1,13.00,8,5091.93,0,12,5,java.lang.Object,0.00,21,0,32,0,21,1,0,14,984,2
"org.apache.lucene.util.automaton.BasicOperations",20,0.00,6.35,446,7.24,767766.02,20,0,11,110,28,42.11,144,502,22,1,84.40,0.00,0.00,0.00,5,20.00,16,21716.59,0,11,8,java.lang.Object,0.00,90,0,127,0,90,9,0,46,3706,2
"org.apache.lucene.util.automaton.BasicOperations$PointTransitionSet",6,0.28,3.00,62,0.70,33737.60,11,5,11,22,3,103.92,3,72,0,1,103.92,0.00,0.00,0.43,2,0.00,7,2088.42,0,3,3,java.lang.Object,0.00,16,0,18,0,16,3,0,3,431,3
"org.apache.lucene.util.automaton.BasicOperations$PointTransitions",4,0.11,1.00,14,0.14,2614.47,7,3,11,5,0,131.03,0,21,0,1,131.03,0.00,0.00,0.42,0,0.00,1,406.97,0,0,0,java.lang.Object,0.00,1,0,4,0,1,4,1,0,104,3
"org.apache.lucene.util.automaton.BasicOperations$TransitionList",1,0.00,2.00,9,0.11,3156.50,3,2,11,3,3,107.69,0,12,0,1,107.69,0.00,0.00,1.00,0,0.00,2,341.64,0,0,3,java.lang.Object,0.00,2,0,2,0,2,1,0,0,75,3
"org.apache.lucene.util.automaton.ByteRunAutomaton",3,0.00,2.00,15,0.15,5316.83,3,0,0,5,8,86.96,20,17,5,2,119.19,0.00,0.50,0.00,0,4.00,3,462.57,0,0,3,org.apache.lucene.util.automaton.RunAutomaton,0.00,2,1,6,0,2,3,0,3,104,1
"org.apache.lucene.util.automaton.CharacterRunAutomaton",3,0.00,2.33,23,0.27,10304.81,3,0,0,6,20,69.15,22,23,18,2,111.44,0.00,0.50,0.00,0,1.00,3,798.46,0,0,2,org.apache.lucene.util.automaton.RunAutomaton,0.00,3,1,7,0,3,3,0,3,164,1
"org.apache.lucene.util.automaton.CompiledAutomaton",5,0.25,6.80,158,1.94,211455.55,11,6,8,36,25,34.37,58,196,14,1,78.50,0.00,0.00,0.37,1,1.00,14,5822.02,0,3,12,java.lang.Object,0.00,31,0,34,0,31,2,0,46,1022,1
"org.apache.lucene.util.automaton.CompiledAutomaton$AUTOMATON_TYPE",0,0.00,0.00,2,0.01,66.44,0,0,8,0,0,171.00,0,1,0,1,171.00,0.00,0.00,0.00,0,0.00,0,33.22,0,0,0,java.lang.Object,0.00,0,0,0,0,0,0,0,0,10,1
"org.apache.lucene.util.automaton.DaciukMihovAutomatonBuilder",7,0.04,2.43,63,0.95,42670.58,11,4,4,36,9,63.10,49,78,3,1,105.39,0.00,0.00,0.29,3,11.00,3,2837.03,0,2,6,java.lang.Object,0.00,29,0,17,0,29,5,0,16,561,2
"org.apache.lucene.util.automaton.DaciukMihovAutomatonBuilder$State",14,0.03,1.57,61,0.78,25879.48,19,5,4,20,1,104.84,77,84,0,1,122.71,0.00,0.00,0.17,1,58.00,4,2326.93,0,6,1,java.lang.Object,0.00,6,0,22,0,6,8,0,20,521,2
"org.apache.lucene.util.automaton.Lev1ParametricDescription",2,0.75,5.00,40,0.64,63445.35,10,8,1,2,1,42.52,23,66,1,2,86.65,0.00,0.50,0.50,0,2.00,9,1921.17,0,0,0,org.apache.lucene.util.automaton.LevenshteinAutomata.ParametricDescription,0.00,0,1,10,0,0,2,0,23,370,0
"org.apache.lucene.util.automaton.Lev1TParametricDescription",2,0.75,5.00,40,0.65,63537.89,10,8,1,2,1,49.08,25,66,1,2,86.65,0.00,0.50,0.50,0,2.00,9,1949.39,0,0,0,org.apache.lucene.util.automaton.LevenshteinAutomata.ParametricDescription,0.00,0,1,10,0,0,2,0,24,374,0
"org.apache.lucene.util.automaton.Lev2ParametricDescription",2,0.83,7.00,54,1.63,109001.40,14,12,1,2,1,127.69,54,137,1,2,79.86,0.00,0.50,0.50,0,2.00,13,4889.27,0,0,0,org.apache.lucene.util.automaton.LevenshteinAutomata.ParametricDescription,0.00,0,1,14,0,0,2,0,54,753,0
"org.apache.lucene.util.automaton.Lev2TParametricDescription",2,0.83,7.00,54,2.11,119278.76,14,12,1,2,1,86.82,70,168,1,2,79.55,0.00,0.50,0.50,0,2.00,13,6316.14,0,0,0,org.apache.lucene.util.automaton.LevenshteinAutomata.ParametricDescription,0.00,0,1,14,0,0,2,0,69,912,0
"org.apache.lucene.util.automaton.LevenshteinAutomata",3,0.50,7.33,97,1.33,112963.30,11,8,3,26,12,117.66,63,92,4,1,78.36,0.00,0.00,0.46,1,0.00,10,3995.30,0,1,8,java.lang.Object,0.00,23,0,22,0,23,2,0,29,692,1
"org.apache.lucene.util.automaton.LevenshteinAutomata$ParametricDescription",6,0.05,1.17,28,0.55,24067.88,10,4,3,6,0,140.75,18,51,0,1,120.13,0.00,0.00,0.29,0,10.00,2,1643.87,0,0,0,java.lang.Object,0.00,0,0,7,0,0,6,0,8,326,2
"org.apache.lucene.util.automaton.MinimizationOperations",3,0.00,12.33,160,2.76,667872.33,3,0,4,32,6,13.99,28,147,4,1,63.99,0.00,0.00,0.00,1,3.00,34,8284.23,0,0,3,java.lang.Object,0.00,29,0,37,0,29,3,0,17,1218,2
"org.apache.lucene.util.automaton.MinimizationOperations$IntPair",1,2.00,1.00,5,0.03,434.31,3,2,4,1,0,124.15,0,7,0,1,124.15,0.00,0.00,0.00,0,1.00,1,97.99,0,0,0,java.lang.Object,0.00,0,0,1,0,0,1,0,0,30,2
"org.apache.lucene.util.automaton.MinimizationOperations$StateList",1,3.00,1.00,5,0.03,280.88,4,3,4,2,1,125.65,0,7,0,1,125.65,0.00,0.00,0.00,0,1.00,1,95.08,0,0,1,java.lang.Object,0.00,1,0,1,0,1,1,0,0,28,2
"org.apache.lucene.util.automaton.MinimizationOperations$StateListNode",2,0.50,2.50,15,0.18,5270.67,6,4,4,2,1,112.33,0,22,0,1,112.33,0.00,0.00,0.50,0,0.00,3,535.17,0,0,1,java.lang.Object,0.00,0,0,5,0,0,2,0,0,128,2
"org.apache.lucene.util.automaton.RegExp",46,0.01,3.17,407,5.77,396191.66,68,22,6,90,25,63.77,359,549,20,1,106.06,0.00,0.00,0.06,21,674.00,22,17319.89,0,33,5,java.lang.Object,0.00,44,0,146,0,44,13,0,19,3274,1
"org.apache.lucene.util.automaton.RegExp$Kind",0,0.00,0.00,2,0.03,80.71,0,0,6,0,0,171.00,0,3,0,1,171.00,0.00,0.00,0.00,0,0.00,0,80.71,0,0,0,java.lang.Object,0.00,0,0,0,0,0,0,0,0,19,0
"org.apache.lucene.util.automaton.RunAutomaton",8,0.22,2.75,80,0.98,82759.73,15,7,0,19,8,83.98,44,88,4,1,101.85,0.00,0.00,0.34,0,0.00,8,2952.01,0,1,4,java.lang.Object,0.00,11,0,22,2,11,7,0,14,563,2
"org.apache.lucene.util.automaton.SortedIntSet",8,0.38,4.50,131,1.34,108604.45,16,8,4,21,5,143.19,10,151,2,1,93.19,0.00,0.00,0.45,0,0.00,10,4018.51,0,1,3,java.lang.Object,0.00,13,0,36,0,13,7,0,10,783,1
"org.apache.lucene.util.automaton.SortedIntSet$FrozenIntSet",5,0.08,3.60,55,0.52,37780.92,8,3,4,9,2,101.32,0,67,0,1,101.32,0.00,0.00,0.27,0,6.00,12,1545.40,0,1,2,java.lang.Object,0.00,4,0,18,0,4,4,0,0,330,3
"org.apache.lucene.util.automaton.SpecialOperations",10,0.00,3.30,102,1.60,91437.79,10,0,5,45,15,102.47,44,121,11,1,102.23,0.00,0.00,0.00,3,10.00,8,4794.90,0,5,4,java.lang.Object,0.00,35,0,33,0,35,5,0,19,919,2
"org.apache.lucene.util.automaton.State",18,0.04,2.06,103,1.07,65836.01,24,6,5,28,23,116.94,75,125,21,1,116.70,0.00,0.00,0.20,2,126.00,9,3199.35,0,2,3,java.lang.Object,0.00,10,0,37,0,10,16,1,17,687,1
"org.apache.lucene.util.automaton.State$TransitionsIterable",1,0.00,1.00,3,0.02,201.86,1,0,5,2,1,135.05,0,5,0,1,135.05,0.00,0.00,0.00,0,1.00,1,61.75,0,1,1,java.lang.Object,0.00,1,0,1,0,1,0,1,0,19,1
"org.apache.lucene.util.automaton.State$TransitionsIterable$Iterator<Transition>",3,0.50,1.00,8,0.05,447.53,4,1,5,4,1,142.65,0,11,0,1,142.65,0.00,0.00,0.67,0,1.00,1,142.84,0,1,1,java.lang.Object,0.00,1,0,3,0,1,2,0,0,43,0
"org.apache.lucene.util.automaton.StatePair",6,0.00,1.17,22,0.17,4034.84,9,3,0,7,4,113.03,33,31,3,1,130.90,0.00,0.00,0.33,0,2.00,2,515.73,0,2,1,java.lang.Object,0.00,1,0,7,0,1,4,0,6,139,1
"org.apache.lucene.util.automaton.TestBasicOperations",7,0.00,1.71,75,1.04,37090.01,7,0,2,28,6,154.25,8,82,0,2,104.25,0.00,0.50,0.00,0,7.00,6,3127.97,0,0,6,org.apache.lucene.util.LuceneTestCase,0.00,21,1,12,0,21,7,0,8,618,1
"org.apache.lucene.util.automaton.TestCompiledAutomaton",6,0.00,3.00,70,0.91,51573.58,6,0,9,28,5,100.92,3,81,0,2,100.92,0.00,0.50,0.00,4,6.00,10,2720.49,0,2,5,org.apache.lucene.util.LuceneTestCase,0.00,22,1,18,0,22,4,0,3,512,1
"org.apache.lucene.util.automaton.TestDeterminism",3,0.00,2.00,34,0.41,14366.10,3,0,1,18,4,85.14,17,34,0,2,103.01,0.00,0.50,0.00,0,3.00,2,1224.13,0,0,4,org.apache.lucene.util.LuceneTestCase,0.00,15,1,6,0,15,3,0,14,253,1
"org.apache.lucene.util.automaton.TestDeterminizeLexicon",2,0.50,3.00,32,0.35,9317.31,4,2,5,17,6,136.83,4,31,0,2,96.94,0.00,0.50,0.75,1,0.00,3,1037.45,0,0,6,org.apache.lucene.util.LuceneTestCase,0.00,15,1,6,0,15,2,0,1,207,1
"org.apache.lucene.util.automaton.TestLevenshteinAutomata",16,0.00,2.88,237,3.15,327918.09,16,0,3,51,8,76.18,81,243,0,2,94.05,0.00,0.50,0.00,7,16.00,9,9449.76,0,6,8,org.apache.lucene.util.LuceneTestCase,0.00,35,1,46,0,35,10,0,42,1775,1
"org.apache.lucene.util.automaton.TestMinimize",3,0.00,1.67,26,0.26,5486.60,3,0,1,15,5,151.39,8,26,0,2,111.51,0.00,0.50,0.00,0,3.00,2,788.45,0,0,5,org.apache.lucene.util.LuceneTestCase,0.00,12,1,5,0,12,3,0,4,166,1
"org.apache.lucene.util.automaton.TestSpecialOperations",1,0.00,2.00,10,0.09,1816.32,1,0,1,7,3,134.16,19,10,0,2,107.87,0.00,0.50,0.00,0,1.00,2,284.72,0,0,3,org.apache.lucene.util.LuceneTestCase,0.00,6,1,2,0,6,1,0,2,62,1
"org.apache.lucene.util.automaton.TestUTF32ToUTF8",11,0.40,2.64,148,2.10,172418.26,13,2,5,47,10,146.19,14,169,0,2,96.19,0.00,0.50,0.14,4,34.00,11,6305.48,1,0,10,org.apache.lucene.util.LuceneTestCase,0.00,36,1,29,0,36,11,0,14,1156,1
"org.apache.lucene.util.automaton.Transition",11,0.10,2.18,59,0.84,31388.92,16,5,1,20,26,117.77,49,89,26,1,117.54,0.00,0.00,0.29,1,0.00,9,2524.28,1,3,1,java.lang.Object,0.00,9,0,24,0,9,8,1,11,541,1
"org.apache.lucene.util.automaton.Transition$CompareByDestThenMinMaxSingle",1,0.00,8.00,9,0.17,11921.70,1,0,1,1,1,102.83,0,13,0,1,102.83,0.00,0.00,0.00,0,1.00,8,517.55,0,0,1,java.lang.Object,0.00,0,0,8,0,0,1,1,0,117,3
"org.apache.lucene.util.automaton.Transition$CompareByMinMaxThenDestSingle",1,0.00,8.00,10,0.17,10687.62,1,0,1,1,1,101.49,0,13,0,1,101.49,0.00,0.00,0.00,0,1.00,8,506.29,0,0,1,java.lang.Object,0.00,0,0,8,0,0,1,1,0,116,3
"org.apache.lucene.util.automaton.UTF32ToUTF8",7,0.09,3.57,134,2.15,207815.73,16,9,4,29,7,55.56,43,158,2,1,87.79,0.00,0.00,0.19,6,29.00,7,6457.70,0,2,5,java.lang.Object,0.00,22,0,25,0,22,5,0,39,1195,2
"org.apache.lucene.util.automaton.UTF32ToUTF8$UTF8Byte",0,0.00,0.00,3,0.02,116.27,2,2,4,0,0,171.00,1,4,0,1,171.00,0.00,0.00,0.00,0,0.00,0,46.51,0,0,0,java.lang.Object,0.00,0,0,0,0,0,0,0,1,14,2
"org.apache.lucene.util.automaton.UTF32ToUTF8$UTF8Sequence",6,0.10,2.17,52,0.55,24321.83,8,2,4,11,0,108.72,4,56,0,1,108.72,0.00,0.00,0.58,1,0.00,4,1656.18,0,1,0,java.lang.Object,0.00,5,0,13,0,5,5,0,4,347,2
"org.apache.lucene.analysis.Analyzer",8,0.86,1.25,31,0.25,5350.41,9,1,7,16,332,82.43,81,43,329,1,130.90,0.00,0.00,0.25,1,16.00,2,759.80,0,1,4,java.lang.Object,0.00,8,0,10,70,8,7,0,11,189,2
"org.apache.lucene.analysis.Analyzer$GlobalReuseStrategy",2,0.00,1.00,5,0.04,304.35,2,0,7,4,0,163.20,6,8,0,2,142.59,0.00,0.50,0.00,0,2.00,1,112.16,0,1,0,org.apache.lucene.analysis.ReuseStrategy,0.00,2,1,2,0,2,1,0,2,34,3
"org.apache.lucene.analysis.Analyzer$PerFieldReuseStrategy",2,0.00,2.00,10,0.16,5198.83,2,0,7,7,0,138.49,6,16,0,2,117.88,0.00,0.50,0.00,0,2.00,2,469.32,0,1,0,org.apache.lucene.analysis.ReuseStrategy,0.00,5,1,4,0,5,1,0,2,103,2
"org.apache.lucene.analysis.Analyzer$ReuseStrategy",5,0.75,1.80,21,0.18,4098.55,6,1,7,10,2,107.59,28,31,0,1,125.46,0.00,0.00,0.40,0,7.00,3,533.97,0,2,2,java.lang.Object,0.00,5,0,9,0,5,3,0,5,129,3
"org.apache.lucene.analysis.Analyzer$TokenStreamComponents",5,0.25,1.00,15,0.11,1499.41,7,2,7,6,2,101.48,33,22,0,1,133.70,0.00,0.00,0.30,0,10.00,1,320.03,0,0,2,java.lang.Object,0.00,1,0,5,0,1,5,0,5,90,2
"org.apache.lucene.analysis.AnalyzerWrapper",6,0.00,1.00,11,0.13,2029.17,6,0,2,11,8,118.86,41,19,6,2,151.08,5.00,0.14,0.00,2,6.00,1,377.63,0,3,2,org.apache.lucene.analysis.Analyzer,0.00,5,1,6,5,5,3,0,7,104,2
"org.apache.lucene.analysis.BaseTokenStreamTestCase",38,0.00,3.13,317,6.69,718469.20,38,0,17,122,178,153.37,71,436,164,2,103.37,243.00,0.00,0.00,6,38.00,36,20056.38,0,3,14,org.apache.lucene.util.LuceneTestCase,0.00,84,1,119,243,84,35,0,52,3423,2
"org.apache.lucene.analysis.BaseTokenStreamTestCase$AnalysisThread",2,0.60,1.50,16,0.15,2363.06,7,5,17,5,1,163.02,2,22,0,2,113.02,0.00,0.50,0.50,0,2.00,2,452.08,0,0,1,org.apache.lucene.analysis.Thread,0.00,3,1,3,0,3,2,0,2,108,1
"org.apache.lucene.analysis.BaseTokenStreamTestCase$CheckClearAttributesAttribute",1,0.00,1.00,2,0.01,64.15,1,0,17,1,0,145.54,0,3,0,2,145.54,0.00,0.50,0.00,0,1.00,1,30.46,0,0,0,,0.00,0,1,1,0,0,1,0,0,12,2
"org.apache.lucene.analysis.BaseTokenStreamTestCase$CheckClearAttributesAttributeImpl",5,0.25,1.00,14,0.14,2349.79,6,1,17,8,1,138.73,0,29,0,2,138.73,0.00,0.50,0.80,0,0.00,1,424.21,0,0,1,org.apache.lucene.util.AttributeImpl,0.20,3,1,5,0,3,5,1,0,110,3
"org.apache.lucene.analysis.CachingTokenFilter",5,0.17,2.00,26,0.27,6474.99,8,3,5,13,14,160.14,13,40,11,4,120.26,0.00,0.75,0.47,1,1.00,3,799.19,0,0,3,org.apache.lucene.analysis.TokenFilter,0.71,8,3,10,0,8,5,0,5,182,2
"org.apache.lucene.analysis.CannedTokenStream",2,0.67,1.50,21,0.27,7319.57,8,6,5,13,9,145.43,5,26,3,3,105.54,0.00,0.67,0.50,0,2.00,2,817.74,0,0,6,org.apache.lucene.analysis.TokenStream,0.30,11,2,3,0,11,2,0,3,165,2
"org.apache.lucene.analysis.CharReader",8,0.29,1.12,18,0.18,3333.97,9,1,2,14,28,139.11,6,34,27,3,139.11,0.00,0.67,0.75,0,0.00,2,538.74,0,1,1,org.apache.lucene.analysis.CharStream,0.33,6,2,9,0,6,7,0,1,146,2
"org.apache.lucene.analysis.CharStream",1,0.00,1.00,2,0.01,109.02,1,0,1,1,25,143.25,16,3,25,2,143.73,10.00,0.08,0.00,0,1.00,1,42.11,0,0,0,java.io.Reader,0.00,0,1,1,10,0,1,0,2,15,2
"org.apache.lucene.analysis.CollationTestBase",7,4.00,2.57,145,2.79,119223.17,11,4,28,59,29,56.71,44,176,3,2,88.93,3.00,0.20,0.00,1,7.00,6,8375.97,0,1,26,org.apache.lucene.util.LuceneTestCase,0.00,52,1,18,3,52,6,0,35,1382,2
"org.apache.lucene.analysis.CollationTestBase$Thread",1,0.00,3.00,15,0.20,7148.47,1,0,28,13,3,96.53,0,19,0,1,96.53,0.00,0.00,0.00,0,1.00,3,608.77,0,0,3,java.lang.Object,0.00,12,0,3,0,12,1,0,0,111,0
"org.apache.lucene.analysis.EmptyTokenizer",2,0.00,1.00,5,0.03,319.87,2,0,2,2,4,192.42,3,9,3,4,142.42,0.00,0.75,0.00,0,2.00,1,96.26,0,0,1,org.apache.lucene.analysis.Tokenizer,0.25,0,3,2,0,0,2,0,1,30,2
"org.apache.lucene.analysis.MockAnalyzer",9,0.00,1.89,48,0.60,19373.02,18,9,7,21,233,100.66,47,68,226,2,118.53,0.00,0.50,0.11,0,30.00,9,1787.11,0,0,7,org.apache.lucene.analysis.Analyzer,0.00,12,1,17,0,12,9,0,11,380,2
"org.apache.lucene.analysis.MockCharFilter",6,0.07,2.17,46,0.56,29028.47,12,6,4,16,4,160.28,6,58,3,3,110.28,0.00,0.67,0.22,2,14.00,4,1673.26,0,0,1,org.apache.lucene.analysis.CharStream,0.43,10,2,13,0,10,6,0,6,348,0
"org.apache.lucene.analysis.MockFixedLengthPayloadFilter",2,0.75,1.50,17,0.17,3009.48,6,4,4,5,6,162.20,3,22,2,4,112.20,0.00,0.75,0.62,0,0.00,2,503.74,0,0,4,org.apache.lucene.analysis.TokenFilter,0.29,3,3,3,0,3,2,0,1,113,2
"org.apache.lucene.analysis.MockPayloadAnalyzer",1,0.00,1.00,4,0.06,1129.68,1,0,6,4,10,124.74,4,7,2,2,124.50,0.00,0.50,0.00,0,1.00,1,175.73,0,0,8,org.apache.lucene.analysis.Analyzer,0.00,3,1,1,0,3,1,0,1,42,2
"org.apache.lucene.analysis.MockPayloadFilter",3,0.67,1.67,33,0.29,6977.76,9,6,6,8,7,105.53,0,41,1,4,105.53,0.00,0.75,0.61,0,0.00,3,878.88,1,0,6,org.apache.lucene.analysis.TokenFilter,0.53,5,3,5,0,5,3,0,0,187,1
"org.apache.lucene.analysis.MockReaderWrapper",8,0.03,1.38,40,0.41,23689.59,13,5,4,15,3,117.52,6,56,2,2,117.52,0.00,0.50,0.22,0,20.00,4,1241.89,0,0,1,java.io.Reader,0.00,7,1,11,0,7,8,0,5,269,1
"org.apache.lucene.analysis.MockTokenFilter",4,0.06,1.75,24,0.52,15194.10,10,6,8,12,20,81.43,27,44,14,4,113.66,0.00,0.75,0.21,0,4.00,4,1564.07,0,0,6,org.apache.lucene.analysis.TokenFilter,0.25,8,3,7,0,8,4,0,8,289,2
"org.apache.lucene.analysis.MockTokenizer",12,0.09,1.83,109,1.32,65615.59,26,14,7,26,323,126.45,37,134,317,4,105.83,0.00,0.75,0.15,3,46.00,6,3974.14,3,0,6,org.apache.lucene.analysis.Tokenizer,0.62,14,3,22,0,14,12,0,21,773,1
"org.apache.lucene.analysis.MockTokenizer$State",0,0.00,0.00,2,0.01,107.55,0,0,7,0,0,171.00,0,8,0,1,171.00,0.00,0.00,0.00,0,0.00,0,43.02,0,0,0,java.lang.Object,0.00,0,0,0,0,0,0,0,0,12,2
"org.apache.lucene.analysis.MockVariableLengthPayloadFilter",2,0.80,1.50,18,0.20,3999.89,7,5,4,7,5,159.32,3,23,1,4,109.32,0.00,0.75,0.60,0,0.00,2,590.61,0,0,4,org.apache.lucene.analysis.TokenFilter,0.29,5,3,3,0,5,2,0,1,128,2
"org.apache.lucene.analysis.NumericTokenStream",10,0.21,1.50,44,0.56,13165.64,17,7,15,21,21,79.76,110,60,6,2,123.88,0.00,0.50,0.33,0,0.00,4,1690.59,0,4,15,org.apache.lucene.document.TokenStream,0.00,11,1,15,0,11,6,0,17,363,2
"org.apache.lucene.analysis.NumericTokenStream$NumericAttributeFactory",2,1.00,2.00,7,0.09,2126.48,3,1,15,5,2,129.21,0,12,0,2,129.21,0.00,0.50,0.50,0,2.00,3,255.29,0,1,2,org.apache.lucene.util.AttributeFactory,0.00,3,1,4,0,3,1,0,0,62,3
"org.apache.lucene.analysis.NumericTokenStream$NumericTermAttribute",6,0.00,1.00,7,0.04,133.53,6,0,15,6,0,210.39,9,8,0,2,160.39,0.00,0.50,0.00,0,6.00,1,105.47,0,0,0,,0.00,0,1,6,0,0,6,0,6,41,1
"org.apache.lucene.analysis.NumericTokenStream$NumericTermAttributeImpl",11,0.14,1.18,37,0.41,8457.11,16,5,15,17,5,130.44,3,48,0,2,130.44,0.00,0.50,0.33,1,3.00,3,1224.92,0,1,5,org.apache.lucene.util.AttributeImpl,0.12,6,1,13,0,6,10,2,3,289,3
"org.apache.lucene.analysis.TestCachingTokenFilter",2,1.00,1.50,40,0.60,21166.80,3,1,12,25,14,130.57,4,56,0,3,90.68,0.00,0.67,0.50,1,2.00,2,1802.69,0,0,14,org.apache.lucene.analysis.BaseTokenStreamTestCase,0.00,23,2,3,0,23,2,0,4,329,1
"org.apache.lucene.analysis.TestCachingTokenFilter$TokenStream",1,0.00,2.00,12,0.12,2500.52,4,3,12,4,2,103.83,0,15,0,1,103.83,0.00,0.00,1.00,0,0.00,2,351.22,0,0,2,java.lang.Object,0.00,3,0,2,0,3,1,0,0,78,0
"org.apache.lucene.analysis.TestMockAnalyzer",9,0.00,1.33,59,0.92,19366.89,9,0,8,27,14,155.55,25,87,0,3,115.66,0.00,0.67,0.00,0,9.00,3,2772.31,3,0,14,org.apache.lucene.analysis.BaseTokenStreamTestCase,0.00,18,2,12,0,18,9,0,10,551,1
"org.apache.lucene.analysis.TestMockCharFilter",1,0.00,1.00,12,0.12,2404.22,1,0,2,2,2,103.65,16,20,0,3,104.12,0.00,0.67,0.00,0,1.00,1,349.24,1,0,2,org.apache.lucene.analysis.BaseTokenStreamTestCase,0.00,1,2,1,0,1,1,0,1,77,1
"org.apache.lucene.analysis.TestMockCharFilter$Analyzer",2,0.00,1.00,6,0.08,1393.09,2,0,2,6,4,130.81,0,10,0,1,130.81,0.00,0.00,0.00,0,2.00,1,228.16,0,2,4,java.lang.Object,0.00,4,0,2,0,4,0,0,0,56,0
"org.apache.lucene.analysis.TestNumericTokenStream",4,0.33,3.00,67,1.10,56943.17,6,2,6,28,8,143.12,4,74,0,3,93.12,0.00,0.67,0.25,0,8.00,3,3305.89,0,0,8,org.apache.lucene.analysis.BaseTokenStreamTestCase,0.00,24,2,12,0,24,4,0,4,579,1
"org.apache.lucene.analysis.TestNumericTokenStream$TestAttribute",0,0.00,0.00,1,0.01,49.13,0,0,6,0,0,171.00,0,1,0,2,171.00,0.00,0.50,0.00,0,0.00,0,19.65,0,0,0,,0.00,0,1,0,0,0,0,0,0,7,2
"org.apache.lucene.analysis.TestNumericTokenStream$TestAttributeImpl",0,0.00,0.00,1,0.01,85.59,0,0,6,0,1,171.00,0,1,0,3,171.00,0.00,0.67,0.00,0,0.00,0,28.53,0,0,1,org.apache.lucene.analysis.tokenattributes.CharTermAttributeImpl,0.00,0,2,0,0,0,0,1,0,9,2
"org.apache.lucene.analysis.TestToken",12,0.00,1.42,182,2.46,136607.32,12,0,9,48,15,95.11,3,200,1,2,95.11,0.00,0.50,0.00,2,12.00,5,7380.74,0,0,14,org.apache.lucene.util.LuceneTestCase,0.00,36,1,17,0,36,12,0,3,1463,1
"org.apache.lucene.analysis.TestToken$HashMap<String,Object>",0,0.00,0.00,9,0.19,4144.31,0,0,9,2,8,171.00,0,9,0,1,171.00,0.00,0.00,0.00,0,0.00,0,573.04,0,0,8,java.lang.Object,0.00,2,0,0,0,2,0,0,0,110,0
"org.apache.lucene.analysis.TestToken$SenselessAttribute",0,0.00,0.00,1,0.01,31.02,0,0,9,0,0,171.00,0,1,0,2,171.00,0.00,0.50,0.00,0,0.00,0,15.51,0,0,0,,0.00,0,1,0,0,0,0,0,0,6,1
"org.apache.lucene.analysis.TestToken$SenselessAttributeImpl",4,0.00,1.00,7,0.06,665.56,4,0,9,4,1,153.51,0,10,0,2,153.51,0.00,0.50,0.00,0,4.00,1,183.13,0,0,1,org.apache.lucene.util.AttributeImpl,0.22,0,1,4,0,0,4,1,0,55,3
"org.apache.lucene.analysis.Token",38,0.24,1.32,195,2.03,54770.97,45,7,12,56,71,77.70,282,260,59,3,119.99,0.00,0.67,0.38,2,0.00,5,6090.49,9,10,12,org.apache.lucene.analysis.tokenattributes.CharTermAttributeImpl,0.13,18,2,50,0,18,28,5,38,1360,1
"org.apache.lucene.analysis.Token$TokenAttributeFactory",4,0.67,2.00,14,0.18,5042.81,5,1,12,8,2,128.63,2,24,0,2,128.63,0.00,0.50,0.50,1,4.00,3,536.13,0,1,2,AttributeSource.AttributeFactory,0.00,4,1,8,0,4,3,0,1,128,3
"org.apache.lucene.analysis.TokenFilter",4,0.33,1.00,11,0.09,1296.02,5,1,1,7,156,160.62,12,19,155,3,140.00,64.00,0.02,0.75,0,0.00,1,261.65,0,0,1,org.apache.lucene.analysis.TokenStream,0.75,3,2,4,128,3,4,0,6,74,2
"org.apache.lucene.analysis.TokenStream",8,0.00,1.38,21,0.21,6610.50,8,0,9,15,529,116.58,113,33,524,2,136.73,192.00,0.01,0.00,1,8.00,4,644.67,0,0,6,org.apache.lucene.util.AttributeSource,0.00,7,1,11,192,7,8,1,9,153,2
"org.apache.lucene.analysis.TokenStreamToDot",6,0.22,3.00,78,0.94,41343.20,14,8,6,20,6,138.85,17,97,1,1,98.97,0.00,0.00,0.31,4,2.00,9,2815.82,0,0,5,java.lang.Object,0.00,14,0,18,0,14,6,0,15,547,1
"org.apache.lucene.analysis.Tokenizer",6,0.80,1.33,23,0.22,5180.15,7,1,3,8,432,130.25,24,32,429,3,130.01,16.00,0.06,0.33,0,10.00,2,651.91,0,0,3,org.apache.lucene.analysis.TokenStream,0.21,2,2,8,32,2,6,0,10,160,2
"org.apache.lucene.analysis.VocabularyAssert",4,0.00,1.75,30,0.47,14257.01,4,0,9,18,2,161.38,6,45,0,1,111.38,0.00,0.00,0.00,1,4.00,3,1408.38,0,0,2,java.lang.Object,0.00,14,0,7,0,14,4,0,6,284,1
"org.apache.solr.search.grouping.distributed.ShardRequestFactory",1,0.00,1.00,2,0.01,44.48,1,0,2,1,3,109.23,12,3,1,1,146.79,0.00,0.00,0.00,0,1.00,1,29.65,0,1,2,,0.00,0,0,1,0,0,0,0,2,12,1
"org.apache.solr.search.grouping.distributed.ShardResponseProcessor",1,0.00,1.00,2,0.01,39.00,1,0,2,1,6,109.68,12,3,4,1,147.24,0.00,0.00,0.00,0,1.00,1,34.00,0,0,2,,0.00,0,0,1,0,0,1,0,2,13,1
"org.apache.lucene.analysis.compound.hyphenation.ByteVector",11,0.30,1.36,49,0.37,9039.20,15,4,0,12,1,165.40,23,65,1,1,125.52,0.00,0.00,0.52,0,0.00,2,1112.59,0,0,0,java.lang.Object,0.00,1,0,15,0,1,11,0,7,271,1
"org.apache.lucene.analysis.compound.hyphenation.CharVector",13,0.27,1.31,55,0.44,10504.63,17,4,0,16,2,175.58,24,74,2,1,125.58,0.00,0.00,0.50,0,0.00,2,1306.80,0,1,0,java.lang.Object,0.00,3,0,17,0,3,12,1,7,317,1
"org.apache.lucene.analysis.compound.hyphenation.Hyphen",3,1.00,1.33,23,0.19,6976.59,6,3,0,7,1,113.14,12,29,1,1,112.90,0.00,0.00,1.00,0,0.00,2,583.72,0,1,0,java.lang.Object,0.00,4,0,4,0,4,2,0,1,138,1
"org.apache.lucene.analysis.compound.hyphenation.Hyphenation",3,0.00,1.00,8,0.04,406.54,4,1,0,3,2,143.22,14,12,2,1,142.98,0.00,0.00,1.00,0,0.00,1,123.63,0,0,0,java.lang.Object,0.00,0,0,3,0,0,3,0,4,39,1
"org.apache.lucene.analysis.compound.hyphenation.HyphenationException",1,0.00,1.00,3,0.02,106.02,1,0,0,1,2,105.03,6,5,2,2,137.25,0.00,0.50,0.00,0,1.00,1,45.51,0,0,0,java.lang.Exception,0.00,0,1,1,0,0,1,0,2,16,1
"org.apache.lucene.analysis.compound.hyphenation.HyphenationTree",15,0.00,3.80,222,2.79,295569.54,19,4,5,52,8,49.99,171,255,2,2,94.12,0.00,0.50,0.25,5,66.00,14,8364.57,4,4,6,org.apache.lucene.analysis.compound.hyphenation.TernaryTree,0.00,37,1,57,0,37,11,1,50,1558,1
"org.apache.lucene.analysis.compound.hyphenation.PatternConsumer",3,0.00,1.00,4,0.03,133.57,3,0,1,3,2,109.91,25,5,2,1,158.02,0.00,0.00,0.00,0,3.00,1,86.02,0,0,0,,0.00,0,0,3,0,0,3,0,4,30,1
"org.apache.lucene.analysis.compound.hyphenation.PatternParser",21,0.04,3.48,234,2.83,140690.74,32,11,12,80,5,141.62,61,292,2,2,101.74,0.00,0.50,0.13,4,110.00,10,8481.00,0,8,3,org.xml.sax.helpers.DefaultHandler,0.00,59,1,73,0,59,13,1,27,1647,1
"org.apache.lucene.analysis.compound.hyphenation.TernaryTree",21,0.13,2.48,222,2.52,179178.95,30,9,2,36,4,70.31,138,263,3,1,102.53,0.00,0.00,0.23,11,83.00,9,7560.78,0,2,1,java.lang.Object,0.00,15,0,52,1,15,19,1,43,1561,1
"org.apache.lucene.analysis.compound.hyphenation.TernaryTree$Iterator",9,0.25,3.11,101,1.11,65523.33,13,4,2,29,1,122.09,30,132,0,1,101.48,0.00,0.00,0.47,2,0.00,10,3329.95,0,1,1,java.lang.Object,0.00,20,0,28,0,20,8,1,13,659,1
"org.apache.lucene.analysis.compound.hyphenation.TernaryTree$Iterator$Item",3,0.75,1.00,11,0.07,702.58,5,2,2,4,0,134.54,0,16,0,1,134.54,0.00,0.00,1.00,0,0.00,1,198.73,0,1,0,java.lang.Object,0.00,1,0,3,0,1,2,1,0,58,1
"org.apache.lucene.codecs.BlockTermState",2,1.50,1.00,15,0.16,4011.26,6,4,3,4,14,81.25,12,20,11,3,113.47,1.50,0.33,1.00,0,0.00,1,491.89,1,1,3,org.apache.lucene.index.OrdTermState,0.43,2,2,2,3,2,1,0,8,113,1
"org.apache.lucene.codecs.BlockTermsReader",8,0.05,1.75,62,0.88,42513.37,14,6,25,29,30,130.63,26,88,6,3,110.01,0.00,0.67,0.21,2,18.00,4,2637.07,0,2,24,org.apache.lucene.codecs.FieldsProducer,0.69,21,2,14,0,21,6,0,16,492,1
"org.apache.lucene.codecs.BlockTermsReader$FieldAndTerm",5,0.12,1.00,14,0.14,2620.12,7,2,25,11,1,138.36,0,23,0,2,138.36,0.00,0.50,0.60,0,2.00,1,432.07,0,1,1,DoubleBarrelLRUCache.CloneableKey,0.00,6,1,5,0,6,4,0,0,113,2
"org.apache.lucene.codecs.BlockTermsReader$FieldReader",7,0.08,1.00,28,0.24,4382.58,13,6,25,9,4,126.52,1,43,0,2,126.52,0.00,0.50,0.10,0,27.00,1,716.29,0,2,4,org.apache.lucene.index.Terms,0.71,2,1,7,0,2,5,0,1,181,1
"org.apache.lucene.codecs.BlockTermsReader$FieldReader$SegmentTermsEnum",16,0.19,4.19,263,3.59,522099.86,34,18,25,45,11,41.73,162,340,0,2,90.21,0.00,0.50,0.23,4,0.00,37,10784.29,0,8,11,org.apache.lucene.index.TermsEnum,0.41,29,1,67,0,29,8,0,144,1841,2
"org.apache.lucene.codecs.BlockTermsReader$TermFieldsEnum",3,0.25,1.33,14,0.11,1968.70,5,2,25,6,2,126.29,0,21,0,2,126.29,0.00,0.50,0.67,0,0.00,2,319.74,0,2,2,org.apache.lucene.index.FieldsEnum,0.67,3,1,4,0,3,1,0,0,82,1
"org.apache.lucene.codecs.BlockTermsWriter",5,0.28,2.20,61,0.78,28452.75,15,10,16,22,21,121.61,18,79,6,2,100.99,0.00,0.50,0.32,2,0.00,6,2350.87,0,1,15,org.apache.lucene.codecs.FieldsConsumer,0.25,17,1,11,0,17,4,0,12,446,1
"org.apache.lucene.codecs.BlockTermsWriter$TermEntry",0,0.00,0.00,3,0.03,468.83,2,2,16,1,2,171.00,0,4,0,1,171.00,0.00,0.00,0.00,0,0.00,0,78.14,0,0,2,java.lang.Object,0.00,1,0,0,0,1,0,0,0,20,2
"org.apache.lucene.codecs.BlockTermsWriter$TermsWriter",7,0.12,2.71,106,1.28,67947.62,19,12,16,29,9,135.39,18,121,0,2,95.50,0.00,0.50,0.19,2,0.00,5,3828.76,0,2,9,org.apache.lucene.codecs.TermsConsumer,0.33,22,1,19,0,22,5,0,18,718,0
"org.apache.lucene.codecs.BlockTreeTermsReader",10,0.01,1.90,81,1.23,77540.21,18,8,36,37,40,106.77,47,113,9,3,106.54,0.50,0.50,0.14,3,26.00,8,3702.01,0,3,31,org.apache.lucene.codecs.FieldsProducer,0.60,27,2,19,1,27,7,0,19,667,1
"org.apache.lucene.codecs.BlockTreeTermsReader$FieldReader",9,0.04,1.22,45,0.53,16299.82,18,9,36,20,10,159.11,18,63,0,2,119.23,0.00,0.50,0.07,0,44.00,2,1575.26,0,4,10,org.apache.lucene.index.Terms,0.62,11,1,11,0,11,5,0,10,333,2
"org.apache.lucene.codecs.BlockTreeTermsReader$FieldReader$IntersectEnum",20,0.07,3.10,250,3.65,337049.67,29,9,36,48,14,79.33,100,300,0,2,97.20,0.00,0.50,0.18,5,34.00,19,10960.52,0,10,14,org.apache.lucene.index.TermsEnum,0.36,28,1,62,0,28,10,0,100,1923,2
"org.apache.lucene.codecs.BlockTreeTermsReader$FieldReader$IntersectEnum$Frame",9,0.19,2.78,128,1.70,98108.06,37,28,36,20,6,96.45,44,152,0,1,96.22,0.00,0.00,0.20,2,0.00,10,5085.51,0,0,6,java.lang.Object,0.00,11,0,25,0,11,9,0,44,901,2
"org.apache.lucene.codecs.BlockTreeTermsReader$FieldReader$IntersectEnum$SegmentTermsEnum",23,0.17,5.26,471,7.61,1007684.84,35,12,36,62,14,47.97,276,584,0,2,85.54,0.00,0.50,0.25,6,0.00,23,22817.95,0,12,14,org.apache.lucene.index.TermsEnum,0.33,39,1,121,0,39,11,0,273,3699,2
"org.apache.lucene.codecs.BlockTreeTermsReader$FieldReader$IntersectEnum$SegmentTermsEnum$Frame_0",17,0.19,4.29,293,3.58,257353.56,44,27,36,29,4,62.47,236,354,0,1,91.85,0.00,0.00,0.21,4,0.00,16,10751.79,0,3,4,java.lang.Object,0.00,12,0,73,0,12,14,0,190,1892,2
"org.apache.lucene.codecs.BlockTreeTermsReader$Stats",6,0.32,3.33,94,1.53,108889.22,26,20,36,15,2,93.32,2,106,0,1,93.32,0.00,0.00,0.32,0,2.00,8,4583.05,0,1,2,java.lang.Object,0.00,9,0,20,0,9,5,0,2,801,2
"org.apache.lucene.codecs.BlockTreeTermsReader$TermFieldsEnum",3,0.25,1.33,14,0.11,1968.70,5,2,36,6,2,126.29,0,21,0,2,126.29,0.00,0.50,0.67,0,0.00,2,319.74,0,2,2,org.apache.lucene.index.FieldsEnum,0.67,3,1,4,0,3,1,0,0,82,1
"org.apache.lucene.codecs.BlockTreeTermsWriter",7,0.06,2.00,78,1.16,47195.44,31,24,22,21,31,53.74,58,99,11,2,101.84,1.00,0.33,0.09,2,30.00,6,3486.52,0,0,20,org.apache.lucene.codecs.FieldsConsumer,0.00,14,1,14,1,14,7,0,17,629,1
"org.apache.lucene.codecs.BlockTreeTermsWriter$PendingBlock",4,0.21,3.50,57,0.96,72936.69,12,8,22,22,7,76.53,23,70,0,2,94.41,0.00,0.50,0.28,1,2.00,10,2889.19,0,1,7,org.apache.lucene.codecs.PendingEntry,0.00,18,1,14,0,18,3,0,18,510,3
"org.apache.lucene.codecs.BlockTreeTermsWriter$PendingEntry",1,1.00,1.00,4,0.03,307.28,2,1,22,1,0,128.95,0,6,0,1,128.95,0.00,0.00,0.00,0,1.00,1,76.40,0,0,0,java.lang.Object,0.00,0,0,1,0,0,1,0,0,23,2
"org.apache.lucene.codecs.BlockTreeTermsWriter$PendingTerm",2,0.50,1.00,9,0.07,960.84,4,2,22,3,2,127.42,0,13,0,2,127.42,0.00,0.50,0.25,0,2.00,1,217.71,0,1,2,org.apache.lucene.codecs.PendingEntry,0.00,1,1,2,0,1,1,0,0,58,3
"org.apache.lucene.codecs.BlockTreeTermsWriter$TermsWriter",9,0.10,5.33,263,4.25,661994.88,26,17,22,48,12,95.87,166,309,0,2,77.74,0.00,0.50,0.14,1,0.00,17,12748.69,0,4,12,org.apache.lucene.codecs.TermsConsumer,0.29,39,1,48,0,39,5,0,140,2034,0
"org.apache.lucene.codecs.BlockTreeTermsWriter$TermsWriter$FindBlocks",1,0.00,5.00,25,0.37,31973.00,1,0,22,4,1,38.88,11,26,0,2,83.01,0.00,0.50,0.00,0,0.00,5,1102.71,0,0,1,Builder.FreezeTail,0.00,3,1,5,0,3,1,0,11,196,1
"org.apache.lucene.codecs.Codec",16,0.22,1.06,38,0.40,11548.07,19,3,7,24,74,177.13,35,51,64,1,137.25,0.00,0.00,0.12,7,88.00,2,1195.18,0,6,12,java.lang.Object,0.00,8,0,17,9,8,10,1,19,292,2
"org.apache.lucene.codecs.DocValuesArraySource",16,0.50,1.19,63,0.99,30869.28,18,2,9,18,20,147.91,56,87,17,2,127.29,6.00,0.12,0.03,3,30.00,2,2964.46,0,4,3,org.apache.lucene.index.DocValues.Source,0.00,2,1,19,6,2,12,0,8,665,2
"org.apache.lucene.codecs.DocValuesArraySource$ByteValues",9,0.50,1.11,31,0.34,7258.01,10,1,9,11,3,130.29,0,48,0,3,130.29,0.00,0.67,0.56,2,4.00,2,1021.72,0,1,3,org.apache.lucene.codecs.DocValuesArraySource,0.00,2,2,10,0,2,8,0,0,244,2
"org.apache.lucene.codecs.DocValuesArraySource$DoubleValues",8,0.43,1.12,29,0.30,6061.72,9,1,9,11,4,130.50,4,42,0,3,130.50,0.00,0.67,0.62,1,0.00,2,907.92,1,1,4,org.apache.lucene.codecs.DocValuesArraySource,0.00,3,2,9,0,3,7,0,1,215,2
"org.apache.lucene.codecs.DocValuesArraySource$FloatValues",9,0.50,1.11,31,0.33,6420.68,10,1,9,13,4,130.71,4,46,0,3,130.71,0.00,0.67,0.56,2,4.00,2,1001.94,1,1,4,org.apache.lucene.codecs.DocValuesArraySource,0.00,4,2,10,0,4,8,0,1,238,2
"org.apache.lucene.codecs.DocValuesArraySource$IntValues",9,0.50,1.11,31,0.32,6424.93,10,1,9,11,4,130.71,0,45,0,3,130.71,0.00,0.67,0.56,2,4.00,2,965.45,1,1,4,org.apache.lucene.codecs.DocValuesArraySource,0.00,2,2,10,0,2,8,0,0,232,2
"org.apache.lucene.codecs.DocValuesArraySource$LongValues",8,0.43,1.12,29,0.29,5924.56,9,1,9,10,4,130.58,0,42,0,3,130.58,0.00,0.67,0.62,1,0.00,2,883.20,1,1,4,org.apache.lucene.codecs.DocValuesArraySource,0.00,2,2,9,0,2,7,0,0,211,2
"org.apache.lucene.codecs.DocValuesArraySource$ShortValues",9,0.50,1.11,31,0.32,6145.60,10,1,9,11,4,130.86,0,45,0,3,130.86,0.00,0.67,0.56,2,4.00,2,955.54,1,1,4,org.apache.lucene.codecs.DocValuesArraySource,0.00,2,2,10,0,2,8,0,0,230,2
"org.apache.lucene.codecs.DocValuesConsumer",6,1.00,3.00,49,0.79,31894.56,7,1,10,19,20,63.59,68,84,13,1,107.72,0.00,0.00,0.17,5,10.00,6,2357.66,0,1,7,java.lang.Object,0.00,13,0,18,3,13,5,0,11,431,2
"org.apache.lucene.codecs.DocValuesFormat",3,0.00,1.00,4,0.05,417.76,3,0,6,3,12,204.12,4,5,6,1,154.12,0.00,0.00,0.00,0,3.00,1,135.16,0,2,6,java.lang.Object,0.00,0,0,3,3,0,1,0,1,40,2
"org.apache.lucene.codecs.FieldInfosFormat",3,0.00,1.00,4,0.04,371.66,3,0,4,3,13,204.52,4,5,9,1,154.52,0.00,0.00,0.00,0,3.00,1,116.72,0,0,4,java.lang.Object,0.00,0,0,3,2,0,3,0,1,36,2
"org.apache.lucene.codecs.FieldInfosReader",1,0.00,1.00,2,0.02,156.48,1,0,4,1,11,163.11,3,3,8,1,142.49,0.00,0.00,0.00,0,1.00,1,64.91,0,1,3,java.lang.Object,0.00,0,0,1,3,0,0,0,1,19,2
"org.apache.lucene.codecs.FieldInfosWriter",1,0.00,1.00,2,0.03,183.22,1,0,4,1,10,162.57,3,3,7,1,141.95,0.00,0.00,0.00,0,1.00,1,75.61,0,0,3,java.lang.Object,0.00,0,0,1,3,0,1,0,1,21,2
"org.apache.lucene.codecs.FieldsConsumer",3,0.00,1.67,14,0.19,7691.62,3,0,7,8,31,142.20,9,18,25,1,121.58,0.00,0.00,0.00,1,3.00,3,578.35,0,1,6,java.lang.Object,0.00,5,0,5,7,5,2,1,3,122,2
"org.apache.lucene.codecs.FieldsProducer",1,0.00,1.00,2,0.02,145.59,1,0,3,1,19,124.86,5,3,18,2,142.74,6.00,0.12,0.00,0,1.00,1,52.53,0,0,1,org.apache.lucene.index.Fields,0.00,0,1,1,6,0,1,1,1,17,2
"org.apache.lucene.codecs.FixedGapTermsIndexReader",4,0.18,2.25,59,0.85,57325.10,15,11,16,20,19,115.95,14,70,5,2,95.33,0.00,0.50,0.23,1,6.00,6,2564.98,0,0,14,org.apache.lucene.codecs.TermsIndexReaderBase,0.50,16,1,9,0,16,4,0,14,434,1
"org.apache.lucene.codecs.FixedGapTermsIndexReader$FieldIndexData",6,0.00,1.67,32,0.35,7413.65,12,6,16,11,5,120.46,0,47,0,1,120.46,0.00,0.00,0.17,1,22.00,2,1036.43,0,0,5,java.lang.Object,0.00,5,0,10,0,5,6,0,0,239,2
"org.apache.lucene.codecs.FixedGapTermsIndexReader$FieldIndexData$CoreFieldIndex",1,2.00,5.00,62,0.95,131133.35,6,5,16,11,2,81.60,18,69,0,1,63.47,0.00,0.00,0.60,0,0.00,5,2863.86,0,0,2,java.lang.Object,0.00,10,0,5,0,10,1,0,18,468,2
"org.apache.lucene.codecs.FixedGapTermsIndexReader$IndexEnum",6,0.27,1.83,53,0.83,69686.56,9,3,16,9,1,105.16,2,70,0,2,105.16,0.00,0.50,0.56,0,0.00,5,2503.87,0,1,1,org.apache.lucene.codecs.FieldIndexEnum,0.00,3,1,11,0,3,5,0,2,482,1
"org.apache.lucene.codecs.FixedGapTermsIndexWriter",6,0.12,2.33,75,0.90,41081.52,14,8,13,24,18,120.96,18,86,7,2,100.35,0.00,0.50,0.23,2,6.00,6,2691.64,0,1,11,org.apache.lucene.codecs.TermsIndexWriterBase,0.00,18,1,14,0,18,5,0,9,522,1
"org.apache.lucene.codecs.FixedGapTermsIndexWriter$SimpleFieldWriter",4,0.42,2.50,64,0.71,30027.05,16,12,13,12,5,95.59,17,72,0,2,95.35,0.00,0.50,0.40,0,0.00,3,2130.61,0,0,5,org.apache.lucene.codecs.FieldWriter,0.00,8,1,10,0,8,4,0,17,412,1
"org.apache.lucene.codecs.LiveDocsFormat",5,0.00,1.00,6,0.08,711.01,5,0,7,5,15,204.05,6,7,10,1,154.05,0.00,0.00,0.00,0,5.00,1,252.46,0,3,5,java.lang.Object,0.00,0,0,5,2,0,2,0,5,70,2
"org.apache.lucene.codecs.MappingMultiDocsAndPositionsEnum",11,0.09,1.64,56,0.56,22080.26,19,8,5,22,6,118.81,7,84,2,4,118.81,0.00,0.75,0.20,0,0.00,7,1684.98,0,2,4,org.apache.lucene.index.DocsAndPositionsEnum,1.71,11,3,18,0,11,9,0,2,370,2
"org.apache.lucene.codecs.MappingMultiDocsEnum",6,0.12,2.00,44,0.52,32193.52,14,8,4,11,5,159.95,7,61,2,3,109.95,0.00,0.67,0.23,0,10.00,7,1548.39,0,1,3,org.apache.lucene.index.DocsEnum,1.09,5,2,12,0,5,5,0,2,310,2
"org.apache.lucene.codecs.MultiLevelSkipListReader",11,0.22,2.73,120,1.43,76461.04,25,14,4,20,3,85.34,61,138,1,1,103.21,0.00,0.00,0.27,3,0.00,7,4293.67,0,0,2,java.lang.Object,0.00,9,0,30,2,9,11,0,44,846,2
"org.apache.lucene.codecs.MultiLevelSkipListReader$SkipBuffer",7,0.22,1.00,22,0.23,3964.04,10,3,4,10,1,131.52,0,36,0,3,131.52,0.00,0.67,0.52,0,0.00,1,703.42,0,0,1,org.apache.lucene.store.IndexInput,0.72,3,2,7,0,3,7,0,0,171,3
"org.apache.lucene.codecs.MultiLevelSkipListWriter",6,0.00,2.67,56,0.50,23058.41,9,3,3,14,4,58.85,53,56,1,1,106.95,0.00,0.00,0.33,2,0.00,4,1486.01,0,0,3,java.lang.Object,0.00,8,0,16,2,8,6,0,14,319,2
"org.apache.lucene.codecs.NormsFormat",3,0.00,1.00,4,0.05,417.76,3,0,5,3,11,204.12,3,5,6,1,154.12,0.00,0.00,0.00,0,3.00,1,135.16,0,1,5,java.lang.Object,0.00,0,0,3,2,0,2,0,1,40,2
"org.apache.lucene.codecs.PerDocConsumer",6,0.00,1.50,25,0.29,11049.68,6,0,7,12,15,80.44,45,30,10,1,122.74,0.00,0.00,0.00,3,6.00,4,862.62,0,2,5,java.lang.Object,0.00,6,0,9,7,6,4,1,8,184,2
"org.apache.lucene.codecs.PerDocProducer",1,0.00,1.00,2,0.02,132.18,1,0,3,1,11,182.37,21,3,10,1,143.07,0.00,0.00,0.00,0,1.00,1,52.87,0,1,1,java.lang.Object,0.00,0,0,1,6,0,0,1,2,17,2
"org.apache.lucene.codecs.PerDocProducerBase",11,0.00,1.27,32,0.41,12898.47,11,0,13,20,10,175.43,25,52,3,2,135.55,5.00,0.14,0.00,4,11.00,4,1223.29,0,7,7,org.apache.lucene.codecs.PerDocProducer,0.00,9,1,14,5,9,4,0,4,273,2
"org.apache.lucene.codecs.PostingsBaseFormat",4,1.00,1.00,7,0.07,740.66,5,1,5,4,6,173.76,12,9,1,1,153.14,0.00,0.00,0.00,0,4.00,1,207.59,0,0,5,java.lang.Object,0.00,0,0,4,1,0,4,0,7,60,2
"org.apache.lucene.codecs.PostingsConsumer",4,0.00,4.75,77,0.94,118343.38,4,0,8,15,21,108.35,13,86,14,1,87.73,0.00,0.00,0.00,3,4.00,16,2814.04,0,0,7,java.lang.Object,0.00,11,0,19,8,11,4,0,5,486,2
"org.apache.lucene.codecs.PostingsConsumer$PostingsMergeState",0,0.00,0.00,4,0.02,238.40,3,3,8,0,1,171.00,0,5,0,1,171.00,0.00,0.00,0.00,0,0.00,0,68.11,0,0,1,java.lang.Object,0.00,0,0,0,0,0,0,0,0,19,2
"org.apache.lucene.codecs.PostingsFormat",8,0.19,1.00,17,0.20,4784.56,11,3,6,11,34,177.79,19,26,28,1,137.90,0.00,0.00,0.17,0,24.00,1,597.46,0,5,6,java.lang.Object,0.00,3,0,8,14,3,3,1,7,153,2
"org.apache.lucene.codecs.PostingsReaderBase",7,0.00,1.00,8,0.11,891.51,7,0,7,7,22,175.04,21,10,16,1,154.42,0.00,0.00,0.00,0,7.00,1,344.34,0,2,6,java.lang.Object,0.00,0,0,7,3,0,5,1,9,95,2
"org.apache.lucene.codecs.PostingsWriterBase",6,0.00,1.00,7,0.07,540.76,6,0,4,6,21,205.61,11,8,17,2,155.61,3.00,0.20,0.00,0,6.00,1,208.48,0,0,4,org.apache.lucene.codecs.PostingsConsumer,0.00,0,1,6,3,0,6,1,6,65,2
"org.apache.lucene.codecs.SegmentInfosFormat",2,0.00,1.00,3,0.01,85.26,2,0,0,2,9,147.81,30,4,7,1,158.17,0.00,0.00,0.00,0,2.00,1,42.63,0,1,2,java.lang.Object,0.00,0,0,2,3,0,1,0,9,17,2
"org.apache.lucene.codecs.SegmentInfosReader",1,0.00,1.00,2,0.03,210.87,1,0,5,1,7,103.91,12,3,4,1,141.47,0.00,0.00,0.00,0,1.00,1,86.67,0,0,4,java.lang.Object,0.00,0,0,1,2,0,1,0,2,23,2
"org.apache.lucene.codecs.SegmentInfosWriter",3,0.00,1.00,4,0.05,388.58,3,0,5,3,9,105.89,30,5,6,1,154.37,0.00,0.00,0.00,0,3.00,1,151.62,0,1,4,java.lang.Object,0.00,0,0,3,4,0,2,0,4,43,2
"org.apache.lucene.codecs.StoredFieldsFormat",3,0.00,1.00,4,0.06,544.92,3,0,6,3,13,120.99,19,5,7,1,153.21,0.00,0.00,0.00,0,3.00,1,186.02,0,0,6,java.lang.Object,0.00,0,0,3,2,0,3,0,2,50,2
"org.apache.lucene.codecs.StoredFieldsReader",2,0.00,1.00,3,0.03,211.28,2,0,4,2,10,155.30,9,4,8,1,155.06,0.00,0.00,0.00,0,2.00,1,87.62,0,1,2,java.lang.Object,0.00,0,0,2,2,0,1,2,2,27,2
"org.apache.lucene.codecs.StoredFieldsWriter",6,0.00,2.33,34,0.37,16639.68,6,0,8,14,11,67.62,59,38,5,1,117.62,0.00,0.00,0.00,4,6.00,6,1117.64,0,0,6,java.lang.Object,0.00,8,0,14,3,8,6,1,15,229,2
"org.apache.lucene.codecs.TermStats",1,2.00,1.00,6,0.04,527.22,3,2,0,1,24,120.07,16,8,24,1,120.54,0.00,0.00,0.00,0,1.00,1,124.85,0,0,0,java.lang.Object,0.00,0,0,1,0,0,1,0,1,36,1
"org.apache.lucene.codecs.TermVectorsFormat",3,0.00,1.00,4,0.06,544.92,3,0,6,3,13,203.21,3,5,7,1,153.21,0.00,0.00,0.00,0,3.00,1,186.02,0,0,6,java.lang.Object,0.00,0,0,3,2,0,3,0,1,50,2
"org.apache.lucene.codecs.TermVectorsReader",2,0.00,1.00,3,0.02,174.07,2,0,5,2,14,137.85,11,4,11,1,155.73,0.00,0.00,0.00,0,2.00,1,72.73,0,2,3,java.lang.Object,0.00,0,0,2,2,0,0,2,3,24,2
"org.apache.lucene.codecs.TermVectorsWriter",10,0.00,2.90,118,1.45,159013.89,10,0,15,31,18,50.72,87,131,6,1,98.82,0.00,0.00,0.00,6,10.00,14,4341.08,0,1,12,java.lang.Object,0.00,21,0,29,3,21,9,1,25,752,2
"org.apache.lucene.codecs.TermsConsumer",5,0.17,6.20,107,1.66,278760.41,8,3,9,18,27,84.12,21,127,17,1,83.88,0.00,0.00,0.20,3,8.00,27,4986.25,0,2,10,java.lang.Object,0.00,13,0,31,6,13,3,0,16,804,2
"org.apache.lucene.codecs.TermsIndexReaderBase",4,0.00,1.00,6,0.04,293.67,4,0,4,4,10,176.92,15,7,8,1,156.31,0.00,0.00,0.00,0,4.00,1,120.23,0,0,2,java.lang.Object,0.00,0,0,4,2,0,4,1,8,41,2
"org.apache.lucene.codecs.TermsIndexReaderBase$FieldIndexEnum",5,0.00,1.00,6,0.05,342.92,5,0,4,5,1,206.54,5,7,0,1,156.54,0.00,0.00,0.00,0,5.00,1,135.45,0,1,1,java.lang.Object,0.00,0,0,5,0,0,4,0,3,46,3
"org.apache.lucene.codecs.TermsIndexWriterBase",1,0.00,1.00,3,0.03,197.55,1,0,4,1,10,185.12,1,4,8,1,135.12,0.00,0.00,0.00,0,1.00,1,79.02,0,1,2,java.lang.Object,0.00,0,0,1,2,0,0,1,1,24,2
"org.apache.lucene.codecs.TermsIndexWriterBase$FieldWriter",3,0.00,1.00,4,0.05,347.07,3,0,4,3,2,154.75,0,5,0,1,154.75,0.00,0.00,0.00,0,3.00,1,141.15,0,0,2,java.lang.Object,0.00,0,0,3,0,0,3,0,0,41,2
"org.apache.lucene.codecs.VariableGapTermsIndexReader",8,0.02,1.62,54,0.70,27571.53,15,7,21,25,18,114.01,7,71,1,2,114.01,0.00,0.50,0.16,2,26.00,4,2087.23,0,0,17,org.apache.lucene.codecs.TermsIndexReaderBase,0.50,17,1,13,0,17,8,0,5,407,1
"org.apache.lucene.codecs.VariableGapTermsIndexReader$FieldIndexData",2,0.00,3.50,26,0.38,14867.98,4,2,21,12,7,98.91,9,35,0,1,98.67,0.00,0.00,0.50,1,0.00,5,1140.56,0,0,7,java.lang.Object,0.00,10,0,7,0,10,2,0,3,210,2
"org.apache.lucene.codecs.VariableGapTermsIndexReader$IndexEnum",6,0.00,1.33,23,0.21,4294.06,8,2,21,10,3,130.66,4,38,0,2,130.66,0.00,0.50,0.50,0,2.00,2,631.18,0,1,3,org.apache.lucene.codecs.FieldIndexEnum,0.00,4,1,8,0,4,5,0,4,156,2
"org.apache.lucene.codecs.VariableGapTermsIndexWriter",6,0.12,2.17,69,0.84,33778.82,14,8,16,24,16,52.44,55,79,2,2,102.44,0.00,0.50,0.23,2,6.00,5,2507.04,0,0,14,org.apache.lucene.codecs.TermsIndexWriterBase,0.00,18,1,13,0,18,6,0,44,494,1
"org.apache.lucene.codecs.VariableGapTermsIndexWriter$EveryNOrDocFreqTermSelector",3,0.50,1.33,17,0.14,2794.28,6,3,16,3,3,121.48,1,24,0,2,121.48,0.00,0.50,0.67,0,0.00,2,418.47,0,0,3,org.apache.lucene.codecs.IndexTermSelector,0.00,0,1,4,0,0,3,0,1,102,3
"org.apache.lucene.codecs.VariableGapTermsIndexWriter$EveryNTermSelector",3,0.50,1.33,15,0.11,1807.07,5,2,16,3,3,122.97,1,22,0,2,122.97,0.00,0.50,0.83,0,0.00,2,326.74,0,0,3,org.apache.lucene.codecs.IndexTermSelector,0.00,0,1,4,0,0,3,0,1,82,3
"org.apache.lucene.codecs.VariableGapTermsIndexWriter$FSTFieldWriter",4,0.30,1.75,38,0.46,11975.49,13,9,16,13,7,157.90,7,51,0,2,107.90,0.00,0.50,0.33,0,0.00,2,1389.16,0,0,7,org.apache.lucene.codecs.FieldWriter,0.00,9,1,7,0,9,4,0,7,280,1
"org.apache.lucene.codecs.VariableGapTermsIndexWriter$IndexTermSelector",2,0.00,1.00,3,0.02,153.21,2,0,16,2,3,206.16,2,4,0,1,156.16,0.00,0.00,0.00,0,2.00,1,72.73,0,0,3,java.lang.Object,0.00,0,0,2,0,0,2,0,2,24,3
"org.apache.lucene.LucenePackage",2,0.00,1.00,4,0.02,235.98,2,0,0,3,3,93.46,19,6,3,1,143.46,0.00,0.00,0.00,0,2.00,1,69.80,0,1,0,java.lang.Object,0.00,1,0,2,0,1,1,0,4,23,2
"org.apache.lucene.TestAssertions",1,0.00,2.00,12,0.09,1128.84,1,0,2,5,1,106.78,4,19,0,2,106.55,0.00,0.50,0.00,0,1.00,2,256.53,0,0,1,org.apache.lucene.util.LuceneTestCase,0.00,4,1,2,0,4,1,0,2,63,1
"org.apache.lucene.TestAssertions$TestTokenStream1",1,0.00,1.00,3,0.02,212.64,1,0,2,1,1,134.87,0,4,0,3,134.87,0.00,0.67,0.00,0,1.00,1,57.02,0,0,1,org.apache.lucene.analysis.TokenStream,0.33,0,2,1,0,0,1,0,0,18,1
"org.apache.lucene.TestAssertions$TestTokenStream2",1,0.00,1.00,3,0.02,186.16,1,0,2,1,1,135.33,0,4,0,3,135.33,0.00,0.67,0.00,0,1.00,1,56.19,0,0,1,org.apache.lucene.analysis.TokenStream,0.33,0,2,1,0,0,1,0,0,18,2
"org.apache.lucene.TestAssertions$TestTokenStream3",1,0.00,1.00,3,0.02,168.05,1,0,2,1,1,135.68,0,4,0,3,135.68,0.00,0.67,0.00,0,1.00,1,52.05,0,0,1,org.apache.lucene.analysis.TokenStream,0.33,0,2,1,0,0,1,0,0,17,1
"org.apache.lucene.TestDemo",1,0.00,2.00,29,0.47,20271.54,1,0,11,21,13,52.99,13,29,0,2,82.37,0.00,0.50,0.00,0,1.00,2,1416.78,0,0,13,org.apache.lucene.util.LuceneTestCase,0.00,20,1,2,0,20,1,0,8,237,1
"org.apache.lucene.TestExternalCodecs",1,0.00,9.00,54,1.06,78754.45,1,0,8,30,12,19.21,8,66,0,2,67.32,0.00,0.50,0.00,0,1.00,9,3169.70,0,0,12,org.apache.lucene.util.LuceneTestCase,0.00,29,1,9,0,29,1,0,7,488,1
"org.apache.lucene.TestExternalCodecs$CustomPerFieldCodec",1,0.00,3.00,11,0.13,3088.01,4,3,8,3,2,104.42,0,15,0,3,104.42,0.00,0.67,1.00,0,0.00,3,386.38,0,1,2,org.apache.lucene.codecs.lucene40.Lucene40Codec,0.00,2,2,3,0,2,0,0,0,88,3
"org.apache.lucene.TestMergeSchedulerExternal",0,0.00,0.00,5,0.04,461.50,3,3,17,0,14,171.00,4,5,0,2,171.00,0.00,0.50,0.00,0,0.00,0,105.49,0,0,14,org.apache.lucene.util.LuceneTestCase,0.00,0,1,0,0,0,0,0,1,27,1
"org.apache.lucene.TestMergeSchedulerExternal$MyMergeScheduler",5,0.00,1.20,47,0.60,12736.26,5,0,17,39,11,158.54,5,58,0,3,108.54,0.00,0.67,0.00,0,6.00,2,1809.67,2,1,11,org.apache.lucene.index.ConcurrentMergeScheduler,0.00,34,2,6,0,34,4,0,5,352,1
"org.apache.lucene.TestMergeSchedulerExternal$MyMergeScheduler$FailOnlyOnMerge",1,0.00,3.00,8,0.11,3080.70,1,0,17,6,1,109.59,0,10,0,2,109.59,0.00,0.50,0.00,0,1.00,3,316.06,0,0,1,MockDirectoryWrapper.Failure,0.00,5,1,3,0,5,1,0,0,66,2
"org.apache.lucene.TestMergeSchedulerExternal$MyMergeScheduler$MyMergeThread",1,0.00,1.00,4,0.04,420.51,1,0,17,1,1,127.88,0,7,0,2,127.88,0.00,0.50,0.00,0,0.00,1,109.84,0,0,1,ConcurrentMergeScheduler.MergeThread,0.00,0,1,1,0,0,1,0,0,29,1
"org.apache.lucene.TestMergeSchedulerExternal$MyMergeScheduler$ReportingMergeScheduler",2,0.00,2.00,8,0.11,2797.49,2,0,17,6,3,123.61,0,14,0,2,123.61,0.00,0.50,0.00,0,2.00,3,333.10,0,0,3,org.apache.lucene.index.MergeScheduler,0.50,4,1,4,0,4,2,0,0,75,2
"org.apache.lucene.TestSearch",3,0.00,2.67,81,1.30,74743.01,3,0,11,40,20,103.38,11,93,0,2,82.76,0.00,0.50,0.00,1,3.00,6,3902.48,0,1,20,org.apache.lucene.util.LuceneTestCase,0.00,37,1,8,0,37,2,0,3,682,1
"org.apache.lucene.TestSearchForDuplicates",4,0.13,3.00,79,1.29,61086.53,9,5,10,41,18,129.99,11,84,0,2,90.10,0.00,0.50,0.30,3,0.00,5,3872.00,0,0,18,org.apache.lucene.util.LuceneTestCase,0.00,37,1,12,0,37,4,0,4,663,1
"org.apache.lucene.demo.IndexFiles",3,0.00,5.67,70,1.14,71690.91,3,0,21,39,13,118.71,61,88,1,1,85.33,0.00,0.00,0.00,1,3.00,9,3410.38,0,0,12,java.lang.Object,0.00,36,0,17,0,36,3,0,43,539,1
"org.apache.lucene.demo.SearchFiles",3,0.00,13.33,137,2.36,296288.42,3,0,17,33,11,51.53,16,161,1,1,69.40,0.00,0.00,0.00,1,3.00,20,7087.00,0,0,10,java.lang.Object,0.00,30,0,40,0,30,3,0,7,1062,1
"org.apache.lucene.demo.TestDemo",2,0.00,1.00,22,0.31,7757.17,2,0,5,14,3,103.89,1,27,0,2,103.89,0.00,0.50,0.00,1,2.00,1,931.31,0,0,3,org.apache.lucene.util.LuceneTestCase,0.00,12,1,2,0,12,2,0,1,178,1
"org.apache.solr.uima.ts.EntityAnnotation",10,0.50,1.40,30,0.39,6100.72,12,2,4,16,3,151.81,33,37,3,2,131.19,0.00,0.50,0.05,1,18.00,2,1170.23,0,2,1,org.apache.uima.jcas.tcas.Annotation,0.00,6,1,14,0,6,8,0,17,277,1
"org.apache.solr.uima.ts.EntityAnnotation_Type",6,0.37,2.00,30,0.44,8531.50,12,6,10,15,2,140.55,18,38,2,2,119.94,0.00,0.50,0.47,0,0.00,3,1314.67,0,3,1,org.apache.uima.jcas.tcas.Annotation_Type,0.00,9,1,12,0,9,3,0,14,277,1
"org.apache.solr.uima.ts.EntityAnnotation_Type$FSGenerator",1,0.00,3.00,10,0.12,4415.53,1,0,10,4,2,154.74,1,12,0,1,104.74,0.00,0.00,0.00,0,1.00,3,351.13,0,1,2,java.lang.Object,0.00,3,0,3,0,3,0,0,1,77,0
"org.apache.solr.uima.ts.SentimentAnnotation",8,0.50,1.25,24,0.25,3786.88,10,2,4,14,3,152.70,27,29,3,2,132.08,0.00,0.50,0.06,1,14.00,2,764.10,0,1,1,org.apache.uima.jcas.tcas.Annotation,0.00,6,1,10,0,6,7,0,13,189,1
"org.apache.solr.uima.ts.SentimentAnnotation_Type",4,0.42,1.75,20,0.28,4841.33,8,4,10,13,2,141.14,14,25,2,2,120.52,0.00,0.50,0.56,0,0.00,2,827.16,0,2,1,org.apache.uima.jcas.tcas.Annotation_Type,0.00,9,1,7,0,9,2,0,10,177,1
"org.apache.solr.uima.ts.SentimentAnnotation_Type$FSGenerator",1,0.00,3.00,10,0.12,4415.53,1,0,10,4,2,154.74,1,12,0,1,104.74,0.00,0.00,0.00,0,1.00,3,351.13,0,1,2,java.lang.Object,0.00,3,0,3,0,3,0,0,1,77,0
"org.apache.lucene.queryparser.flexible.standard.builders.AnyQueryNodeBuilder",2,0.00,3.00,17,0.22,9621.35,2,0,11,10,10,147.95,5,25,0,1,108.06,0.00,0.00,0.00,0,2.00,5,657.97,0,1,10,java.lang.Object,0.00,8,0,6,0,8,1,1,2,123,1
"org.apache.lucene.queryparser.flexible.standard.builders.BooleanQueryNodeBuilder",3,0.00,3.00,24,0.33,14490.32,3,0,13,13,13,128.66,10,41,1,1,108.05,0.00,0.00,0.00,0,3.00,5,994.67,0,2,12,java.lang.Object,0.00,10,0,9,0,10,1,1,2,193,1
"org.apache.lucene.queryparser.flexible.standard.builders.BoostQueryNodeBuilder",2,0.00,1.50,10,0.10,2428.49,2,0,5,6,7,141.16,7,15,1,1,120.55,0.00,0.00,0.00,0,2.00,2,296.14,0,1,6,java.lang.Object,0.00,4,0,3,0,4,1,1,2,68,1
"org.apache.lucene.queryparser.flexible.standard.builders.DummyQueryNodeBuilder",2,0.00,1.00,4,0.02,172.08,2,0,5,2,7,96.43,16,7,1,1,144.54,0.00,0.00,0.00,0,2.00,1,66.53,0,1,6,java.lang.Object,0.00,0,0,2,0,0,1,1,4,22,1
"org.apache.lucene.queryparser.flexible.standard.builders.FieldQueryNodeBuilder",2,0.00,1.00,5,0.05,960.57,2,0,5,6,7,178.54,4,9,1,1,138.65,0.00,0.00,0.00,0,2.00,1,159.44,0,1,6,java.lang.Object,0.00,4,0,2,0,4,1,1,2,42,1
"org.apache.lucene.queryparser.flexible.standard.builders.FuzzyQueryNodeBuilder",2,0.00,1.00,5,0.07,1294.83,2,0,5,8,7,177.52,4,10,1,1,137.63,0.00,0.00,0.00,0,2.00,1,199.20,0,1,6,java.lang.Object,0.00,6,0,2,0,6,1,1,2,50,1
"org.apache.lucene.queryparser.flexible.standard.builders.GroupQueryNodeBuilder",2,0.00,1.00,5,0.05,761.31,2,0,5,4,7,160.06,6,9,1,1,139.45,0.00,0.00,0.00,0,2.00,1,155.20,0,1,6,java.lang.Object,0.00,2,0,2,0,2,1,1,2,41,1
"org.apache.lucene.queryparser.flexible.standard.builders.MatchAllDocsQueryNodeBuilder",2,0.00,1.50,6,0.08,1856.27,2,0,7,9,9,150.35,6,13,1,1,129.74,0.00,0.00,0.00,0,2.00,2,241.77,0,1,8,java.lang.Object,0.00,7,0,3,0,7,1,1,3,57,1
"org.apache.lucene.queryparser.flexible.standard.builders.MatchNoDocsQueryNodeBuilder",2,0.00,1.50,6,0.08,1856.27,2,0,7,9,9,150.35,6,13,1,1,129.74,0.00,0.00,0.00,0,2.00,2,241.77,0,1,8,java.lang.Object,0.00,7,0,3,0,7,1,1,3,57,1
"org.apache.lucene.queryparser.flexible.standard.builders.ModifierQueryNodeBuilder",2,0.00,1.00,5,0.05,761.31,2,0,5,4,7,160.06,6,9,1,1,139.45,0.00,0.00,0.00,0,2.00,1,155.20,0,1,6,java.lang.Object,0.00,2,0,2,0,2,1,1,2,41,1
"org.apache.lucene.queryparser.flexible.standard.builders.MultiPhraseQueryNodeBuilder",2,0.00,3.00,22,0.35,19893.92,2,0,11,15,10,140.31,5,30,1,1,100.42,0.00,0.00,0.00,0,2.00,5,1048.81,0,1,9,java.lang.Object,0.00,13,0,6,0,13,1,1,2,189,1
"org.apache.lucene.queryparser.flexible.standard.builders.NumericRangeQueryNodeBuilder",2,0.00,1.00,20,0.41,20869.84,2,0,10,18,11,84.18,10,38,1,1,102.05,0.00,0.00,0.00,0,2.00,1,1224.60,0,1,10,java.lang.Object,0.00,16,0,2,0,16,1,1,3,208,1
"org.apache.lucene.queryparser.flexible.standard.builders.PhraseQueryNodeBuilder",2,0.00,2.00,13,0.15,5724.47,2,0,8,8,9,154.48,5,18,1,1,114.59,0.00,0.00,0.00,0,2.00,3,459.09,0,1,8,java.lang.Object,0.00,6,0,4,0,6,1,1,2,93,1
"org.apache.lucene.queryparser.flexible.standard.builders.PrefixWildcardQueryNodeBuilder",2,0.00,1.50,10,0.16,4468.23,2,0,7,11,9,158.35,5,14,1,1,118.46,0.00,0.00,0.00,0,2.00,2,480.08,0,1,8,java.lang.Object,0.00,9,0,3,0,9,1,1,2,97,1
"org.apache.lucene.queryparser.flexible.standard.builders.RegexpQueryNodeBuilder",2,0.00,1.50,9,0.12,3042.94,2,0,7,8,9,163.27,4,15,1,1,123.39,0.00,0.00,0.00,0,2.00,2,347.36,0,1,8,java.lang.Object,0.00,6,0,3,0,6,1,1,2,76,1
"org.apache.lucene.queryparser.flexible.standard.builders.SlopQueryNodeBuilder",2,0.00,1.50,10,0.11,3328.35,2,0,7,6,9,140.08,7,15,1,1,119.47,0.00,0.00,0.00,0,2.00,2,342.09,0,1,8,java.lang.Object,0.00,4,0,3,0,4,1,1,2,77,1
"org.apache.lucene.queryparser.flexible.standard.builders.StandardBooleanQueryNodeBuilder",3,0.00,3.33,27,0.36,15588.47,3,0,15,16,14,126.48,10,41,1,1,105.87,0.00,0.00,0.00,0,3.00,5,1093.36,0,2,13,java.lang.Object,0.00,13,0,10,0,13,1,1,2,212,1
"org.apache.lucene.queryparser.flexible.standard.builders.StandardQueryBuilder",1,0.00,1.00,2,0.01,88.08,1,0,5,1,28,102.16,7,3,23,2,144.46,0.00,0.50,0.00,0,1.00,1,44.04,0,1,5,,0.00,0,1,1,0,0,0,0,1,15,1
"org.apache.lucene.queryparser.flexible.standard.builders.StandardQueryTreeBuilder",2,0.00,1.00,22,0.34,5193.92,2,0,23,20,43,105.50,9,29,1,2,105.27,0.00,0.50,0.00,0,2.00,1,1017.69,2,1,42,org.apache.lucene.queryparser.flexible.core.builders.QueryTreeBuilder,0.00,18,1,2,0,18,1,1,1,195,1
"org.apache.lucene.queryparser.flexible.standard.builders.TermRangeQueryNodeBuilder",2,0.00,2.50,18,0.26,8197.53,2,0,8,13,10,146.63,5,26,1,1,106.75,0.00,0.00,0.00,0,2.00,4,775.89,0,1,9,java.lang.Object,0.00,11,0,5,0,11,1,1,2,147,1
"org.apache.lucene.queryparser.flexible.standard.builders.WildcardQueryNodeBuilder",2,0.00,1.50,9,0.12,3042.94,2,0,7,8,9,163.27,5,14,1,1,123.39,0.00,0.00,0.00,0,2.00,2,347.36,0,1,8,java.lang.Object,0.00,6,0,3,0,6,1,1,2,76,1
"org.apache.lucene.queryparser.analyzing.ASCIIAnalyzer",1,0.00,1.00,4,0.06,1028.22,1,0,6,4,7,124.82,0,7,1,2,124.82,0.00,0.50,0.00,0,1.00,1,167.13,0,1,6,org.apache.lucene.analysis.Analyzer,0.00,3,1,1,0,3,0,0,0,40,1
"org.apache.lucene.queryparser.analyzing.AnalyzingQueryParser",5,0.00,9.00,136,2.14,205226.28,5,0,10,30,7,114.16,101,197,1,3,80.77,0.00,0.67,0.00,0,5.00,19,6407.52,4,4,6,org.apache.lucene.queryparser.classic.QueryParser,0.00,25,2,45,0,25,1,0,25,1055,1
"org.apache.lucene.queryparser.analyzing.TestAnalyzingQueryParser",6,0.33,1.67,49,0.64,14427.04,15,9,6,12,6,110.57,2,60,0,2,110.57,0.00,0.50,0.39,0,0.00,2,1912.79,1,1,6,org.apache.lucene.util.LuceneTestCase,0.00,6,1,10,0,6,5,0,1,391,1
"org.apache.lucene.queryparser.analyzing.TestFoldingFilter",2,1.00,4.50,22,0.21,8755.91,3,1,6,4,5,103.13,0,30,1,4,103.13,0.00,0.75,0.50,0,2.00,8,626.75,0,0,4,org.apache.lucene.analysis.TokenFilter,0.29,2,3,9,0,2,2,0,0,126,1
"org.apache.lucene.facet.search.params.CountFacetRequest",5,0.00,1.20,14,0.14,2267.54,5,0,7,8,23,106.59,31,27,15,2,138.81,1.00,0.33,0.00,0,5.00,2,406.73,0,1,8,org.apache.lucene.facet.search.params.FacetRequest,0.14,3,1,6,1,3,4,0,4,102,1
"org.apache.lucene.facet.search.params.FacetRequest",23,0.01,1.30,81,0.85,21305.32,34,11,13,36,30,81.67,192,122,21,1,129.78,0.00,0.00,0.08,1,219.00,3,2546.93,1,9,13,java.lang.Object,0.00,13,0,30,6,13,14,1,31,581,2
"org.apache.lucene.facet.search.params.FacetRequest$ResultMode",0,0.00,0.00,2,0.01,23.26,0,0,13,0,0,171.00,1,4,0,1,171.00,0.00,0.00,0.00,0,0.00,0,15.51,0,0,0,java.lang.Object,0.00,0,0,0,0,0,0,1,1,6,1
"org.apache.lucene.facet.search.params.FacetRequest$SortBy",0,0.00,0.00,2,0.01,23.26,0,0,13,0,0,171.00,1,4,0,1,171.00,0.00,0.00,0.00,0,0.00,0,15.51,0,0,0,java.lang.Object,0.00,0,0,0,0,0,0,1,1,6,1
"org.apache.lucene.facet.search.params.FacetRequest$SortOrder",0,0.00,0.00,2,0.01,23.26,0,0,13,0,0,171.00,0,1,0,1,171.00,0.00,0.00,0.00,0,0.00,0,15.51,0,0,0,java.lang.Object,0.00,0,0,0,0,0,0,1,0,6,1
"org.apache.lucene.facet.search.params.FacetRequestTest",6,0.00,1.00,42,0.62,14489.67,6,0,9,27,9,133.45,20,55,0,2,112.84,0.00,0.50,0.00,0,6.00,1,1861.51,0,0,9,org.apache.lucene.util.LuceneTestCase,0.00,21,1,6,0,21,6,0,5,377,1
"org.apache.lucene.facet.search.params.FacetSearchParams",8,0.14,1.25,31,0.29,7470.63,11,3,6,16,44,81.66,65,42,40,1,129.76,0.00,0.00,0.21,1,26.00,2,862.71,0,4,5,java.lang.Object,0.00,8,0,10,0,8,4,0,9,205,1
"org.apache.lucene.facet.search.params.FacetSearchParamsTest",4,0.00,1.25,33,0.47,10477.04,4,0,10,26,10,110.58,16,44,0,2,110.34,0.00,0.50,0.00,0,4.00,2,1396.54,0,0,10,org.apache.lucene.util.LuceneTestCase,0.00,22,1,5,0,22,4,0,1,278,1
"org.apache.lucene.facet.search.params.MultiIteratorsPerCLParamsTest",6,0.50,1.67,66,1.09,37037.17,8,2,33,44,29,84.31,34,98,0,2,102.19,0.00,0.50,0.08,3,10.00,3,3257.24,0,0,29,org.apache.lucene.util.LuceneTestCase,0.00,38,1,10,0,38,6,0,13,599,1
"org.apache.lucene.facet.search.params.MultiIteratorsPerCLParamsTest$PerDimCountFacetRequest",3,0.00,1.00,7,0.09,1324.49,3,0,33,5,8,138.94,2,16,0,3,138.94,0.00,0.67,0.00,0,3.00,1,256.10,1,2,8,org.apache.lucene.facet.search.params.CountFacetRequest,0.00,2,2,3,0,2,1,0,2,65,1
"org.apache.lucene.facet.search.params.MultiIteratorsPerCLParamsTest$PerDimCountFacetRequest$TopKFacetResultsHandler",1,0.00,2.00,7,0.11,3627.44,1,0,33,5,3,111.29,0,11,0,1,111.29,0.00,0.00,0.00,0,0.00,2,330.88,1,1,3,java.lang.Object,0.00,4,0,2,0,4,0,0,0,67,0
"org.apache.lucene.facet.search.params.MultiIteratorsPerCLParamsTest$PerDimensionCLI",5,0.08,1.80,26,0.25,5652.07,8,3,33,11,3,120.75,1,38,0,1,120.75,0.00,0.00,0.40,0,9.00,3,752.76,0,0,3,java.lang.Object,0.00,6,0,9,0,6,5,1,1,176,2
"org.apache.lucene.facet.search.params.ScoreFacetRequest",5,0.00,1.00,12,0.12,1821.68,5,0,6,7,8,139.84,22,24,1,2,139.60,0.00,0.50,0.00,0,5.00,1,355.74,0,1,7,org.apache.lucene.facet.search.params.FacetRequest,0.14,2,1,5,0,2,4,0,3,92,1
"org.apache.lucene.search.highlight.custom.HighlightCustomQueryTest",2,0.00,2.50,25,0.44,13357.06,3,1,19,15,15,50.42,19,42,0,2,100.42,0.00,0.50,1.00,1,0.00,3,1322.85,0,1,15,org.apache.lucene.util.LuceneTestCase,0.00,13,1,5,0,13,1,0,11,252,1
"org.apache.lucene.search.highlight.custom.HighlightCustomQueryTest$CustomQuery",5,0.25,2.40,23,0.28,9961.33,6,1,19,10,4,122.36,0,38,0,2,122.36,0.00,0.50,0.80,0,0.00,7,833.53,2,2,4,org.apache.lucene.search.Query,0.13,5,1,12,0,5,3,0,0,191,2
"org.apache.lucene.search.highlight.custom.HighlightCustomQueryTest$MyQueryScorer",2,0.00,1.50,5,0.06,993.87,2,0,19,3,3,138.44,0,10,0,2,138.44,0.00,0.50,0.00,0,2.00,2,173.10,0,1,3,org.apache.lucene.search.highlight.QueryScorer,0.00,1,1,3,0,1,1,0,0,47,2
"org.apache.lucene.search.highlight.custom.HighlightCustomQueryTest$MyWeightedSpanTermExtractor",3,0.00,1.33,8,0.08,1576.49,3,0,19,4,3,138.28,0,16,0,2,138.28,0.00,0.50,0.00,0,3.00,2,241.66,1,0,3,org.apache.lucene.search.highlight.WeightedSpanTermExtractor,0.00,1,1,4,0,1,3,0,0,61,2
"org.apache.lucene.codecs.appending.AppendingCodec",9,0.02,1.00,27,0.25,3364.22,17,8,16,17,19,132.94,6,45,1,2,132.94,0.00,0.50,0.11,0,65.00,1,759.40,0,8,18,org.apache.lucene.codecs.Codec,0.64,8,1,9,0,8,1,0,1,182,1
"org.apache.lucene.codecs.appending.AppendingPostingsFormat",4,1.00,1.50,25,0.32,10786.78,5,1,14,12,15,114.86,3,46,1,2,114.86,0.00,0.50,0.25,0,6.00,2,970.84,0,2,14,org.apache.lucene.codecs.PostingsFormat,0.00,8,1,6,0,8,2,0,1,202,0
"org.apache.lucene.codecs.appending.AppendingSegmentInfosFormat",1,0.00,1.00,4,0.03,449.58,2,1,2,2,4,127.65,0,7,1,3,127.65,0.00,0.67,1.00,0,0.00,1,99.05,0,1,3,org.apache.lucene.codecs.lucene40.Lucene40SegmentInfosFormat,0.60,1,2,1,0,1,0,0,0,27,1
"org.apache.lucene.codecs.appending.AppendingSegmentInfosWriter",1,0.00,1.00,2,0.02,152.10,1,0,3,1,3,192.59,1,5,1,3,142.59,0.00,0.67,0.00,0,1.00,1,57.02,0,0,2,org.apache.lucene.codecs.lucene40.Lucene40SegmentInfosWriter,0.00,0,2,1,0,0,1,0,1,18,1
"org.apache.lucene.codecs.appending.AppendingTermsReader",4,0.00,1.00,11,0.19,3126.56,4,0,8,8,9,186.99,4,24,1,4,136.99,0.00,0.75,0.00,0,4.00,1,576.35,0,0,8,org.apache.lucene.codecs.BlockTreeTermsReader,0.00,4,3,4,0,4,4,0,1,133,1
"org.apache.lucene.codecs.appending.AppendingTermsWriter",5,0.04,1.00,17,0.21,3230.62,11,6,6,7,7,131.07,4,27,2,3,131.07,0.00,0.67,0.13,0,11.00,1,640.98,0,0,5,org.apache.lucene.codecs.BlockTreeTermsWriter,0.00,2,2,5,0,2,5,0,1,155,1
"org.apache.lucene.codecs.appending.TestAppendingCodec",2,1.00,1.00,57,1.04,32488.12,3,1,26,44,21,83.86,0,61,0,2,83.86,0.00,0.50,0.50,0,2.00,1,3129.54,0,0,21,org.apache.lucene.util.LuceneTestCase,0.00,42,1,2,0,42,2,0,0,511,1
"org.apache.lucene.codecs.appending.TestAppendingCodec$AppendingIndexOutputWrapper",8,0.29,1.00,18,0.18,2778.21,9,1,26,15,1,139.76,0,34,0,3,139.76,0.00,0.67,0.75,0,0.00,1,537.87,0,0,1,org.apache.lucene.store.IndexOutput,0.84,7,2,8,0,7,8,0,0,145,2
"org.apache.lucene.codecs.appending.TestAppendingCodec$SuppressWarnings",2,0.00,1.00,5,0.06,917.40,2,0,26,3,4,138.81,0,10,0,3,138.81,0.00,0.67,0.00,0,2.00,1,187.44,1,1,4,org.apache.lucene.store.MockDirectoryWrapper,0.00,1,2,2,0,1,1,0,0,49,2
"org.apache.lucene.queryparser.flexible.core.processors.NoChildOptimizationQueryNodeProcessor",4,0.00,2.00,16,0.19,8656.45,4,0,3,7,5,142.73,12,31,1,2,122.12,0.00,0.50,0.00,0,4.00,5,579.16,0,3,4,org.apache.lucene.queryparser.flexible.core.processors.QueryNodeProcessorImpl,0.00,3,1,8,0,3,1,0,2,126,1
"org.apache.lucene.queryparser.flexible.core.processors.QueryNodeProcessor",3,0.00,1.00,4,0.02,126.39,3,0,3,3,7,147.85,47,5,5,1,158.21,0.00,0.00,0.00,0,3.00,1,66.26,0,2,3,,0.00,0,0,3,0,0,1,0,4,25,1
"org.apache.lucene.queryparser.flexible.core.processors.QueryNodeProcessorImpl",11,2.00,1.55,49,0.47,17925.54,13,2,5,19,28,74.67,110,68,24,1,123.15,0.00,0.00,0.00,3,11.00,4,1399.68,0,6,4,java.lang.Object,0.00,8,0,17,23,8,5,1,8,317,2
"org.apache.lucene.queryparser.flexible.core.processors.QueryNodeProcessorImpl$ChildrenList",0,0.00,0.00,2,0.02,222.03,1,1,5,0,1,171.00,0,3,0,2,171.00,0.00,0.50,0.00,0,0.00,0,55.51,0,0,1,java.util.ArrayList,0.00,0,1,0,0,0,0,0,0,15,2
"org.apache.lucene.queryparser.flexible.core.processors.QueryNodeProcessorPipeline",28,2.00,1.39,79,0.78,15889.59,30,2,4,32,9,138.24,119,111,5,1,138.01,0.00,0.00,0.00,18,28.00,3,2344.36,0,7,4,java.lang.Object,0.00,4,0,39,2,4,21,2,30,596,1
"org.apache.lucene.queryparser.flexible.core.processors.RemoveDeletedQueryNodesProcessor",5,0.00,2.60,35,0.37,17696.46,5,0,6,13,6,161.31,7,49,2,2,111.31,0.00,0.50,0.00,0,5.00,6,1099.83,1,4,5,org.apache.lucene.queryparser.flexible.core.processors.QueryNodeProcessorImpl,0.00,8,1,13,0,8,1,0,2,227,1
"org.apache.lucene.document.CompressionTools",12,0.00,1.17,49,0.69,24444.27,12,0,7,31,4,162.33,26,67,1,1,122.45,0.00,0.00,0.00,4,12.00,2,2075.22,0,3,3,java.lang.Object,0.00,19,0,14,0,19,9,0,13,449,1
"org.apache.lucene.document.DateTools",7,1.00,1.29,34,0.52,19989.13,8,1,8,23,21,77.14,81,54,19,1,121.27,0.00,0.00,0.00,3,7.00,2,1556.08,0,4,2,java.lang.Object,0.00,16,0,9,0,16,3,0,12,324,1
"org.apache.lucene.document.DateTools$Resolution",2,2.00,1.00,10,0.13,1621.89,4,2,8,6,0,161.90,5,15,0,1,122.02,0.00,0.00,0.00,0,2.00,1,402.99,1,1,0,java.lang.Object,0.00,4,0,2,0,4,1,0,4,93,2
"org.apache.lucene.document.DateTools$ThreadLocal<Calendar>",1,0.00,1.00,3,0.03,357.52,1,0,8,2,0,133.10,0,5,0,1,133.10,0.00,0.00,0.00,0,0.00,1,88.18,0,1,0,java.lang.Object,0.00,1,0,1,0,1,0,0,0,25,0
"org.apache.lucene.document.DateTools$ThreadLocal<SimpleDateFormat",1,0.00,2.00,7,0.09,3080.44,1,0,8,2,0,111.84,0,9,0,1,111.84,0.00,0.00,0.00,0,1.00,2,265.48,0,1,0,java.lang.Object,0.00,1,0,2,0,1,0,0,0,60,0
"org.apache.lucene.document.DocValuesField",6,0.13,1.83,38,0.64,17937.76,9,3,6,15,25,96.59,30,64,21,2,114.46,0.00,0.50,0.22,0,0.00,2,1905.62,0,0,4,org.apache.lucene.document.Field,0.00,9,1,11,0,9,6,0,1,395,1
"org.apache.lucene.document.Document",13,0.25,2.62,80,0.95,35182.56,15,2,6,38,377,72.43,97,107,374,1,114.72,0.00,0.00,0.27,0,30.00,4,2849.75,0,9,5,java.lang.Object,0.00,25,0,34,0,25,4,1,13,608,2
"org.apache.lucene.document.DocumentStoredFieldVisitor",11,0.10,1.18,34,0.48,9919.86,13,2,6,23,11,129.89,10,53,4,2,129.89,0.00,0.50,0.41,0,4.00,2,1447.80,0,2,8,org.apache.lucene.index.StoredFieldVisitor,0.00,12,1,13,0,12,9,0,4,328,1
"org.apache.lucene.document.DoubleField",2,1.00,1.50,17,0.19,3187.26,3,1,6,6,18,62.42,96,22,16,2,112.00,0.00,0.50,0.50,0,0.00,2,555.32,0,0,7,org.apache.lucene.document.Field,0.00,4,1,3,0,4,2,0,3,129,2
"org.apache.lucene.document.Field",36,0.04,2.67,236,2.68,100849.37,42,6,14,78,182,82.38,243,335,172,1,114.60,0.00,0.00,0.13,5,300.00,13,8026.56,0,8,11,java.lang.Object,0.00,42,0,96,8,42,28,1,45,1676,1
"org.apache.lucene.document.Field$Deprecated",2,0.00,1.00,8,0.05,611.64,2,0,14,2,1,149.58,6,12,0,1,128.97,0.00,0.00,0.00,0,2.00,1,145.42,0,0,1,java.lang.Object,0.00,0,0,2,0,0,2,1,2,41,2
"org.apache.lucene.document.Field$Deprecated_0",19,0.00,1.21,51,0.33,5015.72,19,0,14,19,1,190.66,34,64,0,1,140.66,0.00,0.00,0.00,1,19.00,5,979.97,0,0,1,java.lang.Object,0.00,0,0,23,0,0,19,1,10,274,2
"org.apache.lucene.document.Field$Deprecated_1",18,0.00,1.22,49,0.32,5226.80,18,0,14,18,1,190.33,23,61,0,1,140.33,0.00,0.00,0.00,0,18.00,5,953.65,0,0,1,java.lang.Object,0.00,0,0,22,0,0,18,1,7,264,2
"org.apache.lucene.document.Field$TokenStream",2,0.67,1.50,13,0.12,2080.30,5,3,14,7,2,118.12,0,18,0,1,118.12,0.00,0.00,0.67,0,0.00,2,374.08,0,0,2,java.lang.Object,0.00,5,0,3,0,5,2,0,0,88,0
"org.apache.lucene.document.FieldType",27,0.05,1.63,121,1.10,36253.32,39,12,5,43,105,123.80,15,167,101,1,123.80,0.00,0.00,0.03,8,174.00,16,3300.14,0,4,4,java.lang.Object,0.00,16,0,44,0,16,23,1,6,743,1
"org.apache.lucene.document.FieldType$NumericType",0,0.00,0.00,2,0.01,57.06,0,0,5,0,1,171.00,0,1,0,1,171.00,0.00,0.00,0.00,0,0.00,0,28.53,0,0,1,java.lang.Object,0.00,0,0,0,0,0,0,1,0,9,2
"org.apache.lucene.document.FloatField",2,1.00,1.50,17,0.19,3187.26,3,1,6,6,18,62.42,96,22,16,2,112.00,0.00,0.50,0.50,0,0.00,2,555.32,0,0,7,org.apache.lucene.document.Field,0.00,4,1,3,0,4,2,0,3,129,2
"org.apache.lucene.document.IntField",2,1.00,1.50,17,0.19,3187.26,3,1,6,6,28,62.42,96,22,26,2,112.00,0.00,0.50,0.50,0,0.00,2,555.32,0,0,7,org.apache.lucene.document.Field,0.00,4,1,3,0,4,2,0,3,129,2
"org.apache.lucene.document.LazyDocument",3,0.12,2.00,24,0.23,6273.26,7,4,11,9,10,161.01,4,32,2,1,111.01,0.00,0.00,0.33,0,5.00,3,701.51,0,1,8,java.lang.Object,0.00,6,0,6,0,6,2,0,2,155,1
"org.apache.lucene.document.LazyDocument$LazyField",9,0.25,1.67,40,0.42,10876.72,11,2,11,24,5,124.15,0,64,0,1,124.15,0.00,0.00,0.72,0,0.00,2,1273.75,0,7,5,java.lang.Object,0.00,15,0,15,0,15,2,1,0,304,1
"org.apache.lucene.document.LongField",2,1.00,1.50,17,0.19,3187.26,3,1,6,6,19,66.40,106,22,17,2,112.00,0.00,0.50,0.50,0,0.00,2,555.32,0,0,7,org.apache.lucene.document.Field,0.00,4,1,3,0,4,2,0,3,129,2
"org.apache.lucene.document.StoredField",8,0.00,1.00,26,0.20,2034.19,9,1,3,8,17,174.15,19,36,12,2,134.26,0.00,0.50,1.00,0,0.00,1,598.93,0,0,5,org.apache.lucene.document.Field,0.00,0,1,8,0,0,8,0,2,165,2
"org.apache.lucene.document.StringField",2,0.50,1.50,17,0.16,3205.47,4,2,1,4,134,101.63,30,22,132,2,111.98,0.00,0.50,0.25,0,2.00,2,470.41,0,1,2,org.apache.lucene.document.Field,0.05,2,1,3,0,2,1,0,5,122,2
"org.apache.lucene.document.TestBinaryDocument",2,0.00,1.00,45,0.67,16892.31,4,2,6,31,10,60.62,27,50,0,2,90.00,0.00,0.50,0.50,0,2.00,1,2018.68,0,0,10,org.apache.lucene.util.LuceneTestCase,0.00,29,1,2,0,29,2,0,10,358,1
"org.apache.lucene.document.TestDateTools",6,1.00,1.50,117,2.11,77263.13,7,1,12,30,2,58.62,41,140,0,2,90.84,0.00,0.50,0.00,0,6.00,4,6323.35,0,1,2,org.apache.lucene.util.LuceneTestCase,0.00,24,1,9,0,24,5,0,26,1111,1
"org.apache.lucene.document.TestDocument",12,0.45,2.00,237,4.26,234354.58,14,2,22,88,26,109.97,47,266,0,2,89.35,0.00,0.50,0.08,2,22.00,5,12775.09,0,1,26,org.apache.lucene.util.LuceneTestCase,0.00,76,1,24,0,76,11,0,30,2209,1
"org.apache.lucene.document.TextField",3,2.00,1.00,17,0.14,2568.45,5,2,2,4,221,122.07,13,22,218,2,121.83,0.00,0.50,0.00,0,3.00,1,433.94,0,0,3,org.apache.lucene.document.Field,0.00,1,1,3,0,1,3,0,7,119,2
"org.apache.lucene.analysis.commongrams.CommonGramsFilter",6,0.27,1.67,56,0.64,16064.18,17,11,9,24,15,59.82,64,68,8,4,108.29,0.00,0.75,0.32,3,0.00,4,1923.28,1,0,7,org.apache.lucene.analysis.TokenFilter,0.44,18,3,10,0,18,6,0,12,396,2
"org.apache.lucene.analysis.commongrams.CommonGramsFilterTest",11,0.30,1.00,141,2.44,108444.27,12,1,7,30,9,119.91,41,199,0,3,99.29,0.00,0.67,0.73,0,0.00,1,7332.88,3,0,9,org.apache.lucene.analysis.BaseTokenStreamTestCase,0.00,19,2,11,0,19,11,0,17,1358,1
"org.apache.lucene.analysis.commongrams.CommonGramsFilterTest$Analyzer",1,0.00,1.00,4,0.06,1132.62,1,0,7,5,4,124.49,0,7,0,1,124.49,0.00,0.00,0.00,0,0.00,1,189.11,0,1,4,java.lang.Object,0.00,4,0,1,0,4,0,0,0,43,0
"org.apache.lucene.analysis.commongrams.CommonGramsFilterTest$Analyzer_0",1,0.00,1.00,4,0.06,1051.87,1,0,7,4,3,124.74,0,7,0,1,124.74,0.00,0.00,0.00,0,0.00,1,173.06,0,1,3,java.lang.Object,0.00,3,0,1,0,3,0,0,0,40,0
"org.apache.lucene.analysis.commongrams.CommonGramsFilterTest$Analyzer_1",1,0.00,1.00,5,0.07,1297.19,1,0,7,4,3,120.41,0,7,0,1,120.41,0.00,0.00,0.00,0,0.00,1,198.40,0,1,3,java.lang.Object,0.00,3,0,1,0,3,0,0,0,45,0
"org.apache.lucene.analysis.commongrams.CommonGramsFilterTest$Analyzer_2",1,0.00,1.00,5,0.07,1380.66,1,0,7,5,4,120.20,0,7,0,1,120.20,0.00,0.00,0.00,0,0.00,1,214.82,0,1,4,java.lang.Object,0.00,4,0,1,0,4,0,0,0,48,0
"org.apache.lucene.analysis.commongrams.CommonGramsQueryFilter",4,0.33,2.25,34,0.33,11202.38,9,5,5,9,8,59.98,39,46,4,4,109.98,0.00,0.75,0.45,1,2.00,6,985.84,1,0,4,org.apache.lucene.analysis.TokenFilter,0.50,5,3,9,0,5,4,0,7,208,2
"org.apache.lucene.codecs.lucene.Deprecated",14,0.16,2.50,122,1.41,59516.40,31,17,8,34,6,158.53,26,158,0,1,108.53,0.00,0.00,0.21,4,46.00,6,4228.30,0,0,6,java.lang.Object,0.00,20,0,35,0,20,14,0,25,832,0
"org.apache.lucene.codecs.lucene.Deprecated$CloneableTerm",4,0.67,1.00,11,0.10,1553.17,5,1,11,6,1,139.38,0,19,0,2,139.38,0.00,0.50,0.50,1,4.00,1,304.77,0,1,1,DoubleBarrelLRUCache.CloneableKey,0.00,2,1,4,0,2,3,0,0,82,2
"org.apache.lucene.codecs.lucene.Deprecated$DocValuesFormat",3,0.00,1.00,6,0.06,759.46,3,0,20,3,5,140.84,0,11,0,1,140.84,0.00,0.00,0.00,0,3.00,1,188.64,0,2,5,java.lang.Object,0.00,0,0,3,0,0,1,0,0,51,0
"org.apache.lucene.codecs.lucene.Deprecated$Lucene40LiveDocsFormat",1,0.00,1.00,3,0.04,470.68,1,0,20,2,4,132.16,0,5,0,1,132.16,0.00,0.00,0.00,0,1.00,1,115.03,0,0,4,java.lang.Object,0.00,1,0,1,0,1,1,0,0,28,0
"org.apache.lucene.codecs.lucene.Deprecated$NormSource",5,0.50,1.00,16,0.13,2006.80,6,1,21,5,1,132.70,0,26,0,2,132.70,0.00,0.50,0.60,0,2.00,1,383.51,0,2,1,org.apache.lucene.index.Source,0.00,0,1,5,0,0,3,0,0,102,2
"org.apache.lucene.codecs.lucene.Deprecated$NormsDocValues",6,0.40,1.17,23,0.20,4212.37,8,2,21,11,2,130.75,2,36,0,2,130.75,0.00,0.50,0.17,1,10.00,2,608.13,1,3,2,org.apache.lucene.index.DocValues,0.53,5,1,7,0,5,3,0,2,150,1
"org.apache.lucene.codecs.lucene.Deprecated$PreDocsAndPositionsEnum",12,0.09,1.33,48,0.45,12962.18,15,3,25,25,4,124.59,0,74,0,4,124.59,0.00,0.75,0.42,0,0.00,3,1362.20,0,3,4,org.apache.lucene.index.DocsAndPositionsEnum,1.64,13,3,16,0,13,9,0,0,320,2
"org.apache.lucene.codecs.lucene.Deprecated$PreDocsEnum",7,0.17,1.29,26,0.22,4010.76,9,2,25,14,3,131.42,0,40,0,3,131.42,0.00,0.67,0.64,0,0.00,2,670.78,0,2,3,org.apache.lucene.index.DocsEnum,1.00,7,2,9,0,7,5,0,0,166,2
"org.apache.lucene.codecs.lucene.Deprecated$PreFlexFieldsEnum",3,0.25,1.33,13,0.12,1947.82,5,2,25,8,3,126.33,0,20,0,2,126.33,0.00,0.50,0.67,0,0.00,2,345.18,0,2,3,org.apache.lucene.index.FieldsEnum,0.67,5,1,4,0,5,1,0,0,87,1
"org.apache.lucene.codecs.lucene.Deprecated$PreTerms",7,1.00,1.14,21,0.17,3076.03,8,1,25,12,4,132.36,2,36,0,2,132.36,0.00,0.50,0.14,0,12.00,2,512.38,0,2,4,org.apache.lucene.index.Terms,0.71,5,1,8,0,5,5,0,2,134,1
"org.apache.lucene.codecs.lucene.Deprecated$PreTermsEnum",19,0.18,5.16,354,5.46,523593.51,32,13,25,53,8,46.54,143,451,0,2,88.83,0.00,0.50,0.25,7,31.00,14,16374.28,0,6,8,org.apache.lucene.index.TermsEnum,0.31,34,1,98,0,34,13,0,143,2781,1
"org.apache.lucene.codecs.lucene.Deprecated$TVDocsAndPositionsEnum",10,0.11,1.40,52,0.48,13040.01,17,7,27,11,3,120.32,0,78,0,4,120.32,0.00,0.75,0.24,1,22.00,2,1431.64,0,1,3,org.apache.lucene.index.DocsAndPositionsEnum,1.80,1,3,14,0,1,9,0,0,330,2
"org.apache.lucene.codecs.lucene.Deprecated$TVDocsEnum",5,0.19,1.40,25,0.22,4695.24,9,4,27,6,2,121.44,0,37,0,3,121.44,0.00,0.67,0.40,1,0.00,2,672.14,0,0,2,org.apache.lucene.index.DocsEnum,1.20,1,2,7,0,1,5,0,0,159,2
"org.apache.lucene.codecs.lucene.Deprecated$TVFields",4,0.22,2.50,45,0.46,25680.13,7,3,27,14,4,151.96,5,53,0,2,101.96,0.00,0.50,0.50,0,2.00,4,1372.03,0,2,4,org.apache.lucene.index.Fields,0.50,10,1,10,0,10,2,0,5,276,1
"org.apache.lucene.codecs.lucene.Deprecated$TVFields$FieldsEnum",2,0.00,1.50,9,0.11,2701.28,3,1,27,3,1,123.80,0,14,0,1,123.80,0.00,0.00,1.00,0,0.00,2,317.42,0,2,1,java.lang.Object,0.00,1,0,3,0,1,0,0,0,73,0
"org.apache.lucene.codecs.lucene.Deprecated$TVTerms",7,0.11,1.43,32,0.26,6647.13,10,3,27,15,3,125.01,1,49,0,2,125.01,0.00,0.50,0.43,0,0.00,3,793.67,0,2,3,org.apache.lucene.index.Terms,0.71,8,1,10,0,8,5,0,1,192,1
"org.apache.lucene.codecs.lucene.Deprecated$TVTermsEnum",14,0.13,2.07,121,1.28,71320.40,22,8,27,33,6,107.95,3,148,0,2,107.95,0.00,0.50,0.25,3,22.00,6,3831.02,0,6,6,org.apache.lucene.index.TermsEnum,0.37,19,1,29,0,19,8,0,3,769,1
"org.apache.lucene.codecs.lucene.Deprecated$TVTermsEnum$Comparator<TermAndPostings>",1,0.00,1.00,3,0.03,398.03,1,0,27,2,0,132.73,0,4,0,1,132.73,0.00,0.00,0.00,0,1.00,1,93.66,0,0,0,java.lang.Object,0.00,1,0,1,0,1,1,0,0,27,0
"org.apache.lucene.codecs.lucene.Deprecated$TermAndPostings",0,0.00,0.00,6,0.03,356.17,5,5,27,0,1,171.00,0,7,0,1,171.00,0.00,0.00,0.00,0,0.00,0,103.61,0,0,1,java.lang.Object,0.00,0,0,0,0,0,0,0,0,28,1
"org.apache.lucene.codecs.lucene.Deprecated$TermInfoAndOrd",1,1.00,1.00,6,0.05,709.40,2,1,11,1,0,119.52,0,8,0,2,119.52,0.00,0.50,0.00,0,1.00,1,136.97,0,0,0,TermInfo,0.00,0,1,1,0,0,1,0,0,36,3
"org.apache.lucene.codecs.lucene.Deprecated$ThreadResources",17,0.44,2.65,131,1.77,122243.73,19,2,11,50,7,158.88,26,195,0,1,108.88,0.00,0.00,0.09,7,73.00,12,5318.16,0,1,7,java.lang.Object,0.00,33,0,45,0,33,16,0,26,1035,3
"org.apache.lucene.codecs.lucene.PreFlexRWCodec",8,0.02,2.12,49,0.50,10269.65,15,7,13,21,20,167.32,8,75,4,2,117.32,0.00,0.50,0.12,0,50.00,3,1493.16,8,6,16,Lucene3xCodec,0.00,13,1,17,0,13,2,0,5,328,1
"org.apache.lucene.codecs.lucene.PreFlexRWFieldInfosFormat",2,0.00,1.00,5,0.04,550.28,2,0,3,4,5,180.45,5,10,1,2,140.56,0.00,0.50,0.00,0,2.00,1,122.62,0,2,4,Lucene3xFieldInfosFormat,0.00,2,1,2,0,2,0,0,1,35,0
"org.apache.lucene.codecs.lucene.PreFlexRWFieldInfosReader",2,1.00,7.00,52,1.06,132207.51,3,1,15,17,13,80.05,9,64,1,2,79.81,0.00,0.50,0.50,0,2.00,13,3178.05,0,1,12,org.apache.lucene.codecs.FieldInfosReader,0.00,15,1,14,0,15,1,0,6,490,0
"org.apache.lucene.codecs.lucene.PreFlexRWFieldInfosWriter",1,3.00,10.00,36,0.60,29138.43,12,11,9,10,9,76.79,16,43,2,2,77.26,0.00,0.50,0.73,0,0.00,10,1789.79,0,0,7,org.apache.lucene.codecs.FieldInfosWriter,0.00,9,1,10,0,9,1,0,9,304,0
"org.apache.lucene.codecs.lucene.PreFlexRWFieldsWriter",3,0.50,2.33,35,0.48,17610.43,8,5,15,13,14,102.28,2,55,1,2,102.28,0.00,0.50,0.53,0,1.00,4,1425.35,0,1,13,org.apache.lucene.codecs.FieldsConsumer,0.33,10,1,7,0,10,2,0,2,273,0
"org.apache.lucene.codecs.lucene.PreFlexRWFieldsWriter$PreFlexTermsWriter",5,0.05,1.40,26,0.34,6644.48,10,5,15,9,5,120.25,2,40,0,2,120.25,0.00,0.50,0.24,0,10.00,2,1009.90,0,2,5,org.apache.lucene.codecs.TermsConsumer,0.40,4,1,7,0,4,3,0,2,222,1
"org.apache.lucene.codecs.lucene.PreFlexRWFieldsWriter$PreFlexTermsWriter$PostingsWriter",4,0.42,3.00,48,0.60,44645.49,8,4,15,5,3,98.62,3,64,0,2,98.62,0.00,0.50,0.56,0,0.00,5,1807.40,0,1,3,org.apache.lucene.codecs.PostingsConsumer,0.50,1,1,12,0,1,3,0,3,338,1
"org.apache.lucene.codecs.lucene.PreFlexRWNormsConsumer",8,0.02,1.62,37,0.41,8483.57,15,7,17,18,14,174.60,9,62,1,2,124.61,0.00,0.50,0.16,1,14.00,3,1242.78,0,2,13,org.apache.lucene.codecs.PerDocConsumer,0.14,10,1,13,0,10,6,0,5,280,0
"org.apache.lucene.codecs.lucene.PreFlexRWNormsConsumer$Lucene3xNormsDocValuesConsumer",5,0.19,2.40,50,0.50,29683.86,9,4,17,13,4,103.78,3,61,0,2,103.78,0.00,0.50,0.40,1,6.00,6,1500.77,0,1,4,org.apache.lucene.codecs.DocValuesConsumer,0.36,8,1,12,0,8,4,0,3,306,0
"org.apache.lucene.codecs.lucene.PreFlexRWNormsConsumer$NormsWriter",7,0.06,2.29,64,0.76,37729.57,10,3,17,24,9,155.83,7,79,0,1,105.83,0.00,0.00,0.38,1,0.00,8,2293.35,0,0,9,java.lang.Object,0.00,17,0,16,0,17,7,0,7,439,2
"org.apache.lucene.codecs.lucene.PreFlexRWNormsFormat",1,0.00,1.00,3,0.04,713.22,1,0,3,2,4,130.97,4,6,1,2,130.73,0.00,0.50,0.00,0,1.00,1,122.06,0,1,3,Lucene3xNormsFormat,0.00,1,1,1,0,1,0,0,1,31,0
"org.apache.lucene.codecs.lucene.PreFlexRWPostingsFormat",3,0.00,1.00,6,0.05,602.62,3,0,6,5,6,162.25,9,12,1,2,141.64,0.00,0.50,0.00,0,3.00,1,141.74,0,2,5,Lucene3xPostingsFormat,0.00,2,1,3,0,2,1,0,5,41,0
"org.apache.lucene.codecs.lucene.PreFlexRWPostingsFormat$Lucene3xFields",1,0.00,4.00,14,0.15,4368.41,1,0,6,6,0,119.88,3,16,0,1,99.26,0.00,0.00,0.00,0,1.00,4,464.57,0,0,0,java.lang.Object,0.00,5,0,4,0,5,1,0,3,95,0
"org.apache.lucene.codecs.lucene.PreFlexRWSegmentInfosFormat",1,0.00,1.00,4,0.03,394.03,2,1,1,2,3,154.39,19,7,1,2,128.10,0.00,0.50,1.00,0,0.00,1,93.65,0,1,2,Lucene3xSegmentInfosFormat,0.00,1,1,1,0,1,0,0,2,26,0
"org.apache.lucene.codecs.lucene.PreFlexRWSegmentInfosWriter",5,0.00,2.40,51,0.86,53240.63,5,0,12,35,10,141.67,13,67,1,2,101.78,0.00,0.50,0.00,2,5.00,6,2594.01,0,2,9,org.apache.lucene.codecs.SegmentInfosWriter,0.00,30,1,12,0,30,3,0,10,465,0
"org.apache.lucene.codecs.lucene.PreFlexRWStoredFieldsFormat",1,0.00,1.00,3,0.04,573.51,1,0,4,2,5,131.48,0,6,1,2,131.48,0.00,0.50,0.00,0,1.00,1,113.56,0,1,4,Lucene3xStoredFieldsFormat,0.00,1,1,1,0,1,0,0,0,29,0
"org.apache.lucene.codecs.lucene.PreFlexRWStoredFieldsWriter",6,0.20,3.67,76,1.07,56298.07,10,4,10,31,10,139.05,14,99,1,2,99.16,0.00,0.50,0.42,2,0.00,14,3222.50,0,0,9,org.apache.lucene.codecs.StoredFieldsWriter,0.50,25,1,22,0,25,6,0,14,583,1
"org.apache.lucene.codecs.lucene.PreFlexRWTermVectorsFormat",2,0.00,1.00,5,0.07,895.64,2,0,8,4,8,138.89,0,10,1,2,138.89,0.00,0.50,0.00,0,2.00,1,198.52,0,2,7,Lucene3xTermVectorsFormat,0.00,2,1,2,0,2,0,0,0,49,0
"org.apache.lucene.codecs.lucene.PreFlexRWTermVectorsFormat$Lucene3xTermVectorsReader",1,0.00,4.00,14,0.14,4197.83,1,0,8,6,0,120.01,3,16,0,1,99.40,0.00,0.00,0.00,0,1.00,4,422.84,0,0,0,java.lang.Object,0.00,5,0,4,0,5,1,0,3,84,0
"org.apache.lucene.codecs.lucene.PreFlexRWTermVectorsWriter",10,0.19,2.70,120,1.66,76644.32,28,18,13,30,12,139.81,23,147,1,2,99.93,0.00,0.50,0.23,2,0.00,6,4972.77,0,1,11,org.apache.lucene.codecs.TermVectorsWriter,0.50,20,1,27,0,20,9,0,23,952,1
"org.apache.lucene.codecs.lucene.TermInfosWriter",8,0.21,3.50,113,1.81,113605.27,26,18,11,32,11,52.97,56,163,2,1,95.26,0.00,0.00,0.24,4,0.00,7,5434.84,0,0,9,java.lang.Object,0.00,24,0,28,0,24,8,1,43,986,1
"org.apache.lucene.codecs.lucene.TestImpersonation",1,0.00,1.00,4,0.04,470.65,1,0,3,3,2,109.62,5,6,0,2,127.49,0.00,0.50,0.00,0,1.00,1,105.43,0,0,2,org.apache.lucene.util.LuceneTestCase,0.00,2,1,1,0,2,1,0,1,28,1
"org.apache.lucene.codecs.lucene.TestSurrogates",8,1.00,6.50,198,3.38,268113.96,9,1,10,71,13,123.33,20,235,0,2,83.45,0.00,0.50,0.12,4,14.00,15,10149.35,0,3,13,org.apache.lucene.util.LuceneTestCase,0.00,63,1,52,0,63,5,0,20,1641,1
"org.apache.lucene.codecs.lucene.TestSurrogates$SortTermAsUTF16Comparator",1,0.00,2.00,7,0.11,2742.14,2,1,10,7,2,112.24,0,11,0,1,112.24,0.00,0.00,1.00,0,0.00,2,321.08,0,0,2,java.lang.Object,0.00,6,0,2,0,6,1,1,0,77,2
"org.apache.lucene.codecs.lucene.TestTermInfosReaderIndex",9,0.17,1.89,117,1.62,52887.94,18,9,35,72,28,99.62,8,125,0,2,99.62,0.00,0.50,0.26,2,15.00,4,4864.11,0,3,28,org.apache.lucene.util.LuceneTestCase,0.00,63,1,17,0,63,6,0,8,879,1
"org.apache.solr.cloud.AbstractDistributedZkTestCase",7,0.17,3.71,104,1.68,79140.44,10,3,13,47,11,96.03,2,137,1,4,96.03,0.33,0.60,0.19,2,11.00,12,5045.79,6,0,10,org.apache.solr.BaseDistributedSearchTestCase,0.10,40,3,26,1,40,7,0,2,879,2
"org.apache.solr.cloud.AbstractZkTestCase",9,0.05,1.33,71,0.97,29571.81,14,5,13,30,16,111.72,5,92,11,3,111.72,0.50,0.50,0.16,4,28.00,3,2915.30,3,0,5,org.apache.solr.SolrTestCaseJ4,0.04,21,2,12,1,21,9,0,3,577,2
"org.apache.solr.cloud.AssignShard",1,0.00,5.00,19,0.28,15021.52,1,0,8,13,3,41.93,8,24,1,1,90.04,0.00,0.00,0.00,0,1.00,5,838.98,0,1,2,java.lang.Object,0.00,12,0,5,0,12,0,0,2,152,1
"org.apache.solr.cloud.AssignShard$Comparator<String>",1,0.00,1.00,5,0.06,1168.51,1,0,8,3,0,120.77,0,7,0,1,120.77,0.00,0.00,0.00,0,1.00,1,179.56,0,0,0,java.lang.Object,0.00,2,0,1,0,2,1,0,0,44,0
"org.apache.solr.cloud.BasicDistributedZkTest",17,0.04,2.35,337,6.48,479899.79,41,24,34,94,16,108.67,61,398,0,5,88.05,0.00,0.80,0.08,11,52.00,7,19441.94,13,4,16,org.apache.solr.cloud.AbstractDistributedZkTestCase,0.08,77,4,40,0,77,13,0,51,3053,1
"org.apache.solr.cloud.BasicDistributedZkTest$Callable",1,0.00,4.00,17,0.19,6656.95,1,0,34,12,1,144.68,1,23,0,1,94.68,0.00,0.00,0.00,0,1.00,4,565.19,0,1,1,java.lang.Object,0.00,11,0,4,0,11,0,0,1,108,0
"org.apache.solr.cloud.BasicDistributedZkTest$Callable_0",1,0.00,2.00,11,0.12,2934.86,1,0,34,9,1,154.69,1,16,0,1,104.69,0.00,0.00,0.00,0,1.00,2,368.00,0,1,1,java.lang.Object,0.00,8,0,2,0,8,0,0,1,76,0
"org.apache.solr.cloud.BasicZkTest",4,0.00,1.50,67,1.33,58467.95,4,0,13,43,12,93.43,18,91,0,4,93.19,0.00,0.75,0.00,1,4.00,3,3982.90,7,1,12,org.apache.solr.cloud.AbstractZkTestCase,0.00,39,3,6,0,39,3,0,13,590,1
"org.apache.solr.cloud.ChaosMonkey",23,0.02,2.17,176,2.40,111498.61,42,19,17,71,10,160.27,24,236,1,1,110.27,0.00,0.00,0.07,10,317.00,11,7188.10,0,9,9,java.lang.Object,0.00,48,0,50,0,48,14,0,18,1388,1
"org.apache.solr.cloud.ChaosMonkey$Thread",1,0.00,13.00,41,0.56,28247.92,2,1,17,15,1,57.33,5,61,0,1,75.20,0.00,0.00,1.00,0,0.00,13,1673.09,0,0,1,java.lang.Object,0.00,14,0,13,0,14,1,0,5,274,0
"org.apache.solr.cloud.CloudDescriptor",10,0.11,1.00,26,0.16,1690.82,15,5,1,10,12,142.23,2,37,11,1,142.23,0.00,0.00,0.10,0,50.00,1,468.86,0,5,1,java.lang.Object,0.00,0,0,10,0,0,5,0,2,136,1
"org.apache.solr.cloud.CloudStateTest",1,0.00,1.00,32,0.72,44080.66,1,0,10,22,5,78.28,0,38,0,3,78.28,0.00,0.67,0.00,0,1.00,1,2153.45,0,0,5,org.apache.solr.SolrTestCaseJ4,0.00,21,2,1,0,21,1,0,0,361,1
"org.apache.solr.cloud.CloudStateUpdateTest",6,0.27,2.17,131,2.16,111894.01,18,12,20,62,13,137.87,8,153,1,3,87.87,0.00,0.67,0.31,1,6.00,7,6472.89,3,0,12,org.apache.solr.SolrTestCaseJ4,0.08,56,2,13,0,56,6,0,8,1037,1
"org.apache.solr.cloud.CurrentCoreDescriptorProvider",1,0.00,1.00,2,0.01,108.81,1,0,2,1,5,164.35,3,3,4,1,143.73,0.00,0.00,0.00,0,1.00,1,40.14,0,1,1,java.lang.Object,0.00,0,0,1,0,0,0,0,1,14,2
"org.apache.solr.cloud.ElectionContext",3,0.08,1.00,16,0.15,2636.77,9,6,16,4,19,89.52,19,20,9,1,121.74,0.00,0.00,0.11,0,4.00,1,449.35,0,0,10,java.lang.Object,0.00,1,0,3,3,1,3,0,4,111,2
"org.apache.solr.cloud.FullSolrCloudDistribCmdsTest",11,0.00,1.36,160,2.14,78409.35,11,0,23,58,15,147.83,15,181,0,2,97.83,0.00,0.50,0.00,4,11.00,4,6418.82,1,1,15,FullSolrCloudTest,0.00,47,1,15,0,47,10,0,13,1152,1
"org.apache.solr.cloud.Ignore",8,0.00,2.00,68,0.74,25075.74,8,0,13,40,2,159.62,9,85,0,2,109.62,0.00,0.50,0.00,1,8.00,6,2216.87,2,0,2,FullSolrCloudTest,0.00,32,1,16,0,32,8,0,9,422,1
"org.apache.solr.cloud.Ignore$CloudJettyRunner",0,0.00,0.00,4,0.02,88.76,3,3,33,0,1,171.00,0,5,0,1,171.00,0.00,0.00,0.00,0,0.00,0,50.72,0,0,1,java.lang.Object,0.00,0,0,0,0,0,0,0,0,16,0
"org.apache.solr.cloud.Ignore$CloudSolrServerClient",4,0.33,2.75,20,0.21,8640.13,6,2,33,7,1,118.44,0,27,0,1,118.44,0.00,0.00,0.25,0,4.00,7,643.69,0,0,1,java.lang.Object,0.00,3,0,11,0,3,4,0,0,148,1
"org.apache.solr.cloud.Ignore$FullThrottleStopableIndexingThread",5,0.12,2.80,51,0.59,19773.36,11,6,20,26,3,105.13,4,79,0,2,105.13,0.00,0.50,0.27,1,0.00,7,1776.17,0,0,3,org.apache.solr.cloud.StopableIndexingThread,0.00,21,1,14,0,21,5,0,4,338,0
"org.apache.solr.cloud.Ignore$FullThrottleStopableIndexingThread$StreamingUpdateSolrServer",1,0.00,1.00,3,0.04,276.61,1,0,20,2,0,133.97,0,6,0,1,133.97,0.00,0.00,0.00,0,1.00,1,116.80,0,0,0,java.lang.Object,0.00,1,0,1,0,1,1,0,0,32,0
"org.apache.solr.cloud.Ignore$FullThrottleStopableIndexingThread$StreamingUpdateSolrServer_0",1,0.00,1.00,3,0.04,276.61,1,0,20,2,0,133.97,0,6,0,1,133.97,0.00,0.00,0.00,0,1.00,1,116.80,0,0,0,java.lang.Object,0.00,1,0,1,0,1,1,0,0,32,0
"org.apache.solr.cloud.Ignore$StopableIndexingThread",4,0.13,2.25,39,0.49,18837.54,9,5,33,19,0,106.29,0,55,0,2,106.29,0.00,0.50,0.30,0,6.00,6,1482.81,0,0,0,org.apache.zookeeper.Thread,0.00,15,1,9,0,15,4,0,0,279,0
"org.apache.solr.cloud.LeaderElectionIntegrationTest",10,0.09,3.20,151,2.01,71411.65,20,10,22,63,7,146.51,16,176,0,3,96.51,0.00,0.67,0.18,4,22.00,8,6023.92,5,1,7,org.apache.solr.SolrTestCaseJ4,0.08,53,2,32,0,53,9,0,16,1082,1
"org.apache.solr.cloud.LeaderElectionTest",12,0.03,2.17,154,2.04,101902.67,18,6,19,72,10,99.63,11,195,0,3,99.63,0.00,0.67,0.19,3,38.00,9,6113.72,3,1,10,org.apache.solr.SolrTestCaseJ4,0.08,60,2,26,0,60,11,0,11,1123,1
"org.apache.solr.cloud.LeaderElectionTest$ClientThread",5,0.14,2.20,40,0.45,10956.80,12,7,19,16,6,110.82,1,59,0,2,110.82,0.00,0.50,0.26,0,4.00,5,1358.71,0,0,6,org.apache.solr.Thread,0.00,11,1,11,0,11,5,0,1,272,0
"org.apache.solr.cloud.LeaderElectionTest$Thread",1,0.00,4.00,14,0.14,4970.37,1,0,19,6,0,148.82,1,17,0,1,98.82,0.00,0.00,0.00,0,1.00,4,425.55,0,0,0,java.lang.Object,0.00,5,0,4,0,5,1,0,1,83,0
"org.apache.solr.cloud.LeaderElectionTest$Thread_0",1,0.00,6.00,12,0.13,3884.83,1,0,19,6,0,152.07,1,22,0,1,102.07,0.00,0.00,0.00,0,1.00,6,389.56,0,0,0,java.lang.Object,0.00,5,0,6,0,5,1,0,1,79,0
"org.apache.solr.cloud.LeaderElectionTest$Thread_1",1,0.00,4.00,11,0.14,3296.19,1,0,19,7,1,104.13,0,19,0,1,104.13,0.00,0.00,0.00,0,0.00,4,406.08,0,0,1,java.lang.Object,0.00,6,0,4,0,6,1,0,0,81,0
"org.apache.solr.cloud.LeaderElector",9,0.02,2.78,92,1.21,60028.05,15,6,20,36,14,55.24,78,122,8,1,103.35,0.00,0.00,0.15,6,32.00,8,3634.62,0,2,6,java.lang.Object,0.00,27,0,25,0,27,7,0,17,666,1
"org.apache.solr.cloud.LeaderElector$Comparator<String>",1,0.00,1.00,3,0.05,803.06,1,0,20,4,0,130.33,0,6,0,1,130.33,0.00,0.00,0.00,0,1.00,1,146.36,0,0,0,java.lang.Object,0.00,3,0,1,0,3,1,0,0,38,0
"org.apache.solr.cloud.LeaderElector$Watcher",1,0.00,4.00,8,0.10,1935.98,1,0,20,4,0,151.00,2,14,0,1,111.11,0.00,0.00,0.00,0,0.00,4,302.80,0,0,0,java.lang.Object,0.00,3,0,4,0,3,1,0,2,66,0
"org.apache.solr.cloud.NodeStateWatcher",4,0.22,4.25,58,0.89,51397.56,10,6,14,31,4,145.56,6,76,2,1,95.56,0.00,0.00,0.33,1,2.00,12,2655.64,0,1,2,java.lang.Object,0.00,27,0,17,0,27,3,1,4,469,1
"org.apache.solr.cloud.NodeStateWatcher$NodeStateChangeListener",2,0.00,1.00,3,0.04,294.38,2,0,14,2,0,153.93,0,6,0,1,153.93,0.00,0.00,0.00,0,2.00,1,120.54,0,0,0,,0.00,0,0,2,0,0,2,0,0,34,2
"org.apache.solr.cloud.NodeStateWatcherTest",3,1.00,2.67,49,0.71,34462.92,4,1,12,28,8,93.88,0,62,0,3,93.88,0.00,0.67,0.33,1,4.00,5,2144.40,1,0,8,org.apache.solr.SolrTestCaseJ4,0.00,25,2,8,0,25,3,0,0,364,1
"org.apache.solr.cloud.NodeStateWatcherTest$NodeStateChangeListener",2,0.00,1.00,5,0.07,996.98,2,0,12,3,0,138.53,0,11,0,1,138.53,0.00,0.00,0.00,0,2.00,1,210.05,0,0,0,java.lang.Object,0.00,1,0,2,0,1,2,0,0,50,0
"org.apache.solr.cloud.Overseer",14,0.11,2.07,110,1.68,60249.14,22,8,30,56,18,160.69,23,147,5,1,110.69,0.00,0.00,0.22,9,26.00,7,5040.11,0,1,13,java.lang.Object,0.00,42,0,29,0,42,13,2,12,974,1
"org.apache.solr.cloud.Overseer$CloudStateUpdateRequest",1,2.00,1.00,6,0.05,688.43,3,2,30,1,0,119.63,0,8,0,1,119.63,0.00,0.00,0.00,0,1.00,1,136.76,0,0,0,java.lang.Object,0.00,0,0,1,0,0,1,0,0,38,2
"org.apache.solr.cloud.Overseer$CloudStateUpdater",9,0.12,5.11,174,3.25,243815.07,13,4,30,80,10,127.90,20,224,0,1,88.02,0.00,0.00,0.14,1,18.00,14,9738.07,0,6,10,java.lang.Object,0.00,71,0,46,0,71,3,1,12,1689,2
"org.apache.solr.cloud.Overseer$Op",0,0.00,0.00,2,0.01,48.00,0,0,30,0,0,171.00,0,3,0,1,171.00,0.00,0.00,0.00,0,0.00,0,24.00,0,0,0,java.lang.Object,0.00,0,0,0,0,0,0,2,0,8,1
"org.apache.solr.cloud.Overseer$Watcher",1,0.00,4.00,10,0.16,4692.52,1,0,30,5,1,154.47,1,16,0,1,104.47,0.00,0.00,0.00,0,0.00,4,472.05,0,0,1,java.lang.Object,0.00,4,0,4,0,4,1,0,1,89,0
"org.apache.solr.cloud.Overseer$Watcher_0",1,0.00,4.00,11,0.20,7496.03,1,0,30,8,3,151.32,1,20,0,1,101.32,0.00,0.00,0.00,0,0.00,4,612.25,0,0,3,java.lang.Object,0.00,7,0,4,0,7,1,0,1,110,0
"org.apache.solr.cloud.Overseer$ZkOperation",1,0.00,1.00,4,0.03,397.30,1,0,30,2,1,128.07,0,6,0,1,128.07,0.00,0.00,0.00,0,0.00,1,95.57,0,1,1,java.lang.Object,0.00,1,0,1,0,1,0,0,0,25,0
"org.apache.solr.cloud.Overseer$ZkOperation$Watcher_1",1,0.00,4.00,12,0.21,8274.93,1,0,30,7,3,149.57,1,22,0,1,99.57,0.00,0.00,0.00,0,0.00,4,638.07,0,0,3,java.lang.Object,0.00,6,0,4,0,6,1,0,1,114,0
"org.apache.solr.cloud.OverseerElectionContext",2,0.00,1.50,15,0.23,6275.44,4,2,16,10,15,161.85,2,25,3,2,111.85,0.00,0.50,0.50,0,2.00,2,699.84,0,0,12,org.apache.solr.cloud.ElectionContext,0.40,8,1,3,0,8,2,0,2,142,1
"org.apache.solr.cloud.OverseerTest",14,0.15,6.21,440,6.89,562845.36,16,2,29,99,17,78.69,12,513,0,3,78.69,0.00,0.67,0.36,4,10.00,26,20671.49,1,1,17,org.apache.solr.SolrTestCaseJ4,0.00,85,2,87,0,85,13,0,12,3234,1
"org.apache.solr.cloud.OverseerTest$CurrentCoreDescriptorProvider",1,0.00,1.00,3,0.02,260.67,1,0,29,1,0,184.18,1,5,0,1,134.18,0.00,0.00,0.00,0,1.00,1,59.81,0,1,0,java.lang.Object,0.00,0,0,1,0,0,0,0,1,18,0
"org.apache.solr.cloud.OverseerTest$CurrentCoreDescriptorProvider_0",1,0.00,1.00,3,0.02,260.67,1,0,29,1,0,184.18,1,5,0,1,134.18,0.00,0.00,0.00,0,1.00,1,59.81,0,1,0,java.lang.Object,0.00,0,0,1,0,0,0,0,1,18,0
"org.apache.solr.cloud.OverseerTest$MockZKController",5,0.36,3.40,68,1.13,60698.64,12,7,29,37,9,97.00,2,99,0,1,97.00,0.00,0.00,0.43,2,0.00,6,3394.55,0,1,9,java.lang.Object,0.00,32,0,17,0,32,4,0,2,598,2
"org.apache.solr.cloud.OverseerTest$OverseerRestarter",2,0.00,4.00,18,0.18,4707.63,5,3,29,5,1,148.42,4,33,0,1,108.53,0.00,0.00,0.33,0,2.00,7,533.48,0,0,1,java.lang.Object,0.00,3,0,8,0,3,2,1,4,117,1
"org.apache.solr.cloud.OverseerTest$Runnable",1,0.00,2.00,12,0.17,5695.77,1,0,29,10,2,101.01,0,17,0,1,101.01,0.00,0.00,0.00,0,1.00,2,506.25,0,0,2,java.lang.Object,0.00,9,0,2,0,9,1,0,0,97,0
"org.apache.solr.cloud.RecoveryStrategy",11,0.16,3.55,187,2.82,196752.67,25,14,36,88,26,59.10,69,250,1,2,91.32,0.00,0.50,0.21,6,8.00,21,8465.52,0,1,25,org.apache.solr.handler.Thread,0.00,77,1,39,0,77,10,1,69,1369,1
"org.apache.solr.cloud.RecoveryZkTest",7,0.17,1.00,50,0.60,14638.41,10,3,10,34,4,153.21,17,63,0,2,113.33,0.00,0.50,0.19,1,13.00,1,1794.51,1,0,4,FullSolrCloudTest,0.00,27,1,7,0,27,7,0,17,355,1
"org.apache.solr.cloud.ShardLeaderElectionContext",5,0.17,3.60,63,1.13,46005.69,8,3,16,34,14,139.12,12,97,1,3,99.24,0.00,0.67,0.47,1,0.00,8,3375.38,2,0,14,org.apache.solr.cloud.ShardLeaderElectionContextBase,0.30,29,2,18,0,29,5,0,12,608,1
"org.apache.solr.cloud.ShardLeaderElectionContextBase",2,0.25,2.50,16,0.27,7234.11,6,4,16,7,16,159.08,2,30,4,2,109.08,1.00,0.33,0.12,0,2.00,4,805.14,0,0,12,org.apache.solr.cloud.ElectionContext,0.40,5,1,5,1,5,2,0,2,169,0
"org.apache.solr.cloud.ShardLeaderWatcher",4,0.19,2.50,33,0.42,11668.26,11,7,10,13,5,159.82,4,48,1,1,109.82,0.00,0.00,0.29,1,6.00,5,1258.67,0,0,4,java.lang.Object,0.00,9,0,10,0,9,4,1,2,258,1
"org.apache.solr.cloud.ShardLeaderWatcher$ShardLeaderListener",1,0.00,1.00,2,0.01,51.23,1,0,10,1,1,146.31,0,3,0,1,146.31,0.00,0.00,0.00,0,1.00,1,41.70,0,0,1,,0.00,0,0,1,0,0,1,0,0,15,1
"org.apache.solr.cloud.SolrZkServer",6,0.24,3.17,52,0.63,19411.14,15,9,20,26,4,109.41,5,69,2,1,109.41,0.00,0.00,0.31,0,0.00,7,1892.48,0,2,2,java.lang.Object,0.00,20,0,19,0,20,4,0,5,390,1
"org.apache.solr.cloud.SolrZkServer$Thread",1,0.00,3.00,14,0.16,5644.78,1,0,20,9,1,98.45,0,19,0,1,98.45,0.00,0.00,0.00,0,0.00,3,490.81,0,0,1,java.lang.Object,0.00,8,0,3,0,8,1,0,0,96,0
"org.apache.solr.cloud.SolrZkServerProps",7,0.11,9.00,175,3.15,310012.42,10,3,20,67,2,49.54,44,241,1,2,81.76,0.00,0.50,0.24,2,14.00,36,9447.33,0,2,1,org.apache.zookeeper.server.quorum.QuorumPeerConfig,0.00,60,1,63,0,60,5,0,24,1473,0
"org.apache.solr.cloud.SyncStrategy",9,0.02,3.22,117,1.81,69312.41,14,5,29,67,19,98.81,42,163,1,1,98.57,0.00,0.00,0.18,4,20.00,8,5431.76,0,1,18,java.lang.Object,0.00,58,0,29,0,58,8,0,42,994,1
"org.apache.solr.cloud.SyncStrategy$SyncShardRequest",0,0.00,0.00,2,0.01,119.59,1,1,29,0,1,171.00,0,3,0,2,171.00,0.00,0.50,0.00,0,0.00,0,39.86,0,0,1,org.apache.solr.handler.component.ShardRequest,0.00,0,1,0,0,0,0,0,0,12,2
"org.apache.solr.cloud.TestHashPartitioner",1,0.00,2.00,11,0.21,10809.02,1,0,4,7,2,100.23,0,15,0,3,100.23,0.00,0.67,0.00,0,1.00,2,641.02,0,0,2,org.apache.solr.SolrTestCaseJ4,0.00,6,2,2,0,6,1,0,0,122,1
"org.apache.solr.cloud.TestMultiCoreConfBootstrap",5,0.20,1.80,45,0.71,21198.57,10,5,14,30,7,106.71,1,63,0,3,106.71,0.00,0.67,0.36,0,2.00,5,2118.06,3,0,7,org.apache.solr.SolrTestCaseJ4,0.08,25,2,9,0,25,5,0,1,401,1
"org.apache.solr.cloud.ZkController",46,0.02,2.85,492,7.78,393032.56,72,26,39,178,39,102.73,201,693,17,1,102.50,0.00,0.00,0.06,16,698.00,15,23327.01,0,17,24,java.lang.Object,0.00,132,0,131,0,132,29,0,93,4086,2
"org.apache.solr.cloud.ZkController$OnReconnect",1,0.00,1.00,2,0.01,71.89,1,0,39,1,0,145.15,0,3,0,1,145.15,0.00,0.00,0.00,0,1.00,1,30.46,0,0,0,java.lang.Object,0.00,0,0,1,0,0,1,0,0,12,0
"org.apache.solr.cloud.ZkController$OnReconnect_0",1,0.00,8.00,24,0.34,18253.75,1,0,39,14,5,47.92,12,37,0,1,85.48,0.00,0.00,0.00,0,0.00,8,1021.43,0,0,5,java.lang.Object,0.00,13,0,8,0,13,1,0,12,177,0
"org.apache.solr.cloud.ZkControllerTest",6,0.07,2.50,107,1.84,103516.56,9,3,14,55,10,91.53,3,153,0,3,91.53,0.00,0.67,0.39,0,6.00,6,5527.12,3,0,10,org.apache.solr.SolrTestCaseJ4,0.04,49,2,15,0,49,6,0,3,887,1
"org.apache.solr.cloud.ZkControllerTest$CurrentCoreDescriptorProvider",1,0.00,1.00,3,0.02,260.67,1,0,14,1,0,184.18,1,5,0,1,134.18,0.00,0.00,0.00,0,1.00,1,59.81,0,1,0,java.lang.Object,0.00,0,0,1,0,0,0,0,1,18,0
"org.apache.solr.cloud.ZkControllerTest$CurrentCoreDescriptorProvider_0",1,0.00,1.00,3,0.02,260.67,1,0,14,1,0,184.18,1,5,0,1,134.18,0.00,0.00,0.00,0,1.00,1,59.81,0,1,0,java.lang.Object,0.00,0,0,1,0,0,0,0,1,18,0
"org.apache.solr.cloud.ZkControllerTest$CurrentCoreDescriptorProvider_1",1,0.00,1.00,3,0.02,260.67,1,0,14,1,0,184.18,1,5,0,1,134.18,0.00,0.00,0.00,0,1.00,1,59.81,0,1,0,java.lang.Object,0.00,0,0,1,0,0,0,0,1,18,0
"org.apache.solr.cloud.ZkNodePropsTest",1,0.00,1.00,18,0.27,12465.92,1,0,7,8,3,91.92,0,21,0,3,91.92,0.00,0.67,0.00,0,1.00,1,818.60,0,0,3,org.apache.solr.SolrTestCaseJ4,0.00,7,2,1,0,7,1,0,0,154,1
"org.apache.solr.cloud.ZkSolrClientTest",8,0.86,2.75,103,1.38,68265.73,9,1,11,33,5,149.55,15,138,0,3,99.55,0.00,0.67,0.25,0,8.00,10,4135.56,1,2,5,org.apache.solr.util.AbstractSolrTestCase,0.22,25,2,22,0,25,6,0,15,724,1
"org.apache.solr.cloud.ZkSolrClientTest$Watcher",1,0.00,4.00,9,0.09,1660.72,1,0,11,5,0,159.73,1,14,0,1,109.73,0.00,0.00,0.00,0,0.00,4,282.79,0,0,0,java.lang.Object,0.00,4,0,4,0,4,1,0,1,60,0
"org.apache.solr.cloud.ZkSolrResourceLoader",6,0.10,2.00,39,0.55,19561.09,8,2,9,19,6,134.76,23,66,2,2,114.15,0.00,0.50,0.58,0,0.00,5,1659.43,0,4,4,org.apache.solr.core.SolrResourceLoader,0.11,13,1,12,0,13,2,0,5,331,1
"org.apache.solr.cloud.ZkTestServer",13,0.06,1.92,86,0.98,34124.28,20,7,22,48,14,114.90,12,123,14,1,114.90,0.00,0.00,0.09,2,50.00,5,2930.88,0,4,0,java.lang.Object,0.00,35,0,25,0,35,9,0,5,590,1
"org.apache.solr.cloud.ZkTestServer$HostPort",1,2.00,1.00,6,0.04,417.53,3,2,22,1,0,121.34,0,8,0,1,121.34,0.00,0.00,0.00,0,1.00,1,112.24,0,0,0,java.lang.Object,0.00,0,0,1,0,0,1,0,0,33,2
"org.apache.solr.cloud.ZkTestServer$Session",3,0.00,1.00,7,0.04,423.09,3,0,22,3,0,142.85,0,12,0,1,142.85,0.00,0.00,0.00,0,3.00,1,117.62,0,0,0,java.lang.Object,0.00,0,0,3,0,0,3,0,0,37,0
"org.apache.solr.cloud.ZkTestServer$Thread",1,0.00,2.00,6,0.05,985.56,1,0,22,3,0,118.24,0,10,0,1,118.24,0.00,0.00,0.00,0,0.00,2,144.16,0,0,0,java.lang.Object,0.00,2,0,2,0,2,1,0,0,35,0
"org.apache.solr.cloud.ZkTestServer$Thread$ServerConfig",1,0.00,3.00,12,0.13,3143.46,1,0,22,5,1,102.95,0,19,0,1,102.95,0.00,0.00,0.00,0,1.00,3,380.76,0,0,1,java.lang.Object,0.00,4,0,3,0,4,1,0,0,85,0
"org.apache.solr.cloud.ZkTestServer$ZKServerMain",4,0.17,3.50,42,0.47,13476.26,6,2,22,29,0,126.25,13,63,0,1,105.63,0.00,0.00,0.62,1,0.00,4,1410.63,0,0,0,java.lang.Object,0.00,25,0,14,0,25,4,0,6,291,0
"org.apache.lucene.search.grouping.AbstractAllGroupHeadsCollector",8,0.19,1.88,48,0.45,16148.55,11,3,5,15,13,97.93,42,56,10,2,115.80,8.00,0.10,0.17,2,16.00,6,1336.78,0,2,3,org.apache.lucene.search.Collector,0.33,7,1,15,8,7,6,0,13,293,2
"org.apache.lucene.search.grouping.AbstractAllGroupHeadsCollector$GroupHead",3,2.00,1.00,8,0.07,1028.11,5,2,5,3,0,121.94,15,10,0,1,139.81,0.00,0.00,0.00,0,3.00,1,220.93,0,0,0,java.lang.Object,0.00,0,0,3,0,0,3,0,2,62,3
"org.apache.lucene.search.grouping.AbstractAllGroupHeadsCollector$TemporalResult",0,0.00,0.00,3,0.02,116.27,2,2,5,0,0,171.00,0,4,0,1,171.00,0.00,0.00,0.00,0,0.00,0,46.51,0,0,0,java.lang.Object,0.00,0,0,0,0,0,0,0,0,14,1
"org.apache.lucene.search.grouping.AbstractAllGroupsCollector",4,0.00,1.00,7,0.05,438.50,4,0,5,5,8,122.71,27,10,5,2,154.94,7.00,0.11,0.00,1,4.00,1,154.14,0,1,3,org.apache.lucene.search.Collector,0.25,1,1,4,7,1,3,0,4,48,2
"org.apache.lucene.search.grouping.AbstractDistinctValuesCollector",3,0.00,1.00,6,0.06,913.70,3,0,4,3,5,160.83,10,9,3,2,140.21,5.00,0.14,0.00,0,3.00,1,182.64,0,1,2,org.apache.lucene.search.Collector,0.29,0,1,3,5,0,2,0,2,52,2
"org.apache.lucene.search.grouping.AbstractDistinctValuesCollector$GroupCount",1,2.00,1.00,6,0.06,1249.61,3,2,4,2,0,117.59,0,8,0,1,117.59,0.00,0.00,0.00,0,1.00,1,181.24,0,0,0,java.lang.Object,0.00,1,0,1,0,1,1,0,0,47,3
"org.apache.lucene.search.grouping.AbstractFirstPassGroupingCollector",9,0.17,5.56,159,2.13,266526.66,18,9,4,35,13,41.02,93,173,5,2,89.50,7.00,0.11,0.26,2,8.00,27,6402.81,0,1,8,org.apache.lucene.search.Collector,0.31,26,1,50,7,26,8,0,53,1113,2
"org.apache.lucene.search.grouping.AbstractFirstPassGroupingCollector$Comparator<CollectedSearchGroup<?>>",1,0.00,7.00,12,0.15,9117.54,1,0,4,2,2,99.11,0,12,0,1,99.11,0.00,0.00,0.00,0,0.00,7,440.34,0,0,2,java.lang.Object,0.00,1,0,7,0,1,1,0,0,90,0
"org.apache.lucene.search.grouping.AbstractGroupFacetCollector",5,0.06,2.20,51,0.59,44659.53,13,8,6,18,7,102.64,20,60,3,2,102.40,5.00,0.14,0.08,1,7.00,7,1772.53,0,0,4,org.apache.lucene.search.Collector,0.22,13,1,11,5,13,5,0,4,332,2
"org.apache.lucene.search.grouping.AbstractGroupFacetCollector$GroupedFacetResult",5,0.10,2.60,47,0.49,19380.23,10,5,6,15,0,89.05,25,60,0,1,106.93,0.00,0.00,0.28,0,13.00,5,1459.14,0,1,0,java.lang.Object,0.00,10,0,13,0,10,4,0,5,306,2
"org.apache.lucene.search.grouping.AbstractGroupFacetCollector$GroupedFacetResult$Comparator<FacetEntry>",1,0.00,2.00,6,0.06,1777.90,1,0,6,2,0,166.22,1,8,0,1,116.22,0.00,0.00,0.00,0,1.00,2,192.53,0,0,0,java.lang.Object,0.00,1,0,2,0,1,1,0,1,47,0
"org.apache.lucene.search.grouping.AbstractGroupFacetCollector$GroupedFacetResult$Comparator<FacetEntry>_0",1,0.00,1.00,3,0.03,398.03,1,0,6,2,0,132.73,0,4,0,1,132.73,0.00,0.00,0.00,0,1.00,1,93.66,0,0,0,java.lang.Object,0.00,1,0,1,0,1,1,0,0,27,0
"org.apache.lucene.search.grouping.AbstractGroupFacetCollector$GroupedFacetResult$FacetEntry",6,0.20,1.67,23,0.24,6482.20,8,2,6,10,0,179.20,6,36,0,1,129.20,0.00,0.00,0.67,0,0.00,5,709.66,0,2,0,java.lang.Object,0.00,4,0,10,0,4,4,0,2,171,2
"org.apache.lucene.search.grouping.AbstractGroupFacetCollector$GroupedFacetResult$SegmentResult",2,6.00,1.00,13,0.11,2507.43,8,6,6,2,0,157.46,5,15,0,1,117.58,0.00,0.00,0.00,0,2.00,1,332.46,0,0,0,java.lang.Object,0.00,0,0,2,0,0,2,0,1,86,3
"org.apache.lucene.search.grouping.AbstractGroupFacetCollector$GroupedFacetResult$SegmentResultPriorityQueue",2,0.00,1.00,5,0.05,626.51,2,0,6,3,1,140.12,0,8,0,2,140.12,0.00,0.50,0.00,0,2.00,1,147.76,0,0,1,org.apache.lucene.util.PriorityQueue,0.00,1,1,2,0,1,2,0,0,42,2
"org.apache.lucene.search.grouping.AbstractGroupingTestCase",1,0.00,1.00,7,0.05,849.25,1,0,2,3,3,84.19,6,9,2,2,116.41,2.00,0.25,0.00,0,1.00,1,138.19,0,1,1,org.apache.lucene.util.LuceneTestCase,0.00,2,1,1,2,2,0,0,4,36,2
"org.apache.lucene.search.grouping.AbstractSecondPassGroupingCollector",7,0.06,2.43,54,0.86,36844.34,15,8,6,23,15,130.58,27,77,4,2,109.97,7.00,0.11,0.18,1,14.00,5,2568.08,0,0,11,org.apache.lucene.search.Collector,0.36,16,1,17,7,16,7,0,10,492,2
"org.apache.lucene.search.grouping.AbstractSecondPassGroupingCollector$SearchGroupDocs",1,2.00,2.00,6,0.06,1132.10,3,2,6,1,1,117.77,0,8,0,1,117.77,0.00,0.00,0.00,0,1.00,2,171.27,0,0,1,java.lang.Object,0.00,0,0,2,0,0,1,0,0,45,1
"org.apache.lucene.search.grouping.AllGroupHeadsCollectorTest",9,0.88,7.33,349,6.88,842336.75,10,1,21,98,28,112.35,20,388,0,2,72.47,0.00,0.50,0.22,6,19.00,32,20628.62,0,3,28,org.apache.lucene.util.LuceneTestCase,0.00,89,1,66,0,89,6,0,20,3003,1
"org.apache.lucene.search.grouping.AllGroupHeadsCollectorTest$Comparator<GroupDoc>",1,0.00,11.00,25,0.39,30842.19,1,0,21,10,0,132.95,1,30,0,1,82.95,0.00,0.00,0.00,0,1.00,11,1165.44,0,0,0,java.lang.Object,0.00,9,0,11,0,9,1,0,1,208,0
"org.apache.lucene.search.grouping.AllGroupHeadsCollectorTest$GroupDoc",1,7.00,1.00,15,0.13,2406.85,8,7,21,1,1,150.50,1,17,0,1,100.50,0.00,0.00,0.00,0,1.00,1,375.18,0,0,1,java.lang.Object,0.00,0,0,1,0,0,1,0,1,91,2
"org.apache.lucene.search.grouping.AllGroupsCollectorTest",3,0.00,3.00,73,1.34,79515.74,3,0,17,40,18,124.32,8,84,0,2,84.43,0.00,0.50,0.00,2,3.00,5,4018.83,0,1,18,org.apache.lucene.util.LuceneTestCase,0.00,37,1,9,0,37,2,0,8,657,1
"org.apache.lucene.search.grouping.BlockGroupingCollector",7,0.32,8.00,219,2.71,234414.88,29,22,6,43,17,97.39,131,242,2,2,79.26,0.00,0.50,0.32,1,0.00,22,8118.94,0,1,15,org.apache.lucene.search.Collector,0.36,36,1,56,0,36,6,0,64,1372,1
"org.apache.lucene.search.grouping.BlockGroupingCollector$FakeScorer",5,0.38,1.00,13,0.09,1051.80,7,2,6,6,1,141.48,0,23,0,3,141.48,0.00,0.67,0.20,0,11.00,1,263.06,0,0,1,org.apache.lucene.search.Scorer,0.80,1,2,5,0,1,5,0,0,77,3
"org.apache.lucene.search.grouping.BlockGroupingCollector$GroupQueue",2,0.00,2.00,15,0.18,10817.03,2,0,6,2,1,159.92,3,18,0,2,109.92,0.00,0.50,0.00,0,2.00,3,529.98,0,0,1,org.apache.lucene.util.PriorityQueue,0.00,0,1,4,0,0,2,0,3,111,2
"org.apache.lucene.search.grouping.BlockGroupingCollector$OneGroup",0,0.00,0.00,7,0.04,613.73,6,6,6,0,1,171.00,1,8,0,1,171.00,0.00,0.00,0.00,0,0.00,0,134.89,0,0,1,java.lang.Object,0.00,0,0,0,0,0,0,0,1,33,3
"org.apache.lucene.search.grouping.CollectedSearchGroup",0,0.00,0.00,3,0.03,362.64,2,2,0,0,3,171.00,1,4,2,2,171.00,0.00,0.50,0.00,0,0.00,0,77.71,0,0,1,org.apache.lucene.search.grouping.SearchGroup,0.00,0,1,0,0,0,0,0,1,21,1
"org.apache.lucene.search.grouping.DistinctValuesCollectorTest",10,0.07,7.70,300,6.44,618790.42,13,3,21,96,30,127.70,15,337,0,3,77.70,0.00,0.67,0.27,8,22.00,19,19332.61,0,3,30,org.apache.lucene.search.grouping.AbstractGroupingTestCase,0.00,86,2,77,0,86,7,0,15,3024,1
"org.apache.lucene.search.grouping.DistinctValuesCollectorTest$Comparator<AbstractDistinctValuesCollector.GroupCount<Comparable<Object>>>",1,0.00,4.00,10,0.13,4693.08,1,0,21,2,0,104.47,0,13,0,1,104.47,0.00,0.00,0.00,0,1.00,4,390.89,0,0,0,java.lang.Object,0.00,1,0,4,0,1,1,0,0,88,0
"org.apache.lucene.search.grouping.DistinctValuesCollectorTest$GroupCount",1,0.00,1.00,4,0.04,516.40,1,0,21,2,0,127.18,0,6,0,2,127.18,0.00,0.50,0.00,0,1.00,1,118.63,0,0,0,AbstractDistinctValuesCollector.GroupCount,0.00,1,1,1,0,1,1,0,0,33,0
"org.apache.lucene.search.grouping.DistinctValuesCollectorTest$IndexContext",1,5.00,1.00,12,0.15,3625.39,6,5,21,1,2,102.72,0,15,0,1,102.72,0.00,0.00,0.00,0,1.00,1,453.22,0,0,2,java.lang.Object,0.00,0,0,1,0,0,1,0,0,101,2
"org.apache.lucene.search.grouping.DistinctValuesCollectorTest$NullComparator",1,0.00,4.00,12,0.09,2419.01,1,0,21,2,0,103.78,0,14,0,1,103.78,0.00,0.00,0.00,0,1.00,4,279.90,0,0,0,java.lang.Object,0.00,1,0,4,0,1,1,1,0,67,2
"org.apache.lucene.search.grouping.GroupDocs",1,5.00,1.00,12,0.12,2204.74,6,5,1,1,13,66.85,12,18,12,1,104.42,0.00,0.00,0.00,0,1.00,1,361.07,0,0,1,java.lang.Object,0.00,0,0,1,0,0,1,0,6,85,1
"org.apache.lucene.search.grouping.GroupFacetCollectorTest",7,0.00,9.00,410,8.04,1143863.13,7,0,16,102,20,103.55,16,457,0,3,63.66,0.00,0.67,0.00,5,7.00,30,24108.10,1,4,20,org.apache.lucene.search.grouping.AbstractGroupingTestCase,0.00,95,2,63,0,95,3,0,16,3584,1
"org.apache.lucene.search.grouping.GroupFacetCollectorTest$Comparator<String>",1,0.00,4.00,10,0.07,2088.13,1,0,16,2,0,107.24,0,12,0,1,107.24,0.00,0.00,0.00,0,1.00,4,223.55,0,0,0,java.lang.Object,0.00,1,0,4,0,1,1,0,0,55,0
"org.apache.lucene.search.grouping.GroupFacetCollectorTest$Comparator<TermGroupFacetCollector.FacetEntry>",1,0.00,3.00,7,0.09,2307.87,1,0,16,4,0,112.74,0,10,0,1,112.74,0.00,0.00,0.00,0,1.00,3,260.42,0,0,0,java.lang.Object,0.00,3,0,3,0,3,1,0,0,61,0
"org.apache.lucene.search.grouping.GroupFacetCollectorTest$GroupedFacetResult",4,0.11,1.00,14,0.11,1823.51,7,3,16,4,1,132.26,0,19,0,1,132.26,0.00,0.00,0.25,0,10.00,1,326.99,0,1,1,java.lang.Object,0.00,0,0,4,0,0,3,0,0,86,1
"org.apache.lucene.search.grouping.GroupFacetCollectorTest$IndexContext",1,9.00,1.00,20,0.25,6843.56,10,9,16,1,2,92.27,0,23,0,1,92.27,0.00,0.00,0.00,0,1.00,1,742.90,0,0,2,java.lang.Object,0.00,0,0,1,0,0,1,0,0,155,1
"org.apache.lucene.search.grouping.GroupingSearch",24,0.02,2.08,186,2.32,141389.14,45,21,21,58,35,77.40,163,229,2,1,109.62,0.00,0.00,0.06,3,114.00,21,6969.22,0,15,33,java.lang.Object,0.00,34,0,50,0,34,9,0,23,1271,1
"org.apache.lucene.search.grouping.GroupingSearchTest",4,0.00,4.25,127,2.46,196919.26,4,0,16,50,23,117.97,11,143,0,2,78.09,0.00,0.50,0.00,3,4.00,8,7381.75,0,1,23,org.apache.lucene.util.LuceneTestCase,0.00,46,1,17,0,46,3,0,11,1153,1
"org.apache.lucene.search.grouping.SearchGroup",4,0.00,3.25,26,0.38,14990.67,6,2,5,11,18,95.69,21,38,15,1,113.56,0.00,0.00,0.50,0,0.00,8,1144.35,0,2,3,java.lang.Object,0.00,7,0,13,1,7,2,0,5,247,1
"org.apache.lucene.search.grouping.SearchGroup$GroupComparator",2,1.00,4.00,30,0.39,23472.39,4,2,5,6,3,144.76,3,31,0,1,94.76,0.00,0.00,1.00,0,0.00,4,1168.64,0,0,3,java.lang.Object,0.00,4,0,8,0,4,2,1,3,230,2
"org.apache.lucene.search.grouping.SearchGroup$GroupMerger",3,0.67,7.00,80,1.20,108916.00,6,3,5,20,2,49.64,20,92,0,1,81.86,0.00,0.00,0.78,1,0.00,12,3600.23,0,1,2,java.lang.Object,0.00,17,0,21,0,17,2,0,20,626,2
"org.apache.lucene.search.grouping.SearchGroup$MergedGroup",4,0.06,3.25,32,0.32,12173.84,10,6,5,7,0,159.61,4,44,0,1,109.61,0.00,0.00,0.12,1,0.00,5,948.19,0,0,0,java.lang.Object,0.00,3,0,13,0,3,4,0,4,207,2
"org.apache.lucene.search.grouping.SearchGroup$ShardIter",3,0.00,1.33,15,0.17,4032.93,5,2,5,7,1,120.22,0,21,0,1,120.22,0.00,0.00,0.50,0,2.00,2,501.82,0,1,1,java.lang.Object,0.00,4,0,4,0,4,2,0,0,117,2
"org.apache.lucene.search.grouping.TestGrouping",20,0.00,11.35,838,17.89,2759645.32,20,0,33,195,54,90.42,76,979,0,2,69.81,0.00,0.50,0.00,13,20.00,97,53676.59,0,14,54,org.apache.lucene.util.LuceneTestCase,0.00,175,1,227,0,175,6,0,76,7559,1
"org.apache.lucene.search.grouping.TestGrouping$Comparator<GroupDoc>",1,0.00,9.00,23,0.31,21245.14,1,0,33,9,0,135.62,1,28,0,1,85.62,0.00,0.00,0.00,0,1.00,9,925.05,0,0,0,java.lang.Object,0.00,8,0,9,0,8,1,0,1,170,0
"org.apache.lucene.search.grouping.TestGrouping$GroupDoc",1,7.00,1.00,14,0.11,1967.01,8,7,33,1,1,152.31,1,16,0,1,102.31,0.00,0.00,0.00,0,1.00,1,334.46,0,0,1,java.lang.Object,0.00,0,0,1,0,0,1,0,1,82,2
"org.apache.lucene.search.grouping.TestGrouping$ShardSearcher",4,0.33,1.00,11,0.12,1668.05,5,1,33,5,6,139.14,0,17,0,2,139.14,0.00,0.50,0.75,1,0.00,1,355.03,0,2,6,org.apache.lucene.search.IndexSearcher,0.00,1,1,4,0,1,2,0,0,92,2
"org.apache.lucene.search.grouping.TestGrouping$ShardState",1,0.00,4.00,26,0.32,20891.71,3,2,33,10,6,133.88,1,25,0,1,83.88,0.00,0.00,1.00,0,0.00,4,974.28,0,0,6,java.lang.Object,0.00,9,0,4,0,9,1,0,1,180,2
"org.apache.lucene.search.grouping.TestGrouping$ValueHolder",1,1.00,1.00,4,0.03,380.91,2,1,33,1,0,128.22,0,6,0,1,128.22,0.00,0.00,0.00,0,1.00,1,83.05,0,0,0,java.lang.Object,0.00,0,0,1,0,0,1,0,0,25,2
"org.apache.lucene.search.grouping.TopGroups",3,0.17,6.33,78,1.27,202842.75,9,6,5,13,20,42.20,37,104,15,1,79.76,0.00,0.00,0.06,0,4.00,17,3810.16,0,1,5,java.lang.Object,0.00,10,0,19,0,10,2,0,15,652,1
"org.apache.lucene.analysis.pt.PortugueseAnalyzer",5,0.50,1.40,24,0.30,7762.08,7,2,17,18,16,73.34,49,35,1,3,123.34,0.00,0.67,0.10,0,8.00,3,894.00,0,2,15,org.apache.lucene.analysis.util.StopwordAnalyzerBase,0.00,13,2,7,0,13,3,0,8,196,2
"org.apache.lucene.analysis.pt.PortugueseAnalyzer$DefaultSetHolder",0,0.00,0.00,6,0.07,1089.77,1,1,17,0,4,171.00,2,11,0,1,171.00,0.00,0.00,0.00,0,0.00,0,202.05,0,0,4,java.lang.Object,0.00,0,0,0,0,0,0,0,2,47,2
"org.apache.lucene.analysis.pt.PortugueseLightStemFilter",2,0.33,2.00,14,0.16,3794.18,5,3,6,9,10,113.74,9,20,4,4,113.50,0.00,0.75,0.50,0,2.00,3,481.98,0,0,6,org.apache.lucene.analysis.TokenFilter,0.29,7,3,4,0,7,2,0,1,107,2
"org.apache.lucene.analysis.pt.PortugueseLightStemmer",3,0.00,11.00,73,1.25,100714.89,3,0,1,4,1,123.21,7,122,1,1,83.32,0.00,0.00,0.00,0,3.00,14,3736.92,0,0,0,java.lang.Object,0.00,1,0,33,0,1,3,0,1,670,1
"org.apache.lucene.analysis.pt.PortugueseMinimalStemFilter",2,0.33,2.00,14,0.16,3794.18,5,3,6,9,9,113.74,9,20,3,4,113.50,0.00,0.75,0.50,0,2.00,3,481.98,0,0,6,org.apache.lucene.analysis.TokenFilter,0.29,7,3,4,0,7,2,0,1,107,2
"org.apache.lucene.analysis.pt.PortugueseMinimalStemmer",1,0.00,1.00,4,0.06,973.48,2,1,0,3,2,172.84,27,7,1,2,125.01,0.00,0.50,1.00,0,0.00,1,170.48,0,0,1,org.apache.lucene.analysis.pt.RSLPStemmerBase,0.00,2,1,1,0,2,1,0,2,42,1
"org.apache.lucene.analysis.pt.PortugueseStemFilter",2,0.33,2.00,15,0.18,4744.35,5,3,6,9,9,94.87,10,21,3,4,112.74,0.00,0.75,0.50,0,2.00,3,535.08,0,0,6,org.apache.lucene.analysis.TokenFilter,0.29,7,3,4,0,7,2,0,2,116,2
"org.apache.lucene.analysis.pt.PortugueseStemmer",1,0.00,13.00,46,0.71,38971.65,8,7,1,2,2,52.09,14,61,1,2,72.23,0.00,0.50,1.00,0,0.00,13,2131.11,1,0,1,org.apache.lucene.analysis.pt.RSLPStemmerBase,0.00,1,1,13,0,1,1,0,5,364,1
"org.apache.lucene.analysis.pt.RSLPStemmerBase",6,0.10,3.33,71,1.24,74603.25,10,4,14,35,3,51.16,64,98,2,1,99.63,0.00,0.00,0.17,3,14.00,7,3733.28,0,6,1,java.lang.Object,0.00,29,0,20,4,29,0,0,7,691,2
"org.apache.lucene.analysis.pt.RSLPStemmerBase$Rule",3,0.17,1.33,14,0.18,4446.23,6,3,14,5,0,123.74,12,19,0,1,123.51,0.00,0.00,0.44,0,1.00,2,535.01,0,0,0,java.lang.Object,0.00,2,0,4,0,2,3,0,3,130,2
"org.apache.lucene.analysis.pt.RSLPStemmerBase$RuleWithSetExceptions",2,1.00,2.00,12,0.20,6148.13,3,1,14,7,1,114.35,0,17,0,2,114.35,0.00,0.50,0.50,0,2.00,3,599.57,1,0,1,org.apache.lucene.analysis.pt.Rule,0.00,5,1,4,0,5,2,0,0,123,2
"org.apache.lucene.analysis.pt.RSLPStemmerBase$RuleWithSuffixExceptions",2,1.00,4.00,19,0.28,12563.05,3,1,14,4,0,105.18,1,23,0,2,105.18,0.00,0.50,0.50,0,2.00,4,849.28,1,0,0,org.apache.lucene.analysis.pt.Rule,0.00,2,1,8,0,2,2,0,1,173,2
"org.apache.lucene.analysis.pt.RSLPStemmerBase$Step",2,0.25,6.50,37,0.44,27817.76,6,4,14,5,0,73.24,10,41,0,1,91.12,0.00,0.00,0.38,0,2.00,8,1328.87,0,0,0,java.lang.Object,0.00,3,0,13,0,3,2,0,2,265,2
"org.apache.lucene.analysis.pt.TestPortugueseAnalyzer",4,0.00,1.00,15,0.16,2494.63,4,0,4,7,4,181.19,7,21,0,3,131.19,0.00,0.67,0.00,0,4.00,1,481.49,3,0,4,org.apache.lucene.analysis.BaseTokenStreamTestCase,0.00,3,2,4,0,3,4,0,6,114,1
"org.apache.lucene.analysis.pt.TestPortugueseLightStemFilter",5,0.00,1.00,27,0.31,5213.56,5,0,10,8,7,161.04,12,44,0,3,121.16,0.00,0.67,0.00,0,5.00,1,937.41,4,0,7,org.apache.lucene.analysis.BaseTokenStreamTestCase,0.00,3,2,5,0,3,5,0,5,205,1
"org.apache.lucene.analysis.pt.TestPortugueseLightStemFilter$Analyzer",1,0.00,1.00,5,0.06,1073.53,1,0,10,5,5,121.06,0,8,0,1,121.06,0.00,0.00,0.00,0,1.00,1,188.94,0,1,5,java.lang.Object,0.00,4,0,1,0,4,0,0,0,44,0
"org.apache.lucene.analysis.pt.TestPortugueseLightStemFilter$Analyzer_0",1,0.00,1.00,4,0.05,753.46,1,0,10,4,3,125.89,0,6,0,1,125.89,0.00,0.00,0.00,0,1.00,1,135.44,0,1,3,java.lang.Object,0.00,3,0,1,0,3,0,0,0,34,0
"org.apache.lucene.analysis.pt.TestPortugueseMinimalStemFilter",4,0.00,1.00,12,0.17,2096.96,4,0,10,7,7,171.67,9,28,0,3,131.79,0.00,0.67,0.00,0,4.00,1,514.82,3,0,7,org.apache.lucene.analysis.BaseTokenStreamTestCase,0.00,3,2,4,0,3,4,0,4,114,1
"org.apache.lucene.analysis.pt.TestPortugueseMinimalStemFilter$Analyzer",1,0.00,1.00,5,0.06,1073.53,1,0,10,5,5,121.06,0,8,0,1,121.06,0.00,0.00,0.00,0,1.00,1,188.94,0,1,5,java.lang.Object,0.00,4,0,1,0,4,0,0,0,44,0
"org.apache.lucene.analysis.pt.TestPortugueseMinimalStemFilter$Analyzer_0",1,0.00,1.00,4,0.05,753.46,1,0,10,4,3,125.89,0,6,0,1,125.89,0.00,0.00,0.00,0,1.00,1,135.44,0,1,3,java.lang.Object,0.00,3,0,1,0,3,0,0,0,34,0
"org.apache.lucene.analysis.pt.TestPortugueseStemFilter",4,0.00,1.00,12,0.17,2096.96,4,0,10,7,7,171.67,9,28,0,3,131.79,0.00,0.67,0.00,0,4.00,1,514.82,3,0,7,org.apache.lucene.analysis.BaseTokenStreamTestCase,0.00,3,2,4,0,3,4,0,4,114,1
"org.apache.lucene.analysis.pt.TestPortugueseStemFilter$Analyzer",1,0.00,1.00,5,0.06,1073.53,1,0,10,5,5,121.06,0,8,0,1,121.06,0.00,0.00,0.00,0,1.00,1,188.94,0,1,5,java.lang.Object,0.00,4,0,1,0,4,0,0,0,44,0
"org.apache.lucene.analysis.pt.TestPortugueseStemFilter$Analyzer_0",1,0.00,1.00,4,0.05,753.46,1,0,10,4,3,125.89,0,6,0,1,125.89,0.00,0.00,0.00,0,1.00,1,135.44,0,1,3,java.lang.Object,0.00,3,0,1,0,3,0,0,0,34,0
"org.apache.lucene.search.suggest.jaspell.JaspellLookup",8,0.18,3.62,106,1.53,77045.87,15,7,15,44,11,97.78,4,134,3,2,97.78,0.00,0.50,0.30,2,0.00,8,4577.49,0,2,8,org.apache.lucene.search.suggest.Lookup,0.00,36,1,29,0,36,6,0,4,855,1
"org.apache.lucene.search.suggest.jaspell.JaspellTernarySearchTrie",30,0.18,3.30,268,3.77,390658.03,33,3,8,64,1,67.07,366,397,1,1,104.64,0.00,0.00,0.16,13,234.00,15,11300.90,0,15,0,java.lang.Object,0.00,34,0,99,0,34,15,0,38,2177,1
"org.apache.lucene.search.suggest.jaspell.JaspellTernarySearchTrie$TSTNode",1,5.00,1.00,8,0.09,1453.23,8,7,8,1,0,74.85,12,10,0,1,112.41,0.00,0.00,0.29,0,0.00,1,280.48,0,0,0,java.lang.Object,0.00,0,0,1,0,0,1,0,5,64,2
"org.apache.lucene.analysis.de.GermanAnalyzer",5,0.25,1.60,28,0.49,11983.69,8,3,19,19,19,88.82,69,54,1,3,118.21,0.00,0.67,0.13,0,7.00,3,1466.95,0,2,18,org.apache.lucene.analysis.util.StopwordAnalyzerBase,0.00,14,2,8,0,14,3,0,10,286,2
"org.apache.lucene.analysis.de.GermanAnalyzer$DefaultSetHolder",0,0.00,0.00,7,0.11,2278.90,2,2,19,3,4,171.00,3,14,0,1,171.00,0.00,0.00,0.00,0,0.00,0,343.60,0,0,4,java.lang.Object,0.00,3,0,0,0,3,0,0,3,75,2
"org.apache.lucene.analysis.de.GermanLightStemFilter",2,0.33,2.00,14,0.16,3794.18,5,3,6,9,10,113.74,9,20,4,4,113.50,0.00,0.75,0.50,0,2.00,3,481.98,0,0,6,org.apache.lucene.analysis.TokenFilter,0.29,7,3,4,0,7,2,0,1,107,2
"org.apache.lucene.analysis.de.GermanLightStemmer",4,0.00,4.50,32,0.69,36340.93,4,0,0,4,1,85.65,56,65,1,1,105.80,0.00,0.00,0.00,1,4.00,7,2080.72,0,0,0,java.lang.Object,0.00,0,0,18,0,0,4,0,4,419,1
"org.apache.lucene.analysis.de.GermanMinimalStemFilter",2,0.33,2.00,14,0.16,3794.18,5,3,6,9,9,113.74,9,20,3,4,113.50,0.00,0.75,0.50,0,2.00,3,481.98,0,0,6,org.apache.lucene.analysis.TokenFilter,0.29,7,3,4,0,7,2,0,1,107,2
"org.apache.lucene.analysis.de.GermanMinimalStemmer",1,0.00,19.00,22,0.41,48542.86,1,0,0,1,1,46.47,56,28,1,1,83.35,0.00,0.00,0.00,0,1.00,19,1221.27,0,0,0,java.lang.Object,0.00,0,0,19,0,0,1,0,4,229,1
"org.apache.lucene.analysis.de.GermanNormalizationFilter",2,0.50,7.50,48,0.58,54026.99,6,4,5,9,8,35.68,20,66,4,4,84.15,0.00,0.75,0.50,0,2.00,14,1744.36,0,0,4,org.apache.lucene.analysis.TokenFilter,0.29,7,3,15,0,7,2,0,5,308,2
"org.apache.lucene.analysis.de.GermanStemFilter",3,0.00,2.33,18,0.21,5600.37,6,3,6,11,11,66.02,28,30,5,4,116.02,0.00,0.75,0.33,0,4.00,4,641.51,0,0,6,org.apache.lucene.analysis.TokenFilter,0.27,8,3,7,0,8,3,0,6,141,2
"org.apache.lucene.analysis.de.GermanStemmer",7,0.33,6.29,125,2.11,186671.07,9,2,0,20,1,52.26,84,172,1,1,89.83,0.00,0.00,0.21,5,18.00,14,6323.92,0,1,0,java.lang.Object,0.00,13,0,44,0,13,6,0,24,1180,1
"org.apache.lucene.analysis.de.TestGermanAnalyzer",5,0.00,1.00,23,0.28,5180.56,5,0,8,12,7,174.80,6,32,0,3,124.80,0.00,0.67,0.00,0,5.00,1,826.81,3,0,7,org.apache.lucene.analysis.BaseTokenStreamTestCase,0.00,7,2,5,0,7,5,0,4,189,1
"org.apache.lucene.analysis.de.TestGermanLightStemFilter",3,0.00,1.00,10,0.08,885.78,3,0,8,6,5,183.75,5,15,0,3,133.75,0.00,0.67,0.00,0,3.00,1,234.73,2,0,5,org.apache.lucene.analysis.BaseTokenStreamTestCase,0.00,3,2,3,0,3,3,0,3,63,1
"org.apache.lucene.analysis.de.TestGermanLightStemFilter$Analyzer",1,0.00,1.00,4,0.05,1009.20,1,0,8,4,3,124.89,0,7,0,1,124.89,0.00,0.00,0.00,0,1.00,1,159.62,0,1,3,java.lang.Object,0.00,3,0,1,0,3,0,0,0,38,0
"org.apache.lucene.analysis.de.TestGermanLightStemFilter$Analyzer_0",1,0.00,1.00,4,0.05,753.46,1,0,8,4,3,125.89,0,6,0,1,125.89,0.00,0.00,0.00,0,1.00,1,135.44,0,1,3,java.lang.Object,0.00,3,0,1,0,3,0,0,0,34,0
"org.apache.lucene.analysis.de.TestGermanMinimalStemFilter",4,0.00,1.00,19,0.16,1962.96,4,0,8,7,5,177.35,6,25,0,3,127.35,0.00,0.67,0.00,0,4.00,1,493.26,3,0,5,org.apache.lucene.analysis.BaseTokenStreamTestCase,0.00,3,2,4,0,3,4,0,4,118,1
"org.apache.lucene.analysis.de.TestGermanMinimalStemFilter$Analyzer",1,0.00,1.00,4,0.05,1009.20,1,0,8,4,3,124.89,0,7,0,1,124.89,0.00,0.00,0.00,0,1.00,1,159.62,0,1,3,java.lang.Object,0.00,3,0,1,0,3,0,0,0,38,0
"org.apache.lucene.analysis.de.TestGermanMinimalStemFilter$Analyzer_0",1,0.00,1.00,4,0.05,753.46,1,0,8,4,3,125.89,0,6,0,1,125.89,0.00,0.00,0.00,0,1.00,1,135.44,0,1,3,java.lang.Object,0.00,3,0,1,0,3,0,0,0,34,0
"org.apache.lucene.analysis.de.TestGermanNormalizationFilter",5,0.00,1.00,15,0.11,1236.38,5,0,8,7,6,174.24,13,22,0,3,134.36,0.00,0.67,0.00,0,5.00,1,341.11,3,0,6,org.apache.lucene.analysis.BaseTokenStreamTestCase,0.00,2,2,5,0,2,5,0,5,93,1
"org.apache.lucene.analysis.de.TestGermanNormalizationFilter$Analyzer",1,0.00,1.00,5,0.07,1408.25,1,0,8,4,4,120.13,0,7,0,1,120.13,0.00,0.00,0.00,0,1.00,1,198.40,0,1,4,java.lang.Object,0.00,3,0,1,0,3,0,0,0,45,0
"org.apache.lucene.analysis.de.TestGermanNormalizationFilter$Analyzer_0",1,0.00,1.00,4,0.05,753.46,1,0,8,4,3,125.89,0,6,0,1,125.89,0.00,0.00,0.00,0,1.00,1,135.44,0,1,3,java.lang.Object,0.00,3,0,1,0,3,0,0,0,34,0
"org.apache.lucene.analysis.de.TestGermanStemFilter",4,0.00,1.00,14,0.12,1425.38,4,0,9,10,5,172.99,9,20,0,3,133.11,0.00,0.67,0.00,0,4.00,1,354.69,3,0,5,org.apache.lucene.analysis.BaseTokenStreamTestCase,0.00,6,2,4,0,6,4,0,4,92,1
"org.apache.lucene.analysis.de.TestGermanStemFilter$Analyzer",1,0.00,1.00,4,0.05,839.11,1,0,9,5,4,125.52,0,8,0,1,125.52,0.00,0.00,0.00,0,1.00,1,157.34,0,1,4,java.lang.Object,0.00,4,0,1,0,4,0,0,0,38,0
"org.apache.lucene.analysis.de.TestGermanStemFilter$Analyzer_0",1,0.00,1.00,4,0.05,753.46,1,0,9,4,3,125.89,0,6,0,1,125.89,0.00,0.00,0.00,0,1.00,1,135.44,0,1,3,java.lang.Object,0.00,3,0,1,0,3,0,0,0,34,0
"org.apache.solr.search.grouping.distributed.responseprocessor.SearchGroupShardResponseProcessor",1,0.00,12.00,47,1.17,104794.99,1,0,13,36,12,36.30,6,56,1,1,68.52,0.00,0.00,0.00,0,1.00,12,3522.44,0,0,11,java.lang.Object,0.00,35,0,12,0,35,1,1,2,535,1
"org.apache.solr.search.grouping.distributed.responseprocessor.StoredFieldsShardResponseProcessor",1,0.00,4.00,15,0.28,8293.58,1,0,9,15,10,63.73,6,19,1,1,95.95,0.00,0.00,0.00,0,1.00,4,850.85,0,0,9,java.lang.Object,0.00,14,0,4,0,14,1,1,2,148,1
"org.apache.solr.search.grouping.distributed.responseprocessor.TopGroupsShardResponseProcessor",1,0.00,19.00,74,1.55,178940.68,1,0,21,44,17,16.94,7,82,1,1,59.23,0.00,0.00,0.00,0,1.00,19,4660.05,0,0,16,java.lang.Object,0.00,43,0,19,0,43,1,1,3,675,1
"org.apache.lucene.analysis.pl.PolishAnalyzer",5,0.19,1.20,24,0.30,6631.81,9,4,18,16,16,75.80,43,34,1,3,123.91,0.00,0.67,0.10,0,8.00,2,901.76,0,2,15,org.apache.lucene.analysis.util.StopwordAnalyzerBase,0.00,11,2,6,0,11,3,0,9,201,2
"org.apache.lucene.analysis.pl.PolishAnalyzer$DefaultsHolder",0,0.00,0.00,10,0.13,2596.43,2,2,18,0,6,171.00,4,17,0,1,171.00,0.00,0.00,0.00,0,0.00,0,388.81,0,0,6,java.lang.Object,0.00,0,0,0,0,0,0,0,4,83,2
"org.apache.lucene.analysis.pl.TestPolishAnalyzer",4,0.00,1.00,15,0.16,2523.29,4,0,4,7,4,181.15,7,21,0,3,131.15,0.00,0.67,0.00,0,4.00,1,486.07,3,0,4,org.apache.lucene.analysis.BaseTokenStreamTestCase,0.00,3,2,4,0,3,4,0,6,115,1
"org.apache.lucene.analysis.da.DanishAnalyzer",5,0.50,1.20,21,0.26,6053.81,7,2,17,16,15,76.12,42,31,1,3,124.22,0.00,0.67,0.10,0,8.00,2,777.74,0,2,14,org.apache.lucene.analysis.util.StopwordAnalyzerBase,0.00,11,2,6,0,11,3,0,8,177,2
"org.apache.lucene.analysis.da.DanishAnalyzer$DefaultSetHolder",0,0.00,0.00,6,0.07,1089.77,1,1,17,0,4,171.00,2,11,0,1,171.00,0.00,0.00,0.00,0,0.00,0,202.05,0,0,4,java.lang.Object,0.00,0,0,0,0,0,0,0,2,47,2
"org.apache.lucene.analysis.da.TestDanishAnalyzer",4,0.00,1.00,15,0.16,2613.59,4,0,4,7,4,181.03,7,21,0,3,131.03,0.00,0.67,0.00,0,4.00,1,476.37,3,0,4,org.apache.lucene.analysis.BaseTokenStreamTestCase,0.00,3,2,4,0,3,4,0,6,114,1
"org.apache.lucene.queryparser.ext.ExtendableQueryParser",4,0.11,1.25,18,0.26,7472.79,7,3,6,10,8,149.01,77,31,1,3,122.73,0.00,0.67,0.25,0,10.00,2,788.23,1,1,7,org.apache.lucene.queryparser.classic.QueryParser,0.00,6,2,5,0,6,3,0,5,172,1
"org.apache.lucene.queryparser.ext.ExtensionQuery",4,0.11,1.00,14,0.08,1166.53,7,3,1,4,4,89.66,46,19,3,1,133.79,0.00,0.00,0.25,0,10.00,1,254.48,0,3,1,java.lang.Object,0.00,0,0,4,0,0,1,0,6,74,1
"org.apache.lucene.queryparser.ext.ExtensionStub",1,0.00,1.00,3,0.04,713.22,1,0,4,5,8,130.26,16,7,2,2,130.73,0.00,0.50,0.00,0,1.00,1,130.55,0,1,6,org.apache.lucene.queryparser.ext.ParserExtension,0.00,4,1,1,0,4,0,0,1,33,0
"org.apache.lucene.queryparser.ext.Extensions",9,0.29,1.22,30,0.36,12585.20,12,3,4,19,6,99.00,122,43,3,1,128.39,0.00,0.00,0.07,2,23.00,3,1084.84,0,4,3,java.lang.Object,0.00,10,0,11,0,10,5,0,12,255,1
"org.apache.lucene.queryparser.ext.Extensions$Pair",1,2.00,1.00,6,0.05,829.52,3,2,4,1,0,70.88,8,8,0,1,118.99,0.00,0.00,0.00,0,1.00,1,149.41,0,0,0,java.lang.Object,0.00,0,0,1,0,0,1,0,1,41,2
"org.apache.lucene.queryparser.ext.ParserExtension",1,0.00,1.00,2,0.02,137.38,1,0,2,1,7,192.42,26,3,4,1,142.94,0.00,0.00,0.00,0,1.00,1,49.66,0,1,3,java.lang.Object,0.00,0,0,1,1,0,0,0,2,16,2
"org.apache.lucene.queryparser.ext.TestExtendableQueryParser",7,0.67,1.86,72,1.12,41668.13,8,1,11,25,14,103.83,3,91,0,3,103.83,0.00,0.67,0.43,2,10.00,3,3352.44,0,3,14,org.apache.lucene.queryparser.util.QueryParserTestBase,0.00,18,2,13,0,18,4,0,1,613,1
"org.apache.lucene.queryparser.ext.TestExtensions",6,0.20,1.17,33,0.35,6806.97,7,1,1,17,3,120.84,4,45,0,2,120.84,0.00,0.50,0.83,0,0.00,2,1047.08,1,0,3,org.apache.lucene.util.LuceneTestCase,0.00,11,1,7,0,11,6,0,2,250,1
"org.apache.lucene.queries.BooleanFilter",9,0.62,3.11,67,0.92,65861.70,10,1,13,32,12,129.40,28,94,3,2,108.78,0.00,0.50,0.44,3,13.00,15,2759.70,0,5,9,org.apache.lucene.search.Filter,0.00,23,1,28,0,23,4,1,9,535,1
"org.apache.lucene.queries.BooleanFilterTest",23,0.41,1.04,187,2.54,86020.00,25,2,21,49,20,109.17,9,215,0,2,109.17,0.00,0.50,0.11,8,74.00,2,7617.29,2,6,20,org.apache.lucene.util.LuceneTestCase,0.00,26,1,24,0,26,17,0,9,1598,1
"org.apache.lucene.queries.BooleanFilterTest$Filter",1,0.00,1.00,3,0.04,492.38,1,0,21,4,3,132.00,0,5,0,1,132.00,0.00,0.00,0.00,0,1.00,1,108.08,0,1,3,java.lang.Object,0.00,3,0,1,0,3,0,0,0,28,0
"org.apache.lucene.queries.BooleanFilterTest$Filter_0",1,0.00,1.00,3,0.02,204.75,1,0,21,1,2,135.00,0,5,0,1,135.00,0.00,0.00,0.00,0,1.00,1,65.11,0,1,2,java.lang.Object,0.00,0,0,1,0,0,0,0,0,19,0
"org.apache.lucene.queries.BooleanFilterTest$Filter_1",1,0.00,1.00,3,0.02,189.62,1,0,21,2,2,135.26,0,5,0,1,135.26,0.00,0.00,0.00,0,1.00,1,59.81,0,1,2,java.lang.Object,0.00,1,0,1,0,1,0,0,0,18,0
"org.apache.lucene.queries.BooleanFilterTest$Filter_1$DocIdSet",2,0.00,1.00,5,0.03,286.06,2,0,21,2,1,142.80,0,9,0,1,142.80,0.00,0.00,0.00,0,2.00,1,81.08,0,1,1,java.lang.Object,0.00,0,0,2,0,0,1,0,0,26,0
"org.apache.lucene.queries.BoostingQuery",5,0.42,3.40,44,0.51,21882.64,8,3,3,13,6,108.59,20,62,3,2,108.36,0.00,0.50,0.67,0,0.00,11,1528.59,1,2,3,org.apache.lucene.search.Query,0.13,8,1,17,0,8,3,0,6,334,1
"org.apache.lucene.queries.BoostingQuery$BooleanQuery",1,0.00,1.00,3,0.02,223.54,1,0,3,2,2,134.70,0,5,0,1,134.70,0.00,0.00,0.00,0,1.00,1,59.81,0,1,2,java.lang.Object,0.00,1,0,1,0,1,0,0,0,18,0
"org.apache.lucene.queries.BoostingQuery$BooleanQuery$BooleanWeight",1,0.00,1.00,6,0.05,815.36,1,0,3,1,0,119.28,4,12,0,1,119.05,0.00,0.00,0.00,0,0.00,1,153.81,0,0,0,java.lang.Object,0.00,0,0,1,0,0,1,0,4,38,0
"org.apache.lucene.queries.BoostingQueryTest",1,0.00,1.00,8,0.09,1852.95,1,0,3,5,3,111.58,0,10,0,2,111.58,0.00,0.50,0.00,0,1.00,1,283.44,0,0,3,org.apache.lucene.util.LuceneTestCase,0.00,4,1,1,0,4,1,0,0,67,1
"org.apache.lucene.queries.ChainedFilter",10,0.04,3.30,107,1.24,57991.85,18,8,10,30,10,71.57,66,141,1,2,103.79,0.00,0.50,0.16,4,30.00,14,3707.26,0,6,9,org.apache.lucene.search.Filter,0.00,20,1,33,0,20,4,0,17,754,1
"org.apache.lucene.queries.ChainedFilterTest",10,0.36,1.30,113,1.77,61950.82,18,8,20,40,18,152.23,13,128,0,2,102.23,0.00,0.50,0.45,0,2.00,3,5313.53,2,2,18,org.apache.lucene.util.LuceneTestCase,0.00,30,1,13,0,30,8,0,9,981,1
"org.apache.lucene.queries.CustomScoreProvider",5,1.00,2.60,45,0.47,30362.84,6,1,5,9,9,104.92,81,50,5,1,105.39,0.00,0.00,0.00,2,5.00,5,1395.32,0,2,4,java.lang.Object,0.00,4,0,13,0,4,3,0,7,295,1
"org.apache.lucene.queries.CustomScoreQuery",14,0.00,2.21,79,1.01,47886.96,17,3,14,33,18,117.15,63,103,6,2,116.91,3.00,0.20,0.33,3,30.00,6,3039.67,3,5,12,org.apache.lucene.search.Query,0.17,19,1,31,3,19,9,0,20,648,1
"org.apache.lucene.queries.CustomScoreQuery$CustomScorer",5,0.25,2.00,40,0.40,14014.32,10,5,14,10,2,110.00,3,48,0,3,110.00,0.00,0.67,0.40,0,0.00,3,1206.78,0,0,2,org.apache.lucene.search.Scorer,0.80,5,2,10,0,5,5,0,3,264,1
"org.apache.lucene.queries.CustomScoreQuery$CustomWeight",8,0.10,2.25,70,0.86,39158.81,11,3,14,22,8,158.07,13,81,0,2,108.07,0.00,0.50,0.42,1,14.00,3,2574.92,0,4,8,org.apache.lucene.search.Weight,0.57,14,1,18,0,14,4,0,13,510,1
"org.apache.lucene.queries.FilterClause",6,0.00,1.33,19,0.20,6008.87,8,2,2,10,4,150.12,19,32,3,1,129.51,0.00,0.00,0.50,1,2.00,3,602.76,0,3,1,java.lang.Object,0.00,4,0,8,0,4,3,0,4,150,2
"org.apache.lucene.queries.TermsFilter",4,0.33,3.50,43,0.58,27057.49,5,1,10,24,16,103.48,16,60,4,2,103.25,0.00,0.50,0.75,0,0.00,8,1745.71,0,1,12,org.apache.lucene.search.Filter,0.00,20,1,14,0,20,3,0,4,330,1
"org.apache.lucene.queries.TermsFilterTest",3,0.00,1.67,75,1.18,52868.69,3,0,13,31,12,85.30,2,77,0,2,85.30,0.00,0.50,0.00,0,3.00,2,3553.49,0,0,12,org.apache.lucene.util.LuceneTestCase,0.00,28,1,5,0,28,3,0,2,618,1
"org.apache.lucene.queries.TestCustomScoreQuery",11,0.00,1.27,136,2.43,128105.63,11,0,13,43,14,119.28,35,155,0,2,98.67,0.00,0.50,0.00,4,11.00,2,7285.91,0,1,14,org.apache.lucene.queries.function.FunctionTestSetup,0.00,32,1,14,0,32,10,0,25,1281,1
"org.apache.lucene.queries.TestCustomScoreQuery$CustomAddQuery",3,0.00,1.00,7,0.05,418.70,3,0,13,4,5,142.88,2,13,0,3,142.88,0.00,0.67,0.00,0,3.00,1,138.55,0,2,5,org.apache.lucene.queries.CustomScoreQuery,0.11,1,2,3,0,1,1,0,2,43,2
"org.apache.lucene.queries.TestCustomScoreQuery$CustomAddQuery$CustomScoreProvider",2,0.00,2.00,10,0.13,5552.17,2,0,13,5,1,117.65,0,15,0,1,117.65,0.00,0.00,0.00,0,2.00,3,393.08,0,1,1,java.lang.Object,0.00,3,0,4,0,3,1,0,0,87,0
"org.apache.lucene.queries.TestCustomScoreQuery$CustomExternalQuery",2,0.00,1.00,6,0.07,1058.21,2,0,13,5,4,131.76,0,11,0,3,131.76,0.00,0.67,0.00,0,2.00,1,198.25,0,1,4,org.apache.lucene.queries.CustomScoreQuery,0.00,3,2,2,0,3,1,0,0,49,2
"org.apache.lucene.queries.TestCustomScoreQuery$CustomExternalQuery$CustomScoreProvider_1",1,0.00,1.00,4,0.05,1050.87,1,0,13,4,0,124.75,0,6,0,1,124.75,0.00,0.00,0.00,0,1.00,1,160.89,0,0,0,java.lang.Object,0.00,3,0,1,0,3,1,0,0,38,0
"org.apache.lucene.queries.TestCustomScoreQuery$CustomMulAddQuery",3,0.00,1.00,7,0.05,460.08,3,0,13,4,5,142.56,2,13,0,3,142.56,0.00,0.67,0.00,0,3.00,1,150.34,0,2,5,org.apache.lucene.queries.CustomScoreQuery,0.11,1,2,3,0,1,1,0,2,46,2
"org.apache.lucene.queries.TestCustomScoreQuery$CustomMulAddQuery$CustomScoreProvider_0",2,0.00,3.00,20,0.27,15322.66,2,0,13,7,1,152.86,3,28,0,1,102.86,0.00,0.00,0.00,0,2.00,3,807.96,0,1,1,java.lang.Object,0.00,5,0,6,0,5,1,0,3,170,0
"org.apache.solr.search.similarities.BM25SimilarityFactory",2,1.33,1.00,13,0.13,1945.32,5,3,4,6,4,68.45,18,18,0,2,118.44,0.00,0.50,1.00,0,0.00,1,383.28,1,1,4,org.apache.solr.schema.SimilarityFactory,0.40,4,1,2,0,4,1,0,1,90,1
"org.apache.solr.search.similarities.BaseSimilarityTestCase",1,0.00,2.00,9,0.10,2886.61,1,0,6,7,13,158.00,1,12,7,3,108.00,3.50,0.20,0.00,0,0.00,2,314.45,0,1,6,org.apache.solr.SolrTestCaseJ4,0.00,6,2,2,7,6,0,0,1,69,2
"org.apache.solr.search.similarities.CustomSimilarityFactory",1,0.00,1.00,3,0.03,352.50,1,0,2,3,3,133.14,0,6,0,2,133.14,0.00,0.50,0.00,0,0.00,1,85.83,0,1,3,org.apache.solr.schema.SimilarityFactory,0.50,2,1,1,0,2,0,0,0,24,1
"org.apache.solr.search.similarities.DFRSimilarityFactory",5,0.19,5.40,60,0.86,41703.19,9,4,22,28,21,70.10,68,82,1,2,99.48,0.00,0.50,0.40,0,7.00,13,2568.49,1,4,20,org.apache.solr.schema.SimilarityFactory,0.25,23,1,27,0,23,1,0,2,511,1
"org.apache.solr.search.similarities.DefaultSimilarityFactory",2,0.00,1.00,9,0.08,1289.19,3,1,5,5,6,84.13,14,14,1,2,126.42,0.00,0.50,1.00,0,0.00,1,234.73,1,1,5,org.apache.solr.schema.SimilarityFactory,0.40,3,1,2,0,3,1,0,1,60,1
"org.apache.solr.search.similarities.IBSimilarityFactory",4,0.33,2.00,29,0.32,6006.54,8,4,12,15,12,64.30,36,39,0,2,114.30,0.00,0.50,0.50,0,4.00,3,967.83,1,3,12,org.apache.solr.schema.SimilarityFactory,0.29,11,1,8,0,11,1,0,2,213,1
"org.apache.solr.search.similarities.LMDirichletSimilarityFactory",2,1.00,1.50,11,0.12,2356.64,4,2,4,6,4,72.54,16,17,0,2,120.65,0.00,0.50,1.00,0,0.00,2,349.32,1,1,4,org.apache.solr.schema.SimilarityFactory,0.40,4,1,3,0,4,1,0,1,83,1
"org.apache.solr.search.similarities.LMJelinekMercerSimilarityFactory",2,1.00,1.00,11,0.10,1571.20,4,2,4,6,4,74.02,16,16,0,2,122.13,0.00,0.50,1.00,0,0.00,1,308.88,1,1,4,org.apache.solr.schema.SimilarityFactory,0.40,4,1,2,0,4,1,0,1,75,1
"org.apache.solr.search.similarities.MockConfigurableSimilarity",2,1.00,1.00,6,0.03,349.01,3,1,1,2,3,135.55,0,9,2,4,135.55,0.00,0.75,0.50,0,2.00,1,100.40,0,1,1,org.apache.lucene.search.similarities.DefaultSimilarity,0.00,0,3,2,0,0,1,0,0,31,1
"org.apache.solr.search.similarities.SchemaSimilarityFactory",2,0.00,1.00,8,0.07,1147.34,4,2,7,4,7,166.70,5,13,0,2,126.82,0.00,0.50,0.50,0,0.00,1,212.05,0,1,7,org.apache.solr.schema.SimilarityFactory,0.40,2,1,2,0,2,1,1,1,54,1
"org.apache.solr.search.similarities.SchemaSimilarityFactory$PerFieldSimilarityWrapper",1,0.00,3.00,8,0.08,2442.13,1,0,7,3,2,110.38,0,11,0,1,110.38,0.00,0.00,0.00,0,0.00,3,228.92,0,1,2,java.lang.Object,0.00,2,0,3,0,2,0,0,0,51,0
"org.apache.solr.search.similarities.TestBM25SimilarityFactory",3,0.00,1.00,11,0.13,1938.64,3,0,3,8,3,181.07,5,16,0,4,131.07,0.00,0.75,0.00,0,3.00,1,375.32,2,0,3,org.apache.solr.search.similarities.BaseSimilarityTestCase,0.00,5,3,3,0,5,3,0,3,90,1
"org.apache.solr.search.similarities.TestDFRSimilarityFactory",4,0.00,1.00,28,0.42,9157.65,4,0,9,12,9,163.02,6,34,0,4,113.02,0.00,0.75,0.00,0,4.00,1,1266.22,2,0,9,org.apache.solr.search.similarities.BaseSimilarityTestCase,0.00,8,3,4,0,8,4,0,4,270,1
"org.apache.solr.search.similarities.TestDefaultSimilarityFactory",2,0.00,1.00,5,0.05,534.50,2,0,2,4,2,180.54,4,9,0,4,140.66,0.00,0.75,0.00,0,2.00,1,150.66,1,0,2,org.apache.solr.search.similarities.BaseSimilarityTestCase,0.00,2,3,2,0,2,2,0,2,41,1
"org.apache.solr.search.similarities.TestIBSimilarityFactory",3,0.00,1.00,19,0.28,5863.48,3,0,9,10,9,166.06,5,24,0,4,116.06,0.00,0.75,0.00,0,3.00,1,833.86,2,0,9,org.apache.solr.search.similarities.BaseSimilarityTestCase,0.00,7,3,3,0,7,3,0,3,181,1
"org.apache.solr.search.similarities.TestLMDirichletSimilarityFactory",3,0.00,1.00,10,0.11,1553.80,3,0,3,7,3,181.83,5,15,0,4,131.83,0.00,0.75,0.00,0,3.00,1,329.04,2,0,3,org.apache.solr.search.similarities.BaseSimilarityTestCase,0.00,4,3,3,0,4,3,0,3,81,1
"org.apache.solr.search.similarities.TestLMJelinekMercerSimilarityFactory",3,0.00,1.00,10,0.11,1553.80,3,0,3,7,3,181.83,5,15,0,4,131.83,0.00,0.75,0.00,0,3.00,1,329.04,2,0,3,org.apache.solr.search.similarities.BaseSimilarityTestCase,0.00,4,3,3,0,4,3,0,3,81,1
"org.apache.solr.search.similarities.TestPerFieldSimilarity",8,0.00,1.00,24,0.28,3747.21,8,0,4,12,5,182.17,10,34,0,4,132.17,0.00,0.75,0.00,0,8.00,1,831.83,2,0,5,org.apache.solr.search.similarities.BaseSimilarityTestCase,0.00,4,3,8,0,4,8,0,8,203,1
"org.apache.lucene.codecs.simpletext.SimpleTextCodec",9,0.02,1.00,27,0.25,3464.70,17,8,9,17,17,132.84,8,45,0,2,132.84,0.00,0.50,0.11,0,65.00,1,761.23,0,8,17,org.apache.lucene.codecs.Codec,0.64,8,1,9,0,8,1,0,3,183,2
"org.apache.lucene.codecs.simpletext.SimpleTextDocValuesConsumer",8,0.17,4.50,163,2.57,216710.41,26,18,13,47,13,87.22,3,235,1,2,87.22,0.00,0.50,0.20,2,6.00,14,7717.41,0,2,12,org.apache.lucene.codecs.DocValuesConsumer,0.29,39,1,36,0,39,6,0,1,1278,1
"org.apache.lucene.codecs.simpletext.SimpleTextDocValuesFormat",4,0.33,1.00,10,0.13,2139.54,5,1,9,8,10,138.29,3,19,2,2,138.29,0.00,0.50,0.75,0,0.00,1,394.37,0,3,9,org.apache.lucene.codecs.DocValuesFormat,0.00,4,1,4,0,4,1,0,1,98,1
"org.apache.lucene.codecs.simpletext.SimpleTextFieldInfosFormat",3,0.25,1.00,9,0.10,1634.12,5,2,6,6,7,171.54,6,16,1,2,131.66,0.00,0.50,0.33,0,5.00,1,301.71,0,2,6,org.apache.lucene.codecs.FieldInfosFormat,0.67,3,1,3,0,3,1,0,1,76,1
"org.apache.lucene.codecs.simpletext.SimpleTextFieldInfosReader",4,0.00,1.75,63,1.22,144552.14,4,0,17,23,15,141.11,6,72,1,2,91.11,0.00,0.50,0.00,2,4.00,3,3648.62,0,3,14,org.apache.lucene.codecs.FieldInfosReader,0.00,19,1,7,0,19,1,0,1,582,1
"org.apache.lucene.codecs.simpletext.SimpleTextFieldInfosWriter",2,0.69,2.00,55,1.00,73971.29,15,13,11,16,11,102.09,7,61,1,2,81.48,0.00,0.50,0.42,0,2.00,2,3003.53,0,1,10,org.apache.lucene.codecs.FieldInfosWriter,0.00,14,1,4,0,14,1,0,2,514,1
"org.apache.lucene.codecs.simpletext.SimpleTextFieldsReader",5,0.02,1.60,39,0.54,19082.02,17,12,28,15,30,111.16,0,51,6,3,111.16,0.00,0.67,0.07,1,10.00,4,1621.77,0,2,25,org.apache.lucene.codecs.FieldsProducer,0.90,10,2,8,0,10,3,0,0,323,0
"org.apache.lucene.codecs.simpletext.SimpleTextFieldsReader$SimpleTextDocsAndPositionsEnum",12,0.10,2.17,107,1.61,113296.79,27,15,28,26,10,105.83,8,139,0,4,105.83,0.00,0.75,0.16,0,72.00,10,4818.40,0,2,10,org.apache.lucene.index.DocsAndPositionsEnum,1.64,14,3,26,0,14,10,0,8,889,1
"org.apache.lucene.codecs.simpletext.SimpleTextFieldsReader$SimpleTextDocsEnum",7,0.15,2.86,61,0.86,59172.40,15,8,28,18,10,106.15,5,80,0,3,106.15,0.00,0.67,0.25,0,9.00,13,2588.80,0,1,10,org.apache.lucene.index.DocsEnum,1.00,11,2,20,0,11,6,0,5,483,1
"org.apache.lucene.codecs.simpletext.SimpleTextFieldsReader$SimpleTextFieldsEnum",3,0.17,2.00,16,0.21,5351.22,6,3,28,10,7,119.16,0,25,0,2,119.16,0.00,0.50,0.44,0,1.00,4,615.23,0,2,7,org.apache.lucene.index.FieldsEnum,0.67,7,1,6,0,7,1,0,0,136,1
"org.apache.lucene.codecs.simpletext.SimpleTextFieldsReader$SimpleTextTerms",8,0.13,2.25,74,1.35,104175.11,17,9,28,34,16,102.82,7,100,0,2,102.82,0.00,0.50,0.22,1,18.00,9,4042.33,0,2,16,org.apache.lucene.index.Terms,0.67,26,1,18,0,26,6,0,2,684,1
"org.apache.lucene.codecs.simpletext.SimpleTextFieldsReader$SimpleTextTermsEnum",12,0.15,1.83,79,1.21,50582.10,18,6,28,27,9,113.29,9,113,0,2,113.29,0.00,0.50,0.31,0,2.00,4,3633.66,0,6,9,org.apache.lucene.index.TermsEnum,0.40,15,1,22,0,15,6,0,9,722,1
"org.apache.lucene.codecs.simpletext.SimpleTextFieldsReader$TermData",1,2.00,1.00,6,0.04,510.61,3,2,28,1,0,120.65,0,8,0,1,120.65,0.00,0.00,0.00,0,1.00,1,118.21,0,0,0,java.lang.Object,0.00,0,0,1,0,0,1,0,0,34,1
"org.apache.lucene.codecs.simpletext.SimpleTextFieldsWriter",6,0.04,1.00,33,0.42,8719.93,17,11,11,13,11,120.02,0,43,2,2,120.02,0.00,0.50,0.12,2,0.00,1,1274.29,0,1,10,org.apache.lucene.codecs.FieldsConsumer,0.22,7,1,6,0,7,5,0,0,272,0
"org.apache.lucene.codecs.simpletext.SimpleTextFieldsWriter$SimpleTextPostingsWriter",5,0.25,2.00,50,0.50,18073.35,11,6,11,9,3,105.52,4,65,0,2,105.52,0.00,0.50,0.37,0,1.00,4,1499.49,0,1,3,org.apache.lucene.codecs.PostingsConsumer,0.44,4,1,10,0,4,4,0,4,308,1
"org.apache.lucene.codecs.simpletext.SimpleTextFieldsWriter$SimpleTextTermsWriter",5,0.75,1.00,10,0.11,1401.10,6,1,11,8,5,140.50,0,20,0,2,140.50,0.00,0.50,0.40,0,7.00,1,338.28,0,2,5,org.apache.lucene.codecs.TermsConsumer,0.40,3,1,5,0,3,3,0,0,91,1
"org.apache.lucene.codecs.simpletext.SimpleTextLiveDocsFormat",6,0.10,1.83,69,1.07,43878.65,10,4,18,29,17,151.59,8,87,1,2,101.59,0.00,0.50,0.33,1,6.00,3,3208.76,0,3,16,org.apache.lucene.codecs.LiveDocsFormat,0.18,23,1,11,0,23,3,0,3,579,1
"org.apache.lucene.codecs.simpletext.SimpleTextLiveDocsFormat$SimpleTextBits",3,0.25,1.00,10,0.07,940.63,5,2,18,4,1,133.54,0,16,0,1,133.54,0.00,0.00,0.33,0,5.00,1,222.54,0,0,1,java.lang.Object,0.00,1,0,3,0,1,3,1,0,63,1
"org.apache.lucene.codecs.simpletext.SimpleTextLiveDocsFormat$SimpleTextMutableBits",3,0.00,1.00,8,0.07,656.10,3,0,18,6,1,141.35,0,12,0,2,141.35,0.00,0.50,0.00,0,3.00,1,196.41,0,0,1,org.apache.lucene.codecs.simpletext.SimpleTextBits,0.00,3,1,3,0,3,3,1,0,57,1
"org.apache.lucene.codecs.simpletext.SimpleTextNormsFormat",3,0.50,1.00,10,0.13,2152.32,4,1,18,7,14,170.60,7,20,1,2,130.71,0.00,0.50,0.67,0,1.00,1,394.71,0,2,13,org.apache.lucene.codecs.NormsFormat,0.00,4,1,3,0,4,1,0,1,95,1
"org.apache.lucene.codecs.simpletext.SimpleTextNormsFormat$SimpleTextNormsPerDocConsumer",7,0.00,1.29,21,0.30,6185.70,7,0,18,17,9,129.94,0,42,0,3,129.94,0.00,0.67,0.00,1,17.00,3,897.77,1,2,9,org.apache.lucene.codecs.simpletext.SimpleTextPerDocConsumer,0.15,10,2,9,0,10,5,0,0,205,2
"org.apache.lucene.codecs.simpletext.SimpleTextNormsFormat$SimpleTextNormsPerDocProducer",4,0.00,1.00,9,0.09,1268.58,4,0,18,7,4,140.07,0,19,0,4,140.07,0.00,0.75,0.00,0,4.00,1,283.11,0,1,4,org.apache.lucene.codecs.simpletext.SimpleTextPerDocProducer,0.00,3,3,4,0,3,3,0,0,76,2
"org.apache.lucene.codecs.simpletext.SimpleTextPerDocConsumer",7,0.25,1.43,26,0.42,12200.42,9,2,13,18,12,127.60,4,48,2,2,127.60,1.00,0.33,0.29,2,13.00,4,1245.92,0,2,11,org.apache.lucene.codecs.PerDocConsumer,0.15,11,1,10,1,11,5,0,2,269,0
"org.apache.lucene.codecs.simpletext.SimpleTextPerDocProducer",5,0.08,1.40,23,0.35,8289.88,8,3,27,9,14,173.11,7,37,2,3,123.11,0.50,0.50,0.27,0,10.00,2,1064.96,1,3,12,org.apache.lucene.codecs.PerDocProducerBase,0.18,4,2,7,1,4,2,0,2,229,1
"org.apache.lucene.codecs.simpletext.SimpleTextPerDocProducer$BytesSource",8,0.29,1.62,42,0.40,9075.75,13,5,27,12,2,120.76,0,62,0,2,120.76,0.00,0.50,0.45,0,0.00,3,1199.52,0,4,2,org.apache.lucene.index.SortedSource,0.00,4,1,13,0,4,4,0,0,276,3
"org.apache.lucene.codecs.simpletext.SimpleTextPerDocProducer$SimpleTextDocValues",8,0.03,1.62,69,0.89,34971.40,13,5,27,24,9,108.53,0,106,0,2,108.53,0.00,0.50,0.22,0,18.00,4,2655.01,2,4,9,org.apache.lucene.index.DocValues,0.59,16,1,13,0,16,4,0,0,508,2
"org.apache.lucene.codecs.simpletext.SimpleTextPerDocProducer$ValueReader",3,0.80,7.67,77,1.13,62588.69,13,10,27,17,3,84.37,0,115,0,1,84.37,0.00,0.00,0.63,0,0.00,11,3402.26,0,1,3,java.lang.Object,0.00,14,0,23,0,14,2,0,0,586,3
"org.apache.lucene.codecs.simpletext.SimpleTextPerDocProducer$VarIntsArraySource",3,1.00,1.00,10,0.09,1344.15,4,1,27,4,2,132.32,0,16,0,2,132.32,0.00,0.50,0.33,0,4.00,1,274.04,0,1,2,org.apache.lucene.index.Source,0.00,1,1,3,0,1,2,0,0,72,2
"org.apache.lucene.codecs.simpletext.SimpleTextPostingsFormat",5,1.00,1.00,12,0.14,2178.93,6,1,9,9,14,188.99,9,21,7,2,138.99,0.00,0.50,0.20,1,8.00,1,413.29,0,3,9,org.apache.lucene.codecs.PostingsFormat,0.00,4,1,5,0,4,2,0,2,106,1
"org.apache.lucene.codecs.simpletext.SimpleTextSegmentInfosFormat",2,0.00,1.00,7,0.06,816.15,4,2,3,4,6,153.26,6,12,1,2,132.64,0.00,0.50,0.50,0,2.00,1,181.50,0,2,5,org.apache.lucene.codecs.SegmentInfosFormat,1.00,2,1,2,0,2,0,0,1,48,1
"org.apache.lucene.codecs.simpletext.SimpleTextSegmentInfosReader",4,0.00,3.00,116,2.02,214410.88,4,0,16,20,14,128.96,6,118,1,2,78.96,0.00,0.50,0.00,3,4.00,4,6045.35,0,2,13,org.apache.lucene.codecs.SegmentInfosReader,0.00,16,1,12,0,16,2,0,1,986,1
"org.apache.lucene.codecs.simpletext.SimpleTextSegmentInfosWriter",4,0.28,5.25,145,2.72,293238.69,28,24,13,45,12,74.49,16,155,1,2,74.25,0.00,0.50,0.25,1,8.00,13,8155.70,0,1,11,org.apache.lucene.codecs.SegmentInfosWriter,0.00,41,1,21,0,41,3,0,11,1303,1
"org.apache.lucene.codecs.simpletext.SimpleTextStoredFieldsFormat",3,0.00,1.00,7,0.11,1944.48,3,0,9,6,10,177.51,6,14,1,2,137.63,0.00,0.50,0.00,0,3.00,1,336.13,0,2,9,org.apache.lucene.codecs.StoredFieldsFormat,0.00,3,1,3,0,3,1,0,1,81,1
"org.apache.lucene.codecs.simpletext.SimpleTextStoredFieldsReader",11,0.16,2.82,103,1.65,93807.92,16,5,21,46,21,154.21,12,129,2,2,104.21,0.00,0.50,0.35,5,0.00,11,4959.03,0,1,19,org.apache.lucene.codecs.StoredFieldsReader,0.15,35,1,31,0,35,10,0,7,912,1
"org.apache.lucene.codecs.simpletext.SimpleTextStoredFieldsWriter",9,0.11,2.11,108,1.32,59248.03,28,19,10,32,12,100.50,6,134,2,2,100.50,0.00,0.50,0.15,4,4.00,8,3966.04,0,0,10,org.apache.lucene.codecs.StoredFieldsWriter,0.40,23,1,19,0,23,9,0,1,735,1
"org.apache.lucene.codecs.simpletext.SimpleTextTermVectorsFormat",3,0.00,1.00,7,0.11,1885.01,3,0,9,6,10,177.62,6,14,1,2,137.74,0.00,0.50,0.00,0,3.00,1,331.74,0,2,9,org.apache.lucene.codecs.TermVectorsFormat,0.00,3,1,3,0,3,1,0,1,80,1
"org.apache.lucene.codecs.simpletext.SimpleTextTermVectorsReader",10,0.14,2.50,117,1.62,139972.79,14,4,29,41,24,149.29,16,140,3,2,99.29,0.00,0.50,0.38,5,0.00,11,4854.88,0,3,21,org.apache.lucene.codecs.TermVectorsReader,0.33,31,1,25,0,31,7,0,11,863,1
"org.apache.lucene.codecs.simpletext.SimpleTextTermVectorsReader$SimpleTVDocsAndPositionsEnum",10,0.11,1.40,50,0.46,12949.83,17,7,29,11,3,120.34,0,75,0,4,120.34,0.00,0.75,0.24,1,22.00,2,1386.89,0,1,3,org.apache.lucene.index.DocsAndPositionsEnum,1.80,1,3,14,0,1,9,0,0,321,2
"org.apache.lucene.codecs.simpletext.SimpleTextTermVectorsReader$SimpleTVDocsEnum",5,0.19,1.40,26,0.23,4979.81,9,4,29,6,2,121.24,0,38,0,3,121.24,0.00,0.67,0.40,1,0.00,2,689.19,0,0,2,org.apache.lucene.index.DocsEnum,1.20,1,2,7,0,1,5,0,0,163,2
"org.apache.lucene.codecs.simpletext.SimpleTextTermVectorsReader$SimpleTVFields",4,0.67,1.00,10,0.10,1431.15,5,1,29,7,3,139.66,0,18,0,2,139.66,0.00,0.50,0.50,0,4.00,1,305.77,0,2,3,org.apache.lucene.index.Fields,0.50,3,1,4,0,3,2,0,0,80,1
"org.apache.lucene.codecs.simpletext.SimpleTextTermVectorsReader$SimpleTVFields$FieldsEnum",2,0.50,1.50,11,0.13,2757.96,4,2,29,7,1,120.11,0,16,0,1,120.11,0.00,0.00,0.75,0,0.00,2,387.60,0,2,1,java.lang.Object,0.00,5,0,3,0,5,0,0,0,91,0
"org.apache.lucene.codecs.simpletext.SimpleTextTermVectorsReader$SimpleTVPostings",0,0.00,0.00,5,0.03,451.71,4,4,29,0,0,171.00,0,6,0,1,171.00,0.00,0.00,0.00,0,0.00,0,100.38,0,0,0,java.lang.Object,0.00,0,0,0,0,0,0,0,0,28,2
"org.apache.lucene.codecs.simpletext.SimpleTextTermVectorsReader$SimpleTVTerms",7,0.50,1.00,16,0.16,2325.72,8,1,29,11,3,139.91,1,30,0,2,139.91,0.00,0.50,0.57,0,3.00,1,475.68,0,2,3,org.apache.lucene.index.Terms,0.71,4,1,7,0,4,5,0,1,125,2
"org.apache.lucene.codecs.simpletext.SimpleTextTermVectorsReader$SimpleTVTermsEnum",11,0.10,1.55,44,0.59,16614.70,14,3,29,26,6,123.41,2,70,0,2,123.41,0.00,0.50,0.24,1,21.00,3,1758.39,0,6,6,org.apache.lucene.index.TermsEnum,0.42,15,1,17,0,15,5,0,2,390,2
"org.apache.lucene.codecs.simpletext.SimpleTextTermVectorsWriter",12,0.07,1.42,98,1.14,27834.04,33,21,10,24,10,110.73,6,128,1,2,110.73,0.00,0.50,0.11,4,54.00,3,3415.86,0,1,9,org.apache.lucene.codecs.TermVectorsWriter,0.45,12,1,17,0,12,11,0,1,691,1
"org.apache.lucene.codecs.simpletext.SimpleTextUtil",4,0.17,2.50,32,0.37,14220.33,6,2,5,9,20,109.14,0,40,16,1,109.14,0.00,0.00,0.62,1,0.00,5,1111.41,0,0,4,java.lang.Object,0.00,5,0,10,0,5,4,0,0,230,0
"org.apache.lucene.analysis.cz.CzechAnalyzer",5,0.50,1.40,22,0.28,6548.78,7,2,14,16,15,86.35,61,32,2,3,123.92,0.00,0.67,0.10,0,8.00,3,839.35,0,2,13,org.apache.lucene.analysis.util.StopwordAnalyzerBase,0.00,11,2,7,0,11,3,0,7,187,2
"org.apache.lucene.analysis.cz.CzechAnalyzer$DefaultSetHolder",0,0.00,0.00,6,0.07,1134.43,1,1,14,0,4,171.00,2,11,0,1,171.00,0.00,0.00,0.00,0,0.00,0,211.96,0,0,4,java.lang.Object,0.00,0,0,0,0,0,0,0,2,49,2
"org.apache.lucene.analysis.cz.CzechStemFilter",2,0.33,2.00,14,0.16,3794.18,5,3,6,9,11,84.12,27,20,5,4,113.50,0.00,0.75,0.50,0,2.00,3,481.98,0,0,6,org.apache.lucene.analysis.TokenFilter,0.29,7,3,4,0,7,2,0,2,107,2
"org.apache.lucene.analysis.cz.CzechStemmer",4,0.00,4.25,40,1.16,77030.82,4,0,1,5,1,67.40,26,117,1,1,99.62,0.00,0.00,0.00,0,4.00,7,3465.35,0,0,0,java.lang.Object,0.00,1,0,17,0,1,4,0,8,608,1
"org.apache.lucene.analysis.cz.TestCzechAnalyzer",6,0.00,1.00,20,0.29,4711.27,6,0,5,9,4,170.29,14,31,0,3,130.40,0.00,0.67,0.00,0,6.00,1,870.84,3,0,4,org.apache.lucene.analysis.BaseTokenStreamTestCase,0.00,3,2,6,0,3,6,0,4,196,1
"org.apache.lucene.analysis.cz.TestCzechStemmer",9,0.00,1.00,166,2.98,128568.68,9,0,10,17,9,73.58,52,177,0,3,91.46,0.00,0.67,0.00,0,9.00,1,8939.32,3,0,9,org.apache.lucene.analysis.BaseTokenStreamTestCase,0.00,8,2,9,0,8,9,0,33,1613,1
"org.apache.lucene.analysis.cz.TestCzechStemmer$Analyzer",1,0.00,1.00,4,0.05,753.46,1,0,10,4,3,125.89,0,6,0,1,125.89,0.00,0.00,0.00,0,1.00,1,135.44,0,1,3,java.lang.Object,0.00,3,0,1,0,3,0,0,0,34,0
"org.apache.lucene.queryparser.flexible.core.nodes.AndQueryNode",3,0.00,3.00,24,0.35,14613.97,3,0,2,12,9,128.64,9,38,6,3,108.02,0.50,0.50,0.00,0,3.00,4,1051.68,2,2,3,org.apache.lucene.queryparser.flexible.core.nodes.BooleanQueryNode,0.12,9,2,9,1,9,1,0,3,210,1
"org.apache.lucene.queryparser.flexible.core.nodes.AnyQueryNode",8,2.00,2.38,52,0.66,23717.61,10,2,2,16,5,154.32,23,77,2,4,114.43,0.00,0.75,0.00,1,14.00,6,1966.54,3,4,3,org.apache.lucene.queryparser.flexible.core.nodes.AndQueryNode,0.24,8,3,19,0,8,4,0,6,405,1
"org.apache.lucene.queryparser.flexible.core.nodes.BooleanQueryNode",4,0.00,2.25,27,0.35,13482.24,4,0,2,11,19,153.89,11,40,16,2,114.01,5.00,0.14,0.00,0,4.00,4,1045.47,6,2,3,org.apache.lucene.queryparser.flexible.core.nodes.QueryNodeImpl,0.17,7,1,9,5,7,2,0,4,216,1
"org.apache.lucene.queryparser.flexible.core.nodes.BoostQueryNode",7,1.00,1.57,28,0.33,7210.60,8,1,6,15,13,124.95,32,47,6,2,124.71,0.00,0.50,0.00,1,7.00,2,986.51,5,5,7,org.apache.lucene.queryparser.flexible.core.nodes.QueryNodeImpl,0.15,8,1,11,0,8,2,0,5,230,1
"org.apache.lucene.queryparser.flexible.core.nodes.DeletedQueryNode",4,0.00,1.00,9,0.06,913.67,4,0,2,4,7,191.20,6,16,4,2,141.20,2.00,0.25,0.00,0,4.00,1,185.27,1,3,4,org.apache.lucene.queryparser.flexible.core.nodes.QueryNodeImpl,0.17,0,1,4,2,0,1,0,2,54,1
"org.apache.lucene.queryparser.flexible.core.nodes.FieldQueryNode",20,5.00,1.15,60,0.59,11352.79,25,5,2,22,34,171.37,45,92,30,2,131.48,4.00,0.17,0.00,4,20.00,2,1782.23,3,10,4,org.apache.lucene.queryparser.flexible.core.nodes.QueryNodeImpl,0.10,2,1,23,4,2,10,2,11,451,1
"org.apache.lucene.queryparser.flexible.core.nodes.FieldValuePairQueryNode",0,0.00,0.00,1,0.02,186.81,0,0,0,0,3,171.00,23,3,3,1,171.00,0.00,0.00,0.00,0,0.00,0,51.89,0,0,0,,0.00,0,0,0,0,0,0,0,2,15,1
"org.apache.lucene.queryparser.flexible.core.nodes.FieldableNode",2,0.00,1.00,3,0.01,59.70,2,0,0,2,12,168.52,35,4,12,2,159.39,0.00,0.50,0.00,0,2.00,1,41.60,0,1,0,,0.00,0,1,2,0,0,1,0,4,17,1
"org.apache.lucene.queryparser.flexible.core.nodes.FuzzyQueryNode",8,2.00,1.12,26,0.27,5010.50,10,2,1,8,12,151.77,25,41,10,3,131.15,0.00,0.67,0.00,0,8.00,2,811.68,4,3,2,org.apache.lucene.queryparser.flexible.core.nodes.FieldQueryNode,0.13,0,2,9,0,0,5,0,4,201,1
"org.apache.lucene.queryparser.flexible.core.nodes.GroupQueryNode",6,0.00,1.33,21,0.22,3694.06,6,0,6,13,15,171.06,13,33,9,2,131.17,0.00,0.50,0.00,1,6.00,2,650.07,6,2,6,org.apache.lucene.queryparser.flexible.core.nodes.QueryNodeImpl,0.16,7,1,8,0,7,4,0,3,159,1
"org.apache.lucene.queryparser.flexible.core.nodes.MatchAllDocsQueryNode",4,0.00,1.00,9,0.06,1004.43,4,0,1,4,6,190.87,6,16,4,2,140.87,0.00,0.50,0.00,0,4.00,1,183.13,1,3,2,org.apache.lucene.queryparser.flexible.core.nodes.QueryNodeImpl,0.17,0,1,4,0,0,1,0,3,54,1
"org.apache.lucene.queryparser.flexible.core.nodes.MatchNoDocsQueryNode",2,0.00,1.00,4,0.02,180.05,2,0,0,2,6,100.25,22,8,5,3,144.38,0.00,0.67,0.00,0,2.00,1,60.05,0,1,1,org.apache.lucene.queryparser.flexible.core.nodes.DeletedQueryNode,0.12,0,2,2,0,0,1,0,3,21,1
"org.apache.lucene.queryparser.flexible.core.nodes.ModifierQueryNode",0,0.00,0.00,2,0.01,75.00,0,0,6,0,17,171.00,9,2,12,2,171.00,1.00,0.33,0.00,0,0.00,0,30.00,0,0,5,org.apache.lucene.queryparser.flexible.core.nodes.QueryNodeImpl,0.00,0,1,0,1,0,0,0,1,10,1
"org.apache.lucene.queryparser.flexible.core.nodes.ModifierQueryNode$Modifier",3,1.00,3.33,53,0.72,49687.71,4,1,6,15,5,91.84,14,88,0,1,91.60,0.00,0.00,0.00,3,3.00,6,2145.65,1,3,5,java.lang.Object,0.00,12,0,10,0,12,0,0,5,363,1
"org.apache.lucene.queryparser.flexible.core.nodes.NoTokenFoundQueryNode",4,0.00,1.00,10,0.07,1017.93,4,0,1,4,5,190.83,5,18,2,3,140.83,0.00,0.67,0.00,0,4.00,1,208.75,1,2,3,org.apache.lucene.queryparser.flexible.core.nodes.DeletedQueryNode,0.22,0,2,4,0,0,2,0,2,60,1
"org.apache.lucene.queryparser.flexible.core.nodes.OpaqueQueryNode",6,2.00,1.00,20,0.20,3344.25,8,2,1,6,4,171.46,17,29,1,2,131.58,0.00,0.50,0.00,0,6.00,1,586.26,2,5,3,org.apache.lucene.queryparser.flexible.core.nodes.QueryNodeImpl,0.16,0,1,6,0,0,1,0,4,150,1
"org.apache.lucene.queryparser.flexible.core.nodes.OrQueryNode",3,0.00,3.00,26,0.38,16348.12,3,0,3,13,9,128.25,10,38,6,3,107.64,0.00,0.67,0.00,0,3.00,4,1150.85,2,2,3,org.apache.lucene.queryparser.flexible.core.nodes.BooleanQueryNode,0.12,10,2,9,0,10,1,0,3,225,1
"org.apache.lucene.queryparser.flexible.core.nodes.PathQueryNode",10,0.78,1.70,50,0.61,16769.77,11,1,5,24,4,119.65,45,68,1,2,119.41,0.00,0.50,0.30,1,22.00,3,1826.01,1,7,3,org.apache.lucene.queryparser.flexible.core.nodes.QueryNodeImpl,0.14,14,1,17,0,14,3,0,10,395,1
"org.apache.lucene.queryparser.flexible.core.nodes.PathQueryNode$QueryText",6,0.00,1.00,23,0.18,3850.24,9,3,5,6,0,151.71,23,32,0,1,131.10,0.00,0.00,0.33,0,10.00,1,544.31,1,3,0,java.lang.Object,0.00,0,0,6,0,0,3,1,6,143,2
"org.apache.lucene.queryparser.flexible.core.nodes.PhraseSlopQueryNode",9,1.00,1.56,34,0.37,7333.97,10,1,6,18,10,130.18,6,57,1,2,130.18,0.00,0.50,0.00,1,9.00,2,1107.47,5,4,9,org.apache.lucene.queryparser.flexible.core.nodes.QueryNodeImpl,0.14,9,1,14,0,9,5,1,1,265,1
"org.apache.lucene.queryparser.flexible.core.nodes.ProximityQueryNode",12,4.00,2.17,71,1.05,43551.58,16,4,5,23,8,116.95,53,107,1,3,116.72,0.00,0.67,0.00,3,22.00,6,3154.91,4,6,7,org.apache.lucene.queryparser.flexible.core.nodes.BooleanQueryNode,0.17,11,2,26,0,11,6,0,10,628,1
"org.apache.lucene.queryparser.flexible.core.nodes.ProximityQueryNode$ProximityType",2,2.00,1.00,8,0.06,597.62,4,2,5,2,0,129.05,0,11,0,1,129.05,0.00,0.00,0.00,0,2.00,1,177.62,0,0,0,java.lang.Object,0.00,0,0,2,0,0,2,0,0,49,2
"org.apache.lucene.queryparser.flexible.core.nodes.ProximityQueryNode$Type",3,0.00,1.00,11,0.05,469.26,3,0,5,3,0,135.92,0,15,0,1,135.92,0.00,0.00,0.00,0,3.00,1,152.46,0,3,0,java.lang.Object,0.00,0,0,3,0,0,0,0,0,46,1
"org.apache.lucene.queryparser.flexible.core.nodes.QueryNode",14,0.00,1.00,15,0.10,591.15,14,0,3,14,86,178.81,43,16,85,1,158.20,0.00,0.00,0.00,0,14.00,1,308.24,0,7,1,,0.00,0,0,14,0,0,7,0,16,107,1
"org.apache.lucene.queryparser.flexible.core.nodes.QueryNodeImpl",19,6.00,1.68,79,0.93,25016.86,25,6,8,39,21,163.74,42,114,17,1,123.86,0.00,0.00,0.00,6,19.00,4,2804.41,2,7,4,java.lang.Object,0.00,20,0,32,30,20,12,2,19,621,2
"org.apache.lucene.queryparser.flexible.core.nodes.QuotedFieldQueryNode",4,0.00,1.25,13,0.17,3571.81,4,0,1,4,7,150.53,15,24,5,3,129.91,0.00,0.67,0.00,0,4.00,2,520.48,2,3,2,org.apache.lucene.queryparser.flexible.core.nodes.FieldQueryNode,0.14,0,2,5,0,0,1,0,3,127,1
"org.apache.lucene.queryparser.flexible.core.nodes.RangeQueryNode",4,0.00,1.00,5,0.03,213.62,4,0,0,4,4,139.52,21,7,4,2,157.40,0.00,0.50,0.00,0,4.00,1,83.89,0,0,0,,0.00,0,1,4,0,0,4,0,2,31,1
"org.apache.lucene.queryparser.flexible.core.nodes.SlopQueryNode",9,1.00,1.56,34,0.36,7123.99,10,1,4,18,14,180.28,16,56,7,2,130.28,0.00,0.50,0.00,1,9.00,2,1093.22,5,6,7,org.apache.lucene.queryparser.flexible.core.nodes.QueryNodeImpl,0.14,9,1,14,0,9,3,1,2,263,1
"org.apache.lucene.queryparser.flexible.core.nodes.TestQueryNode",2,0.00,1.00,13,0.20,3882.09,2,0,2,15,3,166.08,2,17,0,2,116.08,0.00,0.50,0.00,0,2.00,1,596.40,0,0,3,org.apache.lucene.util.LuceneTestCase,0.00,13,1,2,0,13,2,0,2,125,1
"org.apache.lucene.queryparser.flexible.core.nodes.TextableQueryNode",2,0.00,1.00,3,0.01,38.51,2,0,0,2,4,110.89,19,4,4,1,160.88,0.00,0.00,0.00,0,2.00,1,33.51,0,1,0,,0.00,0,0,2,0,0,1,0,2,15,1
"org.apache.lucene.queryparser.flexible.core.nodes.TokenizedPhraseQueryNode",6,0.00,2.33,39,0.43,14126.29,6,0,2,17,10,165.23,6,54,6,2,115.23,0.00,0.50,0.00,0,6.00,4,1286.15,4,3,4,org.apache.lucene.queryparser.flexible.core.nodes.QueryNodeImpl,0.16,11,1,14,0,11,3,1,3,277,1
"org.apache.lucene.queryparser.flexible.core.nodes.ValueQueryNode",2,0.00,1.00,3,0.02,156.52,2,0,0,2,0,107.61,20,4,0,2,156.09,0.00,0.50,0.00,0,2.00,1,67.80,0,0,0,,0.00,0,1,2,0,0,2,0,2,23,1
"org.apache.lucene.queryparser.flexible.core.util.QueryNodeOperation",2,0.00,4.50,27,0.41,55900.21,2,0,5,9,3,61.87,13,46,0,1,94.09,0.00,0.00,0.00,0,2.00,8,1221.24,0,1,3,java.lang.Object,0.00,7,0,9,0,7,1,0,3,229,2
"org.apache.lucene.queryparser.flexible.core.util.QueryNodeOperation$ANDOperation",0,0.00,0.00,2,0.01,36.00,0,0,5,0,0,171.00,0,3,0,1,171.00,0.00,0.00,0.00,0,0.00,0,24.00,0,0,0,java.lang.Object,0.00,0,0,0,0,0,0,0,0,8,1
"org.apache.lucene.queryparser.flexible.core.util.StringUtils",1,0.00,2.00,6,0.04,902.27,1,0,0,2,7,118.07,16,9,7,1,118.54,0.00,0.00,0.00,0,1.00,2,109.28,0,1,0,java.lang.Object,0.00,1,0,2,0,1,0,0,1,30,2
"org.apache.lucene.queryparser.flexible.core.util.UnescapedCharSequence",12,0.50,1.92,73,0.86,36412.01,14,2,0,24,7,114.64,51,87,7,1,114.40,0.00,0.00,0.04,0,22.00,5,2578.70,0,5,0,java.lang.Object,0.00,12,0,23,0,12,7,1,9,568,2
"org.apache.lucene.queryparser.flexible.spans.SpanOrQueryNodeBuilder",1,0.00,2.00,10,0.13,4739.70,1,0,8,5,8,62.30,7,13,1,1,104.59,0.00,0.00,0.00,0,1.00,2,384.82,0,1,7,java.lang.Object,0.00,4,0,2,0,4,0,1,2,78,1
"org.apache.lucene.queryparser.flexible.spans.SpanTermQueryNodeBuilder",1,0.00,1.00,4,0.05,948.57,1,0,6,5,7,125.33,4,7,1,1,125.10,0.00,0.00,0.00,0,1.00,1,151.44,0,1,6,java.lang.Object,0.00,4,0,1,0,4,0,1,1,38,1
"org.apache.lucene.queryparser.flexible.spans.SpansQueryConfigHandler",2,1.00,1.00,5,0.05,788.09,3,1,3,3,6,139.57,8,9,3,3,139.33,0.00,0.67,0.00,0,2.00,1,142.17,0,1,3,org.apache.lucene.queryparser.flexible.core.config.QueryConfigHandler,0.00,1,2,2,0,1,1,0,3,38,1
"org.apache.lucene.queryparser.flexible.spans.SpansQueryTreeBuilder",2,0.00,1.00,6,0.06,908.13,2,0,7,4,11,114.41,10,11,2,2,132.28,0.00,0.50,0.00,0,2.00,1,187.45,2,1,9,org.apache.lucene.queryparser.flexible.core.builders.QueryTreeBuilder,0.00,2,1,2,0,2,1,1,1,51,1
"org.apache.lucene.queryparser.flexible.spans.SpansValidatorQueryNodeProcessor",3,0.00,1.33,9,0.13,4216.51,3,0,10,6,11,148.96,10,20,2,2,128.35,0.00,0.50,0.00,0,3.00,2,394.23,0,3,9,org.apache.lucene.queryparser.flexible.core.processors.QueryNodeProcessorImpl,0.00,3,1,4,0,3,0,0,1,92,1
"org.apache.lucene.queryparser.flexible.spans.TestSpanQueryParser",8,4.00,1.88,58,0.62,13168.26,12,4,12,25,15,65.90,70,87,0,2,114.00,0.00,0.50,0.00,1,8.00,8,1867.86,1,2,15,org.apache.lucene.util.LuceneTestCase,0.00,17,1,15,0,17,6,0,10,419,1
"org.apache.lucene.queryparser.flexible.spans.TestSpanQueryParserSimpleSample",1,0.00,3.00,16,0.23,5522.56,1,0,10,16,12,141.08,76,19,0,2,96.36,0.00,0.50,0.00,0,1.00,3,704.28,0,0,12,org.apache.lucene.util.LuceneTestCase,0.00,15,1,3,0,15,1,0,13,130,1
"org.apache.lucene.queryparser.flexible.spans.UniqueFieldAttribute",2,0.00,1.00,3,0.02,77.91,2,0,2,2,3,158.71,8,4,1,2,158.47,0.00,0.50,0.00,0,2.00,1,46.77,0,1,2,,0.00,0,1,2,0,0,1,0,1,18,1
"org.apache.lucene.queryparser.flexible.spans.UniqueFieldAttributeImpl",8,0.86,1.25,23,0.23,4685.15,9,1,2,13,4,187.92,8,43,1,2,137.93,0.00,0.50,0.25,2,16.00,2,681.70,0,2,3,org.apache.lucene.util.AttributeImpl,0.15,5,1,10,0,5,6,1,1,171,1
"org.apache.lucene.queryparser.flexible.spans.UniqueFieldQueryNodeProcessor",3,0.00,2.00,16,0.19,6265.13,3,0,6,7,8,139.24,10,29,2,2,118.62,0.00,0.50,0.00,0,3.00,4,564.92,1,3,6,org.apache.lucene.queryparser.flexible.core.processors.QueryNodeProcessorImpl,0.00,4,1,6,0,4,0,0,1,122,1
"org.apache.solr.common.ResourceLoader",3,0.00,1.00,4,0.04,294.58,3,0,3,3,56,137.44,16,6,56,1,155.31,0.00,0.00,0.00,0,3.00,1,109.74,0,3,0,,0.00,0,0,3,0,0,0,0,2,35,1
"org.apache.solr.common.SolrDocument",24,0.17,1.71,92,1.00,40778.07,25,1,9,47,73,167.53,64,142,72,1,127.64,0.00,0.00,0.83,3,0.00,7,3007.88,0,14,1,java.lang.Object,0.00,23,0,41,0,23,10,3,28,682,1
"org.apache.solr.common.SolrDocument$Map<String,Collection<Object>>",13,0.00,1.15,27,0.26,3519.59,13,0,9,15,0,140.58,3,17,0,1,140.58,0.00,0.00,0.00,0,28.00,3,785.14,0,7,0,java.lang.Object,0.00,2,0,15,0,2,6,0,3,214,0
"org.apache.solr.common.SolrDocument$Map<String,Object>",13,0.00,1.15,27,0.24,3026.80,13,0,9,15,0,141.10,3,17,0,1,141.10,0.00,0.00,0.00,0,28.00,3,706.70,0,7,0,java.lang.Object,0.00,2,0,15,0,2,6,0,3,196,0
"org.apache.solr.common.SolrDocumentList",7,0.06,1.14,18,0.17,2582.35,10,3,1,7,46,189.53,7,32,45,2,139.53,0.00,0.50,0.29,0,15.00,2,506.18,1,2,1,java.util.ArrayList,0.00,0,1,8,0,0,5,0,1,130,1
"org.apache.solr.common.SolrDocumentTest",5,0.00,4.20,140,2.08,126369.27,5,0,9,50,2,121.90,13,122,0,2,82.02,0.00,0.50,0.00,0,5.00,15,6253.21,0,0,2,org.apache.lucene.util.LuceneTestCase,0.00,45,1,21,0,45,5,0,12,1139,1
"org.apache.solr.common.SolrDocumentTest$Iterable",1,0.00,1.00,3,0.01,151.48,1,0,9,2,0,136.03,0,4,0,1,136.03,0.00,0.00,0.00,0,1.00,1,42.87,0,1,0,java.lang.Object,0.00,1,0,1,0,1,0,0,0,15,0
"org.apache.solr.common.SolrException",0,0.00,0.00,2,0.01,75.00,0,0,6,0,274,171.00,6,2,274,2,171.00,1.00,0.33,0.00,0,0.00,0,30.00,0,0,0,java.lang.RuntimeException,0.00,0,1,0,1,0,0,0,2,10,1
"org.apache.solr.common.SolrException$ErrorCode",2,0.50,7.50,75,1.06,152089.73,4,2,6,17,1,55.73,11,102,0,1,73.60,0.00,0.00,0.75,0,0.00,14,3180.88,1,1,1,java.lang.Object,0.00,15,0,15,0,15,1,0,4,520,1
"org.apache.solr.common.SolrInputDocument",27,0.08,1.22,70,0.65,10840.18,29,2,6,46,106,179.11,62,114,105,1,139.22,0.00,0.00,0.43,3,0.00,3,1960.79,0,8,1,java.lang.Object,0.00,19,0,33,1,19,19,3,18,508,1
"org.apache.solr.common.SolrInputField",13,0.03,2.23,74,0.73,34345.45,16,3,4,21,23,157.68,33,110,23,1,117.80,0.00,0.00,0.36,1,0.00,7,2202.69,0,6,0,java.lang.Object,0.00,8,0,29,0,8,7,2,17,482,1
"org.apache.solr.common.SolrInputField$Iterator<Object>",3,0.50,1.00,9,0.05,538.54,4,1,4,4,0,135.45,0,12,0,1,135.45,0.00,0.00,0.67,0,1.00,1,161.94,0,1,0,java.lang.Object,0.00,1,0,3,0,1,2,0,0,47,0
"org.apache.lucene.analysis.charfilter.BaseCharFilter",4,0.56,3.75,32,0.55,55271.93,7,3,3,6,6,86.53,21,54,3,4,104.40,1.00,0.43,0.75,0,0.00,8,1639.33,0,0,3,org.apache.lucene.analysis.charfilter.CharFilter,0.31,2,3,15,3,2,4,0,4,330,2
"org.apache.lucene.analysis.charfilter.CharFilter",8,0.14,1.00,18,0.17,2909.00,9,1,3,14,7,179.49,16,33,5,3,139.61,3.50,0.20,0.88,1,0.00,1,510.64,0,0,2,org.apache.lucene.analysis.CharStream,0.33,6,2,8,7,6,8,0,3,140,2
"org.apache.lucene.analysis.charfilter.HTMLStripCharFilterTest",35,0.00,2.14,419,7.01,300148.52,35,0,15,69,6,151.00,45,670,0,3,101.00,0.00,0.67,0.00,5,35.00,7,21022.74,3,1,6,org.apache.lucene.analysis.BaseTokenStreamTestCase,0.00,34,2,75,0,34,34,0,45,3772,1
"org.apache.lucene.analysis.charfilter.HTMLStripCharFilterTest$Analyzer",2,0.00,1.00,6,0.07,1377.59,2,0,15,6,3,130.85,0,10,0,1,130.85,0.00,0.00,0.00,0,2.00,1,222.30,0,2,3,java.lang.Object,0.00,4,0,2,0,4,0,0,0,55,0
"org.apache.lucene.analysis.charfilter.MappingCharFilter",8,0.03,3.75,79,0.96,64272.66,13,5,5,21,13,154.35,8,96,9,5,104.35,0.00,0.80,0.22,4,14.00,10,2884.18,2,0,4,org.apache.lucene.analysis.charfilter.BaseCharFilter,0.24,13,4,30,0,13,8,0,3,570,1
"org.apache.lucene.analysis.charfilter.NormalizeCharMap",1,3.00,5.00,22,0.28,15784.53,4,3,2,9,8,49.93,12,25,8,1,87.49,0.00,0.00,0.00,0,1.00,5,854.31,0,0,0,java.lang.Object,0.00,8,0,5,0,8,1,0,2,162,1
"org.apache.lucene.analysis.charfilter.SuppressWarnings",27,0.05,5.59,764,313.70,10343275.33,117,90,9,60,5,22.66,244,31276,0,5,72.65,0.00,0.80,0.06,10,338.00,95,941093.39,1,1,5,org.apache.lucene.analysis.charfilter.BaseCharFilter,0.25,33,4,151,0,33,26,0,134,65865,2
"org.apache.lucene.analysis.charfilter.SuppressWarnings$TextSegment",6,0.60,1.00,16,0.09,775.34,7,1,9,6,1,193.14,7,22,0,2,143.14,0.00,0.50,0.50,1,6.00,1,264.35,1,0,1,org.apache.lucene.analysis.util.OpenStringBuilder,0.00,0,1,6,0,0,6,0,7,80,1
"org.apache.lucene.analysis.charfilter.TestCharFilter",4,0.00,1.00,15,0.22,2814.37,4,0,5,10,3,130.78,0,20,0,2,130.78,0.00,0.50,0.00,0,4.00,1,668.10,0,0,3,org.apache.lucene.util.LuceneTestCase,0.00,6,1,4,0,6,4,0,0,152,1
"org.apache.lucene.analysis.charfilter.TestCharFilter$CharFilter1",2,0.00,1.00,5,0.03,407.16,2,0,5,2,2,141.59,0,9,0,4,141.59,0.00,0.75,0.00,0,2.00,1,99.28,0,0,2,org.apache.lucene.analysis.charfilter.CharFilter,0.36,0,3,2,0,0,2,0,0,31,1
"org.apache.lucene.analysis.charfilter.TestCharFilter$CharFilter2",2,0.00,1.00,5,0.03,407.16,2,0,5,2,2,141.59,0,9,0,4,141.59,0.00,0.75,0.00,0,2.00,1,99.28,0,0,2,org.apache.lucene.analysis.charfilter.CharFilter,0.36,0,3,2,0,0,2,0,0,31,1
"org.apache.lucene.analysis.charfilter.TestMappingCharFilter",14,0.08,1.00,107,1.35,26648.08,15,1,9,25,9,153.54,29,102,0,3,113.65,0.00,0.67,0.93,0,0.00,1,4061.82,3,0,9,org.apache.lucene.analysis.BaseTokenStreamTestCase,0.00,11,2,14,0,11,14,0,29,819,1
"org.apache.lucene.analysis.charfilter.TestMappingCharFilter$Analyzer",2,0.00,1.00,6,0.08,1393.09,2,0,9,6,4,130.81,0,10,0,1,130.81,0.00,0.00,0.00,0,2.00,1,228.16,0,2,4,java.lang.Object,0.00,4,0,2,0,4,0,0,0,56,0
"org.apache.lucene.facet.index.params.CategoryListParams",7,0.22,1.43,28,0.29,7126.62,10,3,14,17,37,76.30,75,43,27,1,124.77,0.00,0.00,0.14,1,18.00,4,870.31,0,3,12,java.lang.Object,0.00,10,0,10,0,10,4,1,15,207,1
"org.apache.lucene.facet.index.params.CategoryListParamsTest",3,0.00,1.00,23,0.33,10077.74,3,0,4,13,2,61.71,29,42,0,2,111.71,0.00,0.50,0.00,0,3.00,1,991.88,0,0,2,org.apache.lucene.util.LuceneTestCase,0.00,10,1,3,0,10,3,0,8,214,1
"org.apache.lucene.facet.index.params.DefaultFacetIndexingParams",14,0.06,2.21,74,0.73,39981.42,19,5,7,29,23,117.77,59,104,16,1,117.53,0.00,0.00,0.26,1,46.00,14,2198.44,0,5,7,java.lang.Object,0.00,15,0,31,2,15,9,1,10,483,1
"org.apache.lucene.facet.index.params.DefaultFacetIndexingParamsTest",3,0.00,2.00,50,0.95,36309.28,3,0,14,33,12,61.55,18,78,0,2,93.77,0.00,0.50,0.00,0,3.00,4,2851.05,0,0,12,org.apache.lucene.util.LuceneTestCase,0.00,30,1,6,0,30,3,0,3,492,1
"org.apache.lucene.facet.index.params.FacetIndexingParams",7,0.00,1.00,8,0.05,256.59,7,0,4,7,38,110.21,72,9,34,2,158.68,0.00,0.50,0.00,0,7.00,1,138.82,0,3,4,,0.00,0,1,7,0,0,4,0,10,51,1
"org.apache.lucene.facet.index.params.FacetParamsMissingPropertyException",1,0.00,1.00,3,0.02,172.28,1,0,1,1,1,174.89,21,5,0,3,135.59,0.00,0.67,0.00,0,1.00,1,63.94,0,0,1,org.apache.lucene.facet.FacetException,0.00,0,2,1,0,0,1,0,2,20,1
"org.apache.lucene.facet.index.params.PerDimensionIndexingParams",5,0.50,1.60,20,0.22,5473.53,6,1,4,13,7,80.37,59,31,4,2,124.50,1.00,0.33,0.60,0,2.00,3,656.26,1,0,3,org.apache.lucene.facet.index.params.DefaultFacetIndexingParams,0.11,8,1,8,1,8,5,0,9,156,1
"org.apache.lucene.facet.index.params.PerDimensionIndexingParamsTest",2,0.00,1.00,24,0.48,12892.11,2,0,9,23,7,52.64,16,46,0,2,100.75,0.00,0.50,0.00,0,2.00,1,1450.68,0,0,7,org.apache.lucene.util.LuceneTestCase,0.00,21,1,2,0,21,2,0,1,259,1
"org.apache.lucene.analysis.cn.Deprecated",5,0.00,1.20,36,0.47,9580.99,5,0,7,14,3,113.82,21,55,0,3,113.59,0.00,0.67,0.00,0,5.00,2,1416.46,3,0,3,org.apache.lucene.analysis.BaseTokenStreamTestCase,0.00,9,2,6,0,9,5,0,7,296,1
"org.apache.lucene.analysis.cn.Deprecated$JustChineseFilterAnalyzer",1,0.00,1.00,4,0.05,947.95,1,0,7,4,2,125.10,0,7,0,2,125.10,0.00,0.50,0.00,0,1.00,1,162.67,0,1,2,org.apache.lucene.analysis.core.Analyzer,0.00,3,1,1,0,3,0,0,0,39,1
"org.apache.lucene.analysis.cn.Deprecated$JustChineseTokenizerAnalyzer",1,0.00,1.00,3,0.03,425.86,1,0,7,3,0,132.50,0,6,0,2,132.50,0.00,0.50,0.00,0,1.00,1,97.55,0,1,0,org.apache.lucene.analysis.core.Analyzer,0.00,2,1,1,0,2,0,0,0,27,1
"org.apache.lucene.codecs.intblock.FixedIntBlockIndexInput",5,0.12,1.00,18,0.20,4791.80,7,2,5,10,5,179.72,9,26,1,2,129.72,0.00,0.50,0.40,1,6.00,1,608.45,0,2,4,org.apache.lucene.codecs.sep.IntIndexInput,0.75,5,1,5,0,5,3,0,2,147,2
"org.apache.lucene.codecs.intblock.FixedIntBlockIndexInput$BlockReader",1,0.00,1.00,2,0.01,51.30,1,0,5,1,0,146.30,0,3,0,1,146.30,0.00,0.00,0.00,0,1.00,1,27.65,0,0,0,,0.00,0,0,1,0,0,1,0,0,11,1
"org.apache.lucene.codecs.intblock.FixedIntBlockIndexInput$Index",5,0.62,1.40,28,0.30,10827.91,7,2,5,9,1,118.58,2,41,0,2,118.58,0.00,0.50,1.00,0,0.00,3,910.06,0,2,1,IntIndexInput.Index,0.00,4,1,7,0,4,3,0,2,207,1
"org.apache.lucene.codecs.intblock.FixedIntBlockIndexInput$Reader",5,0.45,2.00,50,0.47,14349.56,15,10,5,9,2,106.31,1,64,0,2,106.31,0.00,0.50,0.46,1,0.00,3,1416.44,0,1,2,IntIndexInput.Reader,0.00,4,1,10,0,4,4,0,1,299,2
"org.apache.lucene.codecs.intblock.FixedIntBlockIndexOutput",5,0.12,1.40,24,0.22,4682.10,9,4,3,8,4,164.95,10,35,2,2,125.06,0.00,0.50,0.35,1,6.00,2,648.16,0,1,2,org.apache.lucene.codecs.sep.IntIndexOutput,0.75,3,1,7,0,3,4,0,3,155,2
"org.apache.lucene.codecs.intblock.FixedIntBlockIndexOutput$Index",4,0.67,1.75,30,0.30,11133.18,8,4,3,6,2,112.22,2,42,0,2,112.22,0.00,0.50,0.75,0,0.00,3,905.54,0,1,2,IntIndexOutput.Index,0.00,2,1,7,0,2,3,0,2,199,1
"org.apache.lucene.codecs.intblock.TestIntBlockCodec",2,0.00,2.00,29,0.33,8597.06,2,0,4,14,5,149.48,2,28,0,2,99.48,0.00,0.50,0.00,0,2.00,3,989.89,0,0,5,org.apache.lucene.util.LuceneTestCase,0.00,12,1,4,0,12,2,0,2,193,1
"org.apache.lucene.codecs.intblock.VariableIntBlockIndexInput",5,0.12,1.00,18,0.20,4791.80,7,2,5,10,5,169.61,10,26,1,2,129.72,0.00,0.50,0.40,1,6.00,1,608.45,0,3,4,org.apache.lucene.codecs.sep.IntIndexInput,0.75,5,1,5,0,5,2,0,3,147,2
"org.apache.lucene.codecs.intblock.VariableIntBlockIndexInput$BlockReader",2,0.00,1.00,3,0.02,108.36,2,0,5,2,0,157.35,0,4,0,1,157.35,0.00,0.00,0.00,0,2.00,1,56.18,0,0,0,,0.00,0,0,2,0,0,2,0,0,20,1
"org.apache.lucene.codecs.intblock.VariableIntBlockIndexInput$Index",5,0.62,1.40,27,0.30,9444.38,7,2,5,9,1,169.05,5,40,0,2,119.05,0.00,0.50,1.00,0,0.00,3,893.25,0,2,1,IntIndexInput.Index,0.00,4,1,7,0,4,3,0,5,206,1
"org.apache.lucene.codecs.intblock.VariableIntBlockIndexInput$Reader",5,0.48,2.20,55,0.55,18865.41,15,10,5,10,2,153.81,9,70,0,2,103.81,0.00,0.50,0.48,1,0.00,4,1650.46,0,1,2,IntIndexInput.Reader,0.00,5,1,11,0,5,4,0,9,341,2
"org.apache.lucene.codecs.intblock.VariableIntBlockIndexOutput",5,0.00,1.40,25,0.24,7048.82,8,3,3,8,4,140.67,18,36,2,2,120.05,0.00,0.50,0.33,0,7.00,3,712.03,0,0,2,org.apache.lucene.codecs.sep.IntIndexOutput,0.75,3,1,7,0,3,5,0,7,163,2
"org.apache.lucene.codecs.intblock.VariableIntBlockIndexOutput$Index",3,0.88,2.00,29,0.29,11351.91,7,4,3,5,2,107.07,2,39,0,2,107.07,0.00,0.50,0.83,0,0.00,3,869.91,0,0,2,IntIndexOutput.Index,0.00,2,1,6,0,2,3,0,2,187,1
"org.apache.lucene.analysis.reverse.ReverseStringFilter",8,0.05,2.62,92,1.16,125874.06,16,8,5,17,7,54.76,89,112,4,4,98.88,0.00,0.75,0.08,2,16.00,10,3490.39,0,1,3,org.apache.lucene.analysis.TokenFilter,0.20,9,3,21,0,9,7,0,19,669,2
"org.apache.lucene.analysis.reverse.TestReverseStringFilter",9,0.00,1.00,47,0.64,14847.77,9,0,10,19,7,169.59,17,61,0,3,119.59,0.00,0.67,0.00,0,9.00,1,1916.64,3,0,7,org.apache.lucene.analysis.BaseTokenStreamTestCase,0.00,10,2,9,0,10,9,0,14,412,1
"org.apache.lucene.analysis.reverse.TestReverseStringFilter$Analyzer",1,0.00,1.00,4,0.06,1029.80,1,0,10,4,3,124.82,0,6,0,1,124.82,0.00,0.00,0.00,0,1.00,1,166.32,0,1,3,java.lang.Object,0.00,3,0,1,0,3,0,0,0,39,0
"org.apache.lucene.analysis.reverse.TestReverseStringFilter$Analyzer_0",1,0.00,1.00,4,0.05,771.22,1,0,10,4,3,125.81,0,6,0,1,125.81,0.00,0.00,0.00,0,1.00,1,141.98,0,1,3,java.lang.Object,0.00,3,0,1,0,3,0,0,0,35,0
"org.apache.lucene.benchmark.byTask.stats.Points",7,0.06,1.00,21,0.18,3194.21,10,3,4,13,4,132.50,29,29,2,1,132.26,0.00,0.00,0.29,0,21.00,1,551.54,0,1,3,java.lang.Object,0.00,6,0,7,0,6,6,0,12,141,1
"org.apache.lucene.benchmark.byTask.stats.Report",5,0.06,1.00,18,0.11,1595.94,9,4,0,5,7,101.26,31,24,7,1,133.48,0.00,0.00,0.20,0,17.00,1,319.10,0,1,0,java.lang.Object,0.00,0,0,5,0,0,4,0,6,92,1
"org.apache.lucene.benchmark.byTask.stats.TaskStats",17,0.07,1.47,85,0.79,23473.91,29,12,1,32,10,140.73,66,110,10,1,120.11,0.00,0.00,0.15,0,161.00,6,2358.68,1,3,1,java.lang.Object,0.00,15,0,25,0,15,14,1,26,526,1
"org.apache.lucene.codecs.lucene.BitVector",26,0.15,2.19,223,3.07,229661.03,36,10,9,45,10,145.94,72,290,3,1,106.06,0.00,0.00,0.25,11,0.00,6,9209.71,0,1,7,java.lang.Object,0.00,19,0,57,0,19,25,2,53,1812,1
"org.apache.lucene.codecs.lucene.Lucene40Codec",10,0.03,1.00,31,0.29,4508.42,18,8,10,19,28,182.30,13,51,11,2,132.30,5.00,0.14,0.10,0,74.00,1,866.52,0,9,17,org.apache.lucene.codecs.Codec,0.62,9,1,10,5,9,1,0,5,205,1
"org.apache.lucene.codecs.lucene.Lucene40Codec$PerFieldPostingsFormat",1,0.00,1.00,3,0.03,373.70,1,0,10,2,2,132.94,0,5,0,1,132.94,0.00,0.00,0.00,0,1.00,1,80.34,0,1,2,java.lang.Object,0.00,1,0,1,0,1,0,0,0,23,0
"org.apache.lucene.codecs.lucene.Lucene40DocValuesConsumer",5,0.19,2.00,30,0.42,14906.95,9,4,11,13,11,164.45,6,48,2,3,114.45,0.50,0.50,0.40,1,4.00,3,1255.51,0,1,9,org.apache.lucene.codecs.lucene40.values.DocValuesWriterBase,0.53,8,2,10,1,8,4,0,3,267,1
"org.apache.lucene.codecs.lucene.Lucene40DocValuesFormat",3,0.00,1.00,7,0.10,1744.31,3,0,8,6,12,138.00,0,14,4,2,138.00,0.00,0.50,0.00,0,3.00,1,288.99,0,2,8,org.apache.lucene.codecs.DocValuesFormat,0.00,3,1,3,0,3,1,0,0,72,1
"org.apache.lucene.codecs.lucene.Lucene40DocValuesProducer",4,0.00,1.75,31,0.69,35215.38,6,2,18,14,13,148.17,8,60,2,3,108.28,0.50,0.50,0.50,0,2.00,3,2084.31,1,2,11,org.apache.lucene.codecs.PerDocProducerBase,0.19,10,2,7,1,10,2,0,2,390,1
"org.apache.lucene.codecs.lucene.Lucene40FieldInfosFormat",3,0.25,1.00,9,0.10,1634.12,5,2,6,6,10,181.66,3,16,4,2,131.66,0.00,0.50,0.33,0,5.00,1,301.71,0,2,6,org.apache.lucene.codecs.FieldInfosFormat,0.67,3,1,3,0,3,1,0,1,76,1
"org.apache.lucene.codecs.lucene.Lucene40FieldInfosReader",3,1.00,3.67,68,1.33,114853.17,4,1,15,20,14,36.43,24,96,1,2,84.54,0.00,0.50,0.33,1,4.00,9,3991.30,0,2,13,org.apache.lucene.codecs.FieldInfosReader,0.00,17,1,11,0,17,1,0,7,638,1
"org.apache.lucene.codecs.lucene.Lucene40FieldInfosWriter",2,0.70,5.50,59,0.91,48831.80,12,10,10,14,9,102.12,7,82,2,2,81.51,0.00,0.50,0.45,1,2.00,9,2729.88,0,0,7,org.apache.lucene.codecs.FieldInfosWriter,0.00,12,1,11,0,12,2,0,5,456,1
"org.apache.lucene.codecs.lucene.Lucene40LiveDocsFormat",5,0.50,1.20,24,0.41,11151.86,6,1,9,16,12,122.13,1,36,4,2,122.13,0.00,0.50,0.60,0,2.00,2,1235.06,0,3,8,org.apache.lucene.codecs.LiveDocsFormat,0.20,11,1,6,0,11,2,0,1,255,1
"org.apache.lucene.codecs.lucene.Lucene40NormsFormat",3,0.50,1.00,10,0.12,2004.72,4,1,14,6,15,180.96,4,17,4,2,130.96,0.00,0.50,0.67,0,1.00,1,373.01,0,2,11,org.apache.lucene.codecs.NormsFormat,0.00,3,1,3,0,3,1,0,1,91,1
"org.apache.lucene.codecs.lucene.Lucene40NormsFormat$Lucene40NormsDocValuesConsumer",5,0.00,1.40,19,0.24,7316.86,5,0,14,12,8,128.20,0,31,0,4,128.20,0.00,0.75,0.00,0,8.00,3,720.13,0,2,8,org.apache.lucene.codecs.lucene40.Lucene40DocValuesConsumer,0.00,7,3,7,0,7,3,0,0,160,2
"org.apache.lucene.codecs.lucene.Lucene40NormsFormat$Lucene40NormsDocValuesProducer",4,0.00,1.00,9,0.08,1050.87,4,0,14,7,4,140.72,0,18,0,4,140.72,0.00,0.75,0.00,0,4.00,1,251.05,0,1,4,org.apache.lucene.codecs.lucene40.Lucene40DocValuesProducer,0.00,3,3,4,0,3,3,0,0,70,2
"org.apache.lucene.codecs.lucene.Lucene40PostingsBaseFormat",4,0.00,1.00,9,0.12,2153.50,4,0,8,7,9,188.26,6,17,1,2,138.26,0.00,0.50,0.00,0,4.00,1,352.46,0,2,8,org.apache.lucene.codecs.PostingsBaseFormat,0.00,3,1,4,0,3,2,0,2,89,2
"org.apache.lucene.codecs.lucene.Lucene40PostingsFormat",6,0.08,1.33,36,0.44,12687.79,11,5,12,14,28,165.72,11,60,18,2,115.72,0.00,0.50,0.13,0,10.00,2,1315.13,1,3,12,org.apache.lucene.codecs.PostingsFormat,0.14,8,1,8,0,8,3,0,10,284,1
"org.apache.lucene.codecs.lucene.Lucene40PostingsReader",11,0.02,3.00,107,1.54,70326.02,17,6,19,36,23,125.80,37,155,6,2,105.18,0.00,0.50,0.18,2,30.00,7,4626.64,0,4,18,org.apache.lucene.codecs.PostingsReaderBase,0.22,25,1,33,0,25,7,0,29,903,1
"org.apache.lucene.codecs.lucene.Lucene40PostingsReader$AllDocsSegmentDocsEnum",5,0.00,2.60,57,0.54,28338.70,5,0,19,6,1,102.38,2,69,0,2,102.38,0.00,0.50,0.00,0,8.00,4,1620.59,0,0,1,org.apache.lucene.codecs.lucene40.SegmentDocsEnumBase,0.00,1,1,13,0,1,5,0,2,325,2
"org.apache.lucene.codecs.lucene.Lucene40PostingsReader$LiveDocsSegmentDocsEnum",5,0.00,3.00,81,0.82,49843.76,5,0,19,7,2,94.34,2,89,0,2,94.34,0.00,0.50,0.00,0,5.00,4,2455.64,0,0,2,org.apache.lucene.codecs.lucene40.SegmentDocsEnumBase,0.00,2,1,15,0,2,5,0,2,467,2
"org.apache.lucene.codecs.lucene.Lucene40PostingsReader$SegmentDocsAndPositionsEnum",11,0.18,2.09,100,1.04,43802.57,28,17,19,23,6,146.77,29,135,0,4,106.89,0.00,0.75,0.22,1,30.00,5,3130.97,0,2,6,org.apache.lucene.index.DocsAndPositionsEnum,1.71,12,3,23,0,12,9,0,28,612,2
"org.apache.lucene.codecs.lucene.Lucene40PostingsReader$SegmentDocsEnumBase",14,0.10,2.07,130,1.40,61940.66,34,20,19,24,5,146.41,29,155,0,3,106.53,0.00,0.67,0.15,3,54.00,5,4204.96,1,1,5,org.apache.lucene.index.DocsEnum,0.47,10,2,29,0,10,13,0,29,844,2
"org.apache.lucene.codecs.lucene.Lucene40PostingsReader$SegmentFullPositionsEnum",11,0.25,3.45,159,1.79,131437.10,35,24,19,29,6,116.47,38,207,0,4,95.85,0.00,0.75,0.27,1,6.00,14,5356.66,0,2,6,org.apache.lucene.index.DocsAndPositionsEnum,1.71,18,3,38,0,18,9,0,37,984,1
"org.apache.lucene.codecs.lucene.Lucene40PostingsReader$StandardTermState",3,0.30,1.00,18,0.17,2952.12,8,5,19,5,3,158.29,7,26,0,4,118.40,0.00,0.75,0.40,0,1.00,1,502.82,2,2,3,org.apache.lucene.codecs.BlockTermState,0.80,2,3,3,0,2,1,0,7,121,3
"org.apache.lucene.codecs.lucene.Lucene40PostingsWriter",11,0.17,2.91,163,2.19,146389.08,37,26,16,42,20,77.65,56,208,7,3,95.52,0.00,0.67,0.20,0,9.00,7,6566.93,0,0,14,org.apache.lucene.codecs.PostingsWriterBase,0.71,31,2,32,0,31,11,0,41,1177,2
"org.apache.lucene.codecs.lucene.Lucene40PostingsWriter$PendingTerm",1,3.00,1.00,8,0.06,1058.02,4,3,16,1,0,113.50,0,10,0,1,113.50,0.00,0.00,0.00,0,1.00,1,188.72,0,0,0,java.lang.Object,0.00,0,0,1,0,0,1,0,0,51,2
"org.apache.lucene.codecs.lucene.Lucene40SegmentInfosFormat",2,0.00,1.00,7,0.06,816.15,4,2,3,4,9,82.64,19,12,4,2,132.64,1.00,0.33,0.50,0,2.00,1,181.50,0,2,5,org.apache.lucene.codecs.SegmentInfosFormat,1.00,2,1,2,1,2,0,0,2,48,1
"org.apache.lucene.codecs.lucene.Lucene40SegmentInfosReader",2,0.00,3.00,47,0.72,51779.00,2,0,10,14,8,85.44,8,51,1,2,85.20,0.00,0.50,0.00,1,2.00,4,2164.82,0,1,7,org.apache.lucene.codecs.SegmentInfosReader,0.00,12,1,6,0,12,1,0,5,369,1
"org.apache.lucene.codecs.lucene.Lucene40SegmentInfosWriter",5,0.00,2.40,52,0.88,52698.81,5,0,12,37,11,122.43,15,68,2,2,101.82,1.00,0.33,0.00,2,5.00,6,2648.00,0,2,9,org.apache.lucene.codecs.SegmentInfosWriter,0.00,32,1,12,1,32,3,0,9,475,1
"org.apache.lucene.codecs.lucene.Lucene40SkipListReader",9,0.34,1.33,61,0.58,16203.12,19,10,4,11,6,156.16,20,77,4,2,116.27,0.00,0.50,0.40,0,0.00,4,1743.85,3,0,2,org.apache.lucene.codecs.MultiLevelSkipListReader,0.20,2,1,12,0,2,9,0,10,383,1
"org.apache.lucene.codecs.lucene.Lucene40SkipListWriter",4,0.49,2.25,54,0.63,22673.50,17,13,4,7,4,51.60,35,66,2,2,99.70,0.00,0.50,0.44,0,0.00,4,1898.39,1,0,2,org.apache.lucene.codecs.MultiLevelSkipListWriter,0.20,3,1,9,0,3,4,0,29,389,1
"org.apache.lucene.codecs.lucene.Lucene40StoredFieldsFormat",3,0.00,1.00,7,0.11,1944.48,3,0,9,6,13,137.63,1,16,4,2,137.63,0.00,0.50,0.00,0,3.00,1,336.13,0,2,9,org.apache.lucene.codecs.StoredFieldsFormat,0.00,3,1,3,0,3,1,0,1,81,1
"org.apache.lucene.codecs.lucene.Lucene40StoredFieldsReader",12,0.17,2.17,114,1.68,79692.39,19,7,15,40,15,145.01,34,156,3,2,105.13,0.00,0.50,0.30,3,0.00,5,5045.97,0,2,13,org.apache.lucene.codecs.StoredFieldsReader,0.14,28,1,26,0,28,10,2,14,937,2
"org.apache.lucene.codecs.lucene.Lucene40StoredFieldsWriter",10,0.10,4.10,175,2.29,142024.30,27,17,18,43,19,92.31,49,210,3,2,92.08,0.00,0.50,0.15,4,18.00,14,6862.73,1,0,17,org.apache.lucene.codecs.StoredFieldsWriter,0.38,33,1,41,0,33,10,0,44,1226,2
"org.apache.lucene.codecs.lucene.Lucene40TermVectorsFormat",3,0.00,1.00,7,0.11,1944.48,3,0,9,6,13,137.63,0,14,4,2,137.63,0.00,0.50,0.00,0,3.00,1,336.13,0,2,9,org.apache.lucene.codecs.TermVectorsFormat,0.00,3,1,3,0,3,1,0,0,81,1
"org.apache.lucene.codecs.lucene.Lucene40TermVectorsReader",13,0.11,1.85,123,1.54,73348.70,29,16,26,30,24,145.61,38,153,4,2,105.72,0.00,0.50,0.17,3,37.00,4,4620.71,0,4,20,org.apache.lucene.codecs.TermVectorsReader,0.27,17,1,24,0,17,9,0,30,893,1
"org.apache.lucene.codecs.lucene.Lucene40TermVectorsReader$TVDocsAndPositionsEnum",10,0.11,1.40,52,0.48,13467.87,17,7,26,11,3,120.21,0,78,0,4,120.21,0.00,0.75,0.24,1,22.00,2,1436.16,0,1,3,org.apache.lucene.index.DocsAndPositionsEnum,1.80,1,3,14,0,1,9,0,0,331,2
"org.apache.lucene.codecs.lucene.Lucene40TermVectorsReader$TVDocsEnum",5,0.19,1.40,25,0.22,4658.76,9,4,26,6,2,121.47,0,37,0,3,121.47,0.00,0.67,0.40,1,0.00,2,661.15,0,0,2,org.apache.lucene.index.DocsEnum,1.20,1,2,7,0,1,5,0,0,157,2
"org.apache.lucene.codecs.lucene.Lucene40TermVectorsReader$TVFields",4,0.22,2.50,45,0.46,25680.13,7,3,26,10,4,151.96,5,53,0,2,101.96,0.00,0.50,0.50,0,2.00,4,1372.03,0,2,4,org.apache.lucene.index.Fields,0.50,6,1,10,0,6,2,0,5,276,1
"org.apache.lucene.codecs.lucene.Lucene40TermVectorsReader$TVFields$FieldsEnum",2,0.00,1.50,9,0.11,2701.28,3,1,26,3,1,123.80,0,14,0,1,123.80,0.00,0.00,1.00,0,0.00,2,317.42,0,2,1,java.lang.Object,0.00,1,0,3,0,1,0,0,0,73,0
"org.apache.lucene.codecs.lucene.Lucene40TermVectorsReader$TVTerms",7,0.08,1.29,27,0.23,5992.21,9,2,26,11,3,130.05,3,43,0,2,130.05,0.00,0.50,0.43,0,3.00,3,676.87,0,2,3,org.apache.lucene.index.Terms,0.71,4,1,9,0,4,5,0,3,168,1
"org.apache.lucene.codecs.lucene.Lucene40TermVectorsReader$TVTermsEnum",13,0.13,2.15,109,1.15,57559.96,26,13,26,28,7,108.42,8,141,0,2,108.42,0.00,0.50,0.20,0,56.00,7,3464.89,0,6,7,org.apache.lucene.index.TermsEnum,0.38,15,1,28,0,15,7,0,8,697,1
"org.apache.lucene.codecs.lucene.Lucene40TermVectorsWriter",14,0.13,3.36,214,2.84,173425.46,33,19,19,45,18,115.23,50,258,1,2,94.62,0.00,0.50,0.18,4,30.00,8,8534.26,1,1,17,org.apache.lucene.codecs.TermVectorsWriter,0.42,31,1,47,0,31,13,0,45,1580,2
"org.apache.lucene.codecs.lucene.TestBitVector",16,0.00,2.12,204,2.16,105382.48,16,0,6,35,5,140.39,46,198,0,2,100.50,0.00,0.50,0.00,7,16.00,5,6476.30,0,0,5,org.apache.lucene.util.LuceneTestCase,0.00,19,1,34,0,19,16,0,22,1282,1
"org.apache.lucene.codecs.lucene.TestReuseDocsEnum",5,0.00,2.80,90,1.56,77593.02,5,0,22,34,17,140.94,6,104,0,2,90.94,0.00,0.50,0.00,1,5.00,5,4689.64,0,1,17,org.apache.lucene.util.LuceneTestCase,0.00,29,1,14,0,29,4,0,3,793,1
"org.apache.lucene.codecs.lucene.TestReuseDocsEnum$ReaderUtil.Gather",1,0.00,3.00,10,0.22,9107.74,1,0,22,12,4,102.27,0,13,0,1,102.27,0.00,0.00,0.00,0,1.00,3,665.91,0,0,4,java.lang.Object,0.00,11,0,3,0,11,1,0,0,124,0
"org.apache.lucene.facet.enhancements.CategoryEnhancement",7,0.00,1.00,8,0.05,271.40,7,0,7,7,16,138.35,103,10,10,1,158.49,0.00,0.00,0.00,0,7.00,1,163.59,0,4,7,,0.00,0,0,7,0,0,3,0,9,57,1
"org.apache.lucene.facet.enhancements.CategoryEnhancementDummy1",8,0.00,1.12,19,0.13,1501.93,8,0,7,8,9,181.73,16,33,2,1,141.84,0.00,0.00,0.00,0,8.00,2,396.51,1,4,7,java.lang.Object,0.00,0,0,9,0,0,4,1,1,111,1
"org.apache.lucene.facet.enhancements.CategoryEnhancementDummy2",8,0.86,1.25,24,0.22,4685.92,9,1,8,10,10,171.24,16,40,2,1,131.36,0.00,0.00,0.25,0,16.00,2,656.14,1,4,8,java.lang.Object,0.00,2,0,10,0,2,4,1,1,163,1
"org.apache.lucene.facet.enhancements.CategoryEnhancementDummy3",8,0.86,1.25,24,0.22,4687.56,9,1,7,10,8,171.24,16,40,1,1,131.35,0.00,0.00,0.25,0,16.00,2,657.55,1,4,7,java.lang.Object,0.00,2,0,10,0,2,4,1,1,163,1
"org.apache.lucene.facet.enhancements.EnhancementsCategoryTokenizer",2,1.50,5.00,42,0.56,49422.33,6,4,6,10,6,135.99,48,54,1,6,86.72,0.00,0.83,1.00,1,0.00,8,1670.02,0,0,5,org.apache.lucene.facet.index.streaming.CategoryTokenizer,0.32,8,5,10,0,8,2,0,13,310,1
"org.apache.lucene.facet.enhancements.EnhancementsDocumentBuilder",4,0.00,2.50,21,0.26,8587.77,4,0,11,10,14,70.37,32,39,5,2,118.48,0.00,0.50,0.00,0,0.00,5,783.29,2,3,10,org.apache.lucene.facet.index.CategoryDocumentBuilder,0.00,6,1,10,0,6,1,0,4,169,1
"org.apache.lucene.facet.enhancements.EnhancementsPayloadIterator",3,0.75,2.67,35,0.38,16553.42,7,4,7,9,7,92.11,45,40,2,2,102.46,0.00,0.50,0.75,0,0.00,4,1143.11,1,1,5,org.apache.lucene.facet.search.PayloadIterator,0.22,6,1,8,0,6,2,0,6,233,1
"org.apache.lucene.facet.enhancements.EnhancementsPayloadIteratorTest",5,0.56,1.20,48,0.70,13921.38,9,4,15,22,10,128.85,18,65,0,2,108.24,0.00,0.50,0.70,0,0.00,2,2114.42,0,0,10,org.apache.lucene.util.LuceneTestCase,0.00,17,1,6,0,17,5,0,3,407,1
"org.apache.lucene.facet.enhancements.TwoEnhancementsTest",2,0.00,1.00,48,0.98,31718.50,2,0,20,32,18,42.31,22,72,0,2,86.44,0.00,0.50,0.00,0,2.00,1,2930.60,0,0,18,org.apache.lucene.util.LuceneTestCase,0.00,30,1,2,0,30,2,0,7,474,1
"org.apache.solr.spelling.suggest.tst.TSTLookupFactory",2,1.00,1.00,6,0.05,655.54,3,1,5,3,6,183.39,3,11,1,2,133.39,0.00,0.50,0.50,0,2.00,1,160.07,0,2,5,org.apache.solr.spelling.suggest.LookupFactory,0.50,1,1,2,0,1,0,0,1,43,1
"org.apache.lucene.benchmark.byTask.utils.Algorithm",7,0.00,8.00,187,2.99,423759.94,9,2,9,60,7,47.86,43,242,2,1,80.08,0.00,0.00,0.50,2,0.00,42,8981.89,0,4,5,java.lang.Object,0.00,53,0,56,0,53,3,0,26,1362,1
"org.apache.lucene.benchmark.byTask.utils.Config",17,0.12,3.53,247,3.75,263511.74,24,7,10,69,37,62.74,111,280,36,1,94.96,0.00,0.00,0.26,1,36.00,7,11245.73,0,5,1,java.lang.Object,0.00,52,0,60,0,52,12,0,38,2086,1
"org.apache.lucene.benchmark.byTask.utils.FileUtils",1,0.00,7.00,16,0.17,10646.93,1,0,2,5,1,45.45,10,20,1,1,93.92,0.00,0.00,0.00,0,1.00,7,505.54,0,0,0,java.lang.Object,0.00,4,0,7,0,4,1,0,2,101,1
"org.apache.lucene.benchmark.byTask.utils.Format",7,0.33,1.00,31,0.48,13114.48,9,2,1,12,3,104.90,35,44,3,1,122.77,0.00,0.00,0.79,0,0.00,1,1442.31,0,7,0,java.lang.Object,0.00,5,0,7,0,5,0,0,6,337,1
"org.apache.lucene.benchmark.byTask.utils.StreamUtils",0,0.00,0.00,3,0.02,334.04,1,1,13,0,7,171.00,6,3,7,1,171.00,0.00,0.00,0.00,0,0.00,0,74.23,0,0,0,java.lang.Object,0.00,0,0,0,0,0,0,0,4,19,1
"org.apache.lucene.benchmark.byTask.utils.StreamUtils$Type",3,0.00,3.00,36,0.62,41765.46,5,2,13,23,0,65.64,19,51,0,1,97.86,0.00,0.00,0.50,0,1.00,5,1847.84,0,2,0,java.lang.Object,0.00,20,0,9,0,20,1,0,11,324,1
"org.apache.lucene.benchmark.byTask.utils.StreamUtilsTest",14,0.19,1.00,73,0.78,14259.08,16,2,17,35,3,121.24,0,96,0,3,121.24,0.00,0.67,0.32,6,38.00,1,2334.69,3,4,3,org.apache.lucene.benchmark.BenchmarkTestCase,0.00,21,2,14,0,21,10,0,0,538,1
"org.apache.lucene.benchmark.byTask.utils.StringBuilderReader",11,0.20,1.64,61,0.62,26034.45,15,4,2,19,1,138.86,43,95,1,2,118.24,0.00,0.50,0.43,2,0.00,4,1865.69,0,0,0,java.io.Reader,0.00,8,1,18,0,8,11,0,9,405,1
"org.apache.lucene.benchmark.byTask.utils.TestConfig",1,0.00,1.00,8,0.10,2496.91,1,0,3,6,1,110.56,0,11,0,2,110.56,0.00,0.50,0.00,0,1.00,1,289.50,0,0,1,org.apache.lucene.util.LuceneTestCase,0.00,5,1,1,0,5,1,0,0,65,1
"org.apache.lucene.analysis.ca.CatalanAnalyzer",5,0.25,1.40,24,0.36,8751.92,8,3,17,20,14,74.45,50,39,1,3,122.93,0.00,0.67,0.13,0,8.00,3,1066.13,0,2,13,org.apache.lucene.analysis.util.StopwordAnalyzerBase,0.00,15,2,7,0,15,3,0,8,225,2
"org.apache.lucene.analysis.ca.CatalanAnalyzer$DefaultSetHolder",0,0.00,0.00,6,0.05,732.71,1,1,17,0,2,171.00,2,11,0,1,171.00,0.00,0.00,0.00,0,0.00,0,149.07,0,0,2,java.lang.Object,0.00,0,0,0,0,0,0,0,2,37,2
"org.apache.lucene.analysis.ca.TestCatalanAnalyzer",5,0.00,1.00,18,0.20,3029.76,5,0,4,8,4,181.29,8,26,0,3,131.29,0.00,0.67,0.00,0,5.00,1,606.35,3,0,4,org.apache.lucene.analysis.BaseTokenStreamTestCase,0.00,3,2,5,0,3,5,0,7,142,1
"org.apache.lucene.facet.util.MultiCategoryListIterator",4,0.11,2.50,28,0.27,7245.95,7,3,4,13,1,71.32,31,37,0,1,113.61,0.00,0.00,0.25,0,6.00,3,819.49,0,0,1,java.lang.Object,0.00,9,0,10,0,9,4,1,6,189,1
"org.apache.lucene.facet.util.PartitionsUtils",8,0.00,1.12,21,0.27,5381.65,8,0,4,14,11,105.25,51,37,8,1,137.48,0.00,0.00,0.00,4,8.00,2,811.68,0,2,4,java.lang.Object,0.00,6,0,9,0,6,6,0,11,200,2
"org.apache.lucene.facet.util.ResultSortUtils",1,0.00,5.00,20,0.30,12831.06,1,0,8,10,5,121.65,31,32,1,1,89.75,0.00,0.00,0.00,0,1.00,5,909.11,0,1,4,java.lang.Object,0.00,9,0,5,0,9,0,0,4,184,1
"org.apache.lucene.facet.util.ResultSortUtils$AllValueHeap",7,0.00,1.29,25,0.20,3423.91,10,3,8,15,2,131.97,0,35,0,1,131.97,0.00,0.00,0.33,0,0.00,2,586.31,0,4,2,java.lang.Object,0.00,8,0,9,0,8,3,1,0,153,2
"org.apache.lucene.facet.util.ResultSortUtils$AllValueHeap$Comparator<FacetResultNode>",1,0.00,3.00,8,0.09,2794.33,1,0,8,4,1,109.92,0,12,0,1,109.92,0.00,0.00,0.00,0,0.00,3,261.23,0,0,1,java.lang.Object,0.00,3,0,3,0,3,1,0,0,62,0
"org.apache.lucene.facet.util.ResultSortUtils$MaxOrdinalHeap",2,0.00,1.00,5,0.06,960.04,2,0,8,3,3,138.66,0,10,0,2,138.66,0.00,0.50,0.00,0,2.00,1,173.63,0,0,3,org.apache.lucene.util.PriorityQueue,0.00,1,1,2,0,1,2,1,0,48,2
"org.apache.lucene.facet.util.ResultSortUtils$MaxValueHeap",2,0.00,1.50,10,0.12,3285.96,2,0,8,5,3,119.51,0,15,0,2,119.51,0.00,0.50,0.00,0,2.00,2,369.07,0,0,3,org.apache.lucene.util.PriorityQueue,0.00,3,1,3,0,3,2,1,0,85,2
"org.apache.lucene.facet.util.ResultSortUtils$MinOrdinalHeap",2,0.00,1.00,5,0.06,960.04,2,0,8,3,3,138.66,0,10,0,2,138.66,0.00,0.50,0.00,0,2.00,1,173.63,0,0,3,org.apache.lucene.util.PriorityQueue,0.00,1,1,2,0,1,2,1,0,48,2
"org.apache.lucene.facet.util.ResultSortUtils$MinValueHeap",2,0.00,1.50,10,0.12,3285.96,2,0,8,5,3,119.51,0,15,0,2,119.51,0.00,0.50,0.00,0,2.00,2,369.07,0,0,3,org.apache.lucene.util.PriorityQueue,0.00,3,1,3,0,3,2,1,0,85,2
"org.apache.lucene.facet.util.ScoredDocIdsUtils",5,0.00,2.40,42,0.54,21666.86,5,0,11,24,15,79.09,67,58,6,1,108.47,0.00,0.00,0.00,2,5.00,4,1615.32,0,4,9,java.lang.Object,0.00,19,0,12,0,19,1,0,15,328,1
"org.apache.lucene.facet.util.ScoredDocIdsUtils$AllDocsScoredDocIDs",4,1.00,1.25,13,0.09,1444.80,5,1,11,9,4,133.01,1,20,0,1,133.01,0.00,0.00,0.25,1,6.00,2,266.71,0,2,4,java.lang.Object,0.00,5,0,5,0,5,2,1,1,72,2
"org.apache.lucene.facet.util.ScoredDocIdsUtils$AllDocsScoredDocIDs$DocIdSet_2",2,0.00,1.00,5,0.03,330.65,2,0,11,3,1,142.30,0,9,0,1,142.30,0.00,0.00,0.00,0,2.00,1,86.05,0,1,1,java.lang.Object,0.00,1,0,2,0,1,1,0,0,27,0
"org.apache.lucene.facet.util.ScoredDocIdsUtils$AllDocsScoredDocIDs$DocIdSet_2$DocIdSetIterator_3",3,0.00,2.00,10,0.11,2965.48,4,1,11,3,0,129.46,0,18,0,1,129.46,0.00,0.00,1.00,0,0.00,3,319.78,0,0,0,java.lang.Object,0.00,0,0,6,0,0,3,0,0,78,0
"org.apache.lucene.facet.util.ScoredDocIdsUtils$AllDocsScoredDocIDs$ScoredDocIDsIterator_4",3,0.00,1.33,9,0.06,650.74,3,0,11,5,1,134.74,1,14,0,1,134.74,0.00,0.00,0.00,0,3.00,2,172.79,0,0,1,java.lang.Object,0.00,2,0,4,0,2,3,0,1,48,0
"org.apache.lucene.facet.util.ScoredDocIdsUtils$AllLiveDocsScoredDocIDs",4,0.50,1.25,15,0.11,1696.51,6,2,11,10,4,132.46,1,22,0,1,132.46,0.00,0.00,0.12,1,6.00,2,318.90,0,2,4,java.lang.Object,0.00,6,0,5,0,6,2,1,1,86,3
"org.apache.lucene.facet.util.ScoredDocIdsUtils$AllLiveDocsScoredDocIDs$DocIdSet_5",2,0.00,1.00,5,0.03,330.65,2,0,11,3,1,142.30,0,9,0,1,142.30,0.00,0.00,0.00,0,2.00,1,86.05,0,1,1,java.lang.Object,0.00,1,0,2,0,1,1,0,0,27,0
"org.apache.lucene.facet.util.ScoredDocIdsUtils$AllLiveDocsScoredDocIDs$DocIdSet_5$DocIdSetIterator_6",3,0.25,1.67,14,0.15,4448.69,5,2,11,5,1,123.45,0,21,0,1,123.45,0.00,0.00,0.67,1,0.00,2,446.34,0,0,1,java.lang.Object,0.00,2,0,5,0,2,3,0,0,103,0
"org.apache.lucene.facet.util.ScoredDocIdsUtils$AllLiveDocsScoredDocIDs$ScoredDocIDsIterator_7",3,0.00,1.33,9,0.06,650.74,3,0,11,5,1,134.74,1,14,0,1,134.74,0.00,0.00,0.00,0,3.00,2,172.79,0,0,1,java.lang.Object,0.00,2,0,4,0,2,3,0,1,48,0
"org.apache.lucene.facet.util.ScoredDocIdsUtils$ScoredDocIDs",3,0.00,1.00,7,0.03,230.94,3,0,11,5,2,144.92,0,8,0,1,144.92,0.00,0.00,0.00,0,3.00,1,78.64,0,2,2,java.lang.Object,0.00,2,0,3,0,2,1,0,0,28,0
"org.apache.lucene.facet.util.ScoredDocIdsUtils$ScoredDocIDs$DocIdSet",2,0.00,1.00,5,0.03,330.65,2,0,11,3,1,142.30,0,7,0,1,142.30,0.00,0.00,0.00,0,2.00,1,86.05,0,1,1,java.lang.Object,0.00,1,0,2,0,1,1,0,0,27,0
"org.apache.lucene.facet.util.ScoredDocIdsUtils$ScoredDocIDs$DocIdSet$DocIdSetIterator",3,0.00,2.00,11,0.12,3409.48,4,1,11,3,0,128.98,0,19,0,1,128.98,0.00,0.00,1.00,0,0.00,3,359.37,0,0,0,java.lang.Object,0.00,0,0,6,0,0,3,0,0,86,0
"org.apache.lucene.facet.util.ScoredDocIdsUtils$ScoredDocIDs$ScoredDocIDsIterator",3,0.00,1.00,8,0.05,489.43,4,1,11,3,0,142.35,0,5,0,1,142.35,0.00,0.00,1.00,0,0.00,1,142.84,0,0,0,java.lang.Object,0.00,0,0,3,0,0,3,0,0,43,0
"org.apache.lucene.facet.util.ScoredDocIdsUtils$ScoredDocIDs_0",3,1.00,1.67,15,0.12,3089.92,4,1,11,8,4,121.08,1,19,0,1,121.08,0.00,0.00,0.33,0,4.00,3,368.03,0,2,4,java.lang.Object,0.00,5,0,5,0,5,1,0,1,88,0
"org.apache.lucene.facet.util.ScoredDocIdsUtils$ScoredDocIDs_0$ScoredDocIDsIterator_1",3,0.00,1.33,9,0.06,921.15,3,0,11,6,1,133.55,0,10,0,1,133.55,0.00,0.00,0.00,0,3.00,2,189.56,0,0,1,java.lang.Object,0.00,3,0,4,0,3,3,0,0,51,0
"org.apache.lucene.facet.util.TestScoredDocIDsUtils",5,0.00,2.00,84,1.42,63461.04,5,0,26,55,23,75.74,26,110,0,2,93.61,0.00,0.50,0.00,1,5.00,3,4266.73,0,2,23,org.apache.lucene.util.LuceneTestCase,0.00,50,1,10,0,50,3,0,9,716,1
"org.apache.lucene.facet.util.TestScoredDocIDsUtils$DocumentFactory",2,0.00,1.00,5,0.10,3209.93,2,0,26,2,0,174.41,4,13,0,1,134.53,0.00,0.00,0.00,0,2.00,1,287.07,0,0,0,java.lang.Object,0.00,0,0,2,0,0,2,0,4,69,0
"org.apache.lucene.facet.util.TestScoredDocIDsUtils$DocumentFactory_0",4,0.11,1.50,23,0.24,5245.82,10,6,26,11,4,120.28,2,30,0,1,120.28,0.00,0.00,0.08,2,6.00,3,729.48,0,1,4,java.lang.Object,0.00,7,0,6,0,7,3,0,2,165,2
"org.apache.lucene.facet.search.association.AssociationsFacetRequestTest",5,0.68,1.60,82,1.29,39513.72,12,7,29,43,24,77.41,27,97,0,2,95.28,0.00,0.50,0.69,0,0.00,3,3855.16,0,0,24,org.apache.lucene.util.LuceneTestCase,0.00,38,1,8,0,38,5,0,12,689,1
"org.apache.lucene.facet.FacetException",4,0.00,1.00,10,0.05,359.54,4,0,1,5,4,126.51,21,15,4,2,144.39,1.00,0.33,0.00,0,4.00,1,148.96,0,0,0,java.io.IOException,0.00,1,1,4,1,1,4,0,2,49,1
"org.apache.lucene.facet.FacetTestBase",22,0.04,1.77,145,2.11,73286.01,30,8,46,93,34,134.72,66,188,0,2,114.10,10.00,0.08,0.09,8,162.00,6,6342.47,0,10,34,org.apache.lucene.util.LuceneTestCase,0.00,71,1,39,10,71,12,0,39,1210,2
"org.apache.lucene.facet.FacetTestBase$DefaultFacetIndexingParams",1,0.00,1.00,3,0.01,149.03,1,0,46,1,0,136.09,0,5,0,1,136.09,0.00,0.00,0.00,0,1.00,1,44.54,0,0,0,java.lang.Object,0.00,0,0,1,0,0,1,0,0,15,0
"org.apache.lucene.facet.FacetTestBase$NotSameResultError",1,0.00,1.00,3,0.01,94.05,1,0,46,1,0,137.66,0,5,0,2,137.66,0.00,0.50,0.00,0,1.00,1,42.11,0,0,0,java.lang.Error,0.00,0,1,1,0,0,1,0,0,15,2
"org.apache.lucene.facet.FacetTestBase$SearchTaxoDirPair",1,2.00,1.00,3,0.01,124.34,3,2,46,1,1,136.71,0,4,0,1,136.71,0.00,0.00,0.00,0,1.00,1,44.62,0,0,1,java.lang.Object,0.00,0,0,1,0,0,1,0,0,15,3
"org.apache.lucene.facet.FacetTestUtils",5,0.00,1.80,62,0.90,37985.32,5,0,32,38,31,120.66,16,73,3,1,100.05,0.00,0.00,0.00,0,5.00,2,2704.77,0,2,28,java.lang.Object,0.00,33,0,9,0,33,3,0,1,515,1
"org.apache.lucene.facet.FacetTestUtils$IndexTaxonomyReaderPair",1,1.00,1.00,7,0.04,426.25,4,3,32,3,3,118.77,0,9,0,1,118.77,0.00,0.00,0.67,0,0.00,1,130.51,0,0,3,java.lang.Object,0.00,2,0,1,0,2,1,0,0,37,2
"org.apache.lucene.facet.FacetTestUtils$IndexTaxonomyWriterPair",2,1.00,1.00,9,0.06,618.58,4,2,32,6,2,128.93,0,12,0,1,128.93,0.00,0.00,1.00,0,0.00,1,167.45,0,0,2,java.lang.Object,0.00,4,0,2,0,4,2,0,0,49,2
"org.apache.lucene.queryparser.flexible.core.builders.QueryBuilder",1,0.00,1.00,2,0.01,51.00,1,0,2,1,6,172.56,32,3,4,1,146.32,0.00,0.00,0.00,0,1.00,1,34.00,0,1,2,,0.00,0,0,1,0,0,0,0,3,13,1
"org.apache.lucene.queryparser.flexible.core.builders.QueryTreeBuilder",8,0.29,3.62,56,0.77,38123.12,11,3,8,27,22,77.99,55,84,15,1,110.22,0.00,0.00,0.08,3,16.00,10,2301.69,0,3,7,java.lang.Object,0.00,19,0,29,2,19,5,1,7,468,1
"org.apache.lucene.queryparser.flexible.core.builders.TestQueryTreeBuilder",1,0.00,1.00,7,0.10,1667.17,1,0,7,8,5,114.10,0,10,0,2,114.10,0.00,0.50,0.00,0,1.00,1,290.15,0,0,5,org.apache.lucene.util.LuceneTestCase,0.00,7,1,1,0,7,1,0,0,64,1
"org.apache.lucene.queryparser.flexible.core.builders.TestQueryTreeBuilder$DummyBuilder",1,0.00,1.00,3,0.02,178.19,1,0,7,1,3,135.48,0,5,0,1,135.48,0.00,0.00,0.00,0,1.00,1,62.67,0,1,3,java.lang.Object,0.00,0,0,1,0,0,0,1,0,19,2
"org.apache.lucene.queryparser.flexible.core.parser.EscapeQuerySyntax",1,0.00,1.00,3,0.02,77.59,1,0,1,1,27,108.94,13,4,27,1,138.32,0.00,0.00,0.00,0,1.00,1,52.38,0,1,0,,0.00,0,0,1,0,0,0,0,2,18,1
"org.apache.lucene.queryparser.flexible.core.parser.EscapeQuerySyntax$Type",0,0.00,0.00,2,0.01,39.30,0,0,1,0,0,171.00,0,3,0,1,171.00,0.00,0.00,0.00,0,0.00,0,19.65,0,0,0,java.lang.Object,0.00,0,0,0,0,0,0,0,0,7,1
"org.apache.lucene.queryparser.flexible.core.parser.SyntaxParser",1,0.00,1.00,2,0.01,97.26,1,0,2,1,8,95.64,10,4,7,1,144.12,0.00,0.00,0.00,0,1.00,1,44.54,0,1,2,,0.00,0,0,1,0,0,0,0,2,15,1
"org.apache.lucene.facet.search.aggregator.Aggregator",2,0.00,1.00,3,0.02,80.34,2,0,1,2,14,184.65,39,4,14,1,158.37,0.00,0.00,0.00,0,2.00,1,58.73,0,0,0,,0.00,0,0,2,0,0,2,0,4,21,1
"org.apache.lucene.facet.search.aggregator.ComplementCountingAggregator",2,0.00,1.00,6,0.05,1127.10,2,0,0,2,2,83.06,21,10,1,2,131.54,0.00,0.50,0.00,0,2.00,1,160.83,0,0,1,org.apache.lucene.facet.search.aggregator.CountingAggregator,0.00,0,1,2,0,0,2,0,2,43,1
"org.apache.lucene.facet.search.aggregator.CountingAggregator",5,0.75,1.40,15,0.16,3864.09,6,1,0,7,6,112.51,25,24,5,1,130.38,0.00,0.00,0.40,0,7.00,2,465.04,0,0,1,java.lang.Object,0.00,2,0,7,1,2,5,1,4,116,1
"org.apache.lucene.facet.search.aggregator.ScoringAggregator",5,0.08,1.40,18,0.18,4095.25,8,3,0,7,3,130.42,22,27,2,1,130.18,0.00,0.00,0.27,0,10.00,2,553.83,0,0,1,java.lang.Object,0.00,2,0,7,0,2,5,1,2,136,1
"org.apache.lucene.analysis.br.BrazilianAnalyzer",5,0.38,1.20,20,0.25,6150.56,7,2,16,15,15,74.17,48,31,1,3,124.17,0.00,0.67,0.20,0,7.00,2,755.47,0,2,14,org.apache.lucene.analysis.util.StopwordAnalyzerBase,0.00,10,2,6,0,10,3,0,8,171,2
"org.apache.lucene.analysis.br.BrazilianAnalyzer$DefaultSetHolder",0,0.00,0.00,6,0.07,1124.92,1,1,16,0,4,171.00,2,11,0,1,171.00,0.00,0.00,0.00,0,0.00,0,208.79,0,0,4,java.lang.Object,0.00,0,0,0,0,0,0,0,2,48,2
"org.apache.lucene.analysis.br.BrazilianStemFilter",2,0.50,2.50,16,0.24,8239.60,6,4,7,11,10,60.16,20,23,4,4,108.64,0.00,0.75,0.50,0,2.00,4,719.57,0,0,6,org.apache.lucene.analysis.TokenFilter,0.29,9,3,5,0,9,2,0,5,146,2
"org.apache.lucene.analysis.br.BrazilianStemmer",19,0.04,12.63,670,9.09,931830.14,24,5,0,26,1,25.88,174,761,1,1,75.88,0.00,0.00,0.24,9,43.00,122,27280.09,0,7,0,java.lang.Object,0.00,7,0,240,0,7,12,0,56,4424,1
"org.apache.lucene.analysis.br.TestBrazilianStemmer",9,0.00,1.00,112,1.29,19717.79,9,0,10,17,9,125.05,28,125,0,3,104.44,0.00,0.67,0.00,2,9.00,1,3872.78,4,0,9,org.apache.lucene.analysis.BaseTokenStreamTestCase,0.00,8,2,9,0,8,9,0,23,649,1
"org.apache.lucene.analysis.br.TestBrazilianStemmer$Analyzer",1,0.00,1.00,4,0.05,753.46,1,0,10,4,3,125.89,0,6,0,1,125.89,0.00,0.00,0.00,0,1.00,1,135.44,0,1,3,java.lang.Object,0.00,3,0,1,0,3,0,0,0,34,0
"org.apache.solr.handler.component.AbstractStatsValues",13,0.05,1.85,78,1.04,44567.51,21,8,8,34,11,134.61,50,86,3,1,113.99,0.00,0.00,0.17,3,46.00,7,3120.83,0,1,8,java.lang.Object,0.00,21,0,24,3,21,12,1,14,624,1
"org.apache.solr.handler.component.BadComponentTest",1,0.00,3.00,14,0.13,3246.83,1,0,3,5,2,82.47,5,21,0,3,100.34,0.00,0.67,0.00,0,1.00,3,382.57,3,0,2,org.apache.solr.SolrTestCaseJ4,0.00,4,2,3,0,4,1,0,2,77,1
"org.apache.solr.handler.component.DateStatsValues",7,0.25,1.71,33,0.41,10201.03,9,2,8,16,7,144.12,25,48,1,2,123.51,0.00,0.50,0.71,0,0.00,3,1228.50,0,0,6,org.apache.solr.handler.component.AbstractStatsValues,0.00,9,1,12,0,9,7,0,9,283,0
"org.apache.solr.handler.component.DebugComponent",11,0.50,4.64,133,2.25,208206.15,13,2,10,65,13,146.71,16,184,3,2,96.71,0.00,0.50,0.05,1,20.00,19,6753.82,0,6,10,org.apache.solr.handler.component.SearchComponent,0.62,54,1,51,0,54,5,0,11,1170,1
"org.apache.solr.handler.component.DebugComponentTest",3,0.00,1.00,15,0.36,8032.72,3,0,4,3,2,75.64,22,98,0,3,117.93,0.00,0.67,0.00,0,3.00,1,1076.59,6,0,2,org.apache.solr.SolrTestCaseJ4,0.00,0,2,3,0,0,3,0,19,211,1
"org.apache.solr.handler.component.DistributedQueryElevationComponentTest",5,0.00,1.00,42,0.63,16706.77,5,0,9,10,4,109.56,4,51,0,4,109.56,0.00,0.75,0.00,1,11.00,1,1883.12,7,0,4,org.apache.solr.BaseDistributedSearchTestCase,0.04,5,3,5,0,5,5,0,2,344,1
"org.apache.solr.handler.component.DistributedSpellCheckComponentTest",6,0.20,1.67,69,1.30,47468.87,8,2,8,24,5,141.22,13,84,0,4,101.34,0.00,0.75,0.33,1,14.00,2,3888.78,6,0,5,org.apache.solr.BaseDistributedSearchTestCase,0.10,18,3,10,0,18,6,0,7,665,1
"org.apache.solr.handler.component.DistributedTermsComponentTest",1,0.00,1.00,21,0.39,13316.24,1,0,1,3,1,56.98,6,24,0,4,89.20,0.00,0.75,0.00,0,0.00,1,1166.49,4,0,1,org.apache.solr.BaseDistributedSearchTestCase,0.04,2,3,1,0,2,1,0,1,206,1
"org.apache.solr.handler.component.DummyCustomParamSpellChecker",3,0.00,1.33,12,0.18,5543.15,3,0,9,10,6,80.46,21,20,0,2,122.75,0.00,0.50,0.00,0,3.00,2,549.66,0,1,6,org.apache.solr.spelling.SolrSpellChecker,0.00,7,1,4,0,7,2,0,3,116,1
"org.apache.solr.handler.component.FacetComponent",16,0.20,6.19,318,5.88,684275.92,20,4,16,85,21,44.12,112,395,4,2,86.41,0.00,0.50,0.06,2,54.00,31,17652.45,0,7,17,org.apache.solr.handler.component.SearchComponent,0.32,69,1,99,0,69,9,0,92,2741,1
"org.apache.solr.handler.component.FacetComponent$DistribFieldFacet",5,0.20,2.20,57,0.71,40832.75,15,10,16,21,3,121.78,15,64,0,2,101.17,0.00,0.50,0.26,0,0.00,7,2142.74,0,0,3,org.apache.solr.handler.component.FieldFacet,0.00,16,1,11,0,16,5,0,15,410,2
"org.apache.solr.handler.component.FacetComponent$DistribFieldFacet$Comparator<ShardFacetCount>",1,0.00,1.00,3,0.03,398.03,1,0,16,2,0,132.73,0,4,0,1,132.73,0.00,0.00,0.00,0,1.00,1,93.66,0,0,0,java.lang.Object,0.00,1,0,1,0,1,1,0,0,27,0
"org.apache.solr.handler.component.FacetComponent$DistribFieldFacet$Comparator<ShardFacetCount>_0",1,0.00,3.00,4,0.07,2328.85,1,0,16,2,0,121.77,0,6,0,1,121.77,0.00,0.00,0.00,0,1.00,3,215.06,0,0,0,java.lang.Object,0.00,1,0,3,0,1,1,0,0,53,0
"org.apache.solr.handler.component.FacetComponent$FacetBase",3,0.20,2.00,23,0.25,8013.47,8,5,16,8,7,152.22,7,27,0,1,112.33,0.00,0.00,0.33,0,2.00,4,736.21,0,2,7,java.lang.Object,0.00,5,0,6,0,5,1,0,7,153,2
"org.apache.solr.handler.component.FacetComponent$FacetInfo",1,2.00,5.00,20,0.30,11848.32,5,4,16,9,4,90.02,0,26,0,1,90.02,0.00,0.00,0.50,0,0.00,5,894.26,0,0,4,java.lang.Object,0.00,8,0,5,0,8,1,0,0,181,2
"org.apache.solr.handler.component.FacetComponent$FieldFacet",2,0.11,3.50,30,0.51,22920.35,11,9,16,9,4,134.76,4,35,0,2,94.88,0.00,0.50,0.06,1,2.00,6,1542.31,0,0,4,org.apache.solr.handler.component.FacetBase,0.00,7,1,7,0,7,2,0,4,283,2
"org.apache.solr.handler.component.FacetComponent$QueryFacet",1,1.00,1.00,4,0.03,304.61,2,1,16,1,2,128.98,0,6,0,2,128.98,0.00,0.50,0.00,0,1.00,1,99.07,0,0,2,org.apache.solr.handler.component.FacetBase,0.00,0,1,1,0,0,1,0,0,28,2
"org.apache.solr.handler.component.FacetComponent$ShardFacetCount",1,1.00,1.00,7,0.06,622.13,5,4,16,1,0,157.36,2,10,0,1,117.47,0.00,0.00,0.75,0,0.00,1,186.52,0,1,0,java.lang.Object,0.00,0,0,1,0,0,0,0,2,48,2
"org.apache.solr.handler.component.FieldFacetStats",5,0.34,3.80,81,1.07,47242.03,16,11,8,24,8,134.36,12,93,2,1,94.47,0.00,0.00,0.36,0,0.00,5,3225.00,0,1,6,java.lang.Object,0.00,19,0,19,0,19,4,0,5,594,1
"org.apache.solr.handler.component.FieldOptions",0,0.00,0.00,3,0.02,86.04,6,6,31,0,25,171.00,0,4,1,1,171.00,0.00,0.00,0.00,0,0.00,0,57.36,0,0,24,java.lang.Object,0.00,0,0,0,0,0,0,0,0,16,0
"org.apache.solr.handler.component.HighlightComponent",14,0.23,2.57,96,1.52,71512.43,17,3,21,60,27,162.55,17,141,8,2,112.55,0.00,0.50,0.12,0,38.00,10,4571.45,0,7,21,org.apache.solr.handler.component.SearchComponent,0.55,46,1,36,0,46,7,2,12,848,1
"org.apache.solr.handler.component.HttpShardHandler",8,0.03,4.62,129,2.27,192494.75,13,5,28,66,28,48.94,61,157,1,2,91.23,0.00,0.50,0.22,2,16.00,21,6795.86,0,1,28,org.apache.solr.handler.component.ShardHandler,0.62,58,1,37,0,58,7,0,52,1092,1
"org.apache.solr.handler.component.HttpShardHandler$Callable<ShardResponse>",1,0.00,7.00,32,0.55,32639.26,1,0,28,23,6,28.86,9,40,0,1,78.86,0.00,0.00,0.00,0,0.00,7,1664.41,0,0,6,java.lang.Object,0.00,22,0,7,0,22,1,0,9,265,0
"org.apache.solr.handler.component.HttpShardHandler$SimpleSolrResponse",3,0.00,1.00,9,0.08,1024.20,5,2,28,3,2,133.25,0,16,0,2,133.25,0.00,0.50,0.50,0,2.00,1,229.00,0,1,2,org.apache.solr.client.solrj.SolrResponse,0.67,0,1,3,0,0,2,0,0,61,2
"org.apache.solr.handler.component.HttpShardHandlerFactory",5,0.14,2.60,71,1.25,54151.21,29,24,15,31,12,78.38,27,101,4,2,96.26,0.00,0.50,0.15,1,6.00,4,3759.66,0,2,9,org.apache.solr.handler.component.ShardHandlerFactory,0.57,26,1,13,0,26,3,1,27,636,1
"org.apache.solr.handler.component.MoreLikeThisComponent",8,1.00,1.75,50,0.87,34413.16,9,1,12,33,15,163.23,11,78,3,2,113.23,0.00,0.50,0.00,1,8.00,6,2604.65,0,6,12,org.apache.solr.handler.component.SearchComponent,0.43,25,1,14,0,25,2,0,6,466,1
"org.apache.solr.handler.component.NumericStatsValues",7,0.25,1.14,30,0.35,6771.95,9,2,8,14,7,145.62,24,39,1,2,125.00,0.00,0.50,0.71,0,0.00,2,1058.18,0,0,6,org.apache.solr.handler.component.AbstractStatsValues,0.00,7,1,8,0,7,7,0,8,258,0
"org.apache.solr.handler.component.PivotFacetHelper",3,0.00,3.67,52,1.08,64243.77,3,0,22,33,17,43.87,140,63,1,1,90.70,0.00,0.00,0.00,1,3.00,5,3231.84,0,3,16,java.lang.Object,0.00,30,0,11,0,30,0,0,131,524,1
"org.apache.solr.handler.component.QueryComponent",23,0.29,6.43,537,10.97,1112268.93,26,3,62,301,89,65.01,118,685,7,2,82.89,0.00,0.50,0.06,13,82.00,29,32903.95,0,5,82,org.apache.solr.handler.component.SearchComponent,0.47,278,1,148,0,278,18,0,111,4881,1
"org.apache.solr.handler.component.QueryComponent$EndResultTransformer.SolrDocumentSource",1,0.00,1.00,4,0.04,495.97,1,0,62,2,3,127.32,0,5,0,1,127.32,0.00,0.00,0.00,0,1.00,1,117.70,0,1,3,java.lang.Object,0.00,1,0,1,0,1,0,0,0,31,0
"org.apache.solr.handler.component.QueryElevationComponent",13,0.04,4.54,226,4.18,309165.15,25,12,43,115,37,110.91,42,306,3,2,90.29,0.00,0.50,0.12,1,59.00,19,12530.96,0,8,35,org.apache.solr.handler.component.SearchComponent,0.50,102,1,59,0,102,5,1,34,1979,1
"org.apache.solr.handler.component.QueryElevationComponent$ElevationComparatorSource",2,0.00,1.00,11,0.14,2636.39,5,3,43,5,3,170.36,2,15,0,2,120.36,0.00,0.50,0.33,0,2.00,1,422.51,0,1,3,org.apache.solr.schema.FieldComparatorSource,0.00,3,1,2,0,3,1,0,2,94,0
"org.apache.solr.handler.component.QueryElevationComponent$ElevationComparatorSource$FieldComparator<Integer>",7,0.07,2.29,45,0.67,26997.69,12,5,43,23,8,113.54,3,62,0,1,113.54,0.00,0.00,0.26,0,10.00,7,2009.80,0,2,8,java.lang.Object,0.00,16,0,16,0,16,5,0,3,390,0
"org.apache.solr.handler.component.QueryElevationComponent$ElevationObj",1,4.00,4.00,35,0.53,34269.54,8,7,43,14,4,127.37,1,37,0,1,77.37,0.00,0.00,0.43,0,0.00,4,1594.44,0,0,4,java.lang.Object,0.00,13,0,4,0,13,1,0,1,281,0
"org.apache.solr.handler.component.QueryElevationComponentTest",12,0.00,1.08,208,3.81,163577.83,12,0,19,50,12,142.52,17,353,0,3,92.52,0.00,0.67,0.00,3,50.00,2,11421.17,10,0,12,org.apache.solr.SolrTestCaseJ4,0.04,38,2,13,0,38,12,0,17,1885,1
"org.apache.solr.handler.component.RealTimeGetComponent",12,0.36,4.17,169,2.72,235597.20,14,2,31,83,27,134.00,24,228,2,2,94.11,0.00,0.50,0.17,4,30.00,22,8160.80,0,7,26,org.apache.solr.handler.component.SearchComponent,0.52,71,1,50,0,71,5,0,24,1321,1
"org.apache.solr.handler.component.ResponseBuilder",45,0.01,1.22,179,2.17,70435.66,100,55,24,73,61,178.00,54,239,41,1,128.00,0.00,0.00,0.01,7,1099.00,4,6498.24,0,12,23,java.lang.Object,0.00,28,0,55,0,28,33,0,30,1277,1
"org.apache.solr.handler.component.ResponseBuilder$GlobalCollectionStat",1,2.00,1.00,6,0.06,952.18,3,2,24,1,0,118.52,0,8,0,1,118.52,0.00,0.00,0.00,0,1.00,1,178.04,0,0,0,java.lang.Object,0.00,0,0,1,0,0,1,0,0,45,2
"org.apache.solr.handler.component.SearchComponent",15,0.00,1.00,22,0.16,1379.76,15,0,6,18,29,195.42,32,34,24,1,155.54,0.00,0.00,0.00,0,15.00,1,468.80,0,7,6,java.lang.Object,0.00,3,0,15,12,3,8,2,11,148,2
"org.apache.solr.handler.component.SearchHandler",9,0.04,5.33,171,2.70,237424.27,16,7,18,71,32,88.33,43,221,5,2,88.10,2.00,0.25,0.17,1,13.00,28,8103.49,0,6,27,org.apache.solr.handler.RequestHandlerBase,0.38,62,1,48,2,62,3,2,35,1274,1
"org.apache.solr.handler.component.SearchHandler$CloseHook",2,0.00,1.00,4,0.03,278.39,2,0,18,2,1,142.89,0,8,0,1,142.89,0.00,0.00,0.00,0,2.00,1,95.21,0,0,1,java.lang.Object,0.00,0,0,2,0,0,2,0,0,29,0
"org.apache.solr.handler.component.SearchHandlerTest",2,0.00,1.00,42,0.78,64254.15,2,0,7,18,8,106.80,7,54,0,3,86.19,0.00,0.67,0.00,0,2.00,1,2345.20,1,0,8,org.apache.solr.SolrTestCaseJ4,0.00,16,2,2,0,16,2,0,7,420,1
"org.apache.solr.handler.component.ShardDoc",5,0.11,2.00,24,0.30,8185.74,12,7,11,8,24,162.96,14,38,18,3,123.07,0.00,0.67,0.23,0,2.00,5,890.49,0,1,6,org.apache.lucene.search.FieldDoc,0.25,3,2,10,0,3,4,0,14,202,1
"org.apache.solr.handler.component.ShardFieldSortedHitQueue",7,0.17,2.71,61,0.81,52887.00,10,3,11,21,8,127.16,24,82,1,2,106.54,0.00,0.50,0.19,0,13.00,6,2430.91,0,5,7,org.apache.lucene.util.PriorityQueue,0.00,14,1,19,0,14,2,0,24,477,0
"org.apache.solr.handler.component.ShardFieldSortedHitQueue$Comparator",1,0.00,3.00,9,0.10,3634.02,1,0,11,1,1,107.11,0,12,0,1,107.11,0.00,0.00,0.00,0,1.00,3,299.43,0,0,1,java.lang.Object,0.00,0,0,3,0,0,1,0,0,66,0
"org.apache.solr.handler.component.ShardFieldSortedHitQueue$ShardComparator",3,0.25,1.67,19,0.17,3919.36,5,2,11,7,1,117.32,0,22,0,1,117.32,0.00,0.00,0.33,0,5.00,3,521.29,0,1,1,java.lang.Object,0.00,4,0,5,0,4,2,1,0,123,0
"org.apache.solr.handler.component.ShardFieldSortedHitQueue$ShardComparator_0",1,0.00,4.00,10,0.13,5229.74,1,0,11,3,1,104.10,0,15,0,1,104.10,0.00,0.00,0.00,0,1.00,4,400.25,0,0,1,java.lang.Object,0.00,2,0,4,0,2,1,0,0,85,0
"org.apache.solr.handler.component.ShardFieldSortedHitQueue$ShardComparator_1",1,0.00,4.00,10,0.14,5433.78,1,0,11,3,1,103.97,0,15,0,1,103.97,0.00,0.00,0.00,0,1.00,4,405.11,0,0,1,java.lang.Object,0.00,2,0,4,0,2,1,0,0,86,0
"org.apache.solr.handler.component.ShardFieldSortedHitQueue$ShardComparator_2",1,0.00,4.00,10,0.13,5229.74,1,0,11,3,1,104.10,0,15,0,1,104.10,0.00,0.00,0.00,0,1.00,4,400.25,0,0,1,java.lang.Object,0.00,2,0,4,0,2,1,0,0,85,0
"org.apache.solr.handler.component.ShardHandler",5,0.00,1.00,6,0.04,250.32,5,0,1,5,10,157.62,0,7,6,1,157.62,0.00,0.00,0.00,0,5.00,1,125.16,0,0,4,java.lang.Object,0.00,0,0,5,1,0,5,0,0,43,2
"org.apache.solr.handler.component.ShardHandlerFactory",2,0.00,1.00,3,0.01,85.26,2,0,0,2,6,110.06,16,4,5,1,158.17,0.00,0.00,0.00,0,2.00,1,42.63,0,1,1,java.lang.Object,0.00,0,0,2,1,0,1,0,1,17,2
"org.apache.solr.handler.component.ShardRequest",1,15.00,1.00,21,0.34,8077.22,19,18,3,4,30,40.91,9,27,29,1,90.91,0.00,0.00,0.17,0,0.00,1,1029.14,0,1,2,java.lang.Object,0.00,3,0,1,2,3,0,0,9,189,1
"org.apache.solr.handler.component.ShardResponse",12,0.05,1.08,31,0.24,2952.51,18,6,2,13,14,140.92,2,54,12,1,140.92,0.00,0.00,0.12,0,46.00,2,731.88,0,6,3,java.lang.Object,0.00,1,0,13,0,1,6,0,2,193,2
"org.apache.solr.handler.component.SimpleStats",4,0.08,4.75,75,1.24,79689.29,8,4,21,42,20,129.85,9,98,1,1,89.96,0.00,0.00,0.31,0,4.00,10,3711.45,0,3,19,java.lang.Object,0.00,38,0,19,0,38,1,0,9,617,0
"org.apache.solr.handler.component.SpellCheckComponent",20,0.04,4.45,346,6.23,413414.22,26,6,35,179,48,130.66,58,447,7,2,90.78,0.00,0.50,0.12,7,128.00,14,18699.07,1,9,41,org.apache.solr.handler.component.SearchComponent,0.40,159,1,89,0,159,11,2,37,3047,1
"org.apache.solr.handler.component.SpellCheckComponent$SpellCheckerListener",6,0.00,2.00,32,0.34,7202.67,10,4,35,12,5,120.52,2,50,0,1,120.52,0.00,0.00,0.25,1,10.00,6,1026.76,0,0,5,java.lang.Object,0.00,6,0,12,0,6,6,1,2,229,2
"org.apache.solr.handler.component.SpellCheckComponentTest",12,0.55,1.08,108,2.07,66553.05,13,1,17,46,16,105.90,10,169,0,3,105.90,0.00,0.67,0.50,0,18.00,2,6223.25,11,0,16,org.apache.solr.SolrTestCaseJ4,0.08,34,2,13,0,34,12,0,8,1134,1
"org.apache.solr.handler.component.SpellCheckMergeData",0,0.00,0.00,8,0.20,7544.34,7,7,7,2,5,171.00,6,9,2,1,171.00,0.00,0.00,0.00,0,0.00,0,603.55,0,0,3,java.lang.Object,0.00,2,0,0,0,2,0,0,6,123,1
"org.apache.solr.handler.component.StatsComponent",10,1.00,2.20,62,0.93,38287.26,11,1,21,32,24,163.58,16,89,2,2,113.58,0.00,0.50,0.00,0,10.00,5,2791.25,0,4,22,org.apache.solr.handler.component.SearchComponent,0.64,22,1,22,0,22,6,0,11,540,1
"org.apache.solr.handler.component.StatsComponentTest",14,0.00,1.14,129,2.31,45827.61,14,0,14,25,7,107.69,9,257,0,3,107.69,0.00,0.67,0.00,5,26.00,3,6918.82,5,2,7,org.apache.solr.util.AbstractSolrTestCase,0.19,11,2,16,0,11,12,0,7,1245,1
"org.apache.solr.handler.component.StatsInfo",1,0.00,3.00,10,0.13,3361.64,2,1,21,7,20,105.67,0,13,2,1,105.67,0.00,0.00,1.00,0,0.00,3,394.11,0,0,19,java.lang.Object,0.00,6,0,3,0,6,1,0,0,80,0
"org.apache.solr.handler.component.StatsValues",7,0.00,1.00,8,0.05,237.55,7,0,3,7,9,141.07,38,9,7,1,158.95,0.00,0.00,0.00,0,7.00,1,149.69,0,1,2,,0.00,0,0,7,0,0,6,0,8,54,1
"org.apache.solr.handler.component.StatsValuesFactory",1,0.00,4.00,11,0.30,13820.60,1,0,8,8,24,49.23,9,24,5,1,99.23,0.00,0.00,0.00,0,1.00,4,897.89,0,0,19,java.lang.Object,0.00,7,0,4,0,7,1,0,2,167,1
"org.apache.solr.handler.component.StringStatsValues",8,0.00,1.75,22,0.21,7532.46,8,0,8,9,7,136.46,33,33,1,2,136.22,0.00,0.50,0.00,0,8.00,4,637.87,0,2,6,org.apache.solr.handler.component.AbstractStatsValues,0.00,1,1,14,0,1,6,0,11,168,0
"org.apache.solr.handler.component.TermVectorComponent",12,0.30,4.75,218,3.92,388384.32,15,3,31,88,30,70.43,61,275,1,2,88.30,0.00,0.50,0.06,2,22.00,25,11764.16,1,5,29,org.apache.solr.handler.component.SearchComponent,0.30,76,1,57,0,76,7,1,25,1795,1
"org.apache.solr.handler.component.TermVectorComponent$StoredFieldVisitor",4,0.00,1.25,9,0.14,2086.37,4,0,31,8,1,138.32,0,17,0,1,138.32,0.00,0.00,0.00,0,4.00,2,425.42,0,1,1,java.lang.Object,0.00,4,0,5,0,4,3,0,0,102,0
"org.apache.solr.handler.component.TermVectorComponentTest",5,0.50,2.20,77,1.87,105614.01,6,1,13,31,11,75.02,28,176,0,3,92.89,0.00,0.67,0.60,0,4.00,5,5620.67,6,0,11,org.apache.solr.SolrTestCaseJ4,0.00,26,2,11,0,26,5,0,10,925,1
"org.apache.solr.handler.component.TermsComponent",11,0.50,5.00,165,2.91,303636.51,13,2,21,67,23,112.40,40,217,1,2,91.79,0.00,0.50,0.05,1,20.00,31,8716.40,0,5,22,org.apache.solr.handler.component.SearchComponent,0.31,56,1,55,0,56,6,0,22,1392,1
"org.apache.solr.handler.component.TermsComponent$TermsHelper",7,0.17,3.57,75,1.13,72497.31,9,2,21,30,5,141.67,16,95,0,1,101.79,0.00,0.00,0.36,0,3.00,11,3386.83,0,4,5,java.lang.Object,0.00,23,0,25,0,23,3,0,16,627,1
"org.apache.solr.handler.component.TermsComponent$TermsHelper$Comparator<TermsResponse.Term>",1,0.00,1.00,3,0.04,568.17,1,0,21,3,0,131.51,0,4,0,1,131.51,0.00,0.00,0.00,0,1.00,1,127.52,0,0,0,java.lang.Object,0.00,2,0,1,0,2,1,0,0,35,0
"org.apache.solr.handler.component.TermsComponent$TermsHelper$Comparator<TermsResponse.Term>_0",1,0.00,3.00,10,0.11,3437.55,1,0,21,4,0,105.60,0,12,0,1,105.60,0.00,0.00,0.00,0,1.00,3,321.97,0,0,0,java.lang.Object,0.00,3,0,3,0,3,1,0,0,73,0
"org.apache.solr.handler.component.TermsComponentTest",14,0.00,1.00,63,1.70,46164.16,14,0,6,21,4,120.84,8,212,0,3,120.84,0.00,0.67,0.00,0,26.00,1,5089.55,5,0,4,org.apache.solr.SolrTestCaseJ4,0.00,7,2,14,0,7,14,0,5,944,1
"org.apache.lucene.spatial.prefix.tree.GeohashPrefixTree",7,0.00,1.43,22,0.35,8994.99,7,0,8,17,6,128.64,6,39,4,2,128.64,0.00,0.50,0.00,1,12.00,3,1048.46,2,4,2,org.apache.lucene.spatial.prefix.tree.SpatialPrefixTree,0.17,10,1,10,0,10,3,0,4,237,1
"org.apache.lucene.spatial.prefix.tree.GeohashPrefixTree$Factory",2,0.00,1.50,6,0.09,1891.97,2,0,8,5,3,129.67,1,12,0,2,129.67,0.00,0.50,0.00,0,0.00,2,255.58,0,1,3,org.apache.lucene.spatial.prefix.tree.SpatialPrefixTreeFactory,0.57,3,1,3,0,3,1,0,1,62,2
"org.apache.lucene.spatial.prefix.tree.GeohashPrefixTree$GhCell",9,0.88,1.22,28,0.29,5897.99,10,1,8,16,2,130.98,4,44,0,2,130.98,0.00,0.50,0.22,1,19.00,2,880.33,2,5,2,org.apache.lucene.spatial.prefix.tree.Node,0.34,7,1,11,0,7,4,0,4,213,0
"org.apache.lucene.spatial.prefix.tree.Node",20,0.02,1.65,86,0.94,26831.83,27,7,7,39,11,163.68,45,116,11,1,123.80,0.00,0.00,0.16,8,142.00,5,2812.25,0,8,1,java.lang.Object,0.00,19,0,33,2,19,12,1,17,628,2
"org.apache.lucene.spatial.prefix.tree.QuadPrefixTree",11,0.08,1.73,102,1.57,76977.31,25,14,10,37,5,155.00,17,138,3,2,105.00,0.00,0.50,0.14,2,34.00,4,4717.59,2,4,2,org.apache.lucene.spatial.prefix.tree.SpatialPrefixTree,0.15,26,1,19,0,26,7,0,17,900,1
"org.apache.lucene.spatial.prefix.tree.QuadPrefixTree$Factory",2,0.00,1.50,6,0.08,1504.04,2,0,10,4,3,130.46,1,12,0,2,130.46,0.00,0.50,0.00,0,0.00,2,228.23,0,1,3,org.apache.lucene.spatial.prefix.tree.SpatialPrefixTreeFactory,0.57,2,1,3,0,2,1,0,1,56,2
"org.apache.lucene.spatial.prefix.tree.QuadPrefixTree$QuadCell",9,0.88,1.78,54,0.68,34796.68,10,1,10,17,2,113.59,3,70,0,2,113.59,0.00,0.50,0.22,0,26.00,7,2032.54,2,4,2,org.apache.lucene.spatial.prefix.tree.Node,0.28,8,1,16,0,8,5,0,3,411,0
"org.apache.lucene.spatial.prefix.tree.SpatialPrefixTree",16,0.15,2.44,109,1.32,63598.20,20,4,8,47,12,134.04,58,141,12,1,113.42,0.00,0.00,0.11,5,72.00,8,3968.29,0,10,1,java.lang.Object,0.00,31,0,39,2,31,6,0,16,803,2
"org.apache.lucene.spatial.prefix.tree.SpatialPrefixTreeFactory",5,0.06,2.60,36,0.51,18856.46,9,4,4,22,4,150.98,11,51,3,1,111.09,0.00,0.00,0.20,1,8.00,6,1527.26,0,2,1,java.lang.Object,0.00,17,0,13,2,17,3,0,6,297,2
"org.apache.lucene.spatial.prefix.tree.SpatialPrefixTreeTest",2,1.00,1.50,21,0.30,8883.81,4,2,6,15,3,154.88,2,27,0,2,104.88,0.00,0.50,1.00,0,0.00,2,885.19,1,0,3,org.apache.lucene.util.LuceneTestCase,0.00,13,1,3,0,13,2,0,2,177,1
"org.apache.lucene.analysis.miscellaneous.ASCIIFoldingFilter",4,0.11,60.00,706,25.69,1402237.44,7,3,6,9,15,46.93,1294,1960,10,4,42.63,0.00,0.75,0.42,1,4.00,233,77084.65,0,0,5,org.apache.lucene.analysis.TokenFilter,0.25,5,3,240,0,5,4,0,1249,7499,2
"org.apache.lucene.analysis.miscellaneous.CapitalizationFilter",4,0.23,6.25,85,1.02,80633.24,14,10,6,12,8,39.26,34,100,4,4,87.36,0.00,0.75,0.28,1,6.00,14,3049.66,0,0,4,org.apache.lucene.analysis.TokenFilter,0.25,8,3,25,0,8,4,0,9,567,2
"org.apache.lucene.analysis.miscellaneous.Deprecated",8,0.16,3.62,77,2.19,85639.57,17,9,16,31,9,102.90,134,150,1,2,103.38,0.00,0.50,0.25,3,16.00,5,6560.46,0,3,8,org.apache.lucene.analysis.Analyzer,0.00,23,1,29,0,23,5,0,34,1029,2
"org.apache.lucene.analysis.miscellaneous.Deprecated$FastStringReader",2,1.00,1.00,7,0.04,396.02,3,1,16,2,0,135.12,0,10,0,2,135.12,0.00,0.50,0.50,0,2.00,1,114.45,0,1,0,java.io.StringReader,0.00,0,1,2,0,0,1,0,0,35,2
"org.apache.lucene.analysis.miscellaneous.Deprecated$FastStringTokenizer",7,0.04,1.86,53,0.64,24296.89,15,8,16,19,4,151.34,14,70,0,4,111.45,0.00,0.75,0.16,0,18.00,6,1933.83,2,0,4,org.apache.lucene.analysis.Tokenizer,0.57,12,3,13,0,12,7,0,14,398,3
"org.apache.lucene.analysis.miscellaneous.Deprecated$PatternTokenizer",5,0.12,2.20,45,0.54,16218.54,13,8,16,18,3,107.57,4,58,0,4,107.57,0.00,0.75,0.22,0,10.00,7,1618.23,2,0,3,org.apache.lucene.analysis.Tokenizer,0.63,13,3,11,0,13,5,0,4,335,3
"org.apache.lucene.analysis.miscellaneous.EmptyTokenStream",1,0.00,1.00,3,0.02,297.80,1,0,2,1,2,154.34,3,6,1,3,133.72,0.00,0.67,0.00,0,1.00,1,71.46,0,0,1,org.apache.lucene.analysis.TokenStream,0.33,0,2,1,0,0,1,0,1,21,2
"org.apache.lucene.analysis.miscellaneous.HyphenatedWordsFilter",4,0.61,2.50,47,0.52,19883.92,10,6,4,17,8,65.27,50,59,4,4,102.83,0.00,0.75,0.62,1,0.00,6,1560.37,1,0,4,org.apache.lucene.analysis.TokenFilter,0.50,13,3,10,0,13,4,0,12,311,2
"org.apache.lucene.analysis.miscellaneous.KeepWordFilter",2,0.00,1.00,8,0.10,1439.84,4,2,6,5,8,126.28,8,12,3,5,126.04,0.00,0.80,0.50,0,2.00,1,288.48,0,0,5,org.apache.lucene.analysis.util.FilteringTokenFilter,0.25,3,4,2,0,3,2,0,2,71,2
"org.apache.lucene.analysis.miscellaneous.KeywordMarkerFilter",2,0.33,2.00,14,0.15,3000.38,5,3,6,7,67,66.20,17,20,62,4,114.31,0.00,0.75,0.50,0,2.00,3,458.94,0,0,5,org.apache.lucene.analysis.TokenFilter,0.29,5,3,4,0,5,2,0,2,105,2
"org.apache.lucene.analysis.miscellaneous.LengthFilter",2,0.33,1.00,11,0.13,2542.82,5,3,5,3,7,102.61,10,15,3,5,120.48,0.00,0.80,0.50,0,2.00,1,376.45,0,0,4,org.apache.lucene.analysis.util.FilteringTokenFilter,0.25,1,4,2,0,1,2,0,2,89,2
"org.apache.lucene.analysis.miscellaneous.LimitTokenCountAnalyzer",4,0.00,1.00,12,0.13,1969.11,6,2,2,9,4,182.00,7,21,1,3,132.00,0.00,0.67,0.50,0,2.00,1,397.54,0,3,3,org.apache.lucene.analysis.AnalyzerWrapper,0.00,5,2,4,0,5,1,0,2,103,2
"org.apache.lucene.analysis.miscellaneous.LimitTokenCountFilter",3,0.00,1.33,14,0.12,2076.73,5,2,3,4,4,165.99,7,21,2,4,126.11,0.00,0.75,0.50,0,1.00,2,348.76,1,0,2,org.apache.lucene.analysis.TokenFilter,0.53,1,3,4,0,1,3,0,2,87,2
"org.apache.lucene.analysis.miscellaneous.PatternAnalyzerTest",7,0.00,1.57,52,0.83,21485.39,7,0,9,25,4,79.69,43,81,0,3,111.91,0.00,0.67,0.00,1,7.00,4,2500.85,3,0,4,org.apache.lucene.analysis.BaseTokenStreamTestCase,0.00,18,2,11,0,18,7,0,22,497,1
"org.apache.lucene.analysis.miscellaneous.PatternAnalyzerTest$Thread.UncaughtExceptionHandler",1,0.00,1.00,4,0.04,604.19,1,0,9,3,0,176.64,1,6,0,1,126.64,0.00,0.00,0.00,0,1.00,1,128.10,0,0,0,java.lang.Object,0.00,2,0,1,0,2,1,0,1,33,0
"org.apache.lucene.analysis.miscellaneous.PerFieldAnalyzerWrapper",5,0.12,1.40,15,0.18,3886.15,7,2,4,6,3,88.07,38,25,1,3,130.36,0.00,0.67,0.40,0,7.00,2,549.16,0,3,2,org.apache.lucene.analysis.AnalyzerWrapper,0.00,1,2,7,0,1,2,0,3,135,2
"org.apache.lucene.analysis.miscellaneous.PrefixAndSuffixAwareTokenFilter",7,0.50,1.00,22,0.22,4324.64,8,1,3,16,6,131.22,6,34,3,3,131.22,0.00,0.67,0.57,0,3.00,1,656.55,0,2,3,org.apache.lucene.analysis.TokenStream,0.80,9,2,7,0,9,5,0,1,175,1
"org.apache.lucene.analysis.miscellaneous.PrefixAndSuffixAwareTokenFilter$PrefixAwareTokenFilter",1,0.00,1.00,3,0.03,512.11,1,0,3,2,2,131.87,0,5,0,1,131.87,0.00,0.00,0.00,0,1.00,1,101.46,0,1,2,java.lang.Object,0.00,1,0,1,0,1,0,0,0,28,0
"org.apache.lucene.analysis.miscellaneous.PrefixAndSuffixAwareTokenFilter$PrefixAwareTokenFilter_0",1,0.00,1.00,3,0.03,567.72,1,0,3,2,2,131.51,0,5,0,1,131.51,0.00,0.00,0.00,0,1.00,1,99.27,0,1,2,java.lang.Object,0.00,1,0,1,0,1,0,0,0,28,0
"org.apache.lucene.analysis.miscellaneous.PrefixAwareTokenFilter",13,0.16,1.69,105,1.22,28262.52,30,17,10,52,11,160.91,17,129,2,3,110.91,0.00,0.67,0.20,3,27.00,5,3655.68,1,5,9,org.apache.lucene.analysis.TokenStream,0.57,39,2,22,0,39,8,0,3,751,1
"org.apache.lucene.analysis.miscellaneous.RemoveDuplicatesTokenFilter",3,0.17,2.00,23,0.30,12272.26,6,3,7,11,9,93.00,16,32,4,4,110.87,0.00,0.75,0.44,0,1.00,4,903.09,1,0,5,org.apache.lucene.analysis.TokenFilter,0.53,8,3,6,0,8,3,0,6,184,2
"org.apache.lucene.analysis.miscellaneous.SingleTokenTokenStream",5,0.08,1.20,24,0.21,3737.22,8,3,5,9,8,125.87,4,33,4,3,125.87,0.00,0.67,0.40,0,5.00,2,625.67,0,1,4,org.apache.lucene.analysis.TokenStream,0.46,4,2,6,0,4,4,0,2,150,2
"org.apache.lucene.analysis.miscellaneous.StemmerOverrideFilter",2,0.33,2.50,17,0.22,5325.66,5,3,7,11,8,77.91,13,25,3,4,110.13,0.00,0.75,0.50,0,2.00,4,658.53,0,0,5,org.apache.lucene.analysis.TokenFilter,0.29,9,3,5,0,9,2,0,3,139,2
"org.apache.lucene.analysis.miscellaneous.TestASCIIFoldingFilter",5,0.00,1.80,118,10.56,354487.44,5,0,13,26,8,120.50,1529,1597,0,3,81.87,0.00,0.67,0.00,1,5.00,5,31677.96,2,0,8,org.apache.lucene.analysis.BaseTokenStreamTestCase,0.00,21,2,9,0,21,5,0,1529,3256,1
"org.apache.lucene.analysis.miscellaneous.TestASCIIFoldingFilter$Analyzer",1,0.00,1.00,4,0.05,1009.20,1,0,13,4,3,124.89,0,6,0,1,124.89,0.00,0.00,0.00,0,1.00,1,159.62,0,1,3,java.lang.Object,0.00,3,0,1,0,3,0,0,0,38,0
"org.apache.lucene.analysis.miscellaneous.TestASCIIFoldingFilter$Analyzer_0",1,0.00,1.00,4,0.05,753.46,1,0,13,4,3,125.89,0,6,0,1,125.89,0.00,0.00,0.00,0,1.00,1,135.44,0,1,3,java.lang.Object,0.00,3,0,1,0,3,0,0,0,34,0
"org.apache.lucene.analysis.miscellaneous.TestCapitalizationFilter",6,0.00,1.00,43,0.83,35585.02,6,0,14,15,7,159.76,8,71,0,3,109.76,0.00,0.67,0.00,2,6.00,1,2501.86,3,0,7,org.apache.lucene.analysis.BaseTokenStreamTestCase,0.00,9,2,6,0,9,6,0,8,459,1
"org.apache.lucene.analysis.miscellaneous.TestCapitalizationFilter$Analyzer",1,0.00,1.00,4,0.05,1009.20,1,0,14,4,3,124.89,0,6,0,1,124.89,0.00,0.00,0.00,0,1.00,1,159.62,0,1,3,java.lang.Object,0.00,3,0,1,0,3,0,0,0,38,0
"org.apache.lucene.analysis.miscellaneous.TestCapitalizationFilter$Analyzer_0",1,0.00,1.00,4,0.05,753.46,1,0,14,4,3,125.89,0,6,0,1,125.89,0.00,0.00,0.00,0,1.00,1,135.44,0,1,3,java.lang.Object,0.00,3,0,1,0,3,0,0,0,34,0
"org.apache.lucene.analysis.miscellaneous.TestEmptyTokenStream",1,0.00,1.00,6,0.05,870.31,1,0,3,5,2,118.82,0,8,0,2,118.82,0.00,0.50,0.00,0,1.00,1,150.40,0,0,2,org.apache.lucene.util.LuceneTestCase,0.00,4,1,1,0,4,1,0,0,39,1
"org.apache.lucene.analysis.miscellaneous.TestHyphenatedWordsFilter",5,0.00,1.00,24,0.30,5033.71,5,0,9,10,7,174.89,9,33,0,3,124.89,0.00,0.67,0.00,0,5.00,1,901.46,3,0,7,org.apache.lucene.analysis.BaseTokenStreamTestCase,0.00,5,2,5,0,5,5,0,5,195,1
"org.apache.lucene.analysis.miscellaneous.TestHyphenatedWordsFilter$Analyzer",1,0.00,1.00,4,0.05,1009.20,1,0,9,4,3,124.89,0,6,0,1,124.89,0.00,0.00,0.00,0,1.00,1,159.62,0,1,3,java.lang.Object,0.00,3,0,1,0,3,0,0,0,38,0
"org.apache.lucene.analysis.miscellaneous.TestHyphenatedWordsFilter$Analyzer_0",1,0.00,1.00,4,0.05,753.46,1,0,9,4,3,125.89,0,6,0,1,125.89,0.00,0.00,0.00,0,1.00,1,135.44,0,1,3,java.lang.Object,0.00,3,0,1,0,3,0,0,0,34,0
"org.apache.lucene.analysis.miscellaneous.TestKeepWordFilter",2,0.00,1.00,28,0.45,24845.05,2,0,10,9,7,116.62,6,28,0,3,96.01,0.00,0.67,0.00,0,2.00,1,1341.78,2,0,7,org.apache.lucene.analysis.BaseTokenStreamTestCase,0.00,7,2,2,0,7,2,0,6,261,1
"org.apache.lucene.analysis.miscellaneous.TestKeepWordFilter$Analyzer",1,0.00,1.00,5,0.08,1426.12,1,0,10,5,5,120.09,0,7,0,1,120.09,0.00,0.00,0.00,0,1.00,1,229.14,0,1,5,java.lang.Object,0.00,4,0,1,0,4,0,0,0,50,0
"org.apache.lucene.analysis.miscellaneous.TestKeywordMarkerFilter",2,0.00,1.00,14,0.33,9541.80,2,0,11,8,8,62.03,20,30,0,3,110.51,0.00,0.67,0.00,0,2.00,1,995.93,1,0,8,org.apache.lucene.analysis.BaseTokenStreamTestCase,0.00,6,2,2,0,6,2,0,3,198,1
"org.apache.lucene.analysis.miscellaneous.TestKeywordMarkerFilter$LowerCaseFilterMock",2,0.00,2.00,12,0.14,3102.55,4,2,11,8,4,116.69,0,18,0,4,116.69,0.00,0.75,0.50,0,2.00,3,433.32,0,0,4,org.apache.lucene.analysis.TokenFilter,0.29,6,3,4,0,6,2,0,0,97,3
"org.apache.lucene.analysis.miscellaneous.TestLengthFilter",3,0.00,1.00,14,0.19,3172.13,3,0,5,7,6,124.73,0,24,0,3,124.73,0.00,0.67,0.00,0,3.00,1,583.67,2,0,6,org.apache.lucene.analysis.BaseTokenStreamTestCase,0.00,4,2,3,0,4,3,0,0,125,1
"org.apache.lucene.analysis.miscellaneous.TestLengthFilter$Analyzer",1,0.00,1.00,4,0.05,810.88,1,0,5,4,3,125.63,0,6,0,1,125.63,0.00,0.00,0.00,0,1.00,1,155.16,0,1,3,java.lang.Object,0.00,3,0,1,0,3,0,0,0,37,0
"org.apache.lucene.analysis.miscellaneous.TestLimitTokenCountAnalyzer",2,0.00,1.50,35,0.47,13927.13,2,0,14,25,13,144.75,2,27,0,3,94.75,0.00,0.67,0.00,0,2.00,2,1409.24,1,0,13,org.apache.lucene.analysis.BaseTokenStreamTestCase,0.00,23,2,3,0,23,2,0,2,264,1
"org.apache.lucene.analysis.miscellaneous.TestPerFieldAnalzyerWrapper",1,0.00,1.00,16,0.25,8463.94,1,0,7,14,7,94.68,16,25,0,3,95.16,0.00,0.67,0.00,0,1.00,1,758.91,0,0,7,org.apache.lucene.analysis.BaseTokenStreamTestCase,0.00,13,2,1,0,13,1,0,1,143,1
"org.apache.lucene.analysis.miscellaneous.TestPrefixAndSuffixAwareTokenFilter",2,0.00,1.00,8,0.15,3120.40,2,0,5,7,5,123.40,0,16,0,3,123.40,0.00,0.67,0.00,1,2.00,1,436.66,1,1,5,org.apache.lucene.analysis.BaseTokenStreamTestCase,0.00,5,2,2,0,5,1,0,0,95,1
"org.apache.lucene.analysis.miscellaneous.TestPrefixAwareTokenFilter",2,0.00,1.00,14,0.24,7425.94,2,0,5,7,5,111.37,1,23,0,3,111.37,0.00,0.67,0.00,1,2.00,1,722.39,1,1,5,org.apache.lucene.analysis.BaseTokenStreamTestCase,0.00,5,2,2,0,5,1,0,1,148,1
"org.apache.lucene.analysis.miscellaneous.TestRemoveDuplicatesTokenFilter",10,0.00,1.40,44,0.76,17998.25,10,0,18,30,15,122.83,2,89,0,3,122.83,0.00,0.67,0.00,3,10.00,3,2280.44,3,3,15,org.apache.lucene.analysis.BaseTokenStreamTestCase,0.00,20,2,14,0,20,7,0,2,486,1
"org.apache.lucene.analysis.miscellaneous.TestRemoveDuplicatesTokenFilter$Analyzer",1,0.00,1.00,5,0.07,1319.59,1,0,18,5,4,120.35,0,7,0,1,120.35,0.00,0.00,0.00,0,1.00,1,217.22,0,1,4,java.lang.Object,0.00,4,0,1,0,4,0,0,0,48,0
"org.apache.lucene.analysis.miscellaneous.TestRemoveDuplicatesTokenFilter$Analyzer_0",1,0.00,1.00,4,0.05,753.46,1,0,18,4,3,125.89,0,6,0,1,125.89,0.00,0.00,0.00,0,1.00,1,135.44,0,1,3,java.lang.Object,0.00,3,0,1,0,3,0,0,0,34,0
"org.apache.lucene.analysis.miscellaneous.TestRemoveDuplicatesTokenFilter$TokenStream",1,0.00,2.00,14,0.15,2847.86,4,3,18,11,4,100.88,0,17,0,1,100.88,0.00,0.00,1.00,0,0.00,2,458.76,0,0,4,java.lang.Object,0.00,10,0,2,0,10,1,0,0,100,0
"org.apache.lucene.analysis.miscellaneous.TestSingleTokenTokenFilter",1,0.00,1.00,16,0.18,6223.76,1,0,5,10,4,96.21,0,18,0,2,96.21,0.00,0.50,0.00,0,1.00,1,535.70,0,0,4,org.apache.lucene.util.LuceneTestCase,0.00,9,1,1,0,9,1,0,0,111,1
"org.apache.lucene.analysis.miscellaneous.TestStemmerOverrideFilter",1,0.00,1.00,7,0.11,2588.52,1,0,8,7,7,138.88,19,10,0,3,112.60,0.00,0.67,0.00,0,1.00,1,330.51,1,0,7,org.apache.lucene.analysis.BaseTokenStreamTestCase,0.00,6,2,1,0,6,1,0,4,69,1
"org.apache.lucene.analysis.miscellaneous.TestTrimFilter",3,0.00,1.00,29,0.56,21722.09,3,0,11,10,9,144.90,6,43,0,3,105.01,0.00,0.67,0.00,0,3.00,1,1667.50,3,0,9,org.apache.lucene.analysis.BaseTokenStreamTestCase,0.00,7,2,3,0,7,3,0,3,312,1
"org.apache.lucene.analysis.miscellaneous.TestTrimFilter$Analyzer",1,0.00,1.00,4,0.05,1092.55,1,0,11,4,3,124.61,0,6,0,1,124.61,0.00,0.00,0.00,0,1.00,1,164.08,0,1,3,java.lang.Object,0.00,3,0,1,0,3,0,0,0,39,0
"org.apache.lucene.analysis.miscellaneous.TestTrimFilter$Analyzer_0",1,0.00,1.00,4,0.06,1029.80,1,0,11,4,3,124.82,0,6,0,1,124.82,0.00,0.00,0.00,0,1.00,1,166.32,0,1,3,java.lang.Object,0.00,3,0,1,0,3,0,0,0,39,0
"org.apache.lucene.analysis.miscellaneous.TestTrimFilter$Analyzer_1",1,0.00,1.00,4,0.05,956.71,1,0,11,5,3,125.07,0,6,0,1,125.07,0.00,0.00,0.00,0,1.00,1,159.62,0,1,3,java.lang.Object,0.00,4,0,1,0,4,0,0,0,38,0
"org.apache.lucene.analysis.miscellaneous.TestTrimFilter$Deprecated",3,0.31,1.33,25,0.36,9551.86,11,8,11,19,8,109.66,0,33,0,3,109.66,0.00,0.67,0.33,0,4.00,2,1079.23,0,0,8,org.apache.lucene.analysis.TokenStream,0.27,16,2,4,0,16,3,0,0,215,2
"org.apache.lucene.analysis.miscellaneous.TestWordDelimiterFilter",12,0.00,1.42,130,2.04,86440.66,12,0,17,25,14,103.48,51,158,0,3,103.24,0.00,0.67,0.00,2,12.00,3,6131.06,4,0,14,org.apache.lucene.analysis.BaseTokenStreamTestCase,0.00,13,2,17,0,13,12,0,27,1119,1
"org.apache.lucene.analysis.miscellaneous.TestWordDelimiterFilter$Analyzer",1,0.00,1.00,4,0.06,1051.87,1,0,17,4,3,124.74,0,8,0,1,124.74,0.00,0.00,0.00,0,1.00,1,173.06,0,1,3,java.lang.Object,0.00,3,0,1,0,3,0,0,0,40,0
"org.apache.lucene.analysis.miscellaneous.TestWordDelimiterFilter$Analyzer_0",1,0.00,1.00,4,0.06,1132.62,1,0,17,5,3,124.49,0,8,0,1,124.49,0.00,0.00,0.00,0,1.00,1,189.11,0,1,3,java.lang.Object,0.00,4,0,1,0,4,0,0,0,43,0
"org.apache.lucene.analysis.miscellaneous.TestWordDelimiterFilter$Analyzer_1",1,0.00,1.00,6,0.09,1708.36,1,0,17,6,5,116.52,0,9,0,1,116.52,0.00,0.00,0.00,0,1.00,1,275.53,0,1,5,java.lang.Object,0.00,5,0,1,0,5,0,0,0,58,0
"org.apache.lucene.analysis.miscellaneous.TestWordDelimiterFilter$Analyzer_2",1,0.00,1.00,4,0.06,1051.87,1,0,17,4,3,124.74,0,6,0,1,124.74,0.00,0.00,0.00,0,1.00,1,173.06,0,1,3,java.lang.Object,0.00,3,0,1,0,3,0,0,0,40,0
"org.apache.lucene.analysis.miscellaneous.TestWordDelimiterFilter$Analyzer_3",1,0.00,1.00,4,0.05,790.45,1,0,17,4,3,125.72,0,6,0,1,125.72,0.00,0.00,0.00,0,1.00,1,148.55,0,1,3,java.lang.Object,0.00,3,0,1,0,3,0,0,0,36,0
"org.apache.lucene.analysis.miscellaneous.TestWordDelimiterFilter$LargePosIncTokenFilter",2,0.00,2.00,11,0.13,2544.21,4,2,17,6,4,120.32,0,18,0,4,120.32,0.00,0.75,0.50,0,2.00,3,381.02,0,0,4,org.apache.lucene.analysis.TokenFilter,0.29,4,3,4,0,4,2,0,0,89,2
"org.apache.lucene.analysis.miscellaneous.TrimFilter",2,0.33,5.00,35,0.44,44678.70,5,3,5,10,10,90.72,8,39,6,4,90.48,0.00,0.75,0.50,0,2.00,9,1328.74,0,0,4,org.apache.lucene.analysis.TokenFilter,0.29,8,3,10,0,8,2,0,6,245,2
"org.apache.lucene.analysis.miscellaneous.WordDelimiterFilter",16,0.08,2.69,168,2.22,101180.75,50,34,10,43,17,65.98,202,214,7,4,103.54,0.00,0.75,0.10,8,182.00,20,6646.06,1,0,10,org.apache.lucene.analysis.TokenFilter,0.29,27,3,43,0,27,16,0,63,1215,2
"org.apache.lucene.analysis.miscellaneous.WordDelimiterFilter$WordDelimiterConcatenation",5,0.30,1.40,31,0.28,5013.73,10,5,10,12,0,118.50,21,40,0,1,118.26,0.00,0.00,0.44,2,0.00,3,841.30,0,0,0,java.lang.Object,0.00,7,0,7,0,7,5,0,5,189,1
"org.apache.lucene.analysis.miscellaneous.WordDelimiterIterator",0,0.00,0.00,110,1.67,338590.89,14,14,1,8,3,171.00,109,157,3,1,171.00,0.00,0.00,0.00,0,0.00,0,4995.27,0,0,0,java.lang.Object,0.00,8,0,0,0,8,0,0,47,766,2
"org.apache.lucene.collation.CollationAttributeFactory",3,0.25,1.67,10,0.13,2704.02,5,2,5,6,6,147.95,56,18,2,2,129.82,0.00,0.50,0.33,0,4.00,3,379.42,0,1,4,AttributeSource.AttributeFactory,0.00,3,1,5,0,3,2,0,3,94,1
"org.apache.lucene.collation.CollationKeyAnalyzer",3,0.00,1.33,18,0.19,4372.69,6,3,6,8,7,160.94,66,25,4,2,116.99,0.00,0.50,0.33,0,4.00,2,570.78,0,1,3,org.apache.lucene.analysis.Analyzer,0.00,5,1,4,0,5,2,0,3,132,2
"org.apache.lucene.collation.Deprecated",4,0.61,1.00,20,0.38,10841.45,10,6,6,10,3,157.78,9,38,0,3,117.89,0.00,0.67,0.62,4,0.00,1,1144.25,0,0,3,org.apache.lucene.analysis.CollationTestBase,0.00,6,2,4,0,6,4,0,9,239,1
"org.apache.lucene.collation.Deprecated$TestAnalyzer",2,0.00,1.00,7,0.07,972.01,3,1,6,5,2,132.05,0,11,0,2,132.05,0.00,0.50,1.00,0,0.00,1,202.49,0,1,2,org.apache.lucene.analysis.core.Analyzer,0.00,3,1,2,0,3,1,0,0,52,2
"org.apache.lucene.collation.ICUCollationAttributeFactory",3,0.25,1.67,10,0.13,2704.02,5,2,6,6,6,129.34,49,18,1,2,129.82,0.00,0.50,0.33,0,4.00,3,379.42,0,1,5,AttributeSource.AttributeFactory,0.00,3,1,5,0,3,2,0,3,94,1
"org.apache.lucene.collation.ICUCollationKeyAnalyzer",3,0.00,1.33,18,0.19,4372.69,6,3,7,8,6,143.28,58,24,2,2,116.99,0.00,0.50,0.33,0,4.00,2,570.78,0,1,4,org.apache.lucene.analysis.Analyzer,0.00,5,1,4,0,5,2,0,3,132,2
"org.apache.lucene.collation.TestCollationKeyAnalyzer",6,0.29,1.33,32,0.55,13723.81,13,7,6,18,5,168.41,8,50,0,3,118.41,0.00,0.67,0.38,4,10.00,2,1646.19,2,0,5,org.apache.lucene.analysis.CollationTestBase,0.00,12,2,8,0,12,6,0,8,336,1
"org.apache.lucene.collation.TestICUCollationKeyAnalyzer",6,0.30,1.17,32,0.50,11551.16,12,6,6,17,5,169.03,8,52,0,3,119.03,0.00,0.67,0.42,4,6.00,2,1495.20,2,0,5,org.apache.lucene.analysis.CollationTestBase,0.00,11,2,7,0,11,6,0,8,316,1
"org.apache.lucene.codecs.mockrandom.MockRandomPostingsFormat",5,0.12,8.80,173,3.01,281487.94,7,2,46,53,40,96.58,17,259,1,2,75.96,0.00,0.50,0.40,0,2.00,20,9016.45,0,2,39,org.apache.lucene.codecs.PostingsFormat,0.00,48,1,44,0,48,3,0,15,1396,1
"org.apache.lucene.codecs.mockrandom.MockRandomPostingsFormat$MockIntStreamFactory",4,0.33,1.50,24,0.45,11931.21,6,2,46,20,6,114.52,3,34,0,2,114.52,0.00,0.50,0.75,0,0.00,2,1345.77,0,3,6,org.apache.lucene.codecs.sep.IntStreamFactory,0.00,16,1,6,0,16,1,0,3,271,2
"org.apache.lucene.codecs.mockrandom.MockRandomPostingsFormat$VariableGapTermsIndexWriter.IndexTermSelector",2,1.00,1.00,5,0.06,845.64,3,1,46,4,3,139.09,0,9,0,1,139.09,0.00,0.00,0.50,0,2.00,1,188.46,0,0,3,java.lang.Object,0.00,2,0,2,0,2,2,0,0,49,0
"org.apache.solr.response.transform.BaseEditorialTransformer",5,0.08,1.80,34,0.35,10930.42,8,3,4,14,6,165.54,6,45,2,3,115.54,1.00,0.40,0.27,2,10.00,4,1041.74,0,3,4,org.apache.solr.response.transform.TransformerWithContext,0.30,9,2,9,2,9,2,0,3,228,2
"org.apache.solr.response.transform.DocIdAugmenter",3,0.50,1.33,9,0.07,949.51,4,1,3,4,5,133.45,0,19,1,2,133.45,0.00,0.50,0.67,0,1.00,2,214.00,0,1,4,org.apache.solr.response.transform.DocTransformer,0.29,1,1,4,0,1,2,0,0,58,0
"org.apache.solr.response.transform.DocIdAugmenterFactory",1,0.00,1.00,3,0.03,374.37,1,0,3,2,6,133.17,4,7,0,2,132.94,0.00,0.50,0.00,0,1.00,1,97.26,0,0,6,org.apache.solr.response.transform.TransformerFactory,0.00,1,1,1,0,1,1,0,1,26,1
"org.apache.solr.response.transform.DocTransformer",4,0.00,1.00,6,0.04,340.75,4,0,3,4,20,123.58,27,10,17,1,155.80,0.00,0.00,0.00,1,4.00,1,129.65,0,2,3,java.lang.Object,0.00,0,0,4,11,0,2,0,4,42,2
"org.apache.solr.response.transform.DocTransformers",6,0.40,1.67,26,0.27,7000.03,7,1,6,19,6,124.27,5,42,2,2,124.27,0.00,0.50,0.67,0,0.00,3,799.97,0,1,4,org.apache.solr.response.transform.DocTransformer,0.20,13,1,10,0,13,5,0,1,186,1
"org.apache.solr.response.transform.ElevatedMarkerFactory",1,0.00,1.00,5,0.07,1344.93,1,0,7,6,10,120.52,4,9,1,2,120.29,0.00,0.50,0.00,0,1.00,1,222.33,0,0,9,org.apache.solr.response.transform.TransformerFactory,0.00,5,1,1,0,5,1,0,1,50,1
"org.apache.solr.response.transform.ExcludedMarkerFactory",1,0.00,1.00,5,0.07,1344.93,1,0,8,6,10,120.52,4,9,1,2,120.29,0.00,0.50,0.00,0,1.00,1,222.33,0,0,10,org.apache.solr.response.transform.TransformerFactory,0.00,5,1,1,0,5,1,0,1,50,1
"org.apache.solr.response.transform.ExcludedTransformer",2,0.00,1.00,5,0.06,730.92,2,0,8,4,9,139.59,0,9,1,4,139.59,0.00,0.75,0.00,0,2.00,1,177.32,0,1,8,org.apache.solr.response.transform.BaseEditorialTransformer,0.33,2,3,2,0,2,1,0,0,48,0
"org.apache.solr.response.transform.ExplainAugmenterFactory",3,0.50,2.00,18,0.21,4570.00,4,1,9,7,9,166.75,4,33,0,2,116.75,0.00,0.50,0.67,0,1.00,2,621.72,1,1,9,org.apache.solr.response.transform.TransformerFactory,0.00,4,1,6,0,4,2,0,1,137,1
"org.apache.solr.response.transform.ExplainAugmenterFactory$ExplainAugmenter",3,0.00,2.33,19,0.23,7186.28,5,2,9,9,4,115.17,0,35,0,3,115.17,0.00,0.67,0.50,0,1.00,5,703.66,0,1,4,org.apache.solr.response.transform.TransformerWithContext,0.38,6,2,7,0,6,2,0,0,147,1
"org.apache.solr.response.transform.ExplainAugmenterFactory$Style",0,0.00,0.00,2,0.01,71.32,0,0,9,0,0,171.00,0,5,0,1,171.00,0.00,0.00,0.00,0,0.00,0,28.53,0,0,0,java.lang.Object,0.00,0,0,0,0,0,0,0,0,9,2
"org.apache.solr.response.transform.MarkTransformer",2,0.00,1.00,5,0.06,838.90,2,0,7,4,8,139.12,0,10,1,4,139.12,0.00,0.75,0.00,0,2.00,1,180.52,0,1,7,org.apache.solr.response.transform.BaseEditorialTransformer,0.33,2,3,2,0,2,1,0,0,49,0
"org.apache.solr.response.transform.RenameFieldsTransformer",3,0.50,2.33,24,0.27,9924.69,4,1,3,11,5,149.29,6,31,1,2,109.40,0.00,0.50,0.67,0,1.00,3,812.97,0,1,4,org.apache.solr.response.transform.DocTransformer,0.29,8,1,7,0,8,2,0,1,172,1
"org.apache.solr.response.transform.ScoreAugmenter",3,0.50,1.67,10,0.10,1678.53,4,1,2,5,5,171.33,6,21,2,3,131.45,0.00,0.67,0.67,0,1.00,3,304.59,0,1,3,org.apache.solr.response.transform.TransformerWithContext,0.38,2,2,5,0,2,2,0,1,76,1
"org.apache.solr.response.transform.ShardAugmenterFactory",1,0.00,3.00,9,0.11,3028.83,1,0,3,5,6,107.97,4,16,0,2,107.74,0.00,0.50,0.00,0,1.00,3,343.40,0,1,6,org.apache.solr.response.transform.TransformerFactory,0.00,4,1,3,0,4,0,0,1,71,1
"org.apache.solr.response.transform.TransformContext",0,0.00,0.00,6,0.04,316.78,5,5,4,0,11,171.00,6,8,7,1,171.00,0.00,0.00,0.00,0,0.00,0,126.71,0,0,4,java.lang.Object,0.00,0,0,0,0,0,0,0,1,31,1
"org.apache.solr.response.transform.TransformerFactory",2,0.50,1.00,11,0.14,2579.28,4,2,6,4,14,160.32,5,15,9,1,120.43,0.00,0.00,0.25,0,2.00,1,406.91,0,0,9,java.lang.Object,0.00,2,0,2,6,2,2,1,1,100,2
"org.apache.solr.response.transform.TransformerWithContext",1,1.00,1.00,4,0.04,518.06,2,1,0,1,5,127.40,4,8,3,2,127.17,5.00,0.14,0.00,0,1.00,1,111.01,0,0,2,org.apache.solr.response.transform.DocTransformer,0.00,0,1,1,5,0,1,0,1,30,2
"org.apache.solr.response.transform.ValueAugmenter",3,0.00,1.00,10,0.08,934.70,5,2,7,4,9,133.57,0,19,2,2,133.57,0.00,0.50,0.50,0,1.00,1,236.13,0,1,7,org.apache.solr.response.transform.DocTransformer,0.29,1,1,3,0,1,2,0,0,65,0
"org.apache.solr.response.transform.ValueAugmenterFactory",3,0.25,4.33,27,0.38,12047.73,5,2,7,12,9,156.69,4,46,0,2,106.69,0.00,0.50,0.67,0,1.00,7,1138.15,0,2,9,org.apache.solr.response.transform.TransformerFactory,0.00,9,1,13,0,9,1,0,1,229,1
"org.apache.solr.response.transform.ValueSourceAugmenter",4,0.33,2.00,35,0.48,14562.80,11,7,12,16,14,149.00,10,52,2,2,109.11,0.00,0.50,0.39,0,2.00,4,1453.21,0,1,12,org.apache.solr.response.transform.DocTransformer,0.25,12,1,8,0,12,3,0,3,284,1
"org.apache.lucene.analysis.morfologik.MorfologikAnalyzer",3,2.00,1.00,11,0.14,2679.98,5,2,7,7,6,81.49,31,18,1,2,129.96,0.00,0.50,0.00,0,3.00,1,425.65,0,1,5,org.apache.lucene.analysis.Analyzer,0.00,4,1,3,0,4,2,0,4,102,1
"org.apache.lucene.analysis.morfologik.MorfologikFilter",6,0.20,1.67,54,0.62,14815.02,16,10,12,26,8,108.81,24,64,1,4,108.57,0.00,0.75,0.27,4,2.00,4,1855.70,1,1,7,org.apache.lucene.analysis.TokenFilter,0.44,20,3,10,0,20,5,0,6,381,1
"org.apache.lucene.analysis.morfologik.MorphosyntacticTagAttribute",3,0.00,1.00,4,0.02,95.33,3,0,1,3,4,179.79,11,5,3,2,159.17,0.00,0.50,0.00,0,3.00,1,58.38,0,1,1,,0.00,0,1,3,0,0,2,0,4,23,1
"org.apache.lucene.analysis.morfologik.MorphosyntacticTagAttributeImpl",8,0.57,2.12,28,0.35,12809.50,9,1,1,15,3,167.68,16,44,1,2,127.79,0.00,0.50,0.50,2,8.00,6,1056.81,0,2,2,org.apache.lucene.util.AttributeImpl,0.31,7,1,17,0,7,6,2,5,247,1
"org.apache.lucene.analysis.morfologik.TestMorfologikAnalyzer",8,0.00,1.00,47,0.68,15525.38,8,0,6,19,6,169.03,9,59,0,3,119.04,0.00,0.67,0.00,2,8.00,1,2027.84,2,1,6,org.apache.lucene.analysis.BaseTokenStreamTestCase,0.00,11,2,8,0,11,7,0,7,425,1
"org.apache.lucene.analysis.bg.BulgarianAnalyzer",5,0.50,1.20,21,0.25,5941.93,7,2,14,15,13,74.29,48,29,2,3,124.29,0.00,0.67,0.10,0,8.00,2,759.17,0,2,11,org.apache.lucene.analysis.util.StopwordAnalyzerBase,0.00,10,2,6,0,10,3,0,8,174,2
"org.apache.lucene.analysis.bg.BulgarianAnalyzer$DefaultSetHolder",0,0.00,0.00,6,0.05,732.71,1,1,14,0,2,171.00,2,10,0,1,171.00,0.00,0.00,0.00,0,0.00,0,149.07,0,0,2,java.lang.Object,0.00,0,0,0,0,0,0,0,2,37,2
"org.apache.lucene.analysis.bg.BulgarianStemFilter",2,0.33,2.00,14,0.16,3828.15,5,3,6,9,10,113.71,9,20,4,4,113.47,0.00,0.75,0.50,0,2.00,3,486.85,0,0,6,org.apache.lucene.analysis.TokenFilter,0.29,7,3,4,0,7,2,0,1,108,2
"org.apache.lucene.analysis.bg.BulgarianStemmer",3,0.00,9.00,47,0.77,51673.55,3,0,1,4,1,49.14,34,81,1,1,93.27,0.00,0.00,0.00,0,3.00,14,2298.83,0,0,0,java.lang.Object,0.00,1,0,27,0,1,3,0,15,443,1
"org.apache.lucene.analysis.bg.TestBulgarianAnalyzer",7,0.00,1.00,27,0.36,5959.36,7,0,5,10,4,180.13,10,36,0,3,130.13,0.00,0.67,0.00,0,7.00,1,1066.91,3,0,4,org.apache.lucene.analysis.BaseTokenStreamTestCase,0.00,3,2,7,0,3,7,0,4,239,1
"org.apache.lucene.analysis.bg.TestBulgarianStemmer",7,0.00,1.00,121,2.13,91444.79,7,0,11,15,9,60.47,45,130,0,3,92.69,0.00,0.67,0.00,0,7.00,1,6378.54,3,0,9,org.apache.lucene.analysis.BaseTokenStreamTestCase,0.00,8,2,7,0,8,7,0,31,1170,1
"org.apache.lucene.analysis.bg.TestBulgarianStemmer$Analyzer",1,0.00,1.00,4,0.05,753.46,1,0,11,4,3,125.89,0,6,0,1,125.89,0.00,0.00,0.00,0,1.00,1,135.44,0,1,3,java.lang.Object,0.00,3,0,1,0,3,0,0,0,34,0
"org.apache.lucene.analysis.no.NorwegianAnalyzer",5,0.50,1.20,21,0.26,6053.81,7,2,17,16,15,76.12,42,31,1,3,124.22,0.00,0.67,0.10,0,8.00,2,777.74,0,2,14,org.apache.lucene.analysis.util.StopwordAnalyzerBase,0.00,11,2,6,0,11,3,0,8,177,2
"org.apache.lucene.analysis.no.NorwegianAnalyzer$DefaultSetHolder",0,0.00,0.00,6,0.07,1089.77,1,1,17,0,4,171.00,2,11,0,1,171.00,0.00,0.00,0.00,0,0.00,0,202.05,0,0,4,java.lang.Object,0.00,0,0,0,0,0,0,0,2,47,2
"org.apache.lucene.analysis.no.NorwegianLightStemFilter",2,0.33,2.00,14,0.16,3794.18,5,3,6,9,9,113.74,9,20,3,4,113.50,0.00,0.75,0.50,0,2.00,3,481.98,0,0,6,org.apache.lucene.analysis.TokenFilter,0.29,7,3,4,0,7,2,0,1,107,2
"org.apache.lucene.analysis.no.NorwegianLightStemmer",1,0.00,10.00,12,0.44,35796.90,1,0,1,2,1,139.48,28,45,1,1,94.35,0.00,0.00,0.00,0,1.00,10,1312.66,0,0,0,java.lang.Object,0.00,1,0,10,0,1,1,0,22,234,1
"org.apache.lucene.analysis.no.NorwegianMinimalStemFilter",2,0.33,2.00,14,0.16,3794.18,5,3,6,9,9,113.74,9,20,3,4,113.50,0.00,0.75,0.50,0,2.00,3,481.98,0,0,6,org.apache.lucene.analysis.TokenFilter,0.29,7,3,4,0,7,2,0,1,107,2
"org.apache.lucene.analysis.no.NorwegianMinimalStemmer",1,0.00,6.00,8,0.17,10426.60,1,0,1,2,1,67.70,12,23,1,1,105.26,0.00,0.00,0.00,0,1.00,6,506.57,0,0,0,java.lang.Object,0.00,1,0,6,0,1,1,0,8,102,1
"org.apache.lucene.analysis.no.TestNorwegianAnalyzer",4,0.00,1.00,15,0.16,2494.63,4,0,4,7,4,181.19,7,21,0,3,131.19,0.00,0.67,0.00,0,4.00,1,481.49,3,0,4,org.apache.lucene.analysis.BaseTokenStreamTestCase,0.00,3,2,4,0,3,4,0,6,114,1
"org.apache.lucene.analysis.no.TestNorwegianLightStemFilter",3,0.00,1.00,10,0.08,941.19,3,0,9,8,5,183.54,5,15,0,3,133.54,0.00,0.67,0.00,0,3.00,1,243.95,2,0,5,org.apache.lucene.analysis.BaseTokenStreamTestCase,0.00,5,2,3,0,5,3,0,3,65,1
"org.apache.lucene.analysis.no.TestNorwegianLightStemFilter$Analyzer",1,0.00,1.00,4,0.05,1009.20,1,0,9,4,3,124.89,0,7,0,1,124.89,0.00,0.00,0.00,0,1.00,1,159.62,0,1,3,java.lang.Object,0.00,3,0,1,0,3,0,0,0,38,0
"org.apache.lucene.analysis.no.TestNorwegianLightStemFilter$Analyzer_0",1,0.00,1.00,4,0.05,753.46,1,0,9,4,3,125.89,0,6,0,1,125.89,0.00,0.00,0.00,0,1.00,1,135.44,0,1,3,java.lang.Object,0.00,3,0,1,0,3,0,0,0,34,0
"org.apache.lucene.analysis.no.TestNorwegianMinimalStemFilter",3,0.00,1.00,10,0.08,941.19,3,0,9,8,5,183.54,5,15,0,3,133.54,0.00,0.67,0.00,0,3.00,1,243.95,2,0,5,org.apache.lucene.analysis.BaseTokenStreamTestCase,0.00,5,2,3,0,5,3,0,3,65,1
"org.apache.lucene.analysis.no.TestNorwegianMinimalStemFilter$Analyzer",1,0.00,1.00,4,0.05,1009.20,1,0,9,4,3,124.89,0,7,0,1,124.89,0.00,0.00,0.00,0,1.00,1,159.62,0,1,3,java.lang.Object,0.00,3,0,1,0,3,0,0,0,38,0
"org.apache.lucene.analysis.no.TestNorwegianMinimalStemFilter$Analyzer_0",1,0.00,1.00,4,0.05,753.46,1,0,9,4,3,125.89,0,6,0,1,125.89,0.00,0.00,0.00,0,1.00,1,135.44,0,1,3,java.lang.Object,0.00,3,0,1,0,3,0,0,0,34,0
"org.apache.lucene.search.join.JoinUtil",2,0.00,1.00,6,0.08,1734.39,2,0,3,6,5,81.59,21,13,1,1,130.07,0.00,0.00,0.00,0,2.00,1,233.58,0,1,4,java.lang.Object,0.00,4,0,2,0,4,1,0,3,54,2
"org.apache.lucene.search.join.TermsCollector",5,0.50,1.20,14,0.11,1709.20,7,2,9,8,12,179.66,14,20,4,2,139.78,2.00,0.25,0.10,0,8.00,2,332.84,0,2,8,org.apache.lucene.search.Collector,0.22,3,1,6,2,3,3,0,4,90,1
"org.apache.lucene.search.join.TermsCollector$MV",3,0.50,1.67,26,0.26,9952.51,6,3,9,11,4,109.47,1,29,0,3,109.47,0.00,0.67,0.67,0,1.00,3,784.84,0,0,4,org.apache.lucene.search.join.TermsCollector,0.25,8,2,5,0,8,3,0,1,164,1
"org.apache.lucene.search.join.TermsCollector$SV",3,0.00,1.00,9,0.10,1254.21,5,2,9,8,2,132.56,0,13,0,3,132.56,0.00,0.67,0.50,0,1.00,1,292.91,0,0,2,org.apache.lucene.search.join.TermsCollector,0.25,5,2,3,0,5,3,0,0,74,1
"org.apache.lucene.search.join.TermsQuery",3,1.00,1.33,12,0.12,1885.32,4,1,9,6,8,147.05,10,19,1,3,126.44,0.00,0.67,0.00,0,4.00,2,366.46,0,2,7,org.apache.lucene.search.MultiTermQuery,0.00,3,2,4,0,3,1,0,2,90,0
"org.apache.lucene.search.join.TermsQuery$SeekingTermSetTermsEnum",3,0.81,3.33,47,0.55,30304.33,11,8,9,9,3,145.32,4,59,0,3,95.32,0.00,0.67,0.67,0,0.00,8,1655.93,0,2,3,org.apache.lucene.index.FilteredTermsEnum,0.00,6,2,10,0,6,1,0,4,327,1
"org.apache.lucene.search.join.TestBlockJoin",19,0.00,5.47,651,14.35,2149786.16,19,0,14,105,36,73.92,82,725,0,2,73.69,0.00,0.50,0.00,11,19.00,70,43045.62,0,9,36,org.apache.lucene.util.LuceneTestCase,0.00,86,1,104,0,86,10,0,82,6086,1
"org.apache.lucene.search.join.TestJoinUtil",7,0.00,5.00,211,3.79,311887.86,7,0,15,73,20,128.92,12,233,0,2,78.92,0.00,0.50,0.00,3,7.00,13,11358.62,0,1,20,org.apache.lucene.util.LuceneTestCase,0.00,66,1,35,0,66,6,0,12,1799,1
"org.apache.lucene.search.join.TestJoinUtil$Collector",4,0.67,1.00,9,0.07,688.14,5,1,15,5,2,142.17,0,13,0,1,142.17,0.00,0.00,0.50,0,4.00,1,199.72,0,0,2,java.lang.Object,0.00,1,0,4,0,1,4,0,0,58,0
"org.apache.lucene.search.join.TestJoinUtil$IndexIterationContext",0,0.00,0.00,7,0.16,8271.27,6,6,15,1,0,171.00,0,8,0,1,171.00,0.00,0.00,0.00,0,0.00,0,476.84,0,0,0,java.lang.Object,0.00,1,0,0,0,1,0,0,0,104,2
"org.apache.lucene.search.join.TestJoinUtil$RandomDoc",1,2.00,1.00,8,0.07,1601.26,4,3,15,2,0,112.08,0,10,0,1,112.08,0.00,0.00,0.33,0,0.00,1,221.01,0,0,0,java.lang.Object,0.00,1,0,1,0,1,1,0,0,55,2
"org.apache.lucene.search.join.ToChildBlockJoinQuery",9,0.25,1.22,48,0.53,15429.33,13,4,18,23,15,169.41,13,73,2,2,119.41,0.00,0.50,0.47,0,0.00,2,1600.44,1,4,13,org.apache.lucene.search.Query,0.21,14,1,11,0,14,5,0,6,368,1
"org.apache.lucene.search.join.ToChildBlockJoinQuery$ToChildBlockJoinScorer",6,0.31,3.33,63,0.74,52070.55,13,7,18,16,3,102.64,24,91,0,3,102.41,0.00,0.67,0.40,1,0.00,10,2208.31,0,1,3,org.apache.lucene.search.Scorer,0.94,10,2,20,0,10,5,0,24,432,1
"org.apache.lucene.search.join.ToChildBlockJoinQuery$ToChildBlockJoinWeight",7,0.04,1.43,31,0.38,10623.81,11,4,18,17,8,173.41,11,50,0,2,123.41,0.00,0.50,0.29,0,7.00,4,1149.95,0,3,8,org.apache.lucene.search.Weight,0.62,10,1,10,0,10,4,0,11,256,2
"org.apache.lucene.search.join.ToParentBlockJoinCollector",9,0.21,5.44,202,2.76,224794.61,27,18,9,52,18,41.78,104,221,1,2,85.91,0.00,0.50,0.24,3,0.00,15,8270.83,0,1,17,org.apache.lucene.search.Collector,0.15,43,1,49,0,43,8,0,47,1424,1
"org.apache.lucene.search.join.ToParentBlockJoinCollector$FakeScorer",5,0.38,1.00,13,0.09,1051.80,7,2,9,6,1,141.48,0,23,0,3,141.48,0.00,0.67,0.20,0,11.00,1,263.06,0,0,1,org.apache.lucene.search.Scorer,0.80,1,2,5,0,1,5,0,0,77,3
"org.apache.lucene.search.join.ToParentBlockJoinCollector$OneGroup",1,1.00,4.00,21,0.19,7513.22,5,4,9,1,1,90.84,0,21,0,2,90.84,0.00,0.50,0.75,0,0.00,4,578.14,0,0,1,FieldValueHitQueue.Entry,0.00,0,1,4,0,0,1,0,0,125,3
"org.apache.lucene.search.join.ToParentBlockJoinQuery",9,0.25,1.22,49,0.53,15338.60,13,4,21,22,19,77.14,63,74,3,2,119.43,0.00,0.50,0.47,0,0.00,2,1604.64,1,4,16,org.apache.lucene.search.Query,0.21,13,1,11,0,13,5,0,11,370,1
"org.apache.lucene.search.join.ToParentBlockJoinQuery$BlockJoinScorer",9,0.18,3.00,94,1.01,67014.23,19,10,21,20,4,123.57,27,128,0,3,102.95,0.00,0.67,0.26,1,24.00,12,3025.92,0,1,4,org.apache.lucene.search.Scorer,0.79,11,2,27,0,11,8,0,27,582,1
"org.apache.lucene.search.join.ToParentBlockJoinQuery$BlockJoinWeight",7,0.04,1.57,34,0.43,12612.47,11,4,21,18,9,172.80,12,54,0,2,122.80,0.00,0.50,0.29,0,7.00,5,1281.20,0,3,9,org.apache.lucene.search.Weight,0.62,11,1,11,0,11,4,0,12,277,2
"org.apache.lucene.search.join.ToParentBlockJoinQuery$ScoreMode",0,0.00,0.00,2,0.01,83.05,0,0,21,0,0,171.00,1,5,0,1,171.00,0.00,0.00,0.00,0,0.00,0,33.22,0,0,0,java.lang.Object,0.00,0,0,0,0,0,0,0,1,10,2
"org.apache.lucene.facet.taxonomy.writercache.TaxonomyWriterCache",6,0.00,1.00,7,0.05,242.40,6,0,2,6,5,147.99,94,8,4,1,158.35,0.00,0.00,0.00,0,6.00,1,150.98,0,0,2,,0.00,0,0,6,0,0,6,0,8,52,1
"org.apache.lucene.analysis.nl.Deprecated",18,0.07,3.89,183,2.72,156640.22,23,5,1,37,0,122.98,70,287,0,1,102.36,0.00,0.00,0.13,11,86.00,11,8156.16,0,1,0,java.lang.Object,0.00,19,0,70,0,19,17,0,17,1594,1
"org.apache.lucene.analysis.nl.DutchAnalyzer",6,0.08,2.00,37,0.64,22995.13,11,5,18,23,17,63.60,58,56,1,2,113.59,0.00,0.50,0.13,0,10.00,5,1924.96,0,2,16,org.apache.lucene.analysis.Analyzer,0.00,17,1,12,0,17,4,0,12,391,2
"org.apache.lucene.analysis.nl.DutchAnalyzer$DefaultSetHolder",0,0.00,0.00,12,0.16,4221.07,2,2,18,0,5,171.00,4,17,0,1,171.00,0.00,0.00,0.00,0,0.00,0,488.41,0,0,5,java.lang.Object,0.00,0,0,0,0,0,0,0,4,98,2
"org.apache.lucene.analysis.nl.TestDutchStemmer",11,0.00,1.00,118,1.40,22707.68,11,0,5,14,4,147.48,30,133,0,3,107.59,0.00,0.67,0.00,1,11.00,1,4195.88,5,0,4,org.apache.lucene.analysis.BaseTokenStreamTestCase,0.00,3,2,11,0,3,11,0,10,727,1
"org.apache.lucene.analysis.uima.BaseUIMATokenizer",6,0.00,1.33,26,0.27,5039.12,9,3,10,17,4,165.33,17,37,2,4,125.45,0.67,0.50,0.33,1,14.00,2,820.62,1,1,2,org.apache.lucene.analysis.Tokenizer,0.20,11,3,8,2,11,5,0,3,190,2
"org.apache.lucene.analysis.uima.UIMAAnnotationsTokenizer",4,0.17,1.75,31,0.35,6936.63,8,4,8,19,6,113.84,3,42,2,5,113.84,0.00,0.80,0.38,1,0.00,3,1041.89,3,0,4,org.apache.lucene.analysis.uima.BaseUIMATokenizer,0.62,15,4,7,0,15,4,0,1,224,2
"org.apache.lucene.analysis.uima.UIMABaseAnalyzer",2,0.00,1.00,8,0.08,1170.48,4,2,2,4,3,176.75,3,12,1,2,126.75,0.00,0.50,0.50,0,2.00,1,231.31,0,1,2,org.apache.lucene.analysis.Analyzer,0.00,2,1,2,0,2,1,0,1,62,2
"org.apache.lucene.analysis.uima.UIMABaseAnalyzerTest",5,0.25,1.00,56,0.91,43268.86,6,1,18,32,14,151.15,7,68,0,3,101.15,0.00,0.67,0.80,0,0.00,1,2737.87,4,0,14,org.apache.lucene.analysis.BaseTokenStreamTestCase,0.00,27,2,5,0,27,5,0,5,485,1
"org.apache.lucene.analysis.uima.UIMATypeAwareAnalyzer",2,0.33,1.00,10,0.10,1680.55,5,3,2,4,3,171.90,3,14,1,2,121.90,0.00,0.50,0.50,0,2.00,1,292.97,0,1,2,org.apache.lucene.analysis.Analyzer,0.00,2,1,2,0,2,1,0,1,77,2
"org.apache.lucene.analysis.uima.UIMATypeAwareAnalyzerTest",4,0.33,1.00,14,0.19,3107.77,5,1,6,8,3,180.44,5,26,0,3,130.44,0.00,0.67,0.75,0,0.00,1,575.64,4,0,3,org.apache.lucene.analysis.BaseTokenStreamTestCase,0.00,4,2,4,0,4,4,0,3,129,1
"org.apache.lucene.analysis.uima.UIMATypeAwareAnnotationsTokenizer",4,0.29,2.00,42,0.48,10206.37,11,7,11,23,7,156.71,4,55,2,5,106.71,0.00,0.80,0.36,1,0.00,3,1454.47,3,0,5,org.apache.lucene.analysis.uima.BaseUIMATokenizer,0.62,19,4,8,0,19,4,0,1,299,2
"org.apache.lucene.search.similarities.AfterEffect",3,0.00,1.00,5,0.04,448.86,3,0,1,3,8,136.00,17,7,6,1,153.87,0.00,0.00,0.00,0,3.00,1,133.13,0,2,2,java.lang.Object,0.00,0,0,3,3,0,1,0,5,42,2
"org.apache.lucene.search.similarities.AfterEffect$NoAfterEffect",3,0.00,1.00,7,0.07,882.82,3,0,1,4,3,140.33,0,15,0,2,140.33,0.00,0.50,0.00,0,3.00,1,203.21,0,2,3,org.apache.lucene.search.similarities.AfterEffect,0.33,1,1,3,0,1,1,0,0,55,3
"org.apache.lucene.search.similarities.AfterEffectB",3,0.00,1.00,15,0.22,6896.92,3,0,1,11,6,168.46,4,22,3,2,118.46,0.00,0.50,0.00,1,3.00,1,663.88,0,2,3,org.apache.lucene.search.similarities.AfterEffect,0.33,8,1,3,0,8,1,0,1,144,1
"org.apache.lucene.search.similarities.AfterEffectL",3,0.00,1.00,11,0.13,3145.14,3,0,1,9,6,179.42,4,18,3,2,129.42,0.00,0.50,0.00,1,3.00,1,392.81,0,2,3,org.apache.lucene.search.similarities.AfterEffect,1.00,6,1,3,0,6,1,0,1,92,1
"org.apache.lucene.search.similarities.BM25Similarity",20,0.11,1.40,108,1.59,73172.38,24,4,10,44,13,166.79,36,136,3,2,116.79,0.00,0.50,0.15,4,134.00,3,4783.00,0,7,10,org.apache.lucene.search.similarities.Similarity,0.00,24,1,28,0,24,13,0,17,966,1
"org.apache.lucene.search.similarities.BM25Similarity$BM25Stats",3,0.07,1.00,20,0.20,4064.05,10,7,10,4,1,137.93,9,26,0,2,117.31,0.00,0.50,0.19,0,1.00,1,613.24,0,0,1,org.apache.lucene.search.similarities.SimWeight,0.00,1,1,3,0,1,3,0,9,147,2
"org.apache.lucene.search.similarities.BM25Similarity$ExactBM25DocScorer",3,0.25,1.00,15,0.20,4322.35,7,4,10,6,2,120.05,1,21,0,2,120.05,0.00,0.50,0.42,0,2.00,1,595.40,0,1,2,org.apache.lucene.search.similarities.ExactSimScorer,0.00,3,1,3,0,3,2,0,1,136,1
"org.apache.lucene.search.similarities.BM25Similarity$ExactBM25DocScorerNoNorms",3,0.00,1.67,17,0.20,5389.45,7,4,10,4,1,169.18,5,22,0,2,119.18,0.00,0.50,0.25,0,2.00,2,610.27,0,1,1,org.apache.lucene.search.similarities.ExactSimScorer,0.00,1,1,5,0,1,2,0,5,138,1
"org.apache.lucene.search.similarities.BM25Similarity$SloppyBM25DocScorer",5,0.00,1.40,19,0.27,6689.75,9,4,10,10,3,128.50,2,29,0,2,128.50,0.00,0.50,0.25,0,6.00,2,817.42,0,1,3,org.apache.lucene.search.similarities.SloppySimScorer,0.00,5,1,7,0,5,4,0,2,187,1
"org.apache.lucene.search.similarities.BasicModel",3,0.00,1.00,11,0.15,3391.00,3,0,1,11,12,86.87,21,16,10,1,129.16,0.00,0.00,0.00,1,3.00,1,435.67,0,2,2,java.lang.Object,0.00,8,0,3,7,8,1,0,4,100,2
"org.apache.lucene.search.similarities.BasicModelBE",3,0.00,1.00,9,0.18,6349.13,3,0,1,5,4,127.25,12,16,2,2,127.01,0.00,0.50,0.00,0,3.00,1,530.68,0,1,2,org.apache.lucene.search.similarities.BasicModel,0.33,2,1,3,0,2,2,0,3,121,1
"org.apache.lucene.search.similarities.BasicModelD",2,0.00,1.00,10,0.19,8198.97,2,0,1,4,4,74.19,15,15,2,2,116.48,0.00,0.50,0.00,0,2.00,1,560.80,0,1,2,org.apache.lucene.search.similarities.BasicModel,0.40,2,1,2,0,2,1,0,4,117,1
"org.apache.lucene.search.similarities.BasicModelG",2,0.00,1.00,8,0.11,4039.87,2,0,1,5,4,122.75,8,13,2,2,122.51,0.00,0.50,0.00,0,2.00,1,343.48,0,1,2,org.apache.lucene.search.similarities.BasicModel,0.80,3,1,2,0,3,1,0,3,79,1
"org.apache.lucene.search.similarities.BasicModelIF",2,0.00,1.00,7,0.09,2537.07,2,0,1,5,5,168.65,4,12,3,2,128.76,0.00,0.50,0.00,0,2.00,1,282.37,0,1,2,org.apache.lucene.search.similarities.BasicModel,0.40,3,1,2,0,3,1,0,1,66,1
"org.apache.lucene.search.similarities.BasicModelIn",3,0.00,1.00,15,0.22,6596.40,3,0,2,12,5,168.61,4,24,2,2,118.61,0.00,0.50,0.00,1,3.00,1,669.31,0,2,3,org.apache.lucene.search.similarities.BasicModel,0.33,9,1,3,0,9,1,0,1,144,1
"org.apache.lucene.search.similarities.BasicModelIne",2,0.00,1.00,8,0.13,4365.08,2,0,1,6,4,162.13,5,13,2,2,122.25,0.00,0.50,0.00,0,2.00,1,393.89,0,1,2,org.apache.lucene.search.similarities.BasicModel,0.40,4,1,2,0,4,1,0,1,86,1
"org.apache.lucene.search.similarities.BasicModelP",2,1.00,1.00,7,0.15,5097.75,3,1,1,4,5,126.61,9,14,3,2,126.38,0.00,0.50,0.50,0,2.00,1,463.41,0,1,2,org.apache.lucene.search.similarities.BasicModel,0.40,2,1,2,0,2,1,0,2,101,1
"org.apache.lucene.search.similarities.BasicStats",15,0.05,1.00,44,0.30,4426.23,24,9,1,15,37,180.21,44,62,36,2,140.32,1.00,0.33,0.07,1,111.00,1,901.75,0,0,1,Similarity.SimWeight,0.00,0,1,15,1,0,15,0,27,244,1
"org.apache.lucene.search.similarities.DFRSimilarity",7,0.28,1.29,29,0.37,10560.88,10,3,1,21,10,144.07,22,47,4,3,123.45,0.00,0.67,0.57,0,0.00,2,1114.05,0,2,6,org.apache.lucene.search.similarities.SimilarityBase,0.11,14,2,9,0,14,5,0,4,254,1
"org.apache.lucene.search.similarities.DefaultSimilarity",10,0.78,1.10,24,0.31,6158.47,11,1,3,16,54,138.02,42,44,50,3,137.78,5.50,0.14,0.30,0,22.00,2,929.96,1,1,4,org.apache.lucene.search.similarities.TFIDFSimilarity,0.48,6,2,11,11,6,9,0,12,227,1
"org.apache.lucene.search.similarities.Distribution",3,0.00,1.00,5,0.06,777.46,3,0,1,5,7,152.23,13,9,5,1,151.99,0.00,0.00,0.00,1,3.00,1,184.75,0,2,2,java.lang.Object,0.00,2,0,3,2,2,1,0,4,52,2
"org.apache.lucene.search.similarities.DistributionLL",2,0.00,1.00,5,0.06,1435.81,2,0,0,3,5,93.15,23,10,3,2,137.28,0.00,0.50,0.00,0,2.00,1,181.71,0,1,2,org.apache.lucene.search.similarities.Distribution,0.40,1,1,2,0,1,1,0,2,47,1
"org.apache.lucene.search.similarities.DistributionSPL",2,0.00,1.50,7,0.10,3762.74,2,0,0,4,5,89.76,24,14,3,2,127.32,0.00,0.50,0.00,0,2.00,2,308.81,0,1,2,org.apache.lucene.search.similarities.Distribution,0.40,2,1,3,0,2,1,0,2,71,1
"org.apache.lucene.search.similarities.IBSimilarity",7,0.28,1.14,26,0.33,8192.57,10,3,1,20,10,129.24,31,47,4,3,129.01,0.00,0.67,0.57,0,0.00,2,998.60,0,3,6,org.apache.lucene.search.similarities.SimilarityBase,0.11,13,2,8,0,13,4,0,5,232,1
"org.apache.lucene.search.similarities.LMDirichletSimilarity",8,0.71,1.25,28,0.43,15555.31,9,1,1,16,7,167.14,21,46,4,4,127.25,0.00,0.75,0.38,0,14.00,2,1277.17,1,1,3,org.apache.lucene.search.similarities.LMSimilarity,0.11,8,3,10,0,8,7,0,7,275,1
"org.apache.lucene.search.similarities.LMJelinekMercerSimilarity",6,0.60,1.17,18,0.25,5500.20,7,1,1,12,7,169.73,16,34,4,4,129.84,0.00,0.75,0.50,0,6.00,2,750.88,1,1,3,org.apache.lucene.search.similarities.LMSimilarity,0.12,6,3,7,0,6,5,0,5,176,1
"org.apache.lucene.search.similarities.LMSimilarity",7,0.67,1.14,24,0.27,5198.83,8,1,3,15,7,112.69,40,39,2,3,130.56,1.00,0.40,0.43,0,10.00,2,800.58,1,3,5,org.apache.lucene.search.similarities.SimilarityBase,0.11,8,2,8,2,8,4,0,10,193,2
"org.apache.lucene.search.similarities.LMSimilarity$CollectionModel",2,0.00,1.00,3,0.01,70.11,2,0,3,2,1,198.72,5,4,0,1,158.84,0.00,0.00,0.00,0,2.00,1,42.87,0,1,1,,0.00,0,0,2,0,0,1,0,2,17,2
"org.apache.lucene.search.similarities.LMSimilarity$DefaultCollectionModel",2,0.00,1.00,5,0.06,931.10,2,0,3,4,1,138.76,0,10,0,1,138.76,0.00,0.00,0.00,0,2.00,1,166.55,0,1,1,java.lang.Object,0.00,2,0,2,0,2,1,1,0,45,2
"org.apache.lucene.search.similarities.LMSimilarity$LMStats",3,1.00,1.00,8,0.05,591.97,4,1,3,3,1,162.31,9,12,0,3,141.70,0.00,0.67,0.33,0,4.00,1,163.42,0,0,1,org.apache.lucene.search.similarities.BasicStats,0.00,0,2,3,0,0,3,0,3,48,2
"org.apache.lucene.search.similarities.Lambda",3,0.00,1.00,4,0.03,209.22,3,0,1,3,7,156.72,14,6,5,1,156.48,0.00,0.00,0.00,0,3.00,1,86.61,0,2,2,java.lang.Object,0.00,0,0,3,2,0,1,0,4,30,2
"org.apache.lucene.search.similarities.LambdaDF",3,0.00,1.00,12,0.16,4274.13,3,0,1,11,6,173.71,4,21,3,2,123.71,0.00,0.50,0.00,1,3.00,1,490.90,0,2,3,org.apache.lucene.search.similarities.Lambda,0.33,8,1,3,0,8,1,0,1,112,1
"org.apache.lucene.search.similarities.LambdaTTF",3,0.00,1.00,12,0.16,4274.13,3,0,1,11,6,173.71,4,21,3,2,123.71,0.00,0.50,0.00,1,3.00,1,490.90,0,2,3,org.apache.lucene.search.similarities.Lambda,0.33,8,1,3,0,8,1,0,1,112,1
"org.apache.lucene.search.similarities.MultiSimilarity",5,0.25,1.60,33,0.41,14649.56,6,1,8,12,9,164.56,6,37,1,2,114.56,0.00,0.50,0.80,0,0.00,2,1238.84,0,3,8,org.apache.lucene.search.similarities.Similarity,0.00,7,1,8,0,7,2,0,1,264,1
"org.apache.lucene.search.similarities.MultiSimilarity$MultiExactDocScorer",3,1.00,1.67,16,0.16,4548.82,4,1,8,8,1,119.76,0,22,0,2,119.76,0.00,0.50,0.00,1,3.00,2,482.78,0,1,1,org.apache.lucene.search.similarities.ExactSimScorer,0.00,5,1,5,0,5,2,0,0,112,2
"org.apache.lucene.search.similarities.MultiSimilarity$MultiSloppyDocScorer",5,0.75,1.40,20,0.22,5608.69,6,1,8,12,2,124.45,0,30,0,2,124.45,0.00,0.50,0.40,1,7.00,2,666.67,0,1,2,org.apache.lucene.search.similarities.SloppySimScorer,0.00,7,1,7,0,7,4,0,0,157,2
"org.apache.lucene.search.similarities.MultiSimilarity$MultiStats",3,1.00,1.67,14,0.11,2720.68,4,1,8,5,0,125.13,0,20,0,2,125.13,0.00,0.50,0.33,0,4.00,2,340.45,0,0,0,org.apache.lucene.search.similarities.SimWeight,0.00,2,1,5,0,2,3,0,0,85,2
"org.apache.lucene.search.similarities.Normalization",3,0.00,1.00,12,0.16,3787.41,3,0,1,10,12,91.90,20,16,10,1,124.12,0.00,0.00,0.00,1,3.00,1,473.43,0,2,2,java.lang.Object,0.00,7,0,3,5,7,1,0,5,110,2
"org.apache.lucene.search.similarities.Normalization$NoNormalization",3,0.00,1.00,7,0.07,1063.00,3,0,1,4,3,139.69,0,15,0,2,139.69,0.00,0.50,0.00,0,3.00,1,220.81,0,2,3,org.apache.lucene.search.similarities.Normalization,0.33,1,1,3,0,1,1,0,0,59,3
"org.apache.lucene.search.similarities.NormalizationH1",5,1.00,1.00,12,0.09,1478.80,6,1,0,6,4,122.44,26,20,2,2,140.31,0.00,0.50,0.20,0,8.00,1,268.62,0,1,2,org.apache.lucene.search.similarities.Normalization,0.25,1,1,5,0,1,4,0,2,76,1
"org.apache.lucene.search.similarities.NormalizationH2",5,0.75,1.00,12,0.11,1931.21,6,1,1,6,6,179.29,10,20,4,2,139.40,0.00,0.50,0.40,0,7.00,1,316.00,0,1,2,org.apache.lucene.search.similarities.Normalization,0.25,1,1,5,0,1,4,0,1,85,1
"org.apache.lucene.search.similarities.NormalizationH3",5,0.50,1.00,12,0.13,2501.02,6,1,0,7,6,138.75,20,20,4,2,138.52,0.00,0.50,0.60,0,2.00,1,376.60,0,1,2,org.apache.lucene.search.similarities.Normalization,0.25,2,1,5,0,2,4,0,2,99,1
"org.apache.lucene.search.similarities.NormalizationZ",5,0.50,1.00,12,0.10,1607.16,6,1,0,6,4,140.26,20,20,2,2,140.03,0.00,0.50,0.60,0,2.00,1,312.35,0,1,2,org.apache.lucene.search.similarities.Normalization,0.25,1,1,5,0,1,4,0,2,85,1
"org.apache.lucene.search.similarities.PerFieldSimilarityWrapper",5,0.00,1.00,16,0.24,5495.91,5,0,6,12,17,169.14,11,25,11,2,129.25,4.00,0.17,0.00,1,5.00,1,710.15,0,4,6,org.apache.lucene.search.similarities.Similarity,0.00,7,1,5,4,7,1,0,2,165,2
"org.apache.lucene.search.similarities.PerFieldSimilarityWrapper$PerFieldSimWeight",2,0.00,1.00,7,0.06,765.34,4,2,6,4,1,132.86,0,12,0,2,132.86,0.00,0.50,0.50,0,0.00,1,168.57,0,0,1,org.apache.lucene.search.similarities.SimWeight,0.00,2,1,2,0,2,2,0,0,48,1
"org.apache.lucene.search.similarities.Similarity",6,0.00,1.00,12,0.10,804.21,6,0,17,6,89,193.02,150,15,75,1,143.02,0.00,0.00,0.00,0,6.00,1,313.48,0,0,16,java.lang.Object,0.00,0,0,6,31,0,6,0,11,92,2
"org.apache.lucene.search.similarities.Similarity$ExactSimScorer",2,0.00,1.00,6,0.08,1933.27,2,0,17,5,1,97.47,12,9,0,1,129.69,0.00,0.00,0.00,1,2.00,1,249.26,0,1,1,java.lang.Object,0.00,3,0,2,0,3,1,0,2,62,3
"org.apache.lucene.search.similarities.Similarity$SimWeight",2,0.00,1.00,3,0.02,145.87,2,0,17,2,0,124.11,12,4,0,1,156.33,0.00,0.00,0.00,0,2.00,1,62.72,0,0,0,java.lang.Object,0.00,0,0,2,0,0,2,0,2,22,3
"org.apache.lucene.search.similarities.Similarity$SloppySimScorer",4,0.00,1.00,8,0.10,1955.21,4,0,17,7,2,159.21,14,11,0,1,138.59,0.00,0.00,0.00,1,4.00,1,314.66,0,1,2,java.lang.Object,0.00,3,0,4,0,3,3,0,4,82,3
"org.apache.lucene.search.similarities.SimilarityBase",15,0.24,1.60,97,1.34,63991.97,18,3,10,46,18,70.99,105,118,6,2,113.28,5.00,0.14,0.11,4,68.00,3,4026.94,0,6,12,org.apache.lucene.search.similarities.Similarity,0.00,31,1,24,5,31,9,0,34,819,2
"org.apache.lucene.search.similarities.SimilarityBase$BasicExactDocScorer",3,0.25,2.00,10,0.18,4075.12,5,2,10,7,4,128.37,1,18,0,2,128.37,0.00,0.50,0.67,0,1.00,2,535.62,0,1,4,org.apache.lucene.search.similarities.ExactSimScorer,0.00,4,1,6,0,4,2,0,1,122,1
"org.apache.lucene.search.similarities.SimilarityBase$BasicSloppyDocScorer",5,0.12,1.60,14,0.23,4733.19,7,2,10,9,5,136.23,1,26,0,2,136.23,0.00,0.50,0.40,0,7.00,2,681.95,0,1,5,org.apache.lucene.search.similarities.SloppySimScorer,0.00,4,1,8,0,4,4,0,1,159,1
"org.apache.lucene.search.similarities.TFIDFSimilarity",15,1.00,1.33,80,1.23,63925.14,16,1,10,31,24,82.57,643,103,14,2,116.28,15.00,0.06,0.07,2,28.00,4,3686.20,0,6,10,org.apache.lucene.search.similarities.Similarity,0.19,16,1,20,15,16,9,0,19,736,2
"org.apache.lucene.search.similarities.TFIDFSimilarity$ExactTFIDFDocScorer",3,0.20,2.33,20,0.28,8325.71,8,5,10,6,2,164.66,5,26,0,2,114.66,0.00,0.50,0.33,0,1.00,3,837.58,0,1,2,org.apache.lucene.search.similarities.ExactSimScorer,0.00,3,1,7,0,3,2,0,5,178,2
"org.apache.lucene.search.similarities.TFIDFSimilarity$IDFStats",3,0.08,1.00,18,0.17,3326.54,9,6,10,4,1,157.88,7,24,0,2,118.00,0.00,0.50,0.22,0,1.00,1,522.45,0,0,1,org.apache.lucene.search.similarities.SimWeight,0.00,1,1,3,0,1,3,0,7,127,2
"org.apache.lucene.search.similarities.TFIDFSimilarity$SloppyTFIDFDocScorer",5,0.08,1.40,17,0.23,4944.39,8,3,10,11,3,129.54,2,27,0,2,129.54,0.00,0.50,0.27,0,7.00,2,700.35,0,1,3,org.apache.lucene.search.similarities.SloppySimScorer,0.00,6,1,7,0,6,4,0,2,166,2
"org.apache.lucene.search.similarities.TestSimilarity2",8,1.00,2.62,158,2.25,59695.98,9,1,25,43,27,132.47,17,168,0,2,92.58,0.00,0.50,0.12,0,14.00,7,6738.42,1,0,27,org.apache.lucene.util.LuceneTestCase,0.00,35,1,21,0,35,8,0,13,1169,1
"org.apache.lucene.search.similarities.TestSimilarityBase",36,0.06,1.28,252,4.12,113070.83,56,20,20,114,44,112.12,164,350,0,2,111.88,0.00,0.50,0.11,3,48.00,8,12374.46,2,3,44,org.apache.lucene.util.LuceneTestCase,0.00,78,1,46,0,78,33,0,76,2402,1
"org.apache.lucene.facet.example.adaptive.AdaptiveMain",2,0.00,1.00,14,0.15,3572.97,2,0,9,10,11,93.72,28,17,2,1,113.87,0.00,0.00,0.00,0,2.00,1,451.79,0,1,9,java.lang.Object,0.00,8,0,2,0,8,1,0,5,97,1
"org.apache.lucene.facet.example.adaptive.AdaptiveSearcher",1,0.00,2.00,21,0.38,14770.46,1,0,19,21,19,54.98,42,23,1,1,88.69,0.00,0.00,0.00,0,1.00,2,1130.93,0,1,18,java.lang.Object,0.00,20,0,2,0,20,0,0,17,186,1
"org.apache.solr.search.grouping.collector.FilterCollector",7,0.08,1.14,23,0.18,2623.31,11,4,5,12,7,182.90,10,32,3,2,132.90,0.00,0.50,0.32,0,0.00,2,538.60,0,1,4,org.apache.lucene.search.Collector,0.36,5,1,8,0,5,6,0,2,143,1
"org.apache.lucene.search.spans.FieldMaskingSpanQuery",10,0.17,1.30,41,0.50,14653.89,12,2,12,25,14,123.79,45,67,3,3,123.55,0.00,0.67,0.35,2,6.00,3,1492.26,2,5,11,org.apache.lucene.search.spans.SpanQuery,0.26,15,2,13,0,15,5,0,3,347,1
"org.apache.lucene.search.spans.JustCompileSearchSpans",0,0.00,0.00,6,0.06,759.99,1,1,9,0,6,171.00,7,10,0,1,171.00,0.00,0.00,0.00,0,0.00,0,174.17,0,0,6,java.lang.Object,0.00,0,0,0,0,0,0,0,1,41,1
"org.apache.lucene.search.spans.JustCompileSearchSpans$JustCompilePayloadSpans",7,0.00,1.00,15,0.15,2024.81,7,0,9,8,1,140.39,0,30,0,2,140.39,0.00,0.50,0.00,0,0.00,1,436.73,0,1,1,org.apache.lucene.search.spans.Spans,1.00,1,1,7,0,1,6,0,0,117,2
"org.apache.lucene.search.spans.JustCompileSearchSpans$JustCompileSpanQuery",3,0.00,1.00,7,0.08,1174.84,3,0,9,4,3,139.35,0,14,0,3,139.35,0.00,0.67,0.00,0,0.00,1,248.26,0,3,3,org.apache.lucene.search.spans.SpanQuery,0.19,1,2,3,0,1,0,0,0,63,2
"org.apache.lucene.search.spans.JustCompileSearchSpans$JustCompileSpanScorer",2,0.00,1.00,5,0.05,645.41,2,0,9,3,3,140.01,0,10,0,4,140.01,0.00,0.75,0.00,0,2.00,1,160.57,0,0,3,org.apache.lucene.search.spans.SpanScorer,0.21,1,3,2,0,1,2,0,0,43,2
"org.apache.lucene.search.spans.JustCompileSearchSpans$JustCompileSpans",7,0.00,1.00,15,0.15,2024.81,7,0,9,8,1,140.39,0,30,0,2,140.39,0.00,0.50,0.00,0,0.00,1,436.73,0,1,1,org.apache.lucene.search.spans.Spans,1.00,1,1,7,0,1,6,0,0,117,2
"org.apache.lucene.search.spans.MultiSpansWrapper",9,0.20,3.00,74,0.95,56762.75,14,5,13,28,17,107.14,8,107,8,2,107.14,0.00,0.50,0.38,0,0.00,7,2842.27,0,2,9,org.apache.lucene.search.spans.Spans,0.88,19,1,27,0,19,7,0,2,574,1
"org.apache.lucene.search.spans.NearSpansOrdered",17,0.12,3.18,180,2.33,174461.53,29,12,14,37,11,102.08,70,218,4,2,101.84,0.00,0.50,0.20,3,56.00,12,7000.21,0,3,8,org.apache.lucene.search.spans.Spans,0.58,20,1,54,0,20,14,0,31,1306,1
"org.apache.lucene.search.spans.NearSpansOrdered$Comparator<Spans>",1,0.00,1.00,3,0.03,480.85,1,0,14,2,1,132.08,0,4,0,1,132.08,0.00,0.00,0.00,0,1.00,1,93.66,0,0,1,java.lang.Object,0.00,1,0,1,0,1,1,0,0,27,0
"org.apache.lucene.search.spans.NearSpansUnordered",17,0.08,2.65,135,1.42,52123.27,28,11,12,46,10,151.68,44,166,3,2,111.80,0.00,0.50,0.17,8,92.00,11,4264.11,0,4,8,org.apache.lucene.search.spans.Spans,0.58,29,1,45,0,29,13,0,35,887,1
"org.apache.lucene.search.spans.NearSpansUnordered$CellQueue",2,0.00,1.50,8,0.09,2854.54,2,0,12,4,2,123.61,0,13,0,2,123.61,0.00,0.50,0.00,0,2.00,2,260.58,0,0,2,org.apache.lucene.util.PriorityQueue,0.00,2,1,3,0,2,2,0,0,65,1
"org.apache.lucene.search.spans.NearSpansUnordered$SpansCell",10,0.00,1.30,34,0.36,11038.58,14,4,12,18,1,129.18,4,49,0,2,129.18,0.00,0.50,0.25,3,0.00,4,1088.55,0,2,1,org.apache.lucene.search.spans.Spans,0.82,8,1,13,0,8,8,0,4,266,1
"org.apache.lucene.search.spans.SpanFirstQuery",6,0.00,1.67,29,0.44,16036.32,6,0,2,19,16,171.44,10,48,12,5,121.44,0.00,0.80,0.00,1,0.00,3,1317.08,1,3,4,org.apache.lucene.search.spans.SpanPositionRangeQuery,0.29,13,4,10,0,13,3,0,3,291,1
"org.apache.lucene.search.spans.SpanMultiTermQueryWrapper",9,0.25,1.67,45,0.51,14820.32,10,1,12,24,17,119.72,41,61,6,3,119.48,0.00,0.67,0.78,1,0.00,4,1533.12,0,4,11,org.apache.lucene.search.spans.SpanQuery,0.27,15,2,15,0,15,5,0,6,345,1
"org.apache.lucene.search.spans.SpanMultiTermQueryWrapper$SpanRewriteMethod",1,0.00,1.00,2,0.03,309.01,1,0,12,1,3,140.16,0,4,0,2,140.16,0.00,0.50,0.00,0,1.00,1,90.33,0,0,3,MultiTermQuery.RewriteMethod,0.00,0,1,1,0,0,1,0,0,25,3
"org.apache.lucene.search.spans.SpanMultiTermQueryWrapper$SpanRewriteMethod_0",2,0.00,1.00,8,0.08,1923.95,2,0,12,4,5,92.83,12,14,0,1,125.05,0.00,0.00,0.00,0,2.00,1,243.19,0,1,5,java.lang.Object,0.00,2,0,2,0,2,1,0,2,61,0
"org.apache.lucene.search.spans.SpanMultiTermQueryWrapper$SpanRewriteMethod_0$ScoringRewrite<SpanOrQuery>",3,0.00,1.00,8,0.09,1599.61,3,0,12,7,4,188.30,4,14,0,1,138.30,0.00,0.00,0.00,0,3.00,1,275.65,0,0,4,java.lang.Object,0.00,4,0,3,0,4,3,0,4,69,0
"org.apache.lucene.search.spans.SpanMultiTermQueryWrapper$SpanRewriteMethod_0$TopTermsSpanBooleanQueryRewrite",5,0.00,1.60,16,0.18,4223.19,6,1,12,11,5,180.05,5,25,0,2,130.05,0.00,0.50,1.00,0,0.00,4,534.36,0,0,5,org.apache.lucene.search.spans.SpanRewriteMethod,0.00,6,1,8,0,6,5,0,2,130,3
"org.apache.lucene.search.spans.SpanMultiTermQueryWrapper$SpanRewriteMethod_0$TopTermsSpanBooleanQueryRewrite$TopTermsRewrite<SpanOrQuery>",3,0.00,1.00,9,0.10,1730.15,3,0,12,7,4,131.46,0,15,0,1,131.46,0.00,0.00,0.00,0,3.00,1,294.90,0,0,4,java.lang.Object,0.00,4,0,3,0,4,3,0,0,73,0
"org.apache.lucene.search.spans.SpanNearPayloadCheckQuery",6,0.60,2.50,52,0.63,26122.58,7,1,4,23,6,148.33,16,70,2,4,108.45,0.00,0.75,0.50,1,2.00,7,1886.58,1,3,4,org.apache.lucene.search.spans.SpanPositionCheckQuery,0.31,17,3,15,0,17,3,0,8,388,1
"org.apache.lucene.search.spans.SpanNearQuery",13,0.13,2.54,97,1.22,54400.54,18,5,13,43,39,150.63,26,117,29,3,110.74,0.50,0.50,0.32,2,10.00,6,3666.14,1,5,12,org.apache.lucene.search.spans.SpanQuery,0.35,30,2,33,1,30,8,1,17,747,1
"org.apache.lucene.search.spans.SpanNotQuery",11,0.05,1.64,56,0.69,26363.99,13,2,12,28,21,118.20,10,74,12,3,118.20,0.00,0.67,0.55,2,0.00,5,2079.83,1,4,9,org.apache.lucene.search.spans.SpanQuery,0.38,17,2,18,0,17,7,1,9,470,1
"org.apache.lucene.search.spans.SpanNotQuery$Spans",8,0.18,2.38,37,0.62,41168.25,12,4,12,16,2,159.00,16,67,0,1,119.12,0.00,0.00,0.41,1,0.00,6,1853.68,0,2,2,java.lang.Object,0.00,8,0,19,0,8,6,0,16,401,0
"org.apache.lucene.search.spans.SpanOrQuery",11,0.05,2.45,78,0.98,37387.14,13,2,15,42,35,111.46,9,96,25,3,111.46,0.00,0.67,0.45,2,0.00,5,2934.80,1,5,10,org.apache.lucene.search.spans.SpanQuery,0.38,31,2,27,0,31,6,1,9,614,1
"org.apache.lucene.search.spans.SpanOrQuery$SpanQueue",2,0.00,2.00,11,0.13,6227.84,2,0,15,5,2,117.26,0,18,0,2,117.26,0.00,0.50,0.00,0,2.00,3,383.56,0,0,2,org.apache.lucene.util.PriorityQueue,0.00,3,1,4,0,3,2,0,0,93,1
"org.apache.lucene.search.spans.SpanOrQuery$Spans",10,0.56,2.20,52,0.69,23830.82,11,1,15,27,3,118.15,3,75,0,1,118.15,0.00,0.00,0.50,4,10.00,5,2077.43,0,3,3,java.lang.Object,0.00,17,0,22,0,17,7,0,3,438,0
"org.apache.lucene.search.spans.SpanPayloadCheckQuery",6,0.60,2.33,48,0.62,23272.12,7,1,5,26,6,129.47,21,66,2,4,108.86,0.00,0.75,0.50,1,2.00,5,1872.60,1,3,4,org.apache.lucene.search.spans.SpanPositionCheckQuery,0.31,20,3,14,0,20,3,0,9,386,1
"org.apache.lucene.search.spans.SpanPositionCheckQuery",7,0.50,1.29,25,0.25,6456.96,8,1,11,11,13,150.41,27,33,5,3,129.80,2.00,0.29,0.57,0,3.00,3,747.46,1,4,8,org.apache.lucene.search.spans.SpanQuery,0.15,4,2,9,4,4,3,1,6,180,2
"org.apache.lucene.search.spans.SpanPositionCheckQuery$AcceptStatus",0,0.00,0.00,2,0.01,71.32,0,0,11,0,0,171.00,0,1,0,1,171.00,0.00,0.00,0.00,0,0.00,0,28.53,0,0,0,java.lang.Object,0.00,0,0,0,0,0,0,1,0,9,2
"org.apache.lucene.search.spans.SpanPositionCheckQuery$PositionCheckSpan",10,0.11,1.90,36,0.38,8960.76,11,1,11,19,3,129.81,3,55,0,2,129.81,0.00,0.50,0.90,1,0.00,7,1145.38,0,2,3,org.apache.lucene.search.spans.Spans,0.82,9,1,19,0,9,8,0,3,271,1
"org.apache.lucene.search.spans.SpanPositionRangeQuery",8,0.14,1.50,37,0.52,18364.10,10,2,2,19,8,171.98,12,58,4,4,121.98,0.33,0.60,0.62,1,0.00,3,1561.25,1,2,4,org.apache.lucene.search.spans.SpanPositionCheckQuery,0.29,11,3,12,1,11,6,0,4,350,1
"org.apache.lucene.search.spans.SpanQuery",3,0.00,1.00,5,0.06,722.85,3,0,9,4,73,202.24,4,8,65,2,152.24,14.00,0.06,0.00,0,3.00,1,186.22,0,3,9,org.apache.lucene.search.Query,0.00,1,1,3,14,1,0,0,3,50,2
"org.apache.lucene.search.spans.SpanScorer",7,0.30,1.86,44,0.42,11449.05,12,5,4,14,10,116.52,4,62,6,3,116.52,1.50,0.33,0.46,0,0.00,4,1258.84,0,0,4,org.apache.lucene.search.Scorer,0.88,7,2,13,3,7,7,0,2,278,1
"org.apache.lucene.search.spans.SpanTermQuery",8,0.14,2.75,57,0.81,42258.60,9,1,13,33,50,109.93,7,80,37,3,109.93,0.50,0.50,0.88,0,0.00,7,2436.07,3,4,13,org.apache.lucene.search.spans.SpanQuery,0.29,25,2,22,1,25,4,0,7,476,1
"org.apache.lucene.search.spans.SpanWeight",6,0.30,2.17,50,0.79,29520.87,10,4,12,38,19,108.06,3,69,5,2,108.06,2.00,0.25,0.50,0,0.00,3,2374.27,0,2,15,org.apache.lucene.search.Weight,0.50,32,1,13,2,32,4,0,1,442,1
"org.apache.lucene.search.spans.Spans",7,0.00,1.00,8,0.06,462.42,7,0,2,7,36,114.38,49,9,36,1,156.67,0.00,0.00,0.00,0,7.00,1,173.89,0,1,0,java.lang.Object,0.00,0,0,7,9,0,6,0,9,59,2
"org.apache.lucene.search.spans.TermSpans",11,0.16,1.64,58,0.58,16749.57,18,7,7,21,10,119.75,7,84,5,2,119.75,1.00,0.33,0.29,0,0.00,4,1754.64,0,3,5,org.apache.lucene.search.spans.Spans,0.78,10,1,18,1,10,8,0,4,387,1
"org.apache.lucene.search.spans.TermSpans$EmptyTermSpans",7,0.00,1.00,15,0.11,1376.55,7,0,7,7,2,141.71,0,30,0,3,141.71,0.00,0.67,0.00,0,7.00,1,330.43,0,1,2,org.apache.lucene.search.spans.TermSpans,0.84,0,2,7,0,0,6,0,0,95,3
"org.apache.lucene.search.spans.TestBasics",28,0.12,1.07,288,8.72,210831.47,31,3,30,75,30,153.15,28,434,0,2,103.15,0.00,0.50,0.21,1,28.00,2,26171.33,0,0,30,org.apache.lucene.util.LuceneTestCase,0.00,47,1,30,0,47,28,0,6,4033,1
"org.apache.lucene.search.spans.TestBasics$Analyzer",1,0.00,1.00,4,0.05,1009.20,1,0,30,4,2,124.89,0,6,0,1,124.89,0.00,0.00,0.00,0,1.00,1,159.62,0,1,2,java.lang.Object,0.00,3,0,1,0,3,0,0,0,38,0
"org.apache.lucene.search.spans.TestBasics$SimplePayloadFilter",3,0.50,1.33,19,0.17,2926.66,6,3,30,8,3,118.37,0,26,0,2,118.37,0.00,0.50,0.67,0,0.00,2,501.89,1,0,3,org.apache.lucene.index.TokenFilter,0.00,5,1,4,0,5,3,0,0,118,2
"org.apache.lucene.search.spans.TestFieldMaskingSpanQuery",18,0.08,1.11,176,3.18,130531.84,21,3,18,56,20,104.98,2,253,0,2,104.98,0.00,0.50,0.26,3,0.00,2,9531.84,0,4,20,org.apache.lucene.util.LuceneTestCase,0.00,38,1,20,0,38,14,0,2,1834,1
"org.apache.lucene.search.spans.TestFieldMaskingSpanQuery$Term",1,0.00,1.00,3,0.05,640.22,1,0,18,4,4,131.10,0,6,0,1,131.10,0.00,0.00,0.00,0,1.00,1,144.78,0,1,4,java.lang.Object,0.00,3,0,1,0,3,0,0,0,37,0
"org.apache.lucene.search.spans.TestNearSpansOrdered",16,0.04,1.06,91,1.30,23925.81,21,5,15,50,19,119.91,13,121,0,2,119.91,0.00,0.50,0.24,2,0.00,2,3887.11,2,4,19,org.apache.lucene.util.LuceneTestCase,0.00,34,1,17,0,34,12,0,3,819,1
"org.apache.lucene.search.spans.TestPayloadSpans",14,0.03,2.79,301,5.31,233062.05,19,5,27,61,26,88.20,7,339,0,2,88.20,0.00,0.50,0.23,2,62.00,7,15935.97,1,1,26,org.apache.lucene.util.LuceneTestCase,0.00,47,1,39,0,47,13,0,7,2704,1
"org.apache.lucene.search.spans.TestPayloadSpans$PayloadAnalyzer",1,0.00,1.00,4,0.06,1028.22,1,0,27,4,2,124.82,0,7,0,2,124.82,0.00,0.50,0.00,0,1.00,1,167.13,0,1,2,org.apache.lucene.index.Analyzer,0.00,3,1,1,0,3,0,0,0,40,1
"org.apache.lucene.search.spans.TestPayloadSpans$PayloadFilter",3,0.75,2.00,31,0.36,9049.60,9,6,27,12,4,106.14,0,40,0,2,106.14,0.00,0.50,0.67,0,1.00,4,1093.20,1,0,4,org.apache.lucene.index.TokenFilter,0.00,9,1,6,0,9,3,0,0,225,1
"org.apache.lucene.search.spans.TestPayloadSpans$TestPayloadAnalyzer",1,0.00,1.00,4,0.06,1046.33,1,0,27,4,2,124.76,0,7,0,2,124.76,0.00,0.50,0.00,0,1.00,1,171.27,0,1,2,org.apache.lucene.index.Analyzer,0.00,3,1,1,0,3,0,0,0,41,2
"org.apache.lucene.search.spans.TestSpanExplanations",30,0.00,1.00,101,1.34,18616.10,30,0,1,31,3,131.21,8,132,1,3,131.21,0.50,0.50,0.00,0,30.00,1,4026.30,6,0,2,org.apache.lucene.search.TestExplanations,0.00,1,2,30,1,1,30,0,6,892,1
"org.apache.lucene.search.spans.TestSpanExplanationsOfNonMatches",1,0.00,1.00,3,0.04,549.65,1,0,2,2,3,83.52,8,7,0,4,131.62,0.00,0.75,0.00,0,0.00,1,119.24,0,0,3,org.apache.lucene.search.spans.TestSpanExplanations,0.00,1,3,1,0,1,1,0,2,30,1
"org.apache.lucene.search.spans.TestSpanFirstQuery",1,0.00,1.00,22,0.39,8979.96,1,0,13,22,16,110.41,3,24,0,2,89.79,0.00,0.50,0.00,0,1.00,1,1167.35,0,0,16,org.apache.lucene.util.LuceneTestCase,0.00,21,1,1,0,21,1,0,3,201,1
"org.apache.lucene.search.spans.TestSpanMultiTermQueryWrapper",6,0.20,1.00,44,0.59,11990.32,9,3,11,24,14,163.48,8,53,0,2,113.48,0.00,0.50,0.50,0,0.00,1,1776.29,2,0,14,org.apache.lucene.util.LuceneTestCase,0.00,18,1,6,0,18,6,0,6,362,1
"org.apache.lucene.search.spans.TestSpanSearchEquivalence",8,0.00,1.00,51,0.67,14914.49,8,0,6,18,11,166.22,14,60,0,3,116.22,0.00,0.67,0.00,0,8.00,1,2017.81,3,0,11,org.apache.lucene.search.SearchEquivalenceTestBase,0.00,10,2,8,0,10,8,0,12,441,1
"org.apache.lucene.search.spans.TestSpans",40,0.13,1.10,267,3.90,229519.36,45,5,23,93,27,112.35,16,361,0,2,112.35,0.00,0.50,0.07,10,272.00,3,11693.75,2,5,27,org.apache.lucene.util.LuceneTestCase,0.00,53,1,44,0,53,35,0,16,2292,1
"org.apache.lucene.search.spans.TestSpans$DefaultSimilarity",1,0.00,1.00,3,0.02,175.12,1,0,23,1,0,135.54,0,5,0,1,135.54,0.00,0.00,0.00,0,1.00,1,54.60,0,0,0,java.lang.Object,0.00,0,0,1,0,0,1,0,0,17,0
"org.apache.lucene.search.spans.TestSpansAdvanced",6,0.16,1.33,57,0.92,33545.86,11,5,14,34,18,57.72,50,74,1,2,105.83,1.00,0.33,0.33,3,14.00,3,2766.77,2,0,17,org.apache.lucene.util.LuceneTestCase,0.00,28,1,8,1,28,6,0,15,519,1
"org.apache.lucene.search.spans.TestSpansAdvanced2",6,0.00,1.00,37,0.58,11679.82,8,2,10,24,12,98.20,32,55,0,3,116.07,0.00,0.67,0.50,0,0.00,1,1727.66,5,0,12,org.apache.lucene.search.spans.TestSpansAdvanced,0.75,18,2,6,0,18,6,0,10,344,1
"org.apache.solr.update.AddUpdateCommand",9,0.02,2.22,53,0.62,20497.89,14,5,9,25,48,168.30,12,72,37,2,118.30,0.00,0.50,0.22,2,15.00,8,1846.77,1,6,11,org.apache.solr.update.UpdateCommand,0.21,16,1,20,0,16,3,0,8,387,1
"org.apache.solr.update.CommitTracker",16,0.04,1.88,88,0.91,21963.10,29,13,13,36,9,159.96,45,126,3,1,120.07,0.00,0.00,0.11,2,98.00,5,2739.13,0,1,6,java.lang.Object,0.00,20,0,30,0,20,15,1,34,591,1
"org.apache.solr.update.CommitUpdateCommand",3,0.14,1.00,15,0.17,2240.60,10,7,1,3,25,142.92,9,26,23,2,122.30,0.00,0.50,0.24,0,4.00,1,495.06,1,2,2,org.apache.solr.update.UpdateCommand,0.31,0,1,3,0,0,1,0,3,118,1
"org.apache.solr.update.DefaultSolrCoreState",10,0.11,2.50,71,0.80,21963.03,19,9,9,34,9,112.95,1,115,1,2,112.95,0.00,0.50,0.21,2,34.00,7,2398.14,0,3,8,org.apache.solr.update.SolrCoreState,0.33,24,1,25,0,24,7,0,1,491,2
"org.apache.solr.update.DeleteUpdateCommand",11,0.05,1.64,51,0.51,13130.89,15,4,6,23,29,124.20,6,69,22,2,124.20,0.00,0.50,0.30,1,21.00,4,1531.16,1,5,7,org.apache.solr.update.UpdateCommand,0.19,12,1,18,0,12,6,0,4,352,1
"org.apache.solr.update.DirectUpdateHandler2",28,0.10,3.18,336,4.82,252438.67,47,19,39,127,51,139.22,74,452,12,2,99.33,0.00,0.50,0.15,4,0.00,24,14453.05,3,10,40,org.apache.solr.update.UpdateHandler,0.37,99,1,89,0,99,18,1,67,2513,1
"org.apache.solr.update.DirectUpdateHandlerOptimizeTest",4,0.00,1.50,40,0.46,21755.73,4,0,8,18,9,124.80,14,47,0,3,104.19,0.00,0.67,0.00,1,6.00,3,1392.04,0,2,9,org.apache.solr.util.AbstractSolrTestCase,0.16,14,2,6,0,14,2,0,11,258,1
"org.apache.solr.update.DirectUpdateHandlerOptimizeTest$FileFilter",1,0.00,1.00,3,0.02,227.68,1,0,8,3,0,134.64,0,4,0,1,134.64,0.00,0.00,0.00,0,1.00,1,70.91,0,0,0,java.lang.Object,0.00,2,0,1,0,2,1,0,0,21,0
"org.apache.solr.update.DirectUpdateHandlerTest",9,0.88,1.11,151,2.29,85993.07,10,1,16,39,12,115.33,34,201,0,3,94.72,0.00,0.67,0.22,0,36.00,2,6873.68,16,0,12,org.apache.solr.SolrTestCaseJ4,0.04,30,2,10,0,30,9,0,31,1192,1
"org.apache.solr.update.DocumentBuilder",11,0.13,4.73,134,2.30,211296.94,14,3,10,47,12,64.43,76,190,3,1,96.66,0.00,0.00,0.21,3,31.00,18,6891.70,0,3,9,java.lang.Object,0.00,36,0,52,0,36,8,0,34,1185,1
"org.apache.solr.update.DocumentBuilderTest",12,0.00,1.33,120,2.08,68200.94,12,0,9,37,8,154.06,22,165,0,3,104.07,0.00,0.67,0.00,0,0.00,3,6238.26,2,0,8,org.apache.solr.SolrTestCaseJ4,0.00,25,2,16,0,25,12,0,13,1174,1
"org.apache.solr.update.DummyMergePolicy",2,0.00,1.00,5,0.02,128.32,2,0,2,2,2,185.42,4,7,0,4,145.54,0.00,0.75,0.00,0,2.00,1,60.82,1,0,2,org.apache.lucene.index.LogByteSizeMergePolicy,0.00,0,3,2,0,0,2,0,1,22,0
"org.apache.solr.update.MergeIndexesCommand",3,1.00,1.67,18,0.19,8834.57,4,1,2,8,10,154.42,6,23,7,2,114.54,0.00,0.50,0.33,0,4.00,3,581.18,1,2,3,org.apache.solr.update.UpdateCommand,0.31,5,1,5,0,5,1,0,1,127,1
"org.apache.solr.update.MockEventListener",7,0.17,1.43,23,0.32,7255.52,11,4,11,17,6,129.37,3,35,1,1,129.37,0.00,0.00,0.39,0,0.00,2,952.74,0,0,5,java.lang.Object,0.00,10,0,10,0,10,7,1,3,224,0
"org.apache.solr.update.NewSearcherListener",8,0.00,1.88,37,0.39,9860.92,12,4,15,14,13,124.06,4,54,1,1,124.06,0.00,0.00,0.25,0,14.00,5,1158.50,0,0,12,java.lang.Object,0.00,6,0,15,0,6,8,1,4,258,0
"org.apache.solr.update.NewSearcherListener$AutoCommitTest",7,0.00,1.86,143,2.21,104145.95,7,0,15,39,10,71.60,36,155,0,3,89.47,0.00,0.67,0.00,1,15.00,3,6635.32,4,3,10,org.apache.solr.util.AbstractSolrTestCase,0.15,32,2,13,0,32,4,0,32,1087,1
"org.apache.solr.update.NewSearcherListener$AutoCommitTest$SolrQueryRequestBase",0,0.00,0.00,1,0.01,23.26,0,0,15,0,0,171.00,0,0,0,1,171.00,0.00,0.00,0.00,0,0.00,0,15.51,0,0,0,java.lang.Object,0.00,0,0,0,0,0,0,0,0,6,0
"org.apache.solr.update.NewSearcherListener$AutoCommitTest$SolrQueryRequestBase_0",0,0.00,0.00,1,0.01,23.26,0,0,15,0,0,171.00,0,0,0,1,171.00,0.00,0.00,0.00,0,0.00,0,15.51,0,0,0,java.lang.Object,0.00,0,0,0,0,0,0,0,0,6,0
"org.apache.solr.update.NewSearcherListener$AutoCommitTest$SolrQueryRequestBase_1",0,0.00,0.00,1,0.01,23.26,0,0,15,0,0,171.00,0,0,0,1,171.00,0.00,0.00,0.00,0,0.00,0,15.51,0,0,0,java.lang.Object,0.00,0,0,0,0,0,0,0,0,6,0
"org.apache.solr.update.NewSearcherListener$TriggerOn",0,0.00,0.00,2,0.01,15.51,0,0,15,0,1,171.00,0,1,0,1,171.00,0.00,0.00,0.00,0,0.00,0,15.51,0,0,1,java.lang.Object,0.00,0,0,0,0,0,0,1,0,6,0
"org.apache.solr.update.PeerSync",11,0.13,5.00,265,4.44,319935.47,29,18,36,91,29,51.77,68,327,3,1,83.99,0.00,0.00,0.18,7,7.00,15,13307.10,0,1,26,java.lang.Object,0.00,80,0,55,0,80,10,0,60,2163,1
"org.apache.solr.update.PeerSync$Comparator<Long>",1,0.00,3.00,7,0.08,2728.28,1,0,36,2,0,112.17,0,9,0,1,112.17,0.00,0.00,0.00,0,1.00,3,251.84,0,0,0,java.lang.Object,0.00,1,0,3,0,1,1,0,0,57,0
"org.apache.solr.update.PeerSync$Comparator<Object>",1,0.00,5.00,11,0.17,8536.63,1,0,36,3,0,100.83,0,13,0,1,100.83,0.00,0.00,0.00,0,1.00,5,504.65,0,0,0,java.lang.Object,0.00,2,0,5,0,2,1,0,0,104,0
"org.apache.solr.update.PeerSync$SyncShardRequest",0,0.00,0.00,4,0.03,520.00,3,3,36,0,1,171.00,0,5,0,2,171.00,0.00,0.50,0.00,0,0.00,0,104.00,0,0,1,org.apache.solr.handler.component.ShardRequest,0.00,0,1,0,0,0,0,0,0,26,2
"org.apache.solr.update.PeerSyncTest",3,0.25,1.67,105,2.07,269222.74,5,2,23,15,15,31.99,21,92,0,4,74.28,0.00,0.75,0.33,1,5.00,3,6219.91,6,0,15,org.apache.solr.BaseDistributedSearchTestCase,0.04,12,3,5,0,12,3,0,21,969,1
"org.apache.solr.update.RollbackUpdateCommand",3,0.00,1.00,7,0.05,574.61,3,0,1,3,15,191.80,4,13,13,2,141.80,0.00,0.50,0.00,0,3.00,1,141.26,1,2,2,org.apache.solr.update.UpdateCommand,0.31,0,1,3,0,0,1,0,1,43,1
"org.apache.solr.update.SoftAutoCommitTest",6,0.20,2.17,138,2.41,159375.60,8,2,11,30,8,35.19,55,178,0,3,85.19,0.00,0.67,0.67,0,0.00,5,7221.74,4,2,8,org.apache.solr.util.AbstractSolrTestCase,0.15,24,2,13,0,24,4,0,37,1161,1
"org.apache.solr.update.SolrCmdDistributor",14,0.01,3.00,171,2.30,99856.87,23,9,26,69,14,150.15,20,210,2,1,100.15,0.00,0.00,0.10,7,82.00,8,6885.37,0,1,12,java.lang.Object,0.00,55,0,42,0,55,13,0,20,1282,1
"org.apache.solr.update.SolrCmdDistributor$AddRequest",0,0.00,0.00,3,0.01,54.00,2,2,26,0,2,171.00,0,4,0,1,171.00,0.00,0.00,0.00,0,0.00,0,36.00,0,0,2,java.lang.Object,0.00,0,0,0,0,0,0,0,0,12,0
"org.apache.solr.update.SolrCmdDistributor$Callable<Request>",1,0.00,4.00,20,0.26,16423.30,1,0,26,6,2,138.95,1,27,0,1,88.95,0.00,0.00,0.00,0,0.00,4,766.54,0,1,2,java.lang.Object,0.00,5,0,4,0,5,0,0,1,143,0
"org.apache.solr.update.SolrCmdDistributor$DeleteRequest",0,0.00,0.00,3,0.01,54.00,2,2,26,0,2,171.00,0,4,0,1,171.00,0.00,0.00,0.00,0,0.00,0,36.00,0,0,2,java.lang.Object,0.00,0,0,0,0,0,0,0,0,12,0
"org.apache.solr.update.SolrCmdDistributor$Error",0,0.00,0.00,3,0.02,124.57,2,2,26,0,0,171.00,0,4,0,1,171.00,0.00,0.00,0.00,0,0.00,0,49.83,0,0,0,java.lang.Object,0.00,0,0,0,0,0,0,0,0,15,2
"org.apache.solr.update.SolrCmdDistributor$Node",5,0.00,1.00,6,0.03,193.87,5,0,26,5,1,158.49,0,7,0,1,158.49,0.00,0.00,0.00,0,5.00,1,93.06,0,4,1,java.lang.Object,0.00,0,0,5,0,0,1,0,0,36,3
"org.apache.solr.update.SolrCmdDistributor$Request",0,0.00,0.00,7,0.05,553.87,6,6,26,0,2,171.00,0,8,0,1,171.00,0.00,0.00,0.00,0,0.00,0,146.95,0,0,2,java.lang.Object,0.00,0,0,0,0,0,0,0,0,34,2
"org.apache.solr.update.SolrCmdDistributor$Response",0,0.00,0.00,3,0.03,583.92,2,2,26,1,0,171.00,0,4,0,1,171.00,0.00,0.00,0.00,0,0.00,0,102.19,0,0,0,java.lang.Object,0.00,1,0,0,0,1,0,0,0,25,2
"org.apache.solr.update.SolrCmdDistributor$StdNode",9,0.06,2.67,44,0.52,25473.85,13,4,26,16,1,121.13,0,61,0,2,121.13,0.00,0.50,0.31,0,18.00,13,1552.91,0,5,1,org.apache.solr.update.Node,0.00,7,1,24,0,7,4,0,0,356,2
"org.apache.solr.update.SolrCmdDistributorTest",5,0.00,1.40,76,1.35,73081.48,5,0,15,42,13,144.25,7,89,0,4,94.25,0.00,0.75,0.00,0,10.00,3,4052.77,2,2,13,org.apache.solr.BaseDistributedSearchTestCase,0.07,37,3,7,0,37,3,0,7,675,1
"org.apache.solr.update.SolrCoreState",8,0.00,1.00,10,0.08,554.86,8,0,5,8,7,156.74,38,11,4,1,156.50,0.00,0.00,0.00,0,8.00,1,237.89,0,2,4,java.lang.Object,0.00,0,0,8,1,0,6,0,7,77,2
"org.apache.solr.update.SolrCoreState$IndexWriterCloser",1,0.00,1.00,2,0.01,69.06,1,0,5,1,1,145.29,0,3,0,1,145.29,0.00,0.00,0.00,0,1.00,1,36.53,0,0,1,,0.00,0,0,1,0,0,1,0,0,13,1
"org.apache.solr.update.SolrIndexConfig",6,0.40,4.50,103,1.74,87495.72,23,17,11,44,16,131.85,12,126,6,1,91.97,0.00,0.00,0.39,2,0.00,8,5233.72,0,4,11,java.lang.Object,0.00,38,0,27,0,38,2,0,10,909,1
"org.apache.solr.update.SolrIndexConfigTest",2,0.00,1.50,15,0.18,3993.66,2,0,4,9,4,153.28,4,22,0,3,113.39,0.00,0.67,0.00,0,2.00,2,529.04,0,0,4,org.apache.solr.SolrTestCaseJ4,0.00,7,2,3,0,7,2,0,2,114,1
"org.apache.solr.update.SolrIndexWriter",5,0.18,2.20,46,0.63,17370.12,12,7,19,25,16,65.05,38,69,6,2,107.34,0.00,0.50,0.29,2,0.00,3,1901.44,4,1,10,org.apache.lucene.index.IndexWriter,0.03,20,1,11,0,20,4,0,4,373,1
"org.apache.solr.update.TestIndexingPerformance",5,0.25,2.00,51,0.80,38729.95,7,2,11,28,8,103.15,22,63,0,3,102.91,0.00,0.67,0.30,0,10.00,5,2388.00,0,2,8,org.apache.solr.util.AbstractSolrTestCase,0.16,23,2,10,0,23,3,0,4,402,1
"org.apache.solr.update.TransactionLog",0,0.00,0.00,21,0.29,8261.32,17,17,17,7,13,171.00,20,22,6,1,171.00,0.00,0.00,0.00,0,0.00,0,870.63,0,0,7,java.lang.Object,0.00,7,0,0,0,7,0,0,4,148,1
"org.apache.solr.update.TransactionLog$JavaBinCodec.ObjectResolver",1,0.00,2.00,7,0.08,2174.66,1,0,17,2,2,113.04,0,10,0,1,113.04,0.00,0.00,0.00,0,1.00,2,233.77,0,1,2,java.lang.Object,0.00,1,0,2,0,1,0,0,0,53,0
"org.apache.solr.update.TransactionLog$LogCodec",30,0.00,2.27,249,2.92,100875.77,30,0,17,65,10,149.24,62,328,0,2,109.35,0.00,0.50,0.00,5,222.00,7,8758.76,3,4,10,org.apache.solr.common.util.JavaBinCodec,0.00,35,1,68,0,35,26,0,47,1711,1
"org.apache.solr.update.TransactionLog$LogCodec$ChannelFastInputStream",7,0.83,1.14,25,0.26,5877.00,8,1,17,10,1,130.15,5,37,0,3,130.15,0.00,0.67,0.29,0,9.00,2,792.96,1,1,1,org.apache.solr.common.util.FastInputStream,0.18,3,2,8,0,3,6,0,5,189,0
"org.apache.solr.update.TransactionLog$LogCodec$LogReader",4,0.00,2.00,29,0.34,11878.92,6,2,17,12,1,161.97,7,42,0,1,111.97,0.00,0.00,0.50,0,0.00,5,1007.38,0,2,1,java.lang.Object,0.00,8,0,8,0,8,2,0,3,208,1
"org.apache.solr.update.TransactionLog$LogCodec$ReverseReader",5,0.25,1.80,44,0.45,15093.79,8,3,17,18,1,110.01,21,57,0,1,109.77,0.00,0.00,0.53,0,0.00,4,1364.40,0,2,1,java.lang.Object,0.00,13,0,9,0,13,3,0,17,279,1
"org.apache.solr.update.TransactionLog$LogCodec$ReverseReader$LogCodec_0",1,0.00,1.00,3,0.02,240.44,1,0,17,1,2,174.34,2,5,0,1,134.45,0.00,0.00,0.00,0,1.00,1,65.11,0,1,2,java.lang.Object,0.00,0,0,1,0,0,0,0,2,19,0
"org.apache.solr.update.UpdateCommand",10,0.08,1.10,29,0.23,3343.87,17,7,2,10,13,139.87,8,43,11,1,139.87,0.00,0.00,0.07,1,34.00,2,695.20,1,4,2,java.lang.Object,0.00,0,0,11,5,0,6,1,5,181,2
"org.apache.solr.update.UpdateHandler",21,0.05,1.38,67,0.75,20690.46,30,9,14,39,24,179.55,41,82,10,1,129.55,0.00,0.00,0.06,2,123.00,4,2235.98,0,2,16,java.lang.Object,0.00,18,0,29,1,18,19,1,8,504,2
"org.apache.solr.update.UpdateLog",32,0.07,3.16,374,4.78,191297.53,69,37,28,131,39,122.76,108,489,12,1,102.15,0.00,0.00,0.10,7,54.00,10,14345.66,0,10,28,java.lang.Object,0.00,99,0,101,0,99,22,1,106,2597,1
"org.apache.solr.update.UpdateLog$DeleteUpdate",1,2.00,1.00,6,0.04,614.90,3,2,28,1,0,120.01,0,8,0,1,120.01,0.00,0.00,0.00,0,1.00,1,124.22,0,0,0,java.lang.Object,0.00,0,0,1,0,0,1,0,0,35,1
"org.apache.solr.update.UpdateLog$FilenameFilter",1,0.00,1.00,3,0.02,217.60,1,0,28,2,0,134.79,0,4,0,1,134.79,0.00,0.00,0.00,0,1.00,1,68.92,0,0,0,java.lang.Object,0.00,1,0,1,0,1,1,0,0,20,0
"org.apache.solr.update.UpdateLog$LinkedHashMap<BytesRef,LogPtr>",1,0.00,1.00,3,0.03,271.21,1,0,28,2,0,134.04,0,4,0,1,134.04,0.00,0.00,0.00,0,0.00,1,85.64,0,0,0,java.lang.Object,0.00,1,0,1,0,1,1,0,0,24,0
"org.apache.solr.update.UpdateLog$LogPtr",2,0.50,1.00,8,0.05,768.04,4,2,28,2,0,128.19,0,11,0,1,128.19,0.00,0.00,0.25,0,2.00,1,160.53,0,1,0,java.lang.Object,0.00,0,0,2,0,0,1,0,0,47,2
"org.apache.solr.update.UpdateLog$LogReplayer",3,0.50,10.67,126,1.99,193738.84,11,8,28,44,18,22.03,28,161,0,1,72.03,0.00,0.00,0.46,1,1.00,26,5978.02,0,0,18,java.lang.Object,0.00,41,0,32,0,41,3,1,28,889,0
"org.apache.solr.update.UpdateLog$RecentUpdates",5,0.10,4.60,70,1.04,67184.29,10,5,28,26,3,145.39,6,91,0,1,95.39,0.00,0.00,0.28,0,5.00,12,3115.70,0,3,3,java.lang.Object,0.00,21,0,23,0,21,2,0,6,546,1
"org.apache.solr.update.UpdateLog$RecoveryInfo",1,0.00,1.00,8,0.08,892.21,6,5,28,1,0,114.08,0,11,0,1,114.08,0.00,0.00,1.00,0,0.00,1,247.18,0,1,0,java.lang.Object,0.00,0,0,1,0,0,0,0,0,61,2
"org.apache.solr.update.UpdateLog$State",0,0.00,0.00,2,0.01,36.00,0,0,28,0,1,171.00,0,1,0,1,171.00,0.00,0.00,0.00,0,0.00,0,24.00,0,0,1,java.lang.Object,0.00,0,0,0,0,0,0,1,0,8,1
"org.apache.solr.update.UpdateLog$SyncLevel",0,0.00,0.00,2,0.01,29.48,0,0,28,0,1,171.00,0,1,0,1,171.00,0.00,0.00,0.00,0,0.00,0,19.65,0,0,1,java.lang.Object,0.00,0,0,0,0,0,0,1,0,7,1
"org.apache.solr.update.UpdateLog$Update",0,0.00,0.00,4,0.02,131.77,3,3,28,0,1,171.00,0,5,0,1,171.00,0.00,0.00,0.00,0,0.00,0,56.47,0,0,1,java.lang.Object,0.00,0,0,0,0,0,0,0,0,17,1
"org.apache.solr.update.UpdateParamsTest",3,0.00,1.67,24,0.31,9537.17,3,0,8,20,7,149.50,6,30,0,3,109.62,0.00,0.67,0.00,0,4.00,3,933.78,0,2,7,org.apache.solr.util.AbstractSolrTestCase,0.17,17,2,5,0,17,1,0,4,177,1
"org.apache.solr.update.UpdateParamsTest$SolrQueryRequestBase",0,0.00,0.00,1,0.01,23.26,0,0,8,0,0,171.00,0,0,0,1,171.00,0.00,0.00,0.00,0,0.00,0,15.51,0,0,0,java.lang.Object,0.00,0,0,0,0,0,0,0,0,6,0
"org.apache.solr.update.VersionBucket",1,0.00,2.00,5,0.04,664.56,2,1,0,3,2,104.67,5,8,2,1,122.54,0.00,0.00,1.00,0,0.00,2,131.54,0,0,0,java.lang.Object,0.00,2,0,2,0,2,1,0,5,35,1
"org.apache.solr.update.VersionInfo",12,0.08,1.42,66,0.74,21521.61,22,10,14,39,16,159.11,32,85,5,1,119.22,0.00,0.00,0.18,0,80.00,4,2216.80,0,4,11,java.lang.Object,0.00,27,0,17,0,27,8,0,12,462,1
"org.apache.solr.search.grouping.distributed.requestfactory.SearchGroupsRequestFactory",1,0.00,5.00,23,0.49,32136.45,1,0,9,16,10,110.63,19,29,1,1,84.34,0.00,0.00,0.00,0,1.00,5,1462.61,0,1,9,java.lang.Object,0.00,15,0,5,0,15,0,1,14,250,1
"org.apache.solr.search.grouping.distributed.requestfactory.StoredFieldsShardRequestFactory",2,0.00,5.50,44,0.88,51570.59,2,0,16,30,16,125.68,5,51,1,1,85.79,0.00,0.00,0.00,1,2.00,8,2633.97,0,1,15,java.lang.Object,0.00,28,0,11,0,28,1,1,3,422,1
"org.apache.solr.search.grouping.distributed.requestfactory.TopGroupsShardRequestFactory",4,1.00,3.75,57,1.22,78738.10,5,1,17,38,14,76.25,20,70,1,1,94.13,0.00,0.00,0.25,3,6.00,9,3655.41,0,4,13,java.lang.Object,0.00,34,0,15,0,34,0,1,13,599,1
"org.apache.lucene.facet.example.simple.SimpleIndexer",1,0.00,2.00,24,0.40,17453.99,1,0,14,19,14,48.05,43,24,2,1,85.95,0.00,0.00,0.00,0,1.00,2,1188.97,0,0,12,java.lang.Object,0.00,18,0,2,0,18,1,0,19,198,1
"org.apache.lucene.facet.example.simple.SimpleMain",3,0.00,1.00,33,0.39,10181.63,3,0,9,18,12,60.22,33,37,2,1,104.35,0.00,0.00,0.00,0,3.00,1,1164.94,0,2,10,java.lang.Object,0.00,15,0,3,0,15,1,0,11,230,1
"org.apache.lucene.facet.example.simple.SimpleSearcher",4,0.00,2.00,35,0.64,23932.47,4,0,21,25,23,116.54,71,49,3,1,107.41,0.00,0.00,0.00,2,4.00,4,1926.61,0,4,20,java.lang.Object,0.00,21,0,8,0,21,0,0,23,344,1
"org.apache.lucene.facet.example.simple.SimpleUtils",0,0.00,0.00,7,0.16,4198.75,6,6,6,2,10,171.00,39,17,6,1,171.00,0.00,0.00,0.00,0,0.00,0,482.15,0,0,4,java.lang.Object,0.00,2,0,0,0,2,0,0,8,94,1
"org.apache.lucene.analysis.ja.dict.BinaryDictionary",20,0.02,2.10,191,2.61,212787.37,36,16,13,45,11,103.52,14,223,5,1,103.52,0.00,0.00,0.08,9,62.00,9,7824.29,0,9,6,java.lang.Object,0.00,25,0,42,2,25,11,1,12,1444,2
"org.apache.lucene.analysis.ja.dict.CharacterDefinition",7,0.06,1.29,53,0.88,43998.83,26,19,7,19,13,109.51,5,62,8,1,109.51,0.00,0.00,0.11,0,0.00,3,2648.45,0,1,5,java.lang.Object,0.00,12,0,9,0,12,6,0,3,505,2
"org.apache.lucene.analysis.ja.dict.CharacterDefinition$CharacterClass",0,0.00,0.00,2,0.03,187.65,0,0,7,0,0,171.00,0,3,0,1,171.00,0.00,0.00,0.00,0,0.00,0,75.06,0,0,0,java.lang.Object,0.00,0,0,0,0,0,0,0,0,18,2
"org.apache.lucene.analysis.ja.dict.CharacterDefinition$SingletonHolder",0,0.00,0.00,6,0.04,555.85,1,1,7,0,1,171.00,0,10,0,1,171.00,0.00,0.00,0.00,0,0.00,0,120.82,0,0,1,java.lang.Object,0.00,0,0,0,0,0,0,0,0,33,2
"org.apache.lucene.analysis.ja.dict.ConnectionCosts",3,0.12,2.00,38,0.46,28609.00,7,4,7,10,12,149.25,4,41,7,1,99.25,0.00,0.00,0.33,0,5.00,4,1375.98,0,1,5,java.lang.Object,0.00,7,0,6,0,7,2,0,2,258,2
"org.apache.lucene.analysis.ja.dict.ConnectionCosts$SingletonHolder",0,0.00,0.00,6,0.04,555.85,1,1,7,0,1,171.00,0,10,0,1,171.00,0.00,0.00,0.00,0,0.00,0,120.82,0,0,1,java.lang.Object,0.00,0,0,0,0,0,0,0,0,33,2
"org.apache.lucene.analysis.ja.dict.Dictionary",9,1.00,1.00,11,0.10,730.83,10,1,0,9,5,113.67,67,12,5,1,155.96,0.00,0.00,0.00,0,9.00,1,308.78,0,6,0,,0.00,0,0,9,0,0,3,0,13,97,1
"org.apache.lucene.analysis.ja.dict.TestTokenInfoDictionary",1,0.00,7.00,61,1.02,95380.80,1,0,7,27,7,32.52,6,63,0,2,64.74,0.00,0.50,0.00,0,1.00,7,3056.84,0,0,7,org.apache.lucene.util.LuceneTestCase,0.00,26,1,7,0,26,1,0,6,470,1
"org.apache.lucene.analysis.ja.dict.TokenInfoDictionary",3,0.25,1.33,20,0.21,6024.27,5,2,7,9,11,165.90,5,27,5,2,115.90,0.00,0.50,0.33,0,5.00,2,623.79,0,1,6,org.apache.lucene.analysis.ja.dict.BinaryDictionary,0.00,6,1,4,0,6,2,0,2,134,2
"org.apache.lucene.analysis.ja.dict.TokenInfoDictionary$SingletonHolder",0,0.00,0.00,6,0.04,555.85,1,1,7,0,1,171.00,0,10,0,1,171.00,0.00,0.00,0.00,0,0.00,0,120.82,0,0,1,java.lang.Object,0.00,0,0,0,0,0,0,0,0,33,2
"org.apache.lucene.analysis.ja.dict.TokenInfoFST",6,0.20,1.83,40,0.61,35062.01,10,4,3,13,3,152.06,13,49,2,1,112.17,0.00,0.00,0.42,0,0.00,3,1843.02,0,5,1,java.lang.Object,0.00,7,0,11,0,7,1,0,7,368,2
"org.apache.lucene.analysis.ja.dict.UnknownDictionary",7,0.83,1.43,29,0.25,10224.89,8,1,1,10,6,123.54,4,40,4,2,123.54,0.00,0.50,0.29,0,13.00,4,754.36,0,4,2,org.apache.lucene.analysis.ja.dict.BinaryDictionary,0.22,3,1,10,0,3,3,0,2,177,2
"org.apache.lucene.analysis.ja.dict.UnknownDictionary$SingletonHolder",0,0.00,0.00,6,0.04,555.85,1,1,1,0,1,171.00,0,10,0,1,171.00,0.00,0.00,0.00,0,0.00,0,120.82,0,0,1,java.lang.Object,0.00,0,0,0,0,0,0,0,0,33,2
"org.apache.lucene.analysis.ja.dict.UnknownDictionaryTest",2,1.00,2.50,29,0.36,11659.17,3,1,4,7,2,98.38,0,40,0,2,98.38,0.00,0.50,0.00,0,2.00,3,1073.63,0,0,2,org.apache.lucene.util.LuceneTestCase,0.00,5,1,5,0,5,2,0,0,211,1
"org.apache.lucene.analysis.ja.dict.UserDictionary",16,0.04,2.19,141,2.13,143419.32,24,8,14,58,12,145.89,39,165,5,1,106.01,0.00,0.00,0.09,2,116.00,7,6389.87,0,9,7,java.lang.Object,0.00,42,0,35,0,42,7,1,26,1148,2
"org.apache.lucene.analysis.ja.dict.UserDictionary$Comparator<String",1,0.00,1.00,3,0.04,722.00,1,0,14,2,0,130.69,0,5,0,1,130.69,0.00,0.00,0.00,0,1.00,1,124.00,0,0,0,java.lang.Object,0.00,1,0,1,0,1,1,0,0,33,0
"org.apache.lucene.analysis.ja.dict.UserDictionaryTest",4,0.00,1.00,34,0.55,16484.87,4,0,4,14,2,129.46,13,43,0,2,108.85,0.00,0.50,0.00,0,4.00,1,1637.89,0,0,2,org.apache.lucene.util.LuceneTestCase,0.00,10,1,4,0,10,4,0,13,329,1
"org.apache.lucene.analysis.ar.ArabicAnalyzer",5,0.50,1.40,21,0.28,7150.19,7,2,12,17,12,94.24,67,32,1,3,123.62,0.00,0.67,0.10,0,8.00,3,830.58,0,2,11,org.apache.lucene.analysis.util.StopwordAnalyzerBase,0.00,12,2,7,0,12,3,0,10,184,2
"org.apache.lucene.analysis.ar.ArabicAnalyzer$DefaultSetHolder",0,0.00,0.00,6,0.05,732.71,1,1,12,0,2,171.00,2,10,0,1,171.00,0.00,0.00,0.00,0,0.00,0,149.07,0,0,2,java.lang.Object,0.00,0,0,0,0,0,0,0,2,37,2
"org.apache.lucene.analysis.ar.ArabicNormalizationFilter",2,0.00,1.50,11,0.12,2323.29,4,2,4,8,9,160.58,4,16,5,4,120.70,0.00,0.75,0.50,0,2.00,2,359.90,0,0,4,org.apache.lucene.analysis.TokenFilter,0.29,6,3,3,0,6,2,0,1,84,2
"org.apache.lucene.analysis.ar.ArabicNormalizer",1,0.00,7.00,35,0.49,12385.63,18,17,1,1,2,124.67,22,51,2,1,80.72,0.00,0.00,1.00,0,0.00,7,1463.95,0,0,0,java.lang.Object,0.00,0,0,7,0,0,1,0,2,272,1
"org.apache.lucene.analysis.ar.ArabicStemFilter",2,0.33,2.00,14,0.16,3794.18,5,3,6,9,10,113.74,8,20,4,4,113.50,0.00,0.75,0.50,0,2.00,3,481.98,0,0,6,org.apache.lucene.analysis.TokenFilter,0.29,7,3,4,0,7,2,0,1,107,2
"org.apache.lucene.analysis.ar.ArabicStemmer",5,0.06,3.20,38,0.91,50299.27,18,13,1,6,2,57.69,48,73,2,1,107.69,0.00,0.00,0.03,2,11.00,5,2715.07,0,0,0,java.lang.Object,0.00,1,0,16,0,1,5,0,9,546,1
"org.apache.lucene.analysis.ar.Deprecated",2,0.00,1.00,9,0.12,1974.39,2,0,4,4,1,164.85,4,15,0,3,124.96,0.00,0.67,0.00,0,2.00,1,352.70,1,0,1,org.apache.lucene.analysis.BaseTokenStreamTestCase,0.00,2,2,2,0,2,2,0,1,81,1
"org.apache.lucene.analysis.ar.TestArabicAnalyzer",7,0.00,1.00,35,0.53,14927.94,7,0,3,9,3,139.33,26,45,0,3,118.71,0.00,0.67,0.00,0,7.00,1,1585.45,3,0,3,org.apache.lucene.analysis.BaseTokenStreamTestCase,0.00,2,2,7,0,2,7,0,14,345,1
"org.apache.lucene.analysis.ar.TestArabicNormalizationFilter",16,0.00,1.00,36,0.28,3088.12,16,0,7,20,5,141.77,3,53,0,3,141.77,0.00,0.67,0.00,1,16.00,1,846.90,2,0,5,org.apache.lucene.analysis.BaseTokenStreamTestCase,0.00,4,2,16,0,4,16,0,1,233,1
"org.apache.lucene.analysis.ar.TestArabicNormalizationFilter$Analyzer",1,0.00,1.00,4,0.05,753.46,1,0,7,4,3,125.89,0,6,0,1,125.89,0.00,0.00,0.00,0,1.00,1,135.44,0,1,3,java.lang.Object,0.00,3,0,1,0,3,0,0,0,34,0
"org.apache.lucene.analysis.ar.TestArabicStemFilter",24,0.00,1.00,56,0.47,5710.13,24,0,9,31,7,141.06,4,81,0,3,141.06,0.00,0.67,0.00,1,24.00,1,1400.46,2,0,7,org.apache.lucene.analysis.BaseTokenStreamTestCase,0.00,7,2,24,0,7,24,0,1,373,1
"org.apache.lucene.analysis.ar.TestArabicStemFilter$Analyzer",1,0.00,1.00,4,0.05,753.46,1,0,9,4,3,125.89,0,6,0,1,125.89,0.00,0.00,0.00,0,1.00,1,135.44,0,1,3,java.lang.Object,0.00,3,0,1,0,3,0,0,0,34,0
"org.apache.lucene.analysis.synonym.SolrSynonymParser",5,0.38,5.00,96,1.23,116177.81,7,2,8,25,4,46.26,35,105,2,2,88.55,0.00,0.50,0.20,3,8.00,11,3693.12,0,2,2,SynonymMap.Builder,0.00,20,1,25,0,20,3,0,9,680,1
"org.apache.lucene.analysis.synonym.SynonymFilter",8,0.27,5.38,229,3.01,258377.07,31,23,15,46,34,128.39,189,260,19,4,81.12,0.00,0.75,0.28,3,0.00,15,9035.25,1,0,15,org.apache.lucene.analysis.TokenFilter,0.40,38,3,43,0,38,8,0,129,1497,2
"org.apache.lucene.analysis.synonym.SynonymFilter$PendingInput",1,3.00,1.00,13,0.09,1489.51,8,7,15,2,1,104.46,0,15,0,1,104.46,0.00,0.00,0.57,0,0.00,1,277.11,0,0,1,java.lang.Object,0.00,1,0,1,0,1,1,0,0,64,2
"org.apache.lucene.analysis.synonym.SynonymFilter$PendingOutputs",5,0.42,1.80,37,0.39,15210.42,11,6,15,9,3,111.91,3,47,0,1,111.91,0.00,0.00,0.50,1,0.00,4,1162.91,0,1,3,java.lang.Object,0.00,4,0,9,0,4,4,0,3,248,2
"org.apache.lucene.analysis.synonym.SynonymMap",1,4.00,1.00,10,0.10,1728.23,5,4,20,1,19,88.06,14,11,6,1,108.20,0.00,0.00,0.00,0,1.00,1,298.01,0,0,13,java.lang.Object,0.00,0,0,1,0,0,1,0,6,70,1
"org.apache.lucene.analysis.synonym.SynonymMap$Builder",8,0.00,4.50,149,2.42,211594.38,13,5,20,57,15,71.13,44,177,0,1,89.00,0.00,0.00,0.20,1,16.00,8,7272.93,0,2,15,java.lang.Object,0.00,49,0,36,0,49,6,0,27,1236,2
"org.apache.lucene.analysis.synonym.SynonymMap$Builder$MapEntry",0,0.00,0.00,3,0.03,640.00,2,2,20,1,0,171.00,1,4,0,1,171.00,0.00,0.00,0.00,0,0.00,0,96.00,0,0,0,java.lang.Object,0.00,1,0,0,0,1,0,0,1,24,2
"org.apache.lucene.analysis.synonym.TestSolrSynonymParser",7,0.00,1.00,47,0.76,18227.68,7,0,10,15,8,165.08,11,73,0,3,115.08,0.00,0.67,0.00,0,7.00,1,2289.03,1,0,8,org.apache.lucene.analysis.BaseTokenStreamTestCase,0.00,8,2,7,0,8,7,0,8,449,1
"org.apache.lucene.analysis.synonym.TestSolrSynonymParser$Analyzer",1,0.00,1.00,4,0.06,1111.23,1,0,10,4,3,124.56,0,6,0,1,124.56,0.00,0.00,0.00,0,1.00,1,170.85,0,1,3,java.lang.Object,0.00,3,0,1,0,3,0,0,0,40,0
"org.apache.lucene.analysis.synonym.TestSolrSynonymParser$Analyzer_0",1,0.00,1.00,4,0.06,1111.23,1,0,10,4,3,124.56,0,6,0,1,124.56,0.00,0.00,0.00,0,1.00,1,170.85,0,1,3,java.lang.Object,0.00,3,0,1,0,3,0,0,0,40,0
"org.apache.lucene.analysis.synonym.TestSynonymMapFilter",24,0.13,3.21,476,6.95,618263.47,30,6,19,92,14,138.30,36,545,0,3,88.30,0.00,0.67,0.29,7,0.00,24,20851.02,4,3,14,org.apache.lucene.analysis.BaseTokenStreamTestCase,0.00,68,2,77,0,68,21,0,33,3590,1
"org.apache.lucene.analysis.synonym.TestSynonymMapFilter$Analyzer",1,0.00,1.00,4,0.06,1051.87,1,0,19,4,3,124.74,0,6,0,1,124.74,0.00,0.00,0.00,0,1.00,1,173.06,0,1,3,java.lang.Object,0.00,3,0,1,0,3,0,0,0,40,0
"org.apache.lucene.analysis.synonym.TestSynonymMapFilter$Analyzer_0",1,0.00,1.00,4,0.05,790.45,1,0,19,4,3,125.72,0,6,0,1,125.72,0.00,0.00,0.00,0,1.00,1,148.55,0,1,3,java.lang.Object,0.00,3,0,1,0,3,0,0,0,36,0
"org.apache.lucene.analysis.synonym.TestSynonymMapFilter$Analyzer_1",1,0.00,1.00,4,0.06,1051.87,1,0,19,4,3,124.74,0,6,0,1,124.74,0.00,0.00,0.00,0,1.00,1,173.06,0,1,3,java.lang.Object,0.00,3,0,1,0,3,0,0,0,40,0
"org.apache.lucene.analysis.synonym.TestSynonymMapFilter$Analyzer_10",1,0.00,1.00,4,0.06,1051.87,1,0,19,4,3,124.74,0,6,0,1,124.74,0.00,0.00,0.00,0,1.00,1,173.06,0,1,3,java.lang.Object,0.00,3,0,1,0,3,0,0,0,40,0
"org.apache.lucene.analysis.synonym.TestSynonymMapFilter$Analyzer_11",1,0.00,1.00,4,0.06,1051.87,1,0,19,4,3,124.74,0,6,0,1,124.74,0.00,0.00,0.00,0,1.00,1,173.06,0,1,3,java.lang.Object,0.00,3,0,1,0,3,0,0,0,40,0
"org.apache.lucene.analysis.synonym.TestSynonymMapFilter$Analyzer_2",1,0.00,1.00,4,0.06,1111.23,1,0,19,4,3,124.56,0,6,0,1,124.56,0.00,0.00,0.00,0,1.00,1,170.85,0,1,3,java.lang.Object,0.00,3,0,1,0,3,0,0,0,40,0
"org.apache.lucene.analysis.synonym.TestSynonymMapFilter$Analyzer_3",1,0.00,1.00,4,0.06,1051.87,1,0,19,4,3,124.74,0,6,0,1,124.74,0.00,0.00,0.00,0,1.00,1,173.06,0,1,3,java.lang.Object,0.00,3,0,1,0,3,0,0,0,40,0
"org.apache.lucene.analysis.synonym.TestSynonymMapFilter$Analyzer_4",1,0.00,1.00,4,0.06,1051.87,1,0,19,4,3,124.74,0,6,0,1,124.74,0.00,0.00,0.00,0,1.00,1,173.06,0,1,3,java.lang.Object,0.00,3,0,1,0,3,0,0,0,40,0
"org.apache.lucene.analysis.synonym.TestSynonymMapFilter$Analyzer_5",1,0.00,1.00,4,0.06,1051.87,1,0,19,4,3,124.74,0,6,0,1,124.74,0.00,0.00,0.00,0,1.00,1,173.06,0,1,3,java.lang.Object,0.00,3,0,1,0,3,0,0,0,40,0
"org.apache.lucene.analysis.synonym.TestSynonymMapFilter$Analyzer_6",1,0.00,1.00,4,0.06,1051.87,1,0,19,4,3,124.74,0,6,0,1,124.74,0.00,0.00,0.00,0,1.00,1,173.06,0,1,3,java.lang.Object,0.00,3,0,1,0,3,0,0,0,40,0
"org.apache.lucene.analysis.synonym.TestSynonymMapFilter$Analyzer_7",1,0.00,1.00,4,0.06,1051.87,1,0,19,4,3,124.74,0,6,0,1,124.74,0.00,0.00,0.00,0,1.00,1,173.06,0,1,3,java.lang.Object,0.00,3,0,1,0,3,0,0,0,40,0
"org.apache.lucene.analysis.synonym.TestSynonymMapFilter$Analyzer_8",1,0.00,1.00,4,0.06,1051.87,1,0,19,4,3,124.74,0,6,0,1,124.74,0.00,0.00,0.00,0,1.00,1,173.06,0,1,3,java.lang.Object,0.00,3,0,1,0,3,0,0,0,40,0
"org.apache.lucene.analysis.synonym.TestSynonymMapFilter$Analyzer_9",1,0.00,1.00,4,0.06,1051.87,1,0,19,4,3,124.74,0,6,0,1,124.74,0.00,0.00,0.00,0,1.00,1,173.06,0,1,3,java.lang.Object,0.00,3,0,1,0,3,0,0,0,40,0
"org.apache.lucene.analysis.synonym.TestSynonymMapFilter$OneSyn",0,0.00,0.00,4,0.03,319.82,3,3,19,0,0,171.00,0,5,0,1,171.00,0.00,0.00,0.00,0,0.00,0,79.95,0,0,0,java.lang.Object,0.00,0,0,0,0,0,0,0,0,21,2
"org.apache.lucene.analysis.synonym.TestWordnetSynonymParser",1,0.00,1.00,14,0.26,5506.11,3,2,7,7,7,119.40,3,28,0,3,98.79,0.00,0.67,1.00,0,0.00,1,776.80,1,0,7,org.apache.lucene.analysis.BaseTokenStreamTestCase,0.00,6,2,1,0,6,1,0,3,144,1
"org.apache.lucene.analysis.synonym.TestWordnetSynonymParser$Analyzer",1,0.00,1.00,4,0.06,1111.23,1,0,7,4,3,124.56,0,6,0,1,124.56,0.00,0.00,0.00,0,1.00,1,170.85,0,1,3,java.lang.Object,0.00,3,0,1,0,3,0,0,0,40,0
"org.apache.lucene.analysis.synonym.WordnetSynonymParser",4,0.33,3.50,57,0.66,37393.00,6,2,6,17,3,136.58,9,65,1,2,96.69,0.00,0.50,0.25,2,8.00,6,1993.28,0,1,2,SynonymMap.Builder,0.00,13,1,14,0,13,3,0,4,379,1
"org.apache.lucene.queryparser.flexible.standard.parser.EscapeQuerySyntaxImpl",8,0.05,5.50,146,2.02,195171.83,14,6,5,28,13,57.01,54,180,8,1,89.23,0.00,0.00,0.12,2,34.00,12,6068.94,0,7,5,java.lang.Object,0.00,20,0,44,0,20,1,1,28,1112,1
"org.apache.lucene.queryparser.flexible.standard.parser.JavaCharStream",39,0.10,2.18,267,3.57,243220.54,57,18,0,47,2,161.91,49,479,2,1,111.91,0.00,0.00,0.15,9,189.00,15,10717.33,0,1,0,java.lang.Object,0.00,8,0,85,0,8,38,0,38,2144,1
"org.apache.lucene.queryparser.flexible.standard.parser.ParseException",5,5.00,3.00,88,1.12,86343.00,10,5,4,15,8,62.10,69,105,3,4,91.48,0.00,0.75,0.00,0,5.00,9,3348.03,0,2,5,org.apache.lucene.queryparser.flexible.core.QueryNodeParseException,0.00,10,3,15,0,10,3,0,11,593,1
"org.apache.lucene.queryparser.flexible.standard.parser.StandardSyntaxParser",45,0.07,5.89,749,9.69,1065831.35,69,24,20,96,30,141.23,84,943,5,1,91.23,0.00,0.00,0.11,21,456.00,50,29075.34,0,10,25,java.lang.Object,0.00,51,0,265,0,51,35,2,75,5037,1
"org.apache.lucene.queryparser.flexible.standard.parser.StandardSyntaxParser$JJCalls",0,0.00,0.00,5,0.03,253.51,4,4,20,0,1,171.00,0,6,0,1,171.00,0.00,0.00,0.00,0,0.00,0,78.87,0,0,1,java.lang.Object,0.00,0,0,0,0,0,0,0,0,22,2
"org.apache.lucene.queryparser.flexible.standard.parser.StandardSyntaxParser$LookaheadSuccess",0,0.00,0.00,1,0.01,145.30,0,0,20,0,0,171.00,0,1,0,2,171.00,0.00,0.50,0.00,0,0.00,0,41.51,0,0,0,java.lang.Error,0.00,0,1,0,0,0,0,0,0,12,3
"org.apache.lucene.queryparser.flexible.standard.parser.StandardSyntaxParserConstants",0,0.00,0.00,38,0.60,7264.45,37,37,0,0,2,171.00,41,74,2,1,171.00,0.00,0.00,0.00,0,0.00,0,1786.89,0,0,0,,0.00,0,0,0,0,0,0,0,38,262,1
"org.apache.lucene.queryparser.flexible.standard.parser.StandardSyntaxParserTokenManager",30,0.06,8.60,514,7.72,1137919.98,51,21,20,41,22,88.55,12,900,1,1,88.55,0.00,0.00,0.11,18,298.00,129,23159.38,0,0,21,java.lang.Object,0.00,11,0,258,0,11,30,1,12,3781,1
"org.apache.lucene.queryparser.flexible.standard.parser.SuppressWarnings",6,0.20,1.50,48,0.66,33774.42,11,5,0,14,0,59.58,51,72,0,2,107.69,0.00,0.50,0.03,1,10.00,3,1967.96,1,3,0,java.lang.Error,0.00,8,1,9,0,8,3,0,14,375,1
"org.apache.lucene.queryparser.flexible.standard.parser.Token",7,0.12,1.00,24,0.16,1989.42,15,8,0,8,5,83.88,67,38,5,1,133.88,0.00,0.00,0.02,1,12.00,1,468.86,0,4,0,java.lang.Object,0.00,1,0,7,0,1,3,0,15,131,1
"org.apache.solr.spelling.suggest.fst.FSTLookupFactory",2,0.33,2.00,10,0.18,4408.99,5,3,5,7,6,68.44,19,19,1,2,118.44,0.00,0.50,0.50,0,2.00,3,538.33,0,2,5,org.apache.solr.spelling.suggest.LookupFactory,0.50,5,1,4,0,5,0,0,4,115,1
"org.apache.solr.spelling.suggest.fst.WFSTLookupFactory",2,0.00,1.50,8,0.12,2365.90,4,2,6,6,5,92.03,12,15,0,2,124.25,0.00,0.50,0.50,0,2.00,2,346.29,0,2,5,org.apache.solr.spelling.suggest.LookupFactory,0.50,4,1,3,0,4,0,0,3,79,1
"org.apache.lucene.analysis.cn.smart.AnalyzerProfile",2,1.00,4.50,34,0.43,25273.13,3,1,4,16,2,60.23,12,47,2,1,92.46,0.00,0.00,0.50,1,2.00,7,1286.81,0,1,0,java.lang.Object,0.00,14,0,9,0,14,1,0,4,244,1
"org.apache.lucene.analysis.cn.smart.CharType",0,0.00,0.00,9,0.12,1715.65,8,8,0,0,2,171.00,28,10,2,1,171.00,0.00,0.00,0.00,0,0.00,0,352.93,0,0,0,java.lang.Object,0.00,0,0,0,0,0,0,0,9,76,1
"org.apache.lucene.analysis.cn.smart.SentenceTokenizer",7,0.10,1.86,58,0.67,35139.83,14,7,7,19,7,147.91,14,77,2,4,108.03,0.00,0.75,0.22,1,10.00,7,2011.42,2,0,5,org.apache.lucene.analysis.Tokenizer,0.57,12,3,13,0,12,7,0,6,397,2
"org.apache.lucene.analysis.cn.smart.SmartChineseAnalyzer",5,0.12,1.60,23,0.26,5183.91,9,4,14,11,12,76.21,54,32,2,2,124.69,0.00,0.50,0.15,0,7.00,2,768.92,0,2,10,org.apache.lucene.analysis.Analyzer,0.00,6,1,8,0,6,3,0,9,177,2
"org.apache.lucene.analysis.cn.smart.SmartChineseAnalyzer$DefaultSetHolder",1,1.00,1.00,8,0.09,1108.58,2,1,14,4,4,133.95,3,16,0,1,113.34,0.00,0.00,0.00,0,0.00,1,255.71,0,1,4,java.lang.Object,0.00,3,0,1,0,3,0,0,3,63,2
"org.apache.lucene.analysis.cn.smart.TestSmartChineseAnalyzer",20,0.00,1.25,98,1.46,28388.71,20,0,12,31,9,163.55,52,130,0,3,123.67,0.00,0.67,0.00,0,20.00,3,4381.34,4,0,9,org.apache.lucene.analysis.BaseTokenStreamTestCase,0.00,11,2,25,0,11,20,0,23,900,1
"org.apache.lucene.analysis.cn.smart.TestSmartChineseAnalyzer$Analyzer",1,0.00,1.00,6,0.07,1514.00,1,0,12,5,5,116.93,0,8,0,1,116.93,0.00,0.00,0.00,0,1.00,1,221.62,0,1,5,java.lang.Object,0.00,4,0,1,0,4,0,0,0,50,0
"org.apache.lucene.analysis.cn.smart.TestSmartChineseAnalyzer$Analyzer_0",1,0.00,1.00,4,0.05,753.46,1,0,12,4,3,125.89,0,6,0,1,125.89,0.00,0.00,0.00,0,1.00,1,135.44,0,1,3,java.lang.Object,0.00,3,0,1,0,3,0,0,0,34,0
"org.apache.lucene.analysis.cn.smart.Utility",3,7.00,9.00,48,0.97,77424.94,10,7,1,5,5,108.97,54,90,4,1,90.84,0.00,0.00,0.00,0,3.00,10,2895.23,0,0,2,java.lang.Object,0.00,2,0,27,0,2,3,0,21,551,1
"org.apache.lucene.analysis.cn.smart.WordSegmenter",2,0.00,3.00,20,0.28,9533.58,4,2,5,11,5,60.35,23,31,1,1,104.48,0.00,0.00,0.50,0,2.00,3,850.28,0,2,4,java.lang.Object,0.00,9,0,6,0,9,0,0,5,176,0
"org.apache.lucene.analysis.cn.smart.WordTokenFilter",3,0.39,2.33,36,0.46,16592.42,12,9,9,17,11,58.78,23,46,4,4,101.08,0.00,0.75,0.37,0,1.00,5,1387.85,1,0,7,org.apache.lucene.analysis.TokenFilter,0.53,14,3,7,0,14,3,0,13,266,2
"org.apache.lucene.analysis.cn.smart.WordType",0,0.00,0.00,9,0.12,1715.65,8,8,0,0,4,171.00,28,10,4,1,171.00,0.00,0.00,0.00,0,0.00,0,352.93,0,0,0,java.lang.Object,0.00,0,0,0,0,0,0,0,9,76,1
"org.apache.lucene.util.collections.ArrayHashMap",23,0.10,1.96,177,1.84,67166.22,33,10,2,42,3,69.74,165,219,3,1,112.03,0.00,0.00,0.20,9,112.00,4,5515.03,0,4,0,java.lang.Object,0.00,19,0,45,0,19,19,1,81,1161,1
"org.apache.lucene.util.collections.ArrayHashMap$IndexIterator",4,0.33,1.75,22,0.18,4947.72,7,3,2,5,2,120.68,16,28,0,1,120.45,0.00,0.00,0.58,0,0.00,3,526.52,0,0,2,java.lang.Object,0.00,1,0,7,0,1,4,1,9,129,2
"org.apache.lucene.util.collections.ArrayHashMap$KeyIterator",4,0.33,1.00,9,0.07,1057.18,5,1,2,8,1,140.70,0,14,0,1,140.70,0.00,0.00,0.75,0,0.00,1,219.63,0,0,1,java.lang.Object,0.00,4,0,4,0,4,4,1,0,62,2
"org.apache.lucene.util.collections.ArrayHashMap$ValueIterator",4,0.33,1.00,9,0.07,1057.18,5,1,2,8,1,140.70,0,14,0,1,140.70,0.00,0.00,0.75,0,0.00,1,219.63,0,0,1,java.lang.Object,0.00,4,0,4,0,4,4,1,0,62,2
"org.apache.lucene.util.collections.ArrayHashMapTest",6,1.00,6.50,243,2.90,279398.93,7,1,6,40,7,94.66,20,201,6,2,74.05,0.00,0.50,0.17,0,10.00,10,8710.20,0,0,1,org.apache.lucene.util.LuceneTestCase,0.00,34,1,39,0,34,6,0,5,1570,1
"org.apache.lucene.util.collections.DoubleIterator",3,0.00,1.00,4,0.01,39.00,3,0,0,3,3,119.94,21,5,3,1,162.23,0.00,0.00,0.00,0,3.00,1,34.00,0,0,0,,0.00,0,0,3,0,0,3,0,2,17,1
"org.apache.lucene.util.collections.FloatIterator",3,0.00,1.00,4,0.01,39.00,3,0,0,3,6,119.94,21,5,6,1,162.23,0.00,0.00,0.00,0,3.00,1,34.00,0,0,0,,0.00,0,0,3,0,0,3,0,2,17,1
"org.apache.lucene.util.collections.FloatToObjectMap",23,0.04,2.00,182,1.92,72150.55,33,10,2,42,4,63.31,241,224,3,1,111.78,0.00,0.00,0.13,9,159.00,5,5770.59,0,3,1,java.lang.Object,0.00,19,0,46,0,19,20,1,82,1209,1
"org.apache.lucene.util.collections.FloatToObjectMap$IndexIterator",4,0.33,1.75,22,0.17,4819.23,7,3,2,5,2,102.66,20,27,0,1,120.54,0.00,0.00,0.58,0,0.00,3,499.62,0,0,2,java.lang.Object,0.00,1,0,7,0,1,4,1,9,124,2
"org.apache.lucene.util.collections.FloatToObjectMap$KeyIterator",4,0.33,1.00,9,0.06,715.12,5,1,2,8,2,142.03,0,13,0,1,142.03,0.00,0.00,0.75,0,0.00,1,175.51,0,0,2,java.lang.Object,0.00,4,0,4,0,4,4,1,0,53,2
"org.apache.lucene.util.collections.FloatToObjectMap$ValueIterator",4,0.33,1.00,9,0.07,1057.18,5,1,2,8,1,140.70,0,14,0,1,140.70,0.00,0.00,0.75,0,0.00,1,219.63,0,0,1,java.lang.Object,0.00,4,0,4,0,4,4,1,0,62,2
"org.apache.lucene.util.collections.FloatToObjectMapTest",6,0.00,6.50,242,2.98,295838.27,6,0,7,40,3,94.47,19,200,0,2,73.85,0.00,0.50,0.00,0,6.00,10,8941.66,0,0,3,org.apache.lucene.util.LuceneTestCase,0.00,34,1,39,0,34,6,0,4,1597,1
"org.apache.lucene.util.collections.IntArray",13,0.17,2.77,108,1.00,85913.17,16,3,1,18,4,74.77,86,138,3,1,107.00,0.00,0.00,0.49,2,0.00,12,3003.95,0,1,1,java.lang.Object,0.00,5,0,36,0,5,12,0,16,653,1
"org.apache.lucene.util.collections.IntArrayTest",4,0.00,4.00,83,0.80,40900.96,4,0,3,16,1,72.70,20,74,0,2,90.57,0.00,0.50,0.00,0,4.00,5,2393.76,0,0,1,org.apache.lucene.util.LuceneTestCase,0.00,12,1,16,0,12,4,0,5,474,1
"org.apache.lucene.util.collections.IntHashSet",19,0.06,2.11,164,1.51,56835.41,28,9,1,30,5,65.64,225,186,4,1,109.77,0.00,0.00,0.17,6,100.00,4,4529.93,0,3,1,java.lang.Object,0.00,11,0,40,0,11,16,0,85,980,1
"org.apache.lucene.util.collections.IntHashSet$IndexIterator",4,0.33,1.75,22,0.17,4819.23,7,3,1,5,2,102.66,20,27,0,1,120.54,0.00,0.00,0.58,0,0.00,3,499.62,0,0,2,java.lang.Object,0.00,1,0,7,0,1,4,1,9,124,2
"org.apache.lucene.util.collections.IntHashSet$KeyIterator",4,0.33,1.00,9,0.06,774.03,5,1,1,8,1,141.76,0,13,0,1,141.76,0.00,0.00,0.75,0,0.00,1,173.80,0,0,1,java.lang.Object,0.00,4,0,4,0,4,4,1,0,53,2
"org.apache.lucene.util.collections.IntHashSetTest",10,0.00,3.70,187,1.80,87123.55,10,0,4,28,1,142.85,16,179,0,2,92.85,0.00,0.50,0.00,0,10.00,6,5408.20,0,0,1,org.apache.lucene.util.LuceneTestCase,0.00,18,1,37,0,18,10,0,1,1053,1
"org.apache.lucene.util.collections.IntIterator",3,0.00,1.00,4,0.01,39.00,3,0,0,3,34,119.94,21,5,34,1,162.23,0.00,0.00,0.00,0,3.00,1,34.00,0,0,0,,0.00,0,0,3,0,0,3,0,2,17,1
"org.apache.lucene.util.collections.IntToDoubleMap",23,0.04,2.04,186,1.81,62622.58,34,11,1,42,5,61.62,242,221,3,1,110.10,0.00,0.00,0.13,9,180.00,5,5439.82,0,2,2,java.lang.Object,0.00,19,0,47,0,19,21,0,82,1163,1
"org.apache.lucene.util.collections.IntToDoubleMap$IndexIterator",4,0.33,1.75,22,0.17,4819.23,7,3,1,5,2,102.66,20,27,0,1,120.54,0.00,0.00,0.58,0,0.00,3,499.62,0,0,2,java.lang.Object,0.00,1,0,7,0,1,4,1,9,124,2
"org.apache.lucene.util.collections.IntToDoubleMap$KeyIterator",4,0.33,1.00,9,0.06,774.03,5,1,1,8,1,141.76,0,13,0,1,141.76,0.00,0.00,0.75,0,0.00,1,173.80,0,0,1,java.lang.Object,0.00,4,0,4,0,4,4,1,0,53,2
"org.apache.lucene.util.collections.IntToDoubleMap$ValueIterator",4,0.33,1.00,9,0.06,715.12,5,1,1,8,2,142.03,0,13,0,1,142.03,0.00,0.00,0.75,0,0.00,1,175.51,0,0,2,java.lang.Object,0.00,4,0,4,0,4,4,1,0,53,2
"org.apache.lucene.util.collections.IntToDoubleMapTest",7,0.00,5.71,244,2.79,243026.33,7,0,7,42,4,117.60,19,203,0,2,77.72,0.00,0.50,0.00,1,7.00,10,8372.81,0,0,4,org.apache.lucene.util.LuceneTestCase,0.00,35,1,40,0,35,7,0,4,1512,1
"org.apache.lucene.util.collections.IntToIntMap",23,0.04,2.00,183,1.74,63099.75,34,11,1,40,5,63.76,239,218,4,1,112.24,0.00,0.00,0.13,9,177.00,5,5208.93,0,1,1,java.lang.Object,0.00,17,0,46,0,17,22,0,82,1132,1
"org.apache.lucene.util.collections.IntToIntMap$IndexIterator",4,0.33,1.75,22,0.17,4819.23,7,3,1,5,2,102.66,20,27,0,1,120.54,0.00,0.00,0.58,0,0.00,3,499.62,0,0,2,java.lang.Object,0.00,1,0,7,0,1,4,1,9,124,2
"org.apache.lucene.util.collections.IntToIntMap$KeyIterator",4,0.33,1.00,9,0.06,774.03,5,1,1,8,1,141.76,0,13,0,1,141.76,0.00,0.00,0.75,0,0.00,1,173.80,0,0,1,java.lang.Object,0.00,4,0,4,0,4,4,1,0,53,2
"org.apache.lucene.util.collections.IntToIntMap$ValueIterator",4,0.33,1.00,9,0.06,774.03,5,1,1,8,1,141.76,0,13,0,1,141.76,0.00,0.00,0.75,0,0.00,1,173.80,0,0,1,java.lang.Object,0.00,4,0,4,0,4,4,1,0,53,2
"org.apache.lucene.util.collections.IntToIntMapTest",7,0.00,5.71,244,2.69,246742.65,7,0,6,36,3,117.55,19,203,0,2,77.66,0.00,0.50,0.00,1,7.00,10,8080.91,0,0,3,org.apache.lucene.util.LuceneTestCase,0.00,29,1,40,0,29,7,0,4,1478,1
"org.apache.lucene.util.collections.IntToObjectMap",23,0.04,2.00,182,1.91,73700.98,33,10,2,41,6,63.23,241,224,5,1,111.71,0.00,0.00,0.13,9,159.00,5,5720.50,0,4,1,java.lang.Object,0.00,18,0,46,0,18,19,1,82,1205,1
"org.apache.lucene.util.collections.IntToObjectMap$IndexIterator",4,0.33,1.75,22,0.17,4819.23,7,3,2,5,2,102.66,20,27,0,1,120.54,0.00,0.00,0.58,0,0.00,3,499.62,0,0,2,java.lang.Object,0.00,1,0,7,0,1,4,1,9,124,2
"org.apache.lucene.util.collections.IntToObjectMap$KeyIterator",4,0.33,1.00,9,0.06,774.03,5,1,2,8,1,141.76,0,13,0,1,141.76,0.00,0.00,0.75,0,0.00,1,173.80,0,0,1,java.lang.Object,0.00,4,0,4,0,4,4,1,0,53,2
"org.apache.lucene.util.collections.IntToObjectMap$ValueIterator",4,0.33,1.00,9,0.07,1057.18,5,1,2,8,1,140.70,0,14,0,1,140.70,0.00,0.00,0.75,0,0.00,1,219.63,0,0,1,java.lang.Object,0.00,4,0,4,0,4,4,1,0,62,2
"org.apache.lucene.util.collections.IntToObjectMapTest",6,0.00,6.50,242,2.86,268560.59,6,0,7,40,3,94.80,19,200,0,2,74.18,0.00,0.50,0.00,0,6.00,10,8583.24,0,0,3,org.apache.lucene.util.LuceneTestCase,0.00,34,1,39,0,34,6,0,4,1543,1
"org.apache.lucene.util.collections.LRUHashMap",4,0.67,1.00,11,0.10,1354.29,5,1,2,5,2,166.13,76,17,2,2,139.85,0.00,0.50,0.50,0,4.00,1,303.30,0,0,0,java.util.LinkedHashMap,0.00,1,1,4,0,1,4,0,10,80,1
"org.apache.lucene.util.collections.ObjectToFloatMap",23,0.04,1.96,180,1.84,64346.93,33,10,2,42,4,63.70,240,216,3,1,112.18,0.00,0.00,0.14,9,155.00,4,5520.00,0,2,1,java.lang.Object,0.00,19,0,45,0,19,21,0,82,1164,1
"org.apache.lucene.util.collections.ObjectToFloatMap$IndexIterator",4,0.33,1.75,22,0.18,4957.69,7,3,2,5,2,102.57,20,28,0,1,120.44,0.00,0.00,0.58,0,0.00,3,529.84,0,0,2,java.lang.Object,0.00,1,0,7,0,1,4,1,9,130,2
"org.apache.lucene.util.collections.ObjectToFloatMap$KeyIterator",4,0.33,1.00,9,0.07,1057.18,5,1,2,8,1,140.70,0,14,0,1,140.70,0.00,0.00,0.75,0,0.00,1,219.63,0,0,1,java.lang.Object,0.00,4,0,4,0,4,4,1,0,62,2
"org.apache.lucene.util.collections.ObjectToFloatMap$ValueIterator",4,0.33,1.00,9,0.06,715.12,5,1,2,8,2,142.03,0,13,0,1,142.03,0.00,0.00,0.75,0,0.00,1,175.51,0,0,2,java.lang.Object,0.00,4,0,4,0,4,4,1,0,53,2
"org.apache.lucene.util.collections.ObjectToFloatMapTest",8,0.00,5.12,247,2.90,266131.92,8,0,7,42,3,119.80,19,207,0,2,79.91,0.00,0.50,0.00,2,8.00,10,8687.62,0,0,3,org.apache.lucene.util.LuceneTestCase,0.00,34,1,41,0,34,8,0,4,1568,1
"org.apache.lucene.util.collections.ObjectToIntMap",23,0.04,1.96,180,1.82,65559.18,33,10,2,42,4,63.64,239,216,3,1,112.12,0.00,0.00,0.14,9,155.00,4,5451.60,0,3,1,java.lang.Object,0.00,19,0,45,0,19,20,0,81,1160,1
"org.apache.lucene.util.collections.ObjectToIntMap$IndexIterator",4,0.33,1.75,22,0.18,4957.69,7,3,2,5,2,102.57,20,28,0,1,120.44,0.00,0.00,0.58,0,0.00,3,529.84,0,0,2,java.lang.Object,0.00,1,0,7,0,1,4,1,9,130,2
"org.apache.lucene.util.collections.ObjectToIntMap$KeyIterator",4,0.33,1.00,9,0.07,1057.18,5,1,2,8,1,140.70,0,14,0,1,140.70,0.00,0.00,0.75,0,0.00,1,219.63,0,0,1,java.lang.Object,0.00,4,0,4,0,4,4,1,0,62,2
"org.apache.lucene.util.collections.ObjectToIntMap$ValueIterator",4,0.33,1.00,9,0.06,774.03,5,1,2,8,1,141.76,0,13,0,1,141.76,0.00,0.00,0.75,0,0.00,1,173.80,0,0,1,java.lang.Object,0.00,4,0,4,0,4,4,1,0,53,2
"org.apache.lucene.util.collections.ObjectToIntMapTest",8,0.00,5.12,247,2.87,275007.82,8,0,7,38,3,119.69,19,207,0,2,79.80,0.00,0.50,0.00,2,8.00,10,8620.49,0,0,3,org.apache.lucene.util.LuceneTestCase,0.00,30,1,41,0,30,8,0,4,1563,1
"org.apache.lucene.util.collections.TestLRUHashMap",1,0.00,1.00,31,0.44,28621.09,1,0,3,8,1,113.66,20,34,0,2,80.27,0.00,0.50,0.00,0,1.00,1,1315.06,0,0,1,org.apache.lucene.util.LuceneTestCase,0.00,7,1,1,0,7,1,0,5,247,1
"org.apache.lucene.analysis.hunspell.HunspellAffix",13,0.07,1.00,35,0.24,2684.03,20,7,1,16,3,123.67,72,49,3,1,141.54,0.00,0.00,0.08,0,90.00,1,705.99,0,3,0,java.lang.Object,0.00,3,0,13,0,3,10,0,16,197,1
"org.apache.lucene.analysis.hunspell.HunspellDictionary",14,0.05,2.71,144,2.25,104895.73,30,16,10,65,9,52.96,134,178,6,1,102.96,0.00,0.00,0.11,5,102.00,8,6742.52,0,6,3,java.lang.Object,0.00,51,0,38,0,51,8,0,29,1208,1
"org.apache.lucene.analysis.hunspell.HunspellDictionary$DoubleASCIIFlagParsingStrategy",1,0.00,3.00,14,0.18,11166.78,1,0,10,7,0,116.73,3,15,0,2,96.12,0.00,0.50,0.00,0,1.00,3,544.65,0,0,0,org.apache.lucene.analysis.hunspell.FlagParsingStrategy,0.00,6,1,3,0,6,1,0,1,112,2
"org.apache.lucene.analysis.hunspell.HunspellDictionary$FlagParsingStrategy",2,0.00,1.00,4,0.03,224.41,2,0,10,2,0,111.41,12,6,0,1,143.63,0.00,0.00,0.00,1,2.00,1,87.07,0,0,0,java.lang.Object,0.00,0,0,2,0,0,2,0,2,28,3
"org.apache.lucene.analysis.hunspell.HunspellDictionary$NumFlagParsingStrategy",1,0.00,2.00,10,0.12,3827.43,1,0,10,5,0,105.56,4,10,0,2,105.32,0.00,0.50,0.00,0,1.00,2,363.13,0,0,0,org.apache.lucene.analysis.hunspell.FlagParsingStrategy,0.00,4,1,2,0,4,1,0,2,77,2
"org.apache.lucene.analysis.hunspell.HunspellDictionary$SimpleFlagParsingStrategy",1,0.00,1.00,3,0.02,259.92,1,0,10,2,0,154.80,3,5,0,2,134.19,0.00,0.50,0.00,0,1.00,1,69.84,0,0,0,org.apache.lucene.analysis.hunspell.FlagParsingStrategy,0.00,1,1,1,0,1,1,0,1,21,2
"org.apache.lucene.analysis.hunspell.HunspellDictionaryTest",1,0.00,1.00,13,0.19,5250.94,1,0,7,10,1,100.15,0,13,0,2,100.15,0.00,0.50,0.00,0,1.00,1,584.96,0,0,1,org.apache.lucene.util.LuceneTestCase,0.00,9,1,1,0,9,1,0,0,113,1
"org.apache.lucene.analysis.hunspell.HunspellStemFilter",4,0.19,2.50,38,0.52,21319.82,11,7,8,19,11,73.63,26,50,4,4,105.85,0.00,0.75,0.29,0,4.00,7,1549.41,1,0,7,org.apache.lucene.analysis.TokenFilter,0.50,15,3,10,0,15,4,0,6,306,2
"org.apache.lucene.analysis.hunspell.HunspellStemFilterTest",5,0.75,1.00,25,0.35,8422.79,6,1,14,16,10,169.52,5,30,0,3,119.52,0.00,0.67,0.40,0,7.00,1,1050.97,3,1,10,org.apache.lucene.analysis.BaseTokenStreamTestCase,0.00,11,2,5,0,11,4,0,3,223,1
"org.apache.lucene.analysis.hunspell.HunspellStemFilterTest$Analyzer",1,0.00,1.00,4,0.06,1029.80,1,0,14,4,3,124.82,0,6,0,1,124.82,0.00,0.00,0.00,0,0.00,1,166.32,0,1,3,java.lang.Object,0.00,3,0,1,0,3,0,0,0,39,0
"org.apache.lucene.analysis.hunspell.HunspellStemFilterTest$Analyzer_0",1,0.00,1.00,4,0.05,771.22,1,0,14,4,3,125.81,0,6,0,1,125.81,0.00,0.00,0.00,0,0.00,1,141.98,0,1,3,java.lang.Object,0.00,3,0,1,0,3,0,0,0,35,0
"org.apache.lucene.analysis.hunspell.HunspellStemmer",10,0.08,4.00,134,2.11,134492.22,14,4,12,61,8,54.32,76,161,3,1,96.62,0.00,0.00,0.18,5,18.00,11,6333.74,0,5,5,java.lang.Object,0.00,51,0,40,0,51,5,0,15,1143,1
"org.apache.lucene.analysis.hunspell.HunspellStemmer$Stem",8,0.00,1.00,22,0.19,3552.30,12,4,12,11,1,139.16,35,31,0,1,138.92,0.00,0.00,0.25,0,34.00,1,572.66,0,3,1,java.lang.Object,0.00,3,0,8,0,3,5,0,7,150,2
"org.apache.lucene.analysis.hunspell.HunspellStemmerTest",7,0.17,1.00,58,0.89,33611.08,8,1,9,16,4,108.32,0,72,2,2,108.32,0.00,0.50,0.86,1,0.00,1,2666.26,0,0,2,org.apache.lucene.util.LuceneTestCase,0.00,9,1,7,0,9,7,0,0,539,1
"org.apache.lucene.analysis.hunspell.HunspellWord",4,0.33,1.00,10,0.07,991.21,5,1,1,5,2,123.04,23,15,2,1,140.92,0.00,0.00,0.75,0,0.00,1,221.61,0,0,0,java.lang.Object,0.00,1,0,4,0,1,4,0,6,62,1
"org.apache.lucene.benchmark.byTask.tasks.alt.AltPackageTaskTest",3,0.00,1.67,14,0.14,2611.61,3,0,2,10,2,175.27,4,26,0,3,125.27,0.00,0.67,0.00,1,3.00,2,434.55,1,1,2,org.apache.lucene.benchmark.BenchmarkTestCase,0.00,7,2,5,0,7,2,0,4,104,1
"org.apache.lucene.benchmark.byTask.tasks.alt.AltTestTask",2,0.00,1.00,5,0.03,301.76,2,0,2,2,2,192.61,3,9,0,2,142.61,0.00,0.50,0.00,0,2.00,1,92.11,0,0,2,org.apache.lucene.benchmark.byTask.tasks.PerfTask,0.07,0,1,2,0,0,2,0,1,29,1
"conf.ConfLoader",0,0.00,0.00,1,0.00,12.00,0,0,0,0,1,171.00,17,2,1,1,171.00,0.00,0.00,0.00,0,0.00,0,8.00,0,0,0,java.lang.Object,0.00,0,0,0,0,0,0,0,2,4,1
"org.apache.solr.handler.AnalysisRequestHandlerBase",7,1.00,3.29,115,1.94,117428.88,8,1,27,74,30,44.44,62,137,2,2,92.54,2.00,0.25,0.00,1,7.00,7,5824.59,0,6,28,org.apache.solr.handler.RequestHandlerBase,0.00,67,1,23,2,67,1,0,14,1002,2
"org.apache.solr.handler.AnalysisRequestHandlerBase$AnalysisContext",7,0.12,1.00,22,0.18,2730.00,11,4,27,7,3,114.93,35,30,0,1,132.80,0.00,0.00,0.14,0,32.00,1,554.56,0,4,3,java.lang.Object,0.00,0,0,7,0,0,3,0,3,143,2
"org.apache.solr.handler.AnalysisRequestHandlerBase$AttributeReflector",1,0.00,7.00,12,0.20,9069.90,1,0,27,9,5,139.02,2,18,0,1,99.13,0.00,0.00,0.00,0,1.00,7,610.32,0,0,5,java.lang.Object,0.00,8,0,7,0,8,1,0,2,115,0
"org.apache.solr.handler.AnalysisRequestHandlerBase$Comparator<AttributeSource>",2,0.00,2.00,11,0.16,8010.80,2,0,27,5,1,116.40,1,17,0,1,116.40,0.00,0.00,0.00,1,2.00,3,471.28,0,0,1,java.lang.Object,0.00,3,0,4,0,3,2,0,1,108,0
"org.apache.solr.handler.AnalysisRequestHandlerBase$HashMap<String,String>",0,0.00,0.00,6,0.11,2403.86,0,0,27,1,2,171.00,0,6,0,1,171.00,0.00,0.00,0.00,0,0.00,0,324.33,0,0,2,java.lang.Object,0.00,1,0,0,0,1,0,0,0,69,0
"org.apache.solr.handler.AnalysisRequestHandlerBase$ListBasedTokenStream",3,0.25,2.00,19,0.21,5717.18,5,2,27,9,3,155.87,6,27,0,3,115.98,0.00,0.67,0.67,0,0.00,4,634.32,1,0,3,org.apache.lucene.analysis.TokenStream,0.55,6,2,6,0,6,3,0,2,139,3
"org.apache.solr.handler.AnalysisRequestHandlerBase$TokenTrackingAttribute",4,0.00,1.00,5,0.03,125.71,4,0,27,4,0,159.21,0,6,0,2,159.21,0.00,0.50,0.00,0,4.00,1,80.21,0,0,0,,0.00,0,1,4,0,0,4,0,0,31,1
"org.apache.solr.handler.AnalysisRequestHandlerBase$TokenTrackingAttributeImpl",7,0.06,1.14,26,0.27,4884.36,10,3,27,11,1,130.78,2,38,0,2,130.78,0.00,0.50,0.29,1,10.00,2,818.55,0,0,1,org.apache.lucene.util.AttributeImpl,0.17,4,1,8,0,4,7,1,2,200,3
"org.apache.solr.handler.AnalysisRequestHandlerTestBase",1,0.00,4.00,15,0.29,8647.51,1,0,3,15,4,53.52,7,20,2,3,95.81,1.00,0.40,0.00,0,1.00,4,881.46,0,0,2,org.apache.solr.SolrTestCaseJ4,0.00,14,2,4,2,14,1,0,2,168,2
"org.apache.solr.handler.AnalysisRequestHandlerTestBase$TokenInfo",10,0.01,1.00,38,0.26,5386.26,19,9,3,10,0,131.69,0,58,0,1,131.69,0.00,0.00,0.10,0,82.00,1,771.13,0,4,0,java.lang.Object,0.00,0,0,10,0,0,6,0,0,200,1
"org.apache.solr.handler.BinaryUpdateRequestHandler",8,0.00,2.12,47,0.53,17082.49,8,0,17,22,16,168.53,9,67,1,3,118.53,0.00,0.67,0.00,1,14.00,6,1601.02,0,6,15,org.apache.solr.handler.ContentStreamHandlerBase,0.55,14,2,17,0,14,2,0,2,327,1
"org.apache.solr.handler.BinaryUpdateRequestHandler$ContentStreamLoader",1,0.00,2.00,8,0.08,2240.96,1,0,17,4,3,110.77,0,13,0,1,110.77,0.00,0.00,0.00,0,1.00,2,250.90,0,0,3,java.lang.Object,0.00,3,0,2,0,3,1,0,0,54,0
"org.apache.solr.handler.BinaryUpdateRequestHandler$JavaBinUpdateRequestCodec.StreamingUpdateHandler",1,0.00,5.00,16,0.21,8507.90,2,1,17,7,5,144.77,1,23,0,1,94.77,0.00,0.00,1.00,0,0.00,5,642.66,0,0,5,java.lang.Object,0.00,6,0,5,0,6,1,0,1,125,0
"org.apache.solr.handler.BinaryUpdateRequestHandlerTest",2,0.00,1.00,22,0.33,6988.65,2,0,11,19,11,104.25,0,27,0,3,104.25,0.00,0.67,0.00,0,2.00,1,990.27,1,0,11,org.apache.solr.SolrTestCaseJ4,0.00,17,2,2,0,17,2,0,0,178,1
"org.apache.solr.handler.CSVLoader",7,0.21,7.57,188,3.46,245705.00,34,27,22,59,17,49.74,44,214,3,2,81.96,1.00,0.33,0.22,3,5.00,16,10369.28,0,0,14,org.apache.solr.handler.ContentStreamLoader,0.00,52,1,53,1,52,7,0,34,1653,1
"org.apache.solr.handler.CSVLoader$FieldAdder",1,0.00,2.00,4,0.05,722.56,1,0,22,3,1,125.87,0,7,0,1,125.87,0.00,0.00,0.00,0,0.00,2,161.62,0,0,1,java.lang.Object,0.00,2,0,2,0,2,1,0,0,39,1
"org.apache.solr.handler.CSVLoader$FieldAdderEmpty",1,0.00,1.00,3,0.05,552.70,1,0,22,2,1,131.61,0,6,0,2,131.61,0.00,0.50,0.00,0,0.00,1,145.01,0,0,1,CSVLoader.FieldAdder,0.00,1,1,1,0,1,1,0,0,36,1
"org.apache.solr.handler.CSVLoader$FieldMapperSingle",2,0.33,1.50,11,0.12,1987.08,5,3,22,4,1,121.23,0,15,0,2,121.23,0.00,0.50,0.50,0,2.00,2,367.65,0,0,1,CSVLoader.FieldAdder,0.00,2,1,3,0,2,2,0,0,92,1
"org.apache.solr.handler.CSVLoader$FieldSplitter",2,0.00,2.50,17,0.20,7720.41,4,2,22,7,2,108.86,0,22,0,2,108.86,0.00,0.50,0.50,0,2.00,4,614.38,0,0,2,CSVLoader.FieldAdder,0.00,5,1,5,0,5,2,0,0,129,1
"org.apache.solr.handler.CSVLoader$FieldTrimmer",2,1.00,1.00,6,0.07,878.59,3,1,22,4,1,132.39,0,8,0,2,132.39,0.00,0.50,0.50,0,2.00,1,208.90,0,0,1,CSVLoader.FieldAdder,0.00,2,1,2,0,2,2,0,0,56,1
"org.apache.solr.handler.CSVLoader$SingleThreadedCSVLoader",2,0.00,1.00,7,0.07,1064.84,2,0,22,4,4,131.73,0,11,0,3,131.73,0.00,0.67,0.00,0,2.00,1,199.13,1,0,4,org.apache.solr.handler.CSVLoader,0.00,2,2,2,0,2,2,0,0,51,0
"org.apache.solr.handler.CSVRequestHandler",5,1.00,1.00,12,0.10,1315.58,6,1,22,7,15,140.71,4,23,2,3,140.71,0.00,0.67,0.00,0,5.00,1,298.53,0,5,13,org.apache.solr.handler.ContentStreamHandlerBase,0.63,2,2,5,0,2,0,0,2,83,1
"org.apache.solr.handler.CSVRequestHandlerTest",2,0.00,1.00,14,0.20,3815.21,2,0,8,11,8,113.64,0,20,0,3,113.64,0.00,0.67,0.00,0,2.00,1,605.99,1,0,8,org.apache.solr.SolrTestCaseJ4,0.00,9,2,2,0,9,2,0,0,119,1
"org.apache.solr.handler.ContentStreamHandlerBase",2,1.00,2.50,20,0.34,19189.90,3,1,11,14,17,122.74,6,28,5,2,102.13,6.00,0.12,0.00,1,2.00,4,1020.53,0,1,13,org.apache.solr.handler.RequestHandlerBase,0.00,12,1,5,6,12,1,0,3,183,2
"org.apache.solr.handler.ContentStreamLoader",3,1.00,1.00,7,0.05,477.24,4,1,3,3,14,163.05,11,10,11,1,142.43,0.00,0.00,0.33,0,4.00,1,153.97,0,1,3,java.lang.Object,0.00,0,0,3,6,0,2,0,2,45,2
"org.apache.solr.handler.DocumentAnalysisRequestHandler",10,0.08,4.20,130,2.06,120671.72,14,4,27,72,19,46.98,93,181,1,3,96.98,0.00,0.67,0.18,4,30.00,13,6192.39,1,9,18,org.apache.solr.handler.AnalysisRequestHandlerBase,0.41,62,2,42,0,62,1,0,19,1058,1
"org.apache.solr.handler.DocumentAnalysisRequestHandlerTest",6,0.20,1.00,190,4.28,526772.44,7,1,19,48,12,34.15,42,192,0,4,76.44,0.00,0.75,0.83,0,0.00,1,12838.97,3,0,12,org.apache.solr.handler.AnalysisRequestHandlerTestBase,0.05,42,3,6,0,42,6,0,14,1931,1
"org.apache.solr.handler.DocumentAnalysisRequestHandlerTest$ByteStream",3,1.00,1.00,12,0.11,1537.60,4,1,19,6,1,127.20,0,18,0,2,127.20,0.00,0.50,0.33,0,5.00,1,323.72,0,2,1,org.apache.solr.common.util.ContentStreamBase,0.15,3,1,3,0,3,1,0,0,81,1
"org.apache.solr.handler.DocumentAnalysisRequestHandlerTest$SolrQueryRequestBase",1,0.00,1.00,3,0.03,424.29,1,0,19,2,0,132.51,0,5,0,1,132.51,0.00,0.00,0.00,0,1.00,1,99.00,0,1,0,java.lang.Object,0.00,1,0,1,0,1,0,0,0,27,0
"org.apache.solr.handler.DocumentAnalysisRequestHandlerTest$SolrQueryRequestBase_0",1,0.00,1.00,3,0.03,424.29,1,0,19,2,0,132.51,0,5,0,1,132.51,0.00,0.00,0.00,0,1.00,1,99.00,0,1,0,java.lang.Object,0.00,1,0,1,0,1,0,0,0,27,0
"org.apache.solr.handler.DocumentAnalysisRequestHandlerTest$SolrQueryRequestBase_1",1,0.00,1.00,3,0.03,424.29,1,0,19,2,0,132.51,0,5,0,1,132.51,0.00,0.00,0.00,0,1.00,1,99.00,0,1,0,java.lang.Object,0.00,1,0,1,0,1,0,0,0,27,0
"org.apache.solr.handler.DumpRequestHandler",5,0.00,1.40,27,0.38,16918.08,5,0,9,21,6,117.06,4,43,0,2,117.06,0.00,0.50,0.00,0,5.00,3,1147.43,0,4,6,org.apache.solr.handler.RequestHandlerBase,0.47,16,1,7,0,16,1,0,4,219,1
"org.apache.solr.handler.FieldAnalysisRequestHandler",8,0.00,2.62,70,1.10,58386.58,8,0,15,41,13,62.54,88,98,1,3,106.67,0.00,0.67,0.00,2,14.00,7,3290.77,1,8,12,org.apache.solr.handler.AnalysisRequestHandlerBase,0.44,33,2,21,0,33,0,0,8,609,1
"org.apache.solr.handler.FieldAnalysisRequestHandlerTest",6,0.20,1.00,375,9.02,2175034.32,7,1,14,44,12,100.25,16,290,0,4,60.36,0.00,0.75,0.83,0,0.00,1,27067.59,3,0,12,org.apache.solr.handler.AnalysisRequestHandlerTestBase,0.05,38,3,6,0,38,6,0,6,3951,1
"org.apache.solr.handler.JsonLoader",12,0.21,6.17,221,3.76,246876.54,18,6,24,78,18,129.68,26,343,2,2,89.79,0.00,0.50,0.36,9,0.00,24,11283.47,0,4,16,org.apache.solr.handler.ContentStreamLoader,0.00,66,1,74,0,66,8,0,13,1900,0
"org.apache.solr.handler.JsonLoader$SolrParams",3,0.00,1.33,8,0.10,2266.32,3,0,24,7,0,137.04,0,14,0,1,137.04,0.00,0.00,0.00,0,3.00,2,295.99,0,3,0,java.lang.Object,0.00,4,0,4,0,4,0,0,0,75,0
"org.apache.solr.handler.JsonLoaderTest",5,1.00,1.00,96,1.72,54413.05,6,1,12,29,11,91.51,4,147,0,3,91.51,0.00,0.67,0.20,0,8.00,1,5165.03,4,0,11,org.apache.solr.SolrTestCaseJ4,0.00,24,2,5,0,24,5,0,4,879,1
"org.apache.solr.handler.JsonUpdateRequestHandler",6,1.00,1.00,14,0.12,1573.70,7,1,5,8,8,140.72,4,27,2,3,140.72,0.00,0.67,0.00,0,6.00,1,355.89,1,5,6,org.apache.solr.handler.ContentStreamHandlerBase,0.60,2,2,6,0,2,1,0,2,99,1
"org.apache.solr.handler.MoreLikeThisHandler",2,1.00,17.50,116,2.43,288150.43,3,1,33,55,33,19.81,23,159,2,2,63.94,0.00,0.50,0.00,0,2.00,34,7281.81,1,0,31,org.apache.solr.handler.RequestHandlerBase,0.00,53,1,35,0,53,2,0,17,993,1
"org.apache.solr.handler.MoreLikeThisHandler$InterestingTerm",5,2.00,1.20,18,0.14,2455.53,7,2,33,7,1,131.97,4,32,0,1,131.97,0.00,0.00,0.00,0,5.00,2,418.99,0,5,1,java.lang.Object,0.00,2,0,6,0,2,0,0,2,110,2
"org.apache.solr.handler.MoreLikeThisHandler$InterestingTerm$Comparator<InterestingTerm>",1,0.00,3.00,6,0.07,2283.77,1,0,33,1,0,115.27,0,8,0,1,115.27,0.00,0.00,0.00,0,1.00,3,200.59,0,0,0,java.lang.Object,0.00,0,0,3,0,0,1,0,0,47,0
"org.apache.solr.handler.MoreLikeThisHandler$InterestingTerm$MoreLikeThisHelper",10,0.14,2.00,94,1.57,53058.69,19,9,33,60,21,105.91,6,125,0,1,105.91,0.00,0.00,0.23,2,22.00,4,4716.74,0,8,21,java.lang.Object,0.00,50,0,20,0,50,2,0,6,848,2
"org.apache.solr.handler.MoreLikeThisHandlerTest",2,0.00,2.00,49,1.02,49033.55,2,0,12,17,12,42.50,14,76,0,3,84.79,0.00,0.67,0.00,0,0.00,3,3058.13,5,0,12,org.apache.solr.SolrTestCaseJ4,0.00,15,2,4,0,15,2,0,12,455,1
"org.apache.solr.handler.MoreLikeThisHandlerTest$SolrQueryRequestBase",0,0.00,0.00,1,0.01,23.26,0,0,12,0,0,171.00,0,0,0,1,171.00,0.00,0.00,0.00,0,0.00,0,15.51,0,0,0,java.lang.Object,0.00,0,0,0,0,0,0,0,0,6,0
"org.apache.solr.handler.PingRequestHandler",5,0.00,2.00,31,0.46,23352.71,5,0,8,20,8,152.80,10,54,0,2,112.92,0.00,0.50,0.00,0,5.00,6,1385.25,0,4,8,org.apache.solr.handler.RequestHandlerBase,0.47,15,1,10,0,15,1,0,6,251,1
"org.apache.solr.handler.RealTimeGetHandler",6,0.00,1.00,15,0.12,2152.24,6,0,5,8,2,139.65,1,29,0,3,139.65,0.00,0.67,0.00,0,6.00,1,361.31,0,6,2,org.apache.solr.handler.component.SearchHandler,0.67,2,2,6,0,2,0,0,1,98,1
"org.apache.solr.handler.ReplicationHandler",34,0.05,4.59,573,10.63,844687.46,93,59,51,190,34,131.01,99,718,7,2,91.12,0.00,0.50,0.06,17,318.00,26,31902.28,1,14,29,org.apache.solr.handler.RequestHandlerBase,0.22,156,1,156,0,156,20,1,50,4955,1
"org.apache.solr.handler.ReplicationHandler$BinaryQueryResponseWriter",4,0.00,1.00,9,0.10,1114.82,4,0,51,8,3,140.52,1,12,0,1,140.52,0.00,0.00,0.00,0,6.00,1,294.85,0,1,3,java.lang.Object,0.00,4,0,4,0,4,3,0,1,75,0
"org.apache.solr.handler.ReplicationHandler$CloseHook",2,0.00,1.50,5,0.04,508.08,2,0,51,2,1,140.74,0,9,0,1,140.74,0.00,0.00,0.00,0,2.00,2,123.70,0,0,1,java.lang.Object,0.00,0,0,3,0,0,2,0,0,35,0
"org.apache.solr.handler.ReplicationHandler$FileInfo",2,0.50,1.00,17,0.15,3251.08,6,4,51,4,0,112.03,0,20,0,1,112.03,0.00,0.00,0.50,0,2.00,1,460.88,0,1,0,java.lang.Object,0.00,2,0,2,0,2,1,0,0,111,1
"org.apache.solr.handler.ReplicationHandler$FileStream",3,0.50,6.00,68,1.08,98044.80,7,4,51,30,3,105.58,9,87,0,1,84.96,0.00,0.00,0.58,1,0.00,16,3230.34,0,0,3,java.lang.Object,0.00,27,0,18,0,27,3,0,7,499,1
"org.apache.solr.handler.ReplicationHandler$SolrEventListener",4,0.00,1.75,13,0.12,2069.12,4,0,51,7,5,131.94,16,20,0,1,131.70,0.00,0.00,0.00,0,6.00,4,372.63,0,0,5,java.lang.Object,0.00,3,0,7,0,3,4,0,7,88,0
"org.apache.solr.handler.ReplicationHandler$Thread",1,0.00,1.00,3,0.02,143.17,1,0,51,2,0,136.23,0,5,0,1,136.23,0.00,0.00,0.00,0,1.00,1,52.97,0,0,0,java.lang.Object,0.00,1,0,1,0,1,1,0,0,17,0
"org.apache.solr.handler.RequestHandlerBase",12,0.06,1.92,68,0.85,32105.15,22,10,12,29,34,118.02,49,86,23,1,117.79,0.00,0.00,0.16,1,40.00,7,2562.77,0,8,11,java.lang.Object,0.00,17,0,23,29,17,4,2,9,510,2
"org.apache.solr.handler.RequestHandlerUtils",5,1.00,2.40,40,0.72,28058.54,6,1,11,20,17,128.20,19,57,8,1,107.59,0.00,0.00,0.20,1,8.00,3,2168.95,0,0,9,java.lang.Object,0.00,15,0,12,0,15,5,0,5,422,1
"org.apache.solr.handler.SnapPuller",41,0.03,3.78,523,8.58,498410.80,88,47,34,195,19,118.89,137,681,5,1,98.27,0.00,0.00,0.05,16,867.00,21,25725.97,0,18,16,java.lang.Object,0.00,154,0,155,0,154,23,0,69,4419,1
"org.apache.solr.handler.SnapPuller$FileFetcher",7,0.22,5.00,118,1.72,69747.64,24,17,34,36,2,62.01,43,169,0,1,94.23,0.00,0.00,0.24,3,0.00,12,5170.69,0,1,2,java.lang.Object,0.00,29,0,35,0,29,6,0,32,930,1
"org.apache.solr.handler.SnapPuller$FileFetcher$Runnable_0",1,0.00,2.00,5,0.03,408.00,1,0,34,2,1,124.21,0,8,0,1,124.21,0.00,0.00,0.00,0,0.00,2,96.00,0,0,1,java.lang.Object,0.00,1,0,2,0,1,1,0,0,26,0
"org.apache.solr.handler.SnapPuller$ReplicationHandlerException",1,0.00,1.00,3,0.02,124.13,1,0,34,1,0,136.71,0,5,0,2,136.71,0.00,0.50,0.00,0,1.00,1,49.65,0,0,0,java.lang.InterruptedException,0.00,0,1,1,0,0,1,0,0,17,2
"org.apache.solr.handler.SnapPuller$Runnable",1,0.00,3.00,9,0.08,1293.96,1,0,34,2,0,110.65,0,13,0,1,110.65,0.00,0.00,0.00,0,0.00,3,238.75,0,0,0,java.lang.Object,0.00,1,0,3,0,1,1,0,0,52,0
"org.apache.solr.handler.SnapPuller$Thread",1,0.00,2.00,5,0.06,812.08,1,0,34,3,0,121.86,0,9,0,1,121.86,0.00,0.00,0.00,0,0.00,2,170.52,0,0,0,java.lang.Object,0.00,2,0,2,0,2,1,0,0,41,0
"org.apache.solr.handler.SnapShooter",5,0.17,3.40,68,1.10,41714.55,11,6,23,47,10,148.29,6,86,3,1,98.29,0.00,0.00,0.30,2,2.00,7,3289.83,0,0,9,java.lang.Object,0.00,42,0,17,0,42,5,0,1,578,1
"org.apache.solr.handler.SnapShooter$FileCopier",3,0.25,3.33,42,0.58,34092.08,7,4,23,19,2,116.65,11,59,0,1,96.03,0.00,0.00,0.08,1,5.00,7,1736.68,0,0,2,java.lang.Object,0.00,16,0,10,0,16,3,0,5,320,1
"org.apache.solr.handler.SnapShooter$OldBackupDirectory",2,0.33,2.50,15,0.18,3684.43,5,3,23,11,0,113.55,0,22,0,1,113.55,0.00,0.00,0.17,0,2.00,4,546.54,0,0,0,java.lang.Object,0.00,9,0,5,0,9,2,1,0,120,1
"org.apache.solr.handler.SnapShooter$Thread",1,0.00,1.00,3,0.02,155.40,1,0,23,2,0,135.95,0,5,0,1,135.95,0.00,0.00,0.00,0,1.00,1,58.19,0,0,0,java.lang.Object,0.00,1,0,1,0,1,1,0,0,18,0
"org.apache.solr.handler.StandardRequestHandler",5,0.00,1.20,13,0.09,1425.83,5,0,3,6,3,140.63,20,26,2,3,140.40,0.00,0.67,0.00,0,5.00,2,280.21,0,5,1,org.apache.solr.handler.component.SearchHandler,0.58,1,2,6,0,1,0,0,2,79,1
"org.apache.solr.handler.StandardRequestHandlerTest",4,0.00,1.00,33,0.51,17020.42,4,0,9,11,7,158.74,6,56,0,3,108.74,0.00,0.67,0.00,0,4.00,1,1525.73,5,2,7,org.apache.solr.util.AbstractSolrTestCase,0.24,7,2,4,0,7,2,0,3,274,1
"org.apache.solr.handler.TestCSVLoader",13,0.11,1.08,145,2.15,102551.14,16,3,12,26,5,141.33,33,204,0,3,101.45,0.00,0.67,0.23,4,28.00,2,6457.89,8,0,5,org.apache.solr.SolrTestCaseJ4,0.07,13,2,14,0,13,13,0,33,1094,1
"org.apache.solr.handler.TestReplicationHandler",24,0.20,2.46,512,7.37,383301.86,34,10,36,98,22,108.99,83,556,0,3,88.37,0.00,0.67,0.29,18,50.00,12,22096.58,0,8,22,org.apache.solr.SolrTestCaseJ4,0.00,74,2,59,0,74,16,0,76,3765,1
"org.apache.solr.handler.TestReplicationHandler$BackupThread",2,0.33,2.00,17,0.20,4870.31,5,3,36,7,1,110.49,0,26,0,2,110.49,0.00,0.50,0.50,0,2.00,3,612.91,0,0,1,org.apache.lucene.index.Thread,0.00,5,1,4,0,5,2,0,0,126,0
"org.apache.solr.handler.TestReplicationHandler$CheckStatus",2,0.67,3.00,27,0.35,9170.07,8,6,36,15,1,100.36,0,37,0,2,100.36,0.00,0.50,0.50,0,2.00,5,1036.50,0,0,1,org.apache.lucene.index.Thread,0.00,13,1,6,0,13,2,0,0,194,0
"org.apache.solr.handler.TestReplicationHandler$FilenameFilter",1,0.00,2.00,5,0.03,373.94,1,0,36,2,0,124.51,0,7,0,1,124.51,0.00,0.00,0.00,0,1.00,2,102.01,0,0,0,java.lang.Object,0.00,1,0,2,0,1,1,0,0,27,0
"org.apache.solr.handler.TestReplicationHandler$SolrInstance",10,0.02,1.00,37,0.35,5399.22,15,5,36,19,1,131.69,8,53,0,1,131.69,0.00,0.00,0.22,3,38.00,1,1043.81,0,5,1,java.lang.Object,0.00,9,0,10,0,9,5,0,2,248,2
"org.apache.solr.handler.XMLLoader",5,0.38,10.80,180,3.04,239366.16,7,2,25,66,20,57.67,28,220,3,2,75.54,1.00,0.33,0.20,2,8.00,17,9109.71,0,1,18,org.apache.solr.handler.ContentStreamLoader,0.00,61,1,54,1,61,4,0,17,1412,0
"org.apache.solr.handler.XmlUpdateRequestHandler",6,0.03,1.17,31,0.39,8253.88,19,13,7,13,16,160.06,14,47,11,3,120.18,0.00,0.67,0.05,0,10.00,2,1165.94,1,5,7,org.apache.solr.handler.ContentStreamHandlerBase,0.60,7,2,7,0,7,1,0,12,242,1
"org.apache.solr.handler.XmlUpdateRequestHandlerTest",4,0.00,1.00,46,0.88,26294.18,6,2,19,28,11,152.09,6,86,0,3,102.09,0.00,0.67,0.50,0,0.00,1,2625.79,2,0,11,org.apache.solr.SolrTestCaseJ4,0.00,24,2,4,0,24,4,0,6,469,1
"org.apache.solr.handler.XmlUpdateRequestHandlerTest$MockUpdateRequestProcessor",4,0.33,1.00,16,0.23,5567.28,5,1,19,12,2,123.79,0,25,0,2,123.79,0.00,0.50,0.75,0,0.00,1,683.32,0,0,2,org.apache.solr.update.processor.UpdateRequestProcessor,0.00,8,1,4,0,8,4,0,0,156,1
"org.apache.solr.handler.XsltUpdateRequestHandler",6,0.07,1.17,27,0.32,6220.23,12,6,8,16,9,164.64,12,43,2,3,124.76,0.00,0.67,0.22,0,10.00,2,956.74,1,5,8,org.apache.solr.handler.ContentStreamHandlerBase,0.60,10,2,7,0,10,1,0,10,205,1
"org.apache.solr.handler.XsltUpdateRequestHandlerTest",3,1.00,1.00,30,0.47,12343.26,4,1,16,22,10,105.24,0,51,0,3,105.24,0.00,0.67,0.33,0,5.00,1,1421.88,6,0,10,org.apache.solr.SolrTestCaseJ4,0.04,19,2,3,0,19,3,0,0,252,1
"org.apache.solr.handler.XsltXMLLoader",3,0.00,2.67,38,0.64,24248.39,6,3,24,30,11,81.87,15,51,1,3,99.75,0.00,0.67,0.33,1,5.00,4,1912.59,1,1,11,org.apache.solr.handler.XMLLoader,0.00,27,2,8,0,27,2,0,8,342,0
"org.apache.solr.search.grouping.Command",5,0.00,1.00,6,0.03,159.47,5,0,5,5,10,141.29,29,7,7,1,159.16,0.00,0.00,0.00,0,5.00,1,82.99,0,4,3,,0.00,0,0,5,0,0,1,0,6,33,1
"org.apache.solr.search.grouping.CommandHandler",6,0.25,2.33,64,1.03,33230.51,14,8,16,42,19,154.02,10,86,2,1,104.02,0.00,0.00,0.33,1,0.00,4,3094.77,0,3,17,java.lang.Object,0.00,36,0,14,0,36,3,0,2,577,1
"org.apache.solr.search.grouping.CommandHandler$Builder",6,0.00,1.17,26,0.24,4820.46,11,5,16,11,3,175.63,7,34,0,1,125.63,0.00,0.00,0.20,0,10.00,2,723.31,0,5,3,java.lang.Object,0.00,5,0,7,0,5,1,0,1,175,2
"org.apache.solr.search.grouping.GroupingSpecification",28,0.04,1.11,77,0.53,8302.05,42,14,2,28,10,140.28,5,109,8,1,140.28,0.00,0.00,0.04,0,392.00,2,1587.56,0,6,2,java.lang.Object,0.00,0,0,31,0,0,22,0,1,422,1
"org.apache.lucene.queryparser.surround.parser.CharStream",12,0.00,1.00,13,0.06,250.78,12,0,0,12,3,128.38,79,14,3,1,160.60,0.00,0.00,0.00,0,12.00,1,172.56,0,1,0,,0.00,0,0,12,0,0,11,0,13,70,1
"org.apache.lucene.queryparser.surround.parser.FastCharStream",14,0.14,1.43,56,0.55,20446.20,20,6,1,20,2,173.54,16,80,1,1,123.54,0.00,0.00,0.30,2,2.00,5,1644.78,0,1,1,java.lang.Object,0.00,6,0,20,0,6,13,1,13,372,2
"org.apache.lucene.queryparser.surround.parser.ParseException",5,0.30,3.20,92,1.07,80794.24,10,5,0,14,4,61.39,69,112,3,2,90.77,0.00,0.50,0.44,0,0.00,10,3210.28,1,2,1,java.lang.Exception,0.00,9,1,16,0,9,3,0,11,572,1
"org.apache.lucene.queryparser.surround.parser.QueryParser",46,0.05,4.02,523,6.16,371182.43,75,29,13,87,21,151.07,55,620,5,1,101.07,0.00,0.00,0.08,12,526.00,18,18485.21,0,26,16,java.lang.Object,0.00,41,0,185,0,41,20,1,50,3501,1
"org.apache.lucene.queryparser.surround.parser.QueryParser$JJCalls",0,0.00,0.00,5,0.03,253.51,4,4,13,0,1,171.00,0,6,0,1,171.00,0.00,0.00,0.00,0,0.00,0,78.87,0,0,1,java.lang.Object,0.00,0,0,0,0,0,0,0,0,22,2
"org.apache.lucene.queryparser.surround.parser.QueryParser$LookaheadSuccess",0,0.00,0.00,1,0.01,145.30,0,0,13,0,0,171.00,0,1,0,2,171.00,0.00,0.50,0.00,0,0.00,0,41.51,0,0,0,java.lang.Error,0.00,0,1,0,0,0,0,0,0,12,3
"org.apache.lucene.queryparser.surround.parser.QueryParserConstants",0,0.00,0.00,27,0.39,4761.14,26,26,0,0,2,171.00,30,53,2,1,171.00,0.00,0.00,0.00,0,0.00,0,1182.50,0,0,0,,0.00,0,0,0,0,0,0,0,27,186,1
"org.apache.lucene.queryparser.surround.parser.QueryParserTokenManager",21,0.07,10.24,386,6.13,1092753.23,40,19,13,31,14,86.50,12,668,1,1,86.50,0.00,0.00,0.12,11,162.00,155,18386.30,0,2,13,java.lang.Object,0.00,10,0,215,0,10,19,1,12,2909,1
"org.apache.lucene.queryparser.surround.parser.SuppressWarnings",6,0.20,1.50,48,0.66,33774.42,11,5,0,14,0,59.58,51,72,0,2,107.69,0.00,0.50,0.03,1,10.00,3,1967.96,1,3,0,java.lang.Error,0.00,8,1,9,0,8,3,0,14,375,1
"org.apache.lucene.queryparser.surround.parser.Token",7,0.12,1.00,24,0.16,1989.42,15,8,0,8,5,83.88,67,38,5,1,133.88,0.00,0.00,0.02,1,12.00,1,468.86,0,4,0,java.lang.Object,0.00,1,0,7,0,1,3,0,15,131,1
"org.apache.lucene.queries.mlt.MoreLikeThis",41,0.00,1.80,246,3.13,145104.69,65,24,20,87,23,69.76,466,321,3,1,113.89,0.00,0.00,0.04,5,825.00,9,9396.80,0,13,20,java.lang.Object,0.00,46,0,74,0,46,28,0,92,1824,2
"org.apache.lucene.queries.mlt.MoreLikeThis$FreqQ",2,0.00,1.00,7,0.07,1627.99,2,0,20,2,1,130.28,0,11,0,2,130.28,0.00,0.50,0.00,0,2.00,1,223.95,0,0,1,org.apache.lucene.util.PriorityQueue,0.00,0,1,2,0,0,2,0,0,58,2
"org.apache.lucene.queries.mlt.MoreLikeThis$Int",1,0.00,1.00,4,0.02,114.30,2,1,20,1,0,132.34,0,6,0,1,132.34,0.00,0.00,1.00,0,0.00,1,49.65,0,0,0,java.lang.Object,0.00,0,0,1,0,0,1,0,0,17,2
"org.apache.lucene.queries.mlt.MoreLikeThisQuery",19,0.01,1.11,62,0.56,12287.16,28,9,9,30,7,131.05,12,85,1,2,131.05,0.00,0.50,0.11,0,149.00,2,1691.25,0,6,6,org.apache.lucene.search.Query,0.00,11,1,21,0,11,13,0,4,396,1
"org.apache.lucene.queries.mlt.TestMoreLikeThis",6,0.13,1.33,66,1.02,32738.30,9,3,17,38,12,102.66,4,80,0,2,102.66,0.00,0.50,0.44,2,0.00,2,3058.97,2,1,12,org.apache.lucene.util.LuceneTestCase,0.00,32,1,8,0,32,5,0,4,558,1
"org.apache.lucene.queries.function.valuesource.BoolFunction",0,0.00,0.00,1,0.01,49.13,0,0,1,0,4,171.00,1,2,3,2,171.00,3.00,0.20,0.00,0,0.00,0,19.65,0,0,1,org.apache.lucene.queries.function.ValueSource,0.00,0,1,0,3,0,0,0,1,7,2
"org.apache.lucene.queries.function.valuesource.ByteFieldSource",6,0.80,1.50,20,0.27,8073.40,7,1,5,12,8,178.47,7,32,4,3,128.47,0.00,0.67,0.33,0,10.00,3,816.68,2,2,4,org.apache.lucene.queries.function.valuesource.FieldCacheSource,0.30,6,2,9,0,6,4,0,1,190,1
"org.apache.lucene.queries.function.valuesource.ByteFieldSource$FunctionValues",9,0.00,1.00,19,0.20,2956.92,9,0,5,11,0,139.95,1,37,0,1,139.95,0.00,0.00,0.00,0,9.00,1,585.73,0,3,0,java.lang.Object,0.00,2,0,9,0,2,6,0,1,158,0
"org.apache.lucene.queries.function.valuesource.BytesRefFieldSource",2,0.00,1.00,5,0.04,352.15,2,0,6,3,10,192.09,3,9,5,3,142.09,0.00,0.67,0.00,0,2.00,1,108.02,0,1,5,org.apache.lucene.queries.function.valuesource.FieldCacheSource,0.00,1,2,2,0,1,1,0,1,32,1
"org.apache.lucene.queries.function.valuesource.BytesRefFieldSource$StringIndexDocValues",3,0.00,1.00,7,0.06,813.15,3,0,6,5,0,140.61,0,13,0,1,140.61,0.00,0.00,0.00,0,3.00,1,194.75,0,3,0,java.lang.Object,0.00,2,0,3,0,2,0,0,0,55,0
"org.apache.lucene.queries.function.valuesource.ConstDoubleDocValues",7,0.14,1.00,27,0.22,2346.94,13,6,10,9,10,133.32,0,41,2,3,133.32,0.00,0.67,0.29,0,14.00,1,671.41,0,2,8,org.apache.lucene.queries.function.docvalues.DoubleDocValues,0.41,2,2,7,0,2,5,0,0,167,0
"org.apache.lucene.queries.function.valuesource.ConstIntDocValues",7,0.14,1.00,27,0.21,2260.59,13,6,10,9,11,133.44,0,41,3,3,133.44,0.00,0.67,0.29,0,14.00,1,635.98,0,2,8,org.apache.lucene.queries.function.docvalues.IntDocValues,0.42,2,2,7,0,2,5,0,0,161,0
"org.apache.lucene.queries.function.valuesource.ConstNumberSource",6,0.00,1.00,7,0.04,235.25,6,0,1,6,6,158.45,3,8,5,2,158.45,4.00,0.17,0.00,0,6.00,1,112.71,0,1,1,org.apache.lucene.queries.function.ValueSource,0.00,0,1,6,4,0,5,0,1,43,2
"org.apache.lucene.queries.function.valuesource.ConstValueSource",11,0.15,1.09,28,0.24,3965.84,13,2,5,13,6,139.62,3,50,2,3,139.62,0.00,0.67,0.36,0,0.00,2,712.75,0,3,4,org.apache.lucene.queries.function.valuesource.ConstNumberSource,0.96,2,2,12,0,2,8,0,1,191,1
"org.apache.lucene.queries.function.valuesource.ConstValueSource$FloatDocValues",7,0.00,1.00,15,0.12,1375.04,7,0,5,8,0,141.71,0,29,0,1,141.71,0.00,0.00,0.00,0,0.00,1,364.39,0,2,0,java.lang.Object,0.00,1,0,7,0,1,5,0,0,103,0
"org.apache.lucene.queries.function.valuesource.DefFunction",3,0.00,1.00,7,0.05,576.08,3,0,9,4,7,141.79,0,13,1,3,141.79,0.00,0.67,0.00,0,3.00,1,159.53,0,2,6,org.apache.lucene.queries.function.valuesource.MultiFunction,0.15,1,2,3,0,1,1,0,0,46,1
"org.apache.lucene.queries.function.valuesource.DefFunction$Values",13,1.00,1.31,39,0.39,8156.74,14,1,9,25,1,131.11,2,64,0,1,131.11,0.00,0.00,0.08,1,24.00,3,1176.91,1,4,1,java.lang.Object,0.00,12,0,17,0,12,9,0,2,302,0
"org.apache.lucene.queries.function.valuesource.DivFloatFunction",3,0.00,1.00,7,0.07,1084.71,3,0,2,4,4,179.51,6,13,1,3,139.63,0.00,0.67,0.00,0,3.00,1,203.62,0,1,3,org.apache.lucene.queries.function.valuesource.DualFloatFunction,0.16,1,2,3,0,1,2,0,2,57,1
"org.apache.lucene.queries.function.valuesource.DocFreqValueSource",7,0.04,1.14,26,0.34,7174.49,11,4,10,17,13,129.46,0,39,4,2,129.46,3.00,0.20,0.21,2,18.00,2,1014.92,0,3,9,org.apache.lucene.queries.function.ValueSource,0.27,10,1,8,3,10,4,0,0,240,1
"org.apache.lucene.queries.function.valuesource.DoubleConstValueSource",11,0.10,1.09,31,0.28,4843.05,14,3,5,13,9,138.93,0,53,5,3,138.93,0.00,0.67,0.24,0,39.00,2,838.41,0,3,4,org.apache.lucene.queries.function.valuesource.ConstNumberSource,0.96,2,2,12,0,2,8,0,0,218,1
"org.apache.lucene.queries.function.valuesource.DoubleConstValueSource$DoubleDocValues",7,0.00,1.00,15,0.12,1356.14,7,0,5,9,0,141.76,0,29,0,1,141.76,0.00,0.00,0.00,0,21.00,1,366.53,0,3,0,java.lang.Object,0.00,2,0,7,0,2,4,0,0,103,0
"org.apache.lucene.queries.function.valuesource.DoubleFieldSource",6,0.80,1.50,21,0.29,8669.39,7,1,11,13,13,178.23,7,31,3,3,128.23,0.00,0.67,0.33,0,10.00,3,876.40,2,2,10,org.apache.lucene.queries.function.valuesource.FieldCacheSource,0.30,7,2,9,0,7,4,0,1,201,1
"org.apache.lucene.queries.function.valuesource.DoubleFieldSource$DoubleDocValues",4,0.00,2.25,27,0.24,9533.97,4,0,11,9,2,115.19,0,41,0,1,115.19,0.00,0.00,0.00,0,4.00,6,727.76,0,2,2,java.lang.Object,0.00,5,0,9,0,5,2,0,0,157,0
"org.apache.lucene.queries.function.valuesource.DoubleFieldSource$DoubleDocValues$ValueFiller",2,0.50,1.00,8,0.08,1194.46,4,2,11,4,2,126.68,0,12,0,1,126.68,0.00,0.00,0.75,0,0.00,1,243.05,0,1,2,java.lang.Object,0.00,2,0,2,0,2,1,0,0,62,0
"org.apache.lucene.queries.function.valuesource.DoubleFieldSource$DoubleDocValues$ValueSourceScorer",1,0.00,1.00,4,0.04,809.86,1,0,11,2,0,125.64,0,6,0,1,125.64,0.00,0.00,0.00,0,1.00,1,127.88,0,0,0,java.lang.Object,0.00,1,0,1,0,1,1,0,0,32,0
"org.apache.lucene.queries.function.valuesource.DoubleFieldSource$DoubleDocValues$ValueSourceScorer_0",1,0.00,1.00,4,0.04,809.86,1,0,11,2,0,125.64,0,6,0,1,125.64,0.00,0.00,0.00,0,1.00,1,127.88,0,0,0,java.lang.Object,0.00,1,0,1,0,1,1,0,0,32,0
"org.apache.lucene.queries.function.valuesource.DoubleFieldSource$DoubleDocValues$ValueSourceScorer_1",1,0.00,1.00,4,0.04,809.86,1,0,11,2,0,125.64,0,6,0,1,125.64,0.00,0.00,0.00,0,1.00,1,127.88,0,0,0,java.lang.Object,0.00,1,0,1,0,1,1,0,0,32,0
"org.apache.lucene.queries.function.valuesource.DoubleFieldSource$DoubleDocValues$ValueSourceScorer_2",1,0.00,1.00,4,0.04,809.86,1,0,11,2,0,125.64,0,6,0,1,125.64,0.00,0.00,0.00,0,1.00,1,127.88,0,0,0,java.lang.Object,0.00,1,0,1,0,1,1,0,0,32,0
"org.apache.lucene.queries.function.valuesource.DualFloatFunction",8,0.00,1.12,28,0.37,10660.06,10,2,7,15,8,128.57,4,41,3,2,128.57,2.00,0.25,0.50,2,8.00,2,1112.18,0,3,5,org.apache.lucene.queries.function.ValueSource,0.25,7,1,9,2,7,5,0,1,265,2
"org.apache.lucene.queries.function.valuesource.DualFloatFunction$FloatDocValues",2,0.00,1.00,5,0.07,1051.02,2,0,7,6,0,138.35,0,9,0,1,138.35,0.00,0.00,0.00,0,2.00,1,212.27,0,1,0,java.lang.Object,0.00,4,0,2,0,4,1,0,0,54,0
"org.apache.lucene.queries.function.valuesource.FieldCacheSource",6,0.10,1.17,17,0.16,4083.88,8,2,2,8,11,187.43,6,28,9,2,137.43,15.00,0.06,0.42,1,6.00,2,493.32,0,3,2,org.apache.lucene.queries.function.ValueSource,0.29,2,1,7,15,2,3,0,1,126,2
"org.apache.lucene.queries.function.valuesource.FloatFieldSource",6,0.80,1.50,21,0.29,8718.01,7,1,9,13,14,178.21,7,31,6,3,128.21,0.00,0.67,0.33,0,10.00,3,880.72,2,2,8,org.apache.lucene.queries.function.valuesource.FieldCacheSource,0.30,7,2,9,0,7,4,0,1,202,1
"org.apache.lucene.queries.function.valuesource.FloatFieldSource$FloatDocValues",4,0.00,1.25,9,0.09,1345.85,4,0,9,6,0,139.82,0,17,0,1,139.82,0.00,0.00,0.00,0,4.00,2,261.24,0,2,0,java.lang.Object,0.00,2,0,5,0,2,2,0,0,70,0
"org.apache.lucene.queries.function.valuesource.FloatFieldSource$FloatDocValues$ValueFiller",2,0.50,1.00,8,0.08,1194.46,4,2,9,4,2,126.68,0,12,0,1,126.68,0.00,0.00,0.75,0,0.00,1,243.05,0,1,2,java.lang.Object,0.00,2,0,2,0,2,1,0,0,62,0
"org.apache.lucene.queries.function.valuesource.IDFValueSource",4,0.00,1.75,20,0.26,6673.44,4,0,9,14,13,119.42,2,30,3,3,119.42,0.00,0.67,0.00,1,6.00,3,779.48,0,3,10,org.apache.lucene.queries.function.valuesource.DocFreqValueSource,0.16,10,2,7,0,10,1,0,2,165,1
"org.apache.lucene.queries.function.valuesource.IfFunction",6,0.60,1.17,28,0.36,10168.48,9,3,10,12,10,123.08,0,42,2,3,123.08,0.00,0.67,0.83,0,0.00,2,1071.00,0,2,8,org.apache.lucene.queries.function.valuesource.BoolFunction,0.43,6,2,7,0,6,4,0,0,255,1
"org.apache.lucene.queries.function.valuesource.IfFunction$FunctionValues",13,0.00,1.77,27,0.50,10972.90,13,0,10,37,0,136.60,3,53,0,1,136.60,0.00,0.00,0.00,0,13.00,2,1486.40,1,4,0,java.lang.Object,0.00,24,0,23,0,24,9,0,3,362,0
"org.apache.lucene.queries.function.valuesource.IntFieldSource",6,0.80,1.50,21,0.30,8820.12,7,1,11,13,15,178.17,6,32,5,3,128.17,0.00,0.67,0.33,0,10.00,3,894.71,2,2,10,org.apache.lucene.queries.function.valuesource.FieldCacheSource,0.30,7,2,9,0,7,4,0,1,205,1
"org.apache.lucene.queries.function.valuesource.IntFieldSource$IntDocValues",10,1.00,1.50,35,0.40,15503.11,11,1,11,17,3,127.99,1,57,0,1,127.99,0.00,0.00,0.00,0,10.00,5,1197.52,0,5,3,java.lang.Object,0.00,7,0,15,0,7,5,0,1,275,0
"org.apache.lucene.queries.function.valuesource.IntFieldSource$IntDocValues$ValueFiller",2,0.50,1.00,8,0.08,1194.46,4,2,11,4,2,126.68,0,12,0,1,126.68,0.00,0.00,0.75,0,0.00,1,243.05,0,1,2,java.lang.Object,0.00,2,0,2,0,2,1,0,0,62,0
"org.apache.lucene.queries.function.valuesource.IntFieldSource$IntDocValues$ValueSourceScorer",1,0.00,1.00,4,0.04,984.65,1,0,11,1,0,164.86,2,6,0,1,124.97,0.00,0.00,0.00,0,1.00,1,127.88,0,0,0,java.lang.Object,0.00,0,0,1,0,0,1,0,2,32,0
"org.apache.lucene.queries.function.valuesource.JoinDocFreqValueSource",5,0.12,1.40,19,0.25,5561.60,7,2,9,13,9,179.14,5,30,2,3,129.14,0.00,0.67,0.40,0,1.00,3,744.51,2,2,7,org.apache.lucene.queries.function.valuesource.FieldCacheSource,0.32,8,2,7,0,8,3,0,1,174,1
"org.apache.lucene.queries.function.valuesource.JoinDocFreqValueSource$IntDocValues",1,0.00,2.00,8,0.10,2530.79,2,1,9,5,1,160.35,1,14,0,1,110.35,0.00,0.00,1.00,0,0.00,2,294.63,0,0,1,java.lang.Object,0.00,4,0,2,0,4,1,0,1,65,0
"org.apache.lucene.queries.function.valuesource.LinearFloatFunction",6,0.13,1.17,25,0.35,10542.45,9,3,7,13,7,172.95,8,39,2,2,122.95,0.00,0.50,0.44,1,0.00,2,1039.09,0,2,5,org.apache.lucene.queries.function.ValueSource,0.29,7,1,7,0,7,4,0,1,240,1
"org.apache.lucene.queries.function.valuesource.LinearFloatFunction$FloatDocValues",2,0.00,1.00,5,0.07,1090.62,2,0,7,4,0,138.22,0,9,0,1,138.22,0.00,0.00,0.00,0,0.00,1,201.69,0,1,0,java.lang.Object,0.00,2,0,2,0,2,1,0,0,51,0
"org.apache.lucene.queries.function.valuesource.LiteralValueSource",6,0.07,1.50,21,0.22,4931.25,9,3,7,11,9,130.16,5,32,4,2,130.16,0.00,0.50,0.28,0,0.00,4,647.94,0,3,5,org.apache.lucene.queries.function.ValueSource,0.29,5,1,9,0,5,3,0,2,159,1
"org.apache.lucene.queries.function.valuesource.LiteralValueSource$StrDocValues",3,0.00,1.00,8,0.06,704.16,3,0,7,4,1,141.10,0,14,0,1,141.10,0.00,0.00,0.00,0,2.00,1,190.66,0,2,1,java.lang.Object,0.00,1,0,3,0,1,1,0,0,52,0
"org.apache.lucene.queries.function.valuesource.LongFieldSource",9,0.88,1.33,27,0.33,9008.68,10,1,11,17,13,129.51,7,41,3,3,129.51,0.50,0.50,0.22,0,22.00,3,1004.98,2,4,10,org.apache.lucene.queries.function.valuesource.FieldCacheSource,0.26,8,2,12,1,8,5,0,1,240,1
"org.apache.lucene.queries.function.valuesource.LongFieldSource$LongDocValues",5,0.00,2.00,24,0.27,12718.15,5,0,11,8,2,121.57,1,36,0,1,121.57,0.00,0.00,0.00,0,5.00,5,810.70,0,3,2,java.lang.Object,0.00,3,0,10,0,3,2,0,1,174,0
"org.apache.lucene.queries.function.valuesource.LongFieldSource$LongDocValues$ValueFiller",2,0.50,1.00,8,0.08,1129.61,4,2,11,3,2,126.87,0,12,0,1,126.87,0.00,0.00,0.75,0,0.00,1,241.43,0,1,2,java.lang.Object,0.00,1,0,2,0,1,1,0,0,61,0
"org.apache.lucene.queries.function.valuesource.LongFieldSource$LongDocValues$ValueSourceScorer",1,0.00,1.00,4,0.04,902.61,1,0,11,1,0,165.15,2,6,0,1,125.27,0.00,0.00,0.00,0,1.00,1,129.71,0,0,0,java.lang.Object,0.00,0,0,1,0,0,1,0,2,32,0
"org.apache.lucene.queries.function.valuesource.MaxDocValueSource",6,0.00,1.00,14,0.17,2576.18,6,0,6,13,6,139.04,0,26,1,2,139.04,0.00,0.50,0.00,1,6.00,1,497.14,0,3,5,org.apache.lucene.queries.function.ValueSource,0.29,7,1,6,0,7,3,0,0,125,1
"org.apache.lucene.queries.function.valuesource.MaxFloatFunction",3,0.00,1.67,16,0.13,4119.40,3,0,2,5,4,170.10,3,23,1,3,120.10,0.00,0.67,0.00,0,3.00,3,400.96,0,1,3,org.apache.lucene.queries.function.valuesource.MultiFloatFunction,0.16,2,2,5,0,2,2,0,1,92,1
"org.apache.lucene.queries.function.valuesource.MinFloatFunction",3,0.00,1.67,16,0.13,4119.40,3,0,2,5,4,170.10,3,23,1,3,120.10,0.00,0.67,0.00,0,3.00,3,400.96,0,1,3,org.apache.lucene.queries.function.valuesource.MultiFloatFunction,0.16,2,2,5,0,2,2,0,1,92,1
"org.apache.lucene.queries.function.valuesource.MultiBoolFunction",8,0.86,1.62,35,0.38,10323.04,9,1,8,19,7,123.93,0,48,1,3,123.93,0.00,0.67,0.25,2,16.00,3,1139.94,0,3,6,org.apache.lucene.queries.function.valuesource.BoolFunction,0.38,11,2,13,0,11,5,0,0,257,2
"org.apache.lucene.queries.function.valuesource.MultiBoolFunction$BoolDocValues",2,0.00,2.00,15,0.14,4195.93,2,0,8,8,0,113.16,0,20,0,1,113.16,0.00,0.00,0.00,0,2.00,3,412.66,0,1,0,java.lang.Object,0.00,6,0,4,0,6,1,0,0,90,0
"org.apache.lucene.queries.function.valuesource.MultiFloatFunction",8,0.86,1.62,37,0.41,12956.29,9,1,8,20,10,123.16,5,1,5,2,123.16,4.00,0.17,0.25,1,16.00,3,1231.15,0,3,5,org.apache.lucene.queries.function.ValueSource,0.25,12,1,13,4,12,5,0,2,276,2
"org.apache.lucene.queries.function.valuesource.MultiFloatFunction$FloatDocValues",2,0.00,2.00,16,0.15,5048.94,2,0,8,9,0,110.36,0,0,0,1,110.36,0.00,0.00,0.00,0,2.00,3,460.82,0,1,0,java.lang.Object,0.00,7,0,4,0,7,1,0,0,99,0
"org.apache.lucene.queries.function.valuesource.MultiFunction",9,0.88,1.78,51,0.55,19841.69,10,1,9,19,8,118.47,0,65,3,2,118.47,1.00,0.33,0.22,3,19.00,3,1662.03,0,5,5,org.apache.lucene.queries.function.ValueSource,0.24,10,1,16,1,10,4,0,0,361,2
"org.apache.lucene.queries.function.valuesource.MultiFunction$Values",3,1.00,1.00,8,0.07,1052.44,4,1,9,5,2,139.73,1,14,0,2,139.73,0.00,0.50,0.33,0,4.00,1,211.41,1,2,2,org.apache.lucene.queries.function.FunctionValues,0.14,2,1,3,0,2,1,0,1,59,1
"org.apache.lucene.queries.function.valuesource.MultiValueSource",1,0.00,1.00,2,0.01,80.15,1,0,1,1,10,145.01,4,3,9,2,144.78,3.00,0.20,0.00,0,1.00,1,35.16,0,0,1,org.apache.lucene.queries.function.ValueSource,0.00,0,1,1,3,0,1,0,1,13,2
"org.apache.lucene.queries.function.valuesource.NormValueSource",7,0.50,1.43,25,0.34,8013.24,8,1,9,21,11,129.03,0,40,2,2,129.03,0.00,0.50,0.57,2,3.00,3,1022.09,0,3,9,org.apache.lucene.queries.function.ValueSource,0.27,14,1,10,0,14,4,0,0,224,1
"org.apache.lucene.queries.function.valuesource.NormValueSource$FloatDocValues",1,0.00,1.00,3,0.03,397.41,1,0,9,2,0,132.73,0,5,0,1,132.73,0.00,0.00,0.00,0,1.00,1,87.61,0,0,0,java.lang.Object,0.00,1,0,1,0,1,1,0,0,24,0
"org.apache.lucene.queries.function.valuesource.NumDocsValueSource",5,0.00,1.00,11,0.12,1790.45,5,0,6,11,6,139.66,1,21,1,2,139.66,0.00,0.50,0.00,1,5.00,1,372.92,0,3,5,org.apache.lucene.queries.function.ValueSource,0.31,6,1,5,0,6,2,0,1,97,1
"org.apache.lucene.queries.function.valuesource.NumericIndexDocValueSource",6,0.40,2.17,29,0.36,12593.76,7,1,7,16,4,172.20,8,52,1,2,122.20,0.00,0.50,0.67,1,0.00,7,1077.73,0,3,3,org.apache.lucene.queries.function.ValueSource,0.43,10,1,13,0,10,3,0,1,236,1
"org.apache.lucene.queries.function.valuesource.NumericIndexDocValueSource$FunctionValues",2,0.00,1.00,5,0.05,698.46,2,0,7,3,0,139.74,1,9,0,1,139.74,0.00,0.00,0.00,0,2.00,1,154.57,0,1,0,java.lang.Object,0.00,1,0,2,0,1,1,0,1,42,0
"org.apache.lucene.queries.function.valuesource.NumericIndexDocValueSource$FunctionValues_0",2,0.00,1.00,5,0.05,698.46,2,0,7,3,0,139.74,0,9,0,1,139.74,0.00,0.00,0.00,0,2.00,1,154.57,0,1,0,java.lang.Object,0.00,1,0,2,0,1,1,0,0,42,0
"org.apache.lucene.queries.function.valuesource.OrdFieldSource",5,0.00,1.20,17,0.27,6668.36,7,2,14,13,15,149.17,18,29,3,2,128.55,0.00,0.50,0.50,1,0.00,2,804.85,0,2,12,org.apache.lucene.queries.function.ValueSource,0.31,8,1,6,0,8,3,0,2,177,1
"org.apache.lucene.queries.function.valuesource.OrdFieldSource$IntDocValues",6,0.00,1.00,13,0.12,1853.46,6,0,14,9,0,140.16,0,24,0,1,140.16,0.00,0.00,0.00,0,6.00,1,357.77,0,2,0,java.lang.Object,0.00,3,0,6,0,3,4,0,0,98,0
"org.apache.lucene.queries.function.valuesource.OrdFieldSource$IntDocValues$ValueFiller",2,0.00,1.00,7,0.07,1095.52,3,1,14,4,2,131.64,0,11,0,1,131.64,0.00,0.00,1.00,0,0.00,1,210.49,0,1,2,java.lang.Object,0.00,2,0,2,0,2,1,0,0,55,0
"org.apache.lucene.queries.function.valuesource.PowFloatFunction",3,0.00,1.00,7,0.08,1106.61,3,0,2,5,3,179.44,6,13,0,3,139.56,0.00,0.67,0.00,0,3.00,1,226.70,0,1,3,org.apache.lucene.queries.function.valuesource.DualFloatFunction,0.16,2,2,3,0,2,2,0,2,62,1
"org.apache.lucene.queries.function.valuesource.ProductFloatFunction",3,0.00,1.33,11,0.08,1964.72,3,0,2,4,5,180.96,3,17,2,3,130.96,0.00,0.67,0.00,0,3.00,2,249.77,0,1,3,org.apache.lucene.queries.function.valuesource.MultiFloatFunction,0.16,1,2,4,0,1,2,0,1,64,1
"org.apache.lucene.queries.function.valuesource.QueryDocValues",6,0.32,4.00,70,0.84,36030.83,16,10,11,17,13,141.97,14,99,1,3,102.08,0.00,0.67,0.37,1,0.00,7,2515.34,0,3,13,org.apache.lucene.queries.function.docvalues.FloatDocValues,0.36,11,2,24,0,11,3,0,14,488,0
"org.apache.lucene.queries.function.valuesource.QueryDocValues$ValueFiller",2,0.00,3.50,28,0.29,16348.92,3,1,11,4,2,147.15,3,38,0,1,97.15,0.00,0.00,1.00,0,0.00,6,872.92,0,1,2,java.lang.Object,0.00,2,0,7,0,2,1,0,3,168,0
"org.apache.lucene.queries.function.valuesource.QueryValueSource",8,0.14,1.12,23,0.25,5310.21,10,2,11,13,22,137.52,3,33,11,2,137.52,0.00,0.50,0.38,1,10.00,2,763.57,0,3,12,org.apache.lucene.queries.function.ValueSource,0.25,5,1,9,0,5,5,0,1,188,1
"org.apache.lucene.queries.function.valuesource.RangeMapFloatFunction",6,0.20,1.33,33,0.53,20706.96,11,5,7,14,7,167.00,8,50,2,2,117.00,0.00,0.50,0.37,1,0.00,2,1585.47,0,2,5,org.apache.lucene.queries.function.ValueSource,0.29,8,1,8,0,8,4,0,1,346,1
"org.apache.lucene.queries.function.valuesource.RangeMapFloatFunction$FloatDocValues",2,0.00,2.00,6,0.12,2925.74,2,0,7,4,0,128.12,0,10,0,1,128.12,0.00,0.00,0.00,0,0.00,3,346.79,0,1,0,java.lang.Object,0.00,2,0,4,0,2,1,0,0,78,0
"org.apache.lucene.queries.function.valuesource.ReciprocalFloatFunction",6,0.20,1.17,25,0.38,11100.28,10,4,7,14,7,143.39,21,42,2,2,122.78,0.00,0.50,0.42,1,0.00,2,1154.15,0,2,5,org.apache.lucene.queries.function.ValueSource,0.29,8,1,7,0,8,4,0,2,265,1
"org.apache.lucene.queries.function.valuesource.ReciprocalFloatFunction$FloatDocValues",2,0.00,1.00,5,0.09,1592.79,2,0,7,5,0,136.93,0,11,0,1,136.93,0.00,0.00,0.00,0,0.00,1,278.56,0,1,0,java.lang.Object,0.00,3,0,2,0,3,1,0,0,66,0
"org.apache.lucene.queries.function.valuesource.ReverseOrdFieldSource",5,0.12,1.40,20,0.30,8157.34,7,2,12,14,13,123.40,21,32,3,2,123.17,0.00,0.50,0.40,1,2.00,2,907.53,0,2,10,org.apache.lucene.queries.function.ValueSource,0.31,9,1,7,0,9,3,0,2,195,1
"org.apache.lucene.queries.function.valuesource.ReverseOrdFieldSource$IntDocValues",1,0.00,1.00,3,0.03,573.82,1,0,12,2,0,131.48,0,5,0,1,131.48,0.00,0.00,0.00,0,1.00,1,101.53,0,0,0,java.lang.Object,0.00,1,0,1,0,1,1,0,0,27,0
"org.apache.lucene.queries.function.valuesource.ScaleFloatFunction",7,0.22,2.29,59,0.80,42465.49,10,3,8,21,8,147.22,14,77,2,2,107.33,0.00,0.50,0.52,1,0.00,7,2414.23,0,3,6,org.apache.lucene.queries.function.ValueSource,0.27,14,1,16,0,14,4,0,4,481,1
"org.apache.lucene.queries.function.valuesource.ScaleFloatFunction$FloatDocValues",2,0.00,1.00,5,0.09,1502.89,2,0,8,4,0,137.12,0,12,0,1,137.12,0.00,0.00,0.00,0,0.00,1,283.20,0,1,0,java.lang.Object,0.00,2,0,2,0,2,1,0,0,66,0
"org.apache.lucene.queries.function.valuesource.ScaleFloatFunction$ScaleInfo",0,0.00,0.00,3,0.01,138.68,2,2,8,0,0,171.00,0,4,0,1,171.00,0.00,0.00,0.00,0,0.00,0,44.38,0,0,0,java.lang.Object,0.00,0,0,0,0,0,0,0,0,14,2
"org.apache.lucene.queries.function.valuesource.ShortFieldSource",6,0.80,1.50,20,0.27,8073.40,7,1,5,12,8,128.47,4,32,4,3,128.47,0.00,0.67,0.33,0,10.00,3,816.68,2,2,4,org.apache.lucene.queries.function.valuesource.FieldCacheSource,0.30,6,2,9,0,6,4,0,1,190,1
"org.apache.lucene.queries.function.valuesource.ShortFieldSource$FunctionValues",8,0.00,1.00,17,0.18,2697.89,8,0,5,10,0,139.86,0,33,0,1,139.86,0.00,0.00,0.00,0,8.00,1,530.22,0,2,0,java.lang.Object,0.00,2,0,8,0,2,6,0,0,143,0
"org.apache.lucene.queries.function.valuesource.SimpleBoolFunction",8,0.57,1.12,19,0.23,4269.18,9,1,7,15,7,138.27,0,31,1,3,138.27,0.00,0.67,0.50,2,8.00,2,678.32,0,3,6,org.apache.lucene.queries.function.valuesource.BoolFunction,0.38,7,2,9,0,7,5,0,0,172,2
"org.apache.lucene.queries.function.valuesource.SimpleBoolFunction$BoolDocValues",2,0.00,1.00,5,0.06,768.98,2,0,7,5,0,139.42,0,9,0,1,139.42,0.00,0.00,0.00,0,2.00,1,168.92,0,1,0,java.lang.Object,0.00,3,0,2,0,3,1,0,0,45,0
"org.apache.lucene.queries.function.valuesource.SimpleFloatFunction",3,0.00,1.00,7,0.07,1065.76,3,0,6,5,7,139.69,2,11,2,3,139.69,0.00,0.67,0.00,0,4.00,1,199.56,0,1,5,org.apache.lucene.queries.function.valuesource.SingleFunction,0.00,2,2,3,0,2,2,0,1,54,2
"org.apache.lucene.queries.function.valuesource.SimpleFloatFunction$FloatDocValues",2,0.00,1.00,5,0.06,768.98,2,0,6,5,0,139.42,0,9,0,1,139.42,0.00,0.00,0.00,0,2.00,1,168.92,0,1,0,java.lang.Object,0.00,3,0,2,0,3,1,0,0,45,0
"org.apache.lucene.queries.function.valuesource.SingleFunction",6,0.60,1.17,15,0.19,4569.48,7,1,4,13,5,137.04,2,26,3,2,137.04,2.00,0.25,0.50,2,6.00,2,584.67,0,2,2,org.apache.lucene.queries.function.ValueSource,0.29,7,1,7,2,7,4,0,1,147,2
"org.apache.lucene.queries.function.valuesource.SumFloatFunction",3,0.00,1.33,11,0.08,1964.72,3,0,2,4,4,180.96,3,17,1,3,130.96,0.00,0.67,0.00,0,3.00,2,249.77,0,1,3,org.apache.lucene.queries.function.valuesource.MultiFloatFunction,0.16,1,2,4,0,1,2,0,1,64,1
"org.apache.lucene.queries.function.valuesource.SumTotalTermFreqValueSource",7,0.67,1.57,27,0.34,9200.75,8,1,10,17,10,128.54,5,40,2,2,128.54,0.00,0.50,0.43,2,10.00,4,1023.09,0,3,8,org.apache.lucene.queries.function.ValueSource,0.27,10,1,11,0,10,4,0,2,225,1
"org.apache.lucene.queries.function.valuesource.SumTotalTermFreqValueSource$LongDocValues",1,0.00,1.00,3,0.02,180.53,1,0,10,1,0,135.43,0,5,0,1,135.43,0.00,0.00,0.00,0,1.00,1,58.21,0,0,0,java.lang.Object,0.00,0,0,1,0,0,1,0,0,18,0
"org.apache.lucene.queries.function.valuesource.TFValueSource",3,0.00,1.33,13,0.17,4223.50,3,0,9,10,11,123.68,0,20,1,4,123.68,0.00,0.75,0.00,0,4.00,2,513.99,0,2,10,org.apache.lucene.queries.function.valuesource.TermFreqValueSource,0.19,7,3,4,0,7,1,0,0,110,1
"org.apache.lucene.queries.function.valuesource.TFValueSource$FloatDocValues",2,1.00,4.50,28,0.28,10128.81,5,3,9,10,2,138.61,5,39,0,1,98.73,0.00,0.00,0.83,1,0.00,5,843.34,0,0,2,java.lang.Object,0.00,8,0,9,0,8,2,0,5,174,0
"org.apache.lucene.queries.function.valuesource.TFValueSource$FloatDocValues$DocsEnum",4,0.00,1.00,9,0.07,952.86,4,0,9,4,1,141.05,0,17,0,1,141.05,0.00,0.00,0.00,0,4.00,1,214.67,0,0,1,java.lang.Object,0.00,0,0,4,0,0,4,0,0,60,0
"org.apache.lucene.queries.function.valuesource.TermFreqValueSource",3,0.00,1.00,9,0.10,1557.60,3,0,7,6,9,131.82,0,15,2,3,131.82,0.50,0.50,0.00,0,4.00,1,289.81,0,2,7,org.apache.lucene.queries.function.valuesource.DocFreqValueSource,0.17,3,2,3,1,3,1,0,0,73,1
"org.apache.lucene.queries.function.valuesource.TermFreqValueSource$IntDocValues",2,1.00,4.50,28,0.26,9632.31,5,3,7,9,2,138.79,5,39,0,1,98.90,0.00,0.00,0.83,1,0.00,5,792.81,0,0,2,java.lang.Object,0.00,7,0,9,0,7,2,0,5,166,0
"org.apache.lucene.queries.function.valuesource.TermFreqValueSource$IntDocValues$DocsEnum",4,0.00,1.00,9,0.07,952.86,4,0,7,4,1,141.05,0,17,0,1,141.05,0.00,0.00,0.00,0,4.00,1,214.67,0,0,1,java.lang.Object,0.00,0,0,4,0,0,4,0,0,60,0
"org.apache.lucene.queries.function.valuesource.TotalTermFreqValueSource",7,0.04,1.29,29,0.37,8609.76,11,4,8,17,8,124.15,5,42,2,2,124.15,0.00,0.50,0.21,2,18.00,2,1110.18,0,3,6,org.apache.lucene.queries.function.ValueSource,0.27,10,1,9,0,10,4,0,2,256,1
"org.apache.lucene.queries.function.valuesource.TotalTermFreqValueSource$LongDocValues",1,0.00,1.00,3,0.02,180.53,1,0,8,1,0,135.43,0,5,0,1,135.43,0.00,0.00,0.00,0,1.00,1,58.21,0,0,0,java.lang.Object,0.00,0,0,1,0,0,1,0,0,18,0
"org.apache.lucene.queries.function.valuesource.VectorValueSource",9,0.50,1.89,48,0.50,20326.55,10,1,7,20,12,118.37,6,63,7,3,118.37,1.00,0.40,0.56,1,4.00,4,1499.55,0,4,5,org.apache.lucene.queries.function.valuesource.MultiValueSource,0.50,11,2,17,2,11,5,0,3,328,1
"org.apache.lucene.queries.function.valuesource.VectorValueSource$FunctionValues",8,0.00,1.00,24,0.37,7298.98,8,0,7,25,0,129.89,0,40,0,1,129.89,0.00,0.00,0.00,0,8.00,1,1122.63,0,1,0,java.lang.Object,0.00,17,0,8,0,17,7,0,0,267,0
"org.apache.lucene.queries.function.valuesource.VectorValueSource$FunctionValues_0",8,0.00,2.12,56,0.56,18413.85,8,0,7,21,0,112.83,0,59,0,1,112.83,0.00,0.00,0.00,0,8.00,3,1675.11,0,1,0,java.lang.Object,0.00,13,0,17,0,13,7,0,0,369,0
"org.apache.lucene.benchmark.byTask.tasks.AddDocTask",7,0.17,1.14,25,0.24,4018.43,9,2,4,13,8,171.33,16,40,4,2,131.45,1.00,0.33,0.36,0,11.00,2,705.08,4,1,4,org.apache.lucene.benchmark.byTask.tasks.PerfTask,0.29,6,1,8,1,6,6,0,4,174,1
"org.apache.lucene.benchmark.byTask.tasks.AddFacetedDocTask",4,0.22,1.75,21,0.22,4345.19,7,3,4,12,5,141.51,15,32,0,3,120.89,0.00,0.67,0.50,0,0.00,2,671.30,4,1,5,org.apache.lucene.benchmark.byTask.tasks.AddDocTask,0.23,8,2,7,0,8,3,0,2,155,1
"org.apache.lucene.benchmark.byTask.tasks.BenchmarkHighlighter",1,0.00,1.00,2,0.03,263.79,1,0,3,1,7,140.70,0,4,4,1,140.70,0.00,0.00,0.00,0,1.00,1,95.01,0,0,3,java.lang.Object,0.00,0,0,1,0,0,1,0,0,25,2
"org.apache.lucene.benchmark.byTask.tasks.ClearStatsTask",3,0.00,1.00,8,0.06,639.05,3,0,1,5,2,99.14,23,14,0,2,141.44,0.00,0.50,0.00,0,3.00,1,170.05,1,0,2,org.apache.lucene.benchmark.byTask.tasks.PerfTask,0.13,2,1,3,0,2,3,0,3,49,1
"org.apache.lucene.benchmark.byTask.tasks.CloseIndexTask",4,0.67,1.50,18,0.17,3522.94,5,1,4,12,8,175.26,6,28,4,2,125.26,0.00,0.50,0.50,0,4.00,3,521.28,2,0,4,org.apache.lucene.benchmark.byTask.tasks.PerfTask,0.12,8,1,6,0,8,4,0,2,123,1
"org.apache.lucene.benchmark.byTask.tasks.CloseReaderTask",2,0.00,1.50,10,0.11,2410.42,2,0,3,7,3,160.46,5,15,0,2,120.57,0.00,0.50,0.00,0,2.00,2,317.56,1,0,3,org.apache.lucene.benchmark.byTask.tasks.PerfTask,0.07,5,1,3,0,5,2,0,1,72,1
"org.apache.lucene.benchmark.byTask.tasks.CloseTaxonomyIndexTask",2,0.00,1.00,7,0.06,708.45,2,0,3,5,3,173.01,4,11,0,2,133.13,0.00,0.50,0.00,0,2.00,1,172.95,1,0,3,org.apache.lucene.benchmark.byTask.tasks.PerfTask,0.07,3,1,2,0,3,2,0,1,46,1
"org.apache.lucene.benchmark.byTask.tasks.CloseTaxonomyReaderTask",2,0.00,1.50,10,0.11,2410.42,2,0,3,7,3,160.46,4,15,0,2,120.57,0.00,0.50,0.00,0,2.00,2,317.56,1,0,3,org.apache.lucene.benchmark.byTask.tasks.PerfTask,0.07,5,1,3,0,5,2,0,1,72,1
"org.apache.lucene.benchmark.byTask.tasks.CommitIndexTask",4,0.67,1.25,15,0.14,2753.06,5,1,4,8,4,180.80,4,24,0,2,130.80,0.00,0.50,0.50,0,4.00,2,427.85,2,0,4,org.apache.lucene.benchmark.byTask.tasks.PerfTask,0.12,4,1,5,0,4,4,0,1,105,1
"org.apache.lucene.benchmark.byTask.tasks.CommitTaxonomyIndexTask",2,0.00,1.50,10,0.08,1785.59,2,0,2,5,3,171.60,3,15,0,2,121.60,0.00,0.50,0.00,0,2.00,2,240.46,1,0,3,org.apache.lucene.benchmark.byTask.tasks.PerfTask,0.07,3,1,3,0,3,2,0,1,57,1
"org.apache.lucene.benchmark.byTask.tasks.ConsumeContentSourceTask",4,0.00,1.50,22,0.24,5441.11,6,2,4,16,5,170.16,7,33,0,2,120.16,0.00,0.50,0.50,0,0.00,3,727.79,1,1,5,org.apache.lucene.benchmark.byTask.tasks.PerfTask,0.19,12,1,6,0,12,3,0,1,159,1
"org.apache.lucene.benchmark.byTask.tasks.CountingHighlighterTestTask",3,0.50,1.33,13,0.12,2508.95,5,2,12,8,13,175.46,3,20,1,5,125.46,0.00,0.80,0.17,0,5.00,2,371.92,0,2,12,org.apache.lucene.benchmark.byTask.tasks.SearchTravRetHighlightTask,0.00,5,4,4,0,5,1,0,1,92,1
"org.apache.lucene.benchmark.byTask.tasks.CountingHighlighterTestTask$BenchmarkHighlighter",1,0.00,3.00,6,0.13,4319.11,1,0,12,3,5,113.09,0,8,0,1,113.09,0.00,0.00,0.00,0,0.00,3,390.85,0,0,5,java.lang.Object,0.00,2,0,3,0,2,1,0,0,75,0
"org.apache.lucene.benchmark.byTask.tasks.CountingSearchTestTask",4,0.17,1.25,19,0.14,2534.14,8,4,1,5,3,126.43,3,26,1,4,126.43,0.00,0.75,0.38,1,4.00,2,429.84,1,0,2,org.apache.lucene.benchmark.byTask.tasks.SearchTask,0.07,1,3,5,0,1,4,0,1,109,1
"org.apache.lucene.benchmark.byTask.tasks.CreateIndexTask",5,0.00,5.00,81,1.55,115758.25,5,0,24,42,23,73.47,25,110,5,2,91.34,0.00,0.50,0.00,3,5.00,16,4646.54,1,3,19,org.apache.lucene.benchmark.byTask.tasks.PerfTask,0.06,37,1,25,0,37,2,0,1,735,1
"org.apache.lucene.benchmark.byTask.tasks.CreateIndexTaskTest",6,0.00,1.17,52,0.66,18470.01,6,0,11,28,8,109.81,2,64,0,3,109.81,0.00,0.67,0.00,1,6.00,2,1976.11,1,1,8,org.apache.lucene.benchmark.BenchmarkTestCase,0.00,22,2,7,0,22,5,0,2,407,1
"org.apache.lucene.benchmark.byTask.tasks.CreateTaxonomyIndexTask",2,0.00,1.00,7,0.07,1052.49,2,0,4,5,3,171.66,4,11,0,2,131.77,0.00,0.50,0.00,0,2.00,1,199.31,1,0,3,org.apache.lucene.benchmark.byTask.tasks.PerfTask,0.07,3,1,2,0,3,2,0,1,50,1
"org.apache.lucene.benchmark.byTask.tasks.ForceMergeTask",4,0.67,1.25,15,0.14,2700.46,5,1,2,9,3,180.87,5,24,0,2,130.87,0.00,0.50,0.50,0,4.00,2,418.46,2,0,3,org.apache.lucene.benchmark.byTask.tasks.PerfTask,0.12,5,1,5,0,5,4,0,2,102,1
"org.apache.lucene.benchmark.byTask.tasks.NearRealtimeReaderTask",5,0.00,2.40,47,0.58,31489.26,8,3,5,18,6,125.90,18,61,0,2,105.29,0.00,0.50,0.33,0,6.00,7,1736.41,2,0,6,org.apache.lucene.benchmark.byTask.tasks.PerfTask,0.18,13,1,12,0,13,5,0,9,327,1
"org.apache.lucene.benchmark.byTask.tasks.NewAnalyzerTask",5,0.12,3.00,46,0.58,27320.01,7,2,6,22,9,126.33,18,63,7,2,105.72,0.00,0.50,0.40,0,2.00,7,1726.97,2,1,3,org.apache.lucene.benchmark.byTask.tasks.PerfTask,0.12,17,1,15,0,17,4,0,7,333,1
"org.apache.lucene.benchmark.byTask.tasks.NewCollationAnalyzerTask",0,0.00,0.00,2,0.01,75.00,0,0,7,0,3,171.00,9,2,0,2,171.00,0.00,0.50,0.00,0,0.00,0,30.00,0,0,3,org.apache.lucene.benchmark.byTask.tasks.PerfTask,0.00,0,1,0,0,0,0,0,1,10,1
"org.apache.lucene.benchmark.byTask.tasks.NewCollationAnalyzerTask$Implementation",1,2.00,10.00,40,0.82,68072.56,4,3,7,19,1,112.54,2,68,0,1,72.65,0.00,0.00,0.33,0,0.00,10,2472.32,1,0,1,java.lang.Object,0.00,18,0,10,0,18,1,0,2,377,1
"org.apache.lucene.benchmark.byTask.tasks.NewLocaleTask",5,0.08,2.40,25,0.34,8716.74,8,3,3,15,2,139.82,18,41,0,2,119.20,0.00,0.50,0.40,1,7.00,4,1006.22,2,1,2,org.apache.lucene.benchmark.byTask.tasks.PerfTask,0.12,10,1,12,0,10,4,0,3,223,1
"org.apache.lucene.benchmark.byTask.tasks.NewRoundTask",3,0.00,1.00,8,0.06,639.05,3,0,1,5,2,99.14,23,14,0,2,141.44,0.00,0.50,0.00,0,3.00,1,170.05,1,0,2,org.apache.lucene.benchmark.byTask.tasks.PerfTask,0.13,2,1,3,0,2,3,0,3,49,1
"org.apache.lucene.benchmark.byTask.tasks.NewShingleAnalyzerTask",5,0.17,2.80,47,0.58,20928.56,8,3,5,18,6,146.53,11,73,0,2,106.65,0.00,0.50,0.47,1,2.00,5,1751.63,2,0,6,org.apache.lucene.benchmark.byTask.tasks.PerfTask,0.12,13,1,14,0,13,5,0,3,339,1
"org.apache.lucene.benchmark.byTask.tasks.OpenIndexTask",4,0.17,1.50,24,0.26,6252.68,8,4,8,9,9,137.34,12,34,1,2,116.73,0.00,0.50,0.12,0,4.00,2,785.28,2,0,9,org.apache.lucene.benchmark.byTask.tasks.PerfTask,0.12,5,1,6,0,5,4,0,2,169,1
"org.apache.lucene.benchmark.byTask.tasks.OpenReaderTask",5,0.25,2.20,34,0.39,14836.89,7,2,8,16,10,164.45,6,48,4,2,114.45,0.00,0.50,0.30,0,10.00,4,1160.26,2,1,6,org.apache.lucene.benchmark.byTask.tasks.PerfTask,0.12,11,1,11,0,11,4,0,2,243,1
"org.apache.lucene.benchmark.byTask.tasks.OpenTaxonomyIndexTask",2,0.00,1.00,7,0.06,972.50,2,0,3,5,3,171.93,4,11,0,2,132.04,0.00,0.50,0.00,0,2.00,1,181.67,1,0,3,org.apache.lucene.benchmark.byTask.tasks.PerfTask,0.07,3,1,2,0,3,2,0,1,47,1
"org.apache.lucene.benchmark.byTask.tasks.OpenTaxonomyReaderTask",2,0.00,1.00,9,0.08,1461.35,2,0,3,6,3,165.88,5,13,0,2,125.99,0.00,0.50,0.00,0,2.00,1,230.98,1,0,3,org.apache.lucene.benchmark.byTask.tasks.PerfTask,0.07,4,1,2,0,4,2,0,2,57,1
"org.apache.lucene.benchmark.byTask.tasks.PerfTask",28,0.01,1.50,117,1.16,31088.63,41,13,4,52,46,145.08,102,155,45,1,124.47,0.00,0.00,0.06,7,362.00,5,3484.31,1,7,4,java.lang.Object,0.00,24,0,42,57,24,21,1,26,765,2
"org.apache.lucene.benchmark.byTask.tasks.PerfTaskTest",3,0.00,1.67,21,0.29,7608.82,3,0,4,11,4,112.55,2,29,0,3,112.55,0.00,0.67,0.00,2,3.00,3,865.44,0,1,4,org.apache.lucene.benchmark.BenchmarkTestCase,0.00,8,2,5,0,8,2,0,2,191,1
"org.apache.lucene.benchmark.byTask.tasks.PerfTaskTest$MyPerfTask",3,0.00,1.00,7,0.04,402.74,3,0,4,3,2,143.01,0,10,0,2,143.01,0.00,0.50,0.00,0,4.00,1,124.60,0,0,2,org.apache.lucene.benchmark.byTask.tasks.PerfTask,0.06,0,1,3,0,0,3,0,0,39,3
"org.apache.lucene.benchmark.byTask.tasks.PrintReaderTask",4,0.67,1.25,16,0.20,4918.00,5,1,3,11,5,124.16,3,27,0,2,124.16,0.00,0.50,0.50,0,4.00,2,600.84,2,0,5,org.apache.lucene.benchmark.byTask.tasks.PerfTask,0.12,7,1,5,0,7,4,0,1,133,1
"org.apache.lucene.benchmark.byTask.tasks.ReadTask",19,0.26,2.16,127,1.74,153788.80,22,3,23,49,24,131.64,73,156,5,2,111.02,11.00,0.08,0.09,11,79.00,21,5207.39,2,6,20,org.apache.lucene.benchmark.byTask.tasks.PerfTask,0.09,30,1,41,11,30,13,0,24,867,2
"org.apache.lucene.benchmark.byTask.tasks.ReadTokensTask",5,0.00,1.60,32,0.39,15245.38,8,3,13,16,12,154.31,10,48,0,2,114.43,0.00,0.50,0.33,0,1.00,4,1174.22,3,1,12,org.apache.lucene.benchmark.byTask.tasks.PerfTask,0.24,11,1,8,0,11,4,0,4,237,1
"org.apache.lucene.benchmark.byTask.tasks.ReadTokensTask$ReusableStringReader",4,0.00,1.50,25,0.24,11692.25,7,3,13,6,0,114.59,0,33,0,2,114.59,0.00,0.50,0.33,1,4.00,3,705.73,0,0,0,java.io.Reader,0.00,2,1,6,0,2,4,0,0,160,3
"org.apache.lucene.benchmark.byTask.tasks.ReopenReaderTask",2,0.00,1.50,11,0.10,2470.41,2,0,4,6,4,160.37,4,16,0,2,120.49,0.00,0.50,0.00,0,2.00,2,296.28,1,0,4,org.apache.lucene.benchmark.byTask.tasks.PerfTask,0.07,4,1,3,0,4,2,0,1,70,1
"org.apache.lucene.benchmark.byTask.tasks.RepAllTask",3,0.00,2.67,30,0.42,23104.70,3,0,4,16,4,123.48,9,38,0,3,102.87,0.00,0.67,0.00,1,4.00,6,1252.28,3,1,4,org.apache.lucene.benchmark.byTask.tasks.ReportTask,0.08,13,2,8,0,13,2,0,3,238,1
"org.apache.lucene.benchmark.byTask.tasks.RepSelectByPrefTask",3,0.00,2.67,30,0.47,24435.94,3,0,4,20,4,152.67,5,39,0,4,102.67,0.00,0.75,0.00,1,1.00,6,1407.12,3,1,4,org.apache.lucene.benchmark.byTask.tasks.RepSumByPrefTask,0.09,17,3,8,0,17,2,0,2,261,1
"org.apache.lucene.benchmark.byTask.tasks.RepSumByNameRoundTask",3,0.00,2.33,28,0.41,20349.96,3,0,5,21,4,105.27,12,38,0,3,105.04,0.00,0.67,0.00,1,3.00,5,1220.07,2,1,4,org.apache.lucene.benchmark.byTask.tasks.ReportTask,0.08,18,2,7,0,18,2,0,6,232,1
"org.apache.lucene.benchmark.byTask.tasks.RepSumByNameTask",3,0.00,2.33,27,0.38,17845.61,3,0,5,20,5,126.10,11,37,1,3,105.49,0.00,0.67,0.00,1,3.00,5,1137.46,2,1,4,org.apache.lucene.benchmark.byTask.tasks.ReportTask,0.08,17,2,7,0,17,2,0,5,220,1
"org.apache.lucene.benchmark.byTask.tasks.RepSumByPrefRoundTask",3,0.00,2.33,28,0.44,23381.65,3,0,5,22,4,144.45,8,38,0,4,104.56,0.00,0.75,0.00,1,1.00,5,1327.80,2,1,4,org.apache.lucene.benchmark.byTask.tasks.RepSumByPrefTask,0.09,19,3,7,0,19,2,0,5,248,1
"org.apache.lucene.benchmark.byTask.tasks.RepSumByPrefTask",5,0.50,1.80,32,0.46,21300.02,6,1,5,23,7,153.14,10,45,3,3,113.26,1.00,0.40,0.60,1,2.00,5,1378.26,3,2,4,org.apache.lucene.benchmark.byTask.tasks.ReportTask,0.15,18,2,9,2,18,3,0,5,272,1
"org.apache.lucene.benchmark.byTask.tasks.ReportTask",7,0.08,3.14,89,1.39,93088.61,17,10,5,34,9,55.72,50,107,4,2,98.01,6.00,0.12,0.17,3,19.00,10,4180.90,1,4,5,org.apache.lucene.benchmark.byTask.tasks.PerfTask,0.11,27,1,22,6,27,3,0,11,752,2
"org.apache.lucene.benchmark.byTask.tasks.ResetInputsTask",3,0.00,1.00,8,0.05,582.39,3,0,1,4,4,93.65,24,14,2,2,141.75,2.00,0.25,0.00,0,3.00,1,156.28,1,0,2,org.apache.lucene.benchmark.byTask.tasks.PerfTask,0.13,1,1,3,2,1,3,0,3,46,1
"org.apache.lucene.benchmark.byTask.tasks.ResetSystemEraseTask",2,0.00,1.00,6,0.04,466.02,2,0,1,3,2,90.43,23,10,0,4,134.56,0.00,0.75,0.00,0,2.00,1,125.51,1,0,2,org.apache.lucene.benchmark.byTask.tasks.ResetSystemSoftTask,0.11,1,3,2,0,1,2,0,2,36,1
"org.apache.lucene.benchmark.byTask.tasks.ResetSystemSoftTask",2,0.00,1.00,6,0.04,466.02,2,0,1,3,3,90.43,23,10,1,3,134.56,0.50,0.50,0.00,0,2.00,1,125.51,1,0,2,org.apache.lucene.benchmark.byTask.tasks.ResetInputsTask,0.09,1,2,2,1,1,2,0,2,36,1
"org.apache.lucene.benchmark.byTask.tasks.RollbackIndexTask",2,1.00,2.00,13,0.12,2706.72,3,1,5,8,4,157.04,4,19,0,2,117.15,0.00,0.50,0.00,0,2.00,3,369.57,1,0,4,org.apache.lucene.benchmark.byTask.tasks.PerfTask,0.07,6,1,4,0,6,2,0,2,84,1
"org.apache.lucene.benchmark.byTask.tasks.SearchTask",6,0.00,1.00,13,0.08,935.20,6,0,2,7,5,192.50,6,25,3,3,142.50,1.00,0.40,0.00,0,6.00,1,249.03,1,1,3,org.apache.lucene.benchmark.byTask.tasks.ReadTask,0.28,1,2,6,2,1,5,0,1,76,1
"org.apache.lucene.benchmark.byTask.tasks.SearchTravRetHighlightTask",7,0.06,2.29,54,0.88,55182.59,13,6,15,28,13,108.84,30,67,1,4,108.60,0.33,0.60,0.21,0,20.00,8,2627.48,3,2,12,org.apache.lucene.benchmark.byTask.tasks.SearchTravTask,0.19,21,3,16,1,21,5,0,5,504,1
"org.apache.lucene.benchmark.byTask.tasks.SearchTravRetHighlightTask$BenchmarkHighlighter",1,0.00,2.00,5,0.11,2960.05,1,0,15,2,5,117.43,0,8,0,1,117.43,0.00,0.00,0.00,0,0.00,2,321.99,0,0,5,java.lang.Object,0.00,1,0,2,0,1,1,0,0,63,0
"org.apache.lucene.benchmark.byTask.tasks.SearchTravRetLoadFieldSelectorTask",5,0.75,1.40,24,0.22,5714.84,6,1,8,11,5,145.00,16,33,0,4,124.38,0.00,0.75,0.40,0,7.00,2,655.86,0,1,5,org.apache.lucene.benchmark.byTask.tasks.SearchTravTask,0.13,6,3,7,0,6,4,0,3,152,1
"org.apache.lucene.benchmark.byTask.tasks.SearchTravRetTask",2,0.00,1.00,5,0.03,243.05,2,0,1,2,2,111.13,12,9,0,4,143.35,0.00,0.75,0.00,0,2.00,1,82.05,0,0,2,org.apache.lucene.benchmark.byTask.tasks.SearchTravTask,0.07,0,3,2,0,0,2,0,1,27,1
"org.apache.lucene.benchmark.byTask.tasks.SearchTravRetVectorHighlightTask",7,0.00,2.57,55,0.88,62721.84,12,5,11,23,9,108.37,28,70,0,4,108.14,0.00,0.75,0.20,0,19.00,8,2654.42,3,2,9,org.apache.lucene.benchmark.byTask.tasks.SearchTravTask,0.19,16,3,18,0,16,5,0,5,516,1
"org.apache.lucene.benchmark.byTask.tasks.SearchTravRetVectorHighlightTask$BenchmarkHighlighter",1,0.00,2.00,5,0.11,3224.40,1,0,11,1,4,117.14,0,8,0,1,117.14,0.00,0.00,0.00,0,0.00,2,321.99,0,0,4,java.lang.Object,0.00,0,0,2,0,0,1,0,0,63,0
"org.apache.lucene.benchmark.byTask.tasks.SearchTravTask",9,0.88,1.00,21,0.16,1964.74,10,1,2,11,7,191.35,14,39,4,3,141.35,2.50,0.25,0.22,0,19.00,1,468.32,2,1,3,org.apache.lucene.benchmark.byTask.tasks.ReadTask,0.38,2,2,9,5,2,8,0,2,133,1
"org.apache.lucene.benchmark.byTask.tasks.SearchWithCollectorTask",9,0.88,1.33,32,0.32,8272.68,10,1,5,18,6,129.80,4,51,0,4,129.80,0.00,0.75,0.22,0,19.00,4,969.64,4,2,6,org.apache.lucene.benchmark.byTask.tasks.SearchTask,0.52,9,3,12,0,9,7,0,2,225,1
"org.apache.lucene.benchmark.byTask.tasks.SearchWithSortTask",11,0.20,1.73,63,0.68,36725.56,14,3,5,24,6,167.05,15,87,1,3,117.05,0.00,0.67,0.15,0,39.00,8,2045.29,2,2,5,org.apache.lucene.benchmark.byTask.tasks.ReadTask,0.47,13,2,19,0,13,9,0,2,400,1
"org.apache.lucene.benchmark.byTask.tasks.SearchWithSortTaskTest",1,0.00,1.00,5,0.08,1311.34,1,0,5,10,5,120.38,0,7,0,3,120.38,0.00,0.67,0.00,0,1.00,1,245.83,0,0,5,org.apache.lucene.benchmark.BenchmarkTestCase,0.00,9,2,1,0,9,1,0,0,55,1
"org.apache.lucene.benchmark.byTask.tasks.SetPropTask",4,0.00,1.25,17,0.20,4374.79,6,2,1,10,2,76.45,32,26,0,2,124.56,0.00,0.50,0.50,0,4.00,2,586.70,3,0,2,org.apache.lucene.benchmark.byTask.tasks.PerfTask,0.12,6,1,5,0,6,4,0,4,136,1
"org.apache.lucene.benchmark.byTask.tasks.TaskSequence",26,0.10,3.85,304,3.57,245345.41,45,19,7,71,11,140.43,59,352,6,2,100.54,0.00,0.50,0.15,7,310.00,16,10706.71,10,5,5,org.apache.lucene.benchmark.byTask.tasks.PerfTask,0.22,45,1,100,0,45,21,0,29,1940,1
"org.apache.lucene.benchmark.byTask.tasks.TaskSequence$ParallelTask",2,0.00,2.50,13,0.12,2504.62,4,2,7,5,2,117.37,0,22,0,2,117.37,0.00,0.50,0.50,0,2.00,4,353.02,0,0,2,java.lang.Thread,0.00,3,1,5,0,3,2,0,0,80,1
"org.apache.lucene.benchmark.byTask.tasks.TaskSequence$RunBackgroundTask",4,0.11,1.25,15,0.12,1844.52,7,3,7,7,1,132.17,0,23,0,2,132.17,0.00,0.50,0.42,0,2.00,2,362.94,0,0,1,java.lang.Thread,0.00,3,1,5,0,3,4,0,0,94,2
"org.apache.lucene.benchmark.byTask.tasks.UpdateDocTask",7,0.17,1.29,29,0.30,6387.27,9,2,5,15,6,165.06,14,45,0,2,125.17,0.00,0.50,0.36,0,11.00,2,910.65,4,1,6,org.apache.lucene.benchmark.byTask.tasks.PerfTask,0.29,8,1,9,0,8,6,0,4,210,1
"org.apache.lucene.benchmark.byTask.tasks.WaitForMergesTask",2,0.00,1.00,6,0.04,502.02,2,0,5,4,4,184.31,3,10,0,2,134.31,0.00,0.50,0.00,0,2.00,1,133.51,1,0,4,org.apache.lucene.benchmark.byTask.tasks.PerfTask,0.07,2,1,2,0,2,2,0,1,38,1
"org.apache.lucene.benchmark.byTask.tasks.WaitTask",4,0.67,2.00,27,0.29,12278.60,5,1,1,10,2,154.24,11,37,0,2,114.35,0.00,0.50,0.50,0,4.00,5,882.02,1,0,2,org.apache.lucene.benchmark.byTask.tasks.PerfTask,0.12,6,1,8,0,6,4,0,2,185,1
"org.apache.lucene.benchmark.byTask.tasks.WarmTask",6,0.00,1.00,13,0.08,791.17,6,0,2,6,3,193.08,11,25,0,3,143.08,0.00,0.67,0.00,0,6.00,1,228.22,0,1,3,org.apache.lucene.benchmark.byTask.tasks.ReadTask,0.28,0,2,6,0,0,5,0,2,71,1
"org.apache.lucene.benchmark.byTask.tasks.WriteLineDocTask",7,0.22,3.00,88,1.33,65213.81,19,12,15,43,13,67.01,45,110,6,2,99.23,0.00,0.50,0.27,1,4.00,7,3984.28,2,1,7,org.apache.lucene.benchmark.byTask.tasks.PerfTask,0.23,36,1,21,0,36,6,0,9,700,1
"org.apache.lucene.benchmark.byTask.tasks.WriteLineDocTaskTest",13,1.00,1.85,165,2.33,86262.71,14,1,16,45,7,140.39,28,200,0,3,100.51,0.00,0.67,0.08,3,24.00,6,7003.47,1,1,7,org.apache.lucene.benchmark.BenchmarkTestCase,0.00,32,2,24,0,32,12,0,28,1291,1
"org.apache.lucene.benchmark.byTask.tasks.WriteLineDocTaskTest$EmptyDocMaker",1,0.00,1.00,3,0.03,394.65,1,0,16,2,2,132.76,0,6,0,2,132.76,0.00,0.50,0.00,0,1.00,1,77.77,0,1,2,org.apache.lucene.benchmark.byTask.feeds.DocMaker,0.17,1,1,1,0,1,0,0,0,23,3
"org.apache.lucene.benchmark.byTask.tasks.WriteLineDocTaskTest$JustDateDocMaker",1,0.00,1.00,5,0.05,1063.18,1,0,16,4,3,121.09,0,8,0,2,121.09,0.00,0.50,0.00,0,0.00,1,151.44,0,1,3,org.apache.lucene.benchmark.byTask.feeds.DocMaker,0.17,3,1,1,0,3,0,0,0,38,3
"org.apache.lucene.benchmark.byTask.tasks.WriteLineDocTaskTest$LegalJustDateDocMaker",1,0.00,1.00,5,0.05,1063.18,1,0,16,4,3,121.09,0,8,0,2,121.09,0.00,0.50,0.00,0,0.00,1,151.44,0,1,3,org.apache.lucene.benchmark.byTask.feeds.DocMaker,0.17,3,1,1,0,3,0,0,0,38,3
"org.apache.lucene.benchmark.byTask.tasks.WriteLineDocTaskTest$NewLinesDocMaker",1,0.00,1.00,7,0.08,2159.80,1,0,16,4,3,113.22,0,10,0,2,113.22,0.00,0.50,0.00,0,0.00,1,250.18,0,1,3,org.apache.lucene.benchmark.byTask.feeds.DocMaker,0.17,3,1,1,0,3,0,0,0,58,3
"org.apache.lucene.benchmark.byTask.tasks.WriteLineDocTaskTest$NoBodyDocMaker",1,0.00,1.00,6,0.07,1589.35,1,0,16,4,3,116.76,0,9,0,2,116.76,0.00,0.50,0.00,0,0.00,1,199.69,0,1,3,org.apache.lucene.benchmark.byTask.feeds.DocMaker,0.17,3,1,1,0,3,0,0,0,48,3
"org.apache.lucene.benchmark.byTask.tasks.WriteLineDocTaskTest$NoTitleDocMaker",1,0.00,1.00,6,0.07,1589.35,1,0,16,4,3,116.76,0,9,0,2,116.76,0.00,0.50,0.00,0,0.00,1,199.69,0,1,3,org.apache.lucene.benchmark.byTask.feeds.DocMaker,0.17,3,1,1,0,3,0,0,0,48,3
"org.apache.lucene.benchmark.byTask.tasks.WriteLineDocTaskTest$Thread",1,0.00,2.00,5,0.04,716.92,1,0,16,3,0,122.28,0,9,0,1,122.28,0.00,0.00,0.00,0,1.00,2,128.07,0,0,0,java.lang.Object,0.00,2,0,2,0,2,1,0,0,33,0
"org.apache.lucene.benchmark.byTask.tasks.WriteLineDocTaskTest$ThreadingDocMaker",1,0.00,1.00,8,0.12,3254.52,1,0,16,6,3,109.65,0,11,0,2,109.65,0.00,0.50,0.00,0,0.00,1,349.48,0,1,3,org.apache.lucene.benchmark.byTask.feeds.DocMaker,0.17,5,1,1,0,5,0,0,0,75,3
"org.apache.lucene.benchmark.byTask.tasks.WriteLineDocTaskTest$WriteLineDocMaker",1,0.00,1.00,7,0.08,2159.80,1,0,16,4,3,113.22,0,10,0,2,113.22,0.00,0.50,0.00,0,0.00,1,250.18,0,1,3,org.apache.lucene.benchmark.byTask.feeds.DocMaker,0.17,3,1,1,0,3,0,0,0,58,3
"org.apache.lucene.analysis.icu.segmentation.BreakIteratorWrapper",6,0.25,1.17,19,0.18,4264.26,10,4,6,10,5,112.84,33,26,4,1,130.71,0.00,0.00,0.04,1,10.00,2,551.06,0,1,1,java.lang.Object,0.00,4,0,7,2,4,5,0,4,140,1
"org.apache.lucene.analysis.icu.segmentation.BreakIteratorWrapper$BIWrapper",6,0.00,1.67,30,0.31,11397.01,8,2,6,12,1,118.99,2,43,0,2,118.99,0.00,0.50,0.50,0,6.00,5,935.08,0,0,1,org.apache.lucene.analysis.icu.segmentation.BreakIteratorWrapper,0.50,6,1,10,0,6,6,0,2,211,2
"org.apache.lucene.analysis.icu.segmentation.BreakIteratorWrapper$RBBIWrapper",5,0.25,1.00,12,0.09,1065.75,6,1,6,9,1,141.43,0,22,0,2,141.43,0.00,0.50,0.80,0,0.00,1,261.29,0,0,1,org.apache.lucene.analysis.icu.segmentation.BreakIteratorWrapper,0.55,4,1,5,0,4,5,0,0,78,2
"org.apache.lucene.analysis.icu.segmentation.CharArrayIterator",14,0.15,1.36,53,0.39,7709.50,19,5,1,17,5,131.55,11,72,5,1,131.55,0.00,0.00,0.34,1,2.00,2,1169.04,0,1,0,java.lang.Object,0.00,3,0,19,0,3,13,1,2,297,1
"org.apache.lucene.analysis.icu.segmentation.CompositeBreakIterator",7,0.13,1.71,34,0.44,15603.79,12,5,2,19,4,89.83,46,49,1,1,122.05,0.00,0.00,0.31,0,1.00,3,1313.23,0,0,3,java.lang.Object,0.00,12,0,12,0,12,7,0,6,299,1
"org.apache.lucene.analysis.icu.segmentation.DefaultICUTokenizerConfig",3,0.38,2.00,35,0.64,21455.36,15,12,7,11,5,51.64,28,58,2,2,101.64,0.00,0.50,0.33,0,5.00,3,1933.99,0,3,3,org.apache.lucene.analysis.icu.segmentation.ICUTokenizerConfig,0.80,8,1,6,0,8,0,0,9,375,1
"org.apache.lucene.analysis.icu.segmentation.ICUTokenizer",10,0.15,2.30,72,0.98,39390.06,21,11,9,27,13,68.68,72,101,5,4,110.97,0.00,0.75,0.23,3,0.00,4,2952.66,2,0,8,org.apache.lucene.analysis.Tokenizer,0.50,17,3,23,0,17,10,0,22,601,2
"org.apache.lucene.analysis.icu.segmentation.ICUTokenizerConfig",2,0.00,1.00,3,0.02,147.30,2,0,1,2,3,156.53,8,4,3,1,156.30,0.00,0.00,0.00,0,2.00,1,67.31,0,2,0,java.lang.Object,0.00,0,0,2,1,0,0,0,3,23,2
"org.apache.lucene.analysis.icu.segmentation.LaoBreakIterator",14,0.09,2.00,98,1.31,62102.40,21,7,5,33,4,150.48,41,136,3,2,110.60,0.00,0.50,0.22,4,38.00,4,3942.69,1,2,1,com.ibm.icu.text.BreakIterator,0.00,19,1,28,0,19,12,0,6,834,1
"org.apache.lucene.analysis.icu.segmentation.ScriptIterator",7,0.08,1.71,48,0.49,18169.89,15,8,4,11,1,66.86,57,63,1,1,114.96,0.00,0.00,0.20,2,20.00,5,1484.93,0,0,0,java.lang.Object,0.00,4,0,12,0,4,7,0,11,322,1
"org.apache.lucene.analysis.icu.segmentation.TestCharArrayIterator",7,0.00,1.14,61,0.78,17035.89,7,0,2,24,1,160.62,9,69,0,2,110.62,0.00,0.50,0.00,0,7.00,2,2336.73,0,0,1,org.apache.lucene.util.LuceneTestCase,0.00,17,1,8,0,17,7,0,9,497,1
"org.apache.lucene.analysis.icu.segmentation.TestICUTokenizer",29,0.00,1.03,101,1.65,27254.01,29,0,9,38,6,129.78,20,157,0,3,129.78,0.00,0.67,0.00,0,29.00,2,4943.24,4,0,6,org.apache.lucene.analysis.BaseTokenStreamTestCase,0.00,9,2,30,0,9,29,0,14,1059,1
"org.apache.lucene.analysis.icu.segmentation.TestICUTokenizer$Analyzer",1,0.00,1.00,5,0.05,910.74,1,0,9,4,4,121.62,0,8,0,1,121.62,0.00,0.00,0.00,0,1.00,1,161.73,0,1,4,java.lang.Object,0.00,3,0,1,0,3,0,0,0,39,0
"org.apache.lucene.analysis.icu.segmentation.TestLaoBreakIterator",6,0.40,1.50,44,0.55,24428.42,7,1,6,22,2,110.96,3,49,0,2,110.96,0.00,0.50,0.67,1,0.00,3,1656.66,1,0,2,org.apache.lucene.util.LuceneTestCase,0.00,16,1,9,0,16,6,0,1,342,1
"org.apache.lucene.analysis.icu.segmentation.TestWithCJKBigramFilter",12,0.00,1.00,107,1.65,42078.96,12,0,10,14,8,159.40,22,140,0,3,109.40,0.00,0.67,0.00,0,12.00,1,4943.81,2,0,8,org.apache.lucene.analysis.BaseTokenStreamTestCase,0.00,2,2,12,0,2,12,0,6,985,1
"org.apache.lucene.analysis.icu.segmentation.TestWithCJKBigramFilter$Analyzer",1,0.00,1.00,5,0.07,1213.93,1,0,10,5,6,120.64,0,7,0,1,120.64,0.00,0.00,0.00,0,1.00,1,205.42,0,1,6,java.lang.Object,0.00,4,0,1,0,4,0,0,0,46,0
"org.apache.lucene.analysis.icu.segmentation.TestWithCJKBigramFilter$Analyzer_0",1,0.00,1.00,6,0.08,1526.43,1,0,10,6,7,156.79,2,8,0,1,116.90,0.00,0.00,0.00,0,1.00,1,240.99,0,1,7,java.lang.Object,0.00,5,0,1,0,5,0,0,2,53,0
"org.apache.lucene.queryparser.xml.CoreParser",8,0.06,1.38,70,0.96,33614.43,13,5,9,38,30,108.94,33,87,3,1,108.71,0.00,0.00,0.15,2,16.00,3,2880.03,0,3,27,java.lang.Object,0.00,30,0,11,1,30,5,1,5,531,1
"org.apache.lucene.queryparser.xml.CorePlusExtensionsParser",3,0.00,1.00,14,0.18,3227.64,3,0,3,11,12,76.19,32,18,3,2,124.67,0.00,0.50,0.00,0,4.00,1,531.06,0,0,9,org.apache.lucene.queryparser.xml.CoreParser,0.00,8,1,3,0,8,3,0,4,117,1
"org.apache.lucene.queryparser.xml.DOMUtils",17,0.00,2.53,105,1.33,47943.72,17,0,7,42,25,154.48,40,144,24,1,114.59,0.00,0.00,0.00,5,17.00,6,3992.58,0,13,1,java.lang.Object,0.00,25,0,43,0,25,4,0,12,855,1
"org.apache.lucene.queryparser.xml.FilterBuilder",1,0.00,1.00,2,0.01,69.06,1,0,2,1,11,171.57,19,3,9,1,145.29,0.00,0.00,0.00,0,1.00,1,36.53,0,1,2,,0.00,0,0,1,0,0,0,0,2,13,1
"org.apache.lucene.queryparser.xml.FilterBuilderFactory",3,0.00,1.33,11,0.14,3433.29,4,1,3,9,6,96.83,19,16,3,1,129.05,0.00,0.00,1.00,0,0.00,2,408.23,0,2,3,java.lang.Object,0.00,6,0,4,0,6,1,1,2,98,1
"org.apache.lucene.queryparser.xml.ParserException",4,0.00,1.00,9,0.05,332.37,4,0,0,4,37,96.55,32,14,37,2,144.65,0.00,0.50,0.00,0,4.00,1,136.79,0,0,0,java.lang.Exception,0.00,0,1,4,0,0,4,0,6,46,1
"org.apache.lucene.queryparser.xml.QueryBuilder",1,0.00,1.00,2,0.01,69.06,1,0,2,1,17,178.67,20,3,15,1,145.29,0.00,0.00,0.00,0,1.00,1,36.53,0,1,2,,0.00,0,0,1,0,0,0,0,2,13,1
"org.apache.lucene.queryparser.xml.QueryBuilderFactory",3,0.00,1.33,11,0.14,3433.29,4,1,3,9,5,96.83,19,16,2,1,129.05,0.00,0.00,1.00,0,0.00,2,408.23,0,1,3,java.lang.Object,0.00,6,0,4,0,6,2,1,2,98,1
"org.apache.lucene.queryparser.xml.QueryTemplateManager",16,0.08,1.12,71,1.06,23172.93,20,4,16,42,3,144.24,48,106,2,1,123.62,0.00,0.00,0.17,4,106.00,3,3170.19,0,9,1,java.lang.Object,0.00,26,0,18,0,26,7,0,11,650,1
"org.apache.lucene.queryparser.xml.TestParser",24,0.12,1.21,119,1.51,34241.16,28,4,24,56,19,123.66,4,148,1,2,123.66,0.00,0.50,0.14,2,122.00,4,4525.02,0,1,18,org.apache.lucene.util.LuceneTestCase,0.00,32,1,29,0,32,23,0,4,923,1
"org.apache.lucene.queryparser.xml.TestQueryTemplateManager",5,0.14,2.40,58,0.90,24252.11,12,7,18,40,14,103.16,23,85,0,2,102.93,0.00,0.50,0.26,2,6.00,3,2704.13,2,2,14,org.apache.lucene.util.LuceneTestCase,0.00,35,1,12,0,35,3,0,18,504,1
"org.apache.lucene.analysis.icu.tokenattributes.ScriptAttribute",4,0.00,1.00,5,0.02,112.74,4,0,2,4,3,141.71,23,6,2,2,159.58,0.00,0.50,0.00,0,4.00,1,69.99,0,2,1,,0.00,0,1,4,0,0,2,0,6,28,1
"org.apache.lucene.analysis.icu.tokenattributes.ScriptAttributeImpl",9,0.25,1.22,25,0.22,3365.82,10,1,3,13,4,139.46,5,42,1,2,139.46,0.00,0.50,0.78,0,0.00,3,650.85,0,2,3,org.apache.lucene.util.AttributeImpl,0.14,4,1,11,0,4,7,2,1,170,1
"org.apache.lucene.analysis.ja.tokenattributes.BaseFormAttribute",2,0.00,1.00,3,0.02,77.91,2,0,2,2,6,179.09,6,4,4,2,158.47,0.00,0.50,0.00,0,2.00,1,46.77,0,1,2,,0.00,0,1,2,0,0,1,0,1,18,1
"org.apache.lucene.analysis.ja.tokenattributes.BaseFormAttributeImpl",5,0.50,1.20,13,0.13,1839.49,6,1,3,8,4,139.52,3,22,0,2,139.52,0.00,0.50,0.60,0,2.00,2,377.20,0,1,4,org.apache.lucene.util.AttributeImpl,0.20,3,1,6,0,3,4,2,1,100,1
"org.apache.lucene.analysis.ja.tokenattributes.InflectionAttribute",3,0.00,1.00,4,0.02,95.33,3,0,2,3,5,199.06,6,5,3,2,159.17,0.00,0.50,0.00,0,3.00,1,58.38,0,2,2,,0.00,0,1,3,0,0,1,0,1,23,1
"org.apache.lucene.analysis.ja.tokenattributes.InflectionAttributeImpl",6,0.40,1.67,22,0.27,7544.57,7,1,4,12,5,128.68,3,32,0,2,128.68,0.00,0.50,0.67,2,0.00,3,820.19,0,2,5,org.apache.lucene.util.AttributeImpl,0.18,6,1,10,0,6,4,2,1,188,1
"org.apache.lucene.analysis.ja.tokenattributes.PartOfSpeechAttribute",2,0.00,1.00,3,0.02,77.91,2,0,2,2,6,208.47,3,4,4,2,158.47,0.00,0.50,0.00,0,2.00,1,46.77,0,1,2,,0.00,0,1,2,0,0,1,0,1,18,1
"org.apache.lucene.analysis.ja.tokenattributes.PartOfSpeechAttributeImpl",5,0.50,1.40,16,0.18,3730.86,6,1,4,9,5,130.50,3,25,0,2,130.50,0.00,0.50,0.60,1,2.00,2,535.70,0,1,5,org.apache.lucene.util.AttributeImpl,0.20,4,1,7,0,4,4,2,1,130,1
"org.apache.lucene.analysis.ja.tokenattributes.ReadingAttribute",3,0.00,1.00,4,0.02,95.33,3,0,2,3,6,199.06,6,5,4,2,159.17,0.00,0.50,0.00,0,3.00,1,58.38,0,2,2,,0.00,0,1,3,0,0,1,0,1,23,1
"org.apache.lucene.analysis.ja.tokenattributes.ReadingAttributeImpl",6,0.40,1.67,22,0.27,7758.41,7,1,4,11,5,128.58,3,32,0,2,128.58,0.00,0.50,0.67,2,0.00,3,816.11,0,2,5,org.apache.lucene.util.AttributeImpl,0.18,5,1,10,0,5,4,2,1,188,1
"org.apache.lucene.search.vectorhighlight.AbstractTestCase",27,0.02,1.37,129,1.52,37658.87,39,12,26,67,29,163.59,60,180,8,2,123.71,8.00,0.10,0.06,7,275.00,3,4558.42,2,14,21,org.apache.lucene.util.LuceneTestCase,0.00,40,1,37,8,40,13,0,60,969,2
"org.apache.lucene.search.vectorhighlight.AbstractTestCase$BasicNGramTokenizer",13,0.16,1.85,86,0.93,28960.27,30,17,26,27,2,115.47,0,117,0,2,115.47,0.00,0.50,0.21,3,69.00,8,2777.02,1,0,2,org.apache.lucene.search.vectorhighlight.Tokenizer,0.00,14,1,24,0,14,13,0,0,578,2
"org.apache.lucene.search.vectorhighlight.AbstractTestCase$BigramAnalyzer",1,0.00,1.00,3,0.03,443.97,1,0,26,3,1,132.36,0,6,0,2,132.36,0.00,0.50,0.00,0,1.00,1,101.70,0,0,1,org.apache.lucene.analysis.Analyzer,0.00,2,1,1,0,2,1,0,0,28,2
"org.apache.lucene.search.vectorhighlight.BaseFragmentsBuilder",20,0.06,1.65,96,1.69,71675.57,27,7,14,51,14,120.44,2,141,2,1,120.44,0.00,0.00,0.09,9,132.00,4,5080.12,0,14,12,java.lang.Object,0.00,31,0,33,2,31,6,1,2,1013,2
"org.apache.lucene.search.vectorhighlight.BaseFragmentsBuilder$StoredFieldVisitor",2,0.00,1.50,7,0.12,2217.79,2,0,14,7,4,129.13,0,11,0,1,129.13,0.00,0.00,0.00,0,2.00,2,349.35,0,0,4,java.lang.Object,0.00,5,0,3,0,5,2,0,0,78,0
"org.apache.lucene.search.vectorhighlight.BoundaryScanner",2,0.00,1.00,3,0.02,109.20,2,0,0,2,17,146.96,31,4,17,1,157.32,0.00,0.00,0.00,0,2.00,1,62.00,0,0,0,,0.00,0,0,2,0,0,2,0,4,22,1
"org.apache.lucene.search.vectorhighlight.BreakIteratorBoundaryScanner",3,0.50,1.67,13,0.16,3922.68,4,1,1,9,3,163.77,7,17,2,1,123.88,0.00,0.00,0.67,0,1.00,2,471.78,0,0,1,java.lang.Object,0.00,6,0,5,0,6,3,1,3,111,1
"org.apache.lucene.search.vectorhighlight.BreakIteratorBoundaryScannerTest",6,0.40,1.00,44,0.60,14232.77,7,1,3,16,2,112.90,0,54,0,2,112.90,0.00,0.50,0.67,2,0.00,1,1801.94,0,0,2,org.apache.lucene.util.LuceneTestCase,0.00,10,1,6,0,10,6,0,0,377,1
"org.apache.lucene.search.vectorhighlight.FastVectorHighlighter",14,0.00,1.07,47,0.68,14712.71,21,7,4,23,16,87.10,111,71,5,1,129.39,0.00,0.00,0.14,1,94.00,2,2045.32,0,6,11,java.lang.Object,0.00,9,0,15,0,9,8,0,17,456,1
"org.apache.lucene.search.vectorhighlight.FieldFragList",3,0.50,1.00,8,0.08,1521.14,4,1,4,6,10,96.18,21,11,10,1,138.47,0.00,0.00,0.67,0,1.00,1,253.81,0,1,0,java.lang.Object,0.00,3,0,3,0,3,2,0,4,66,1
"org.apache.lucene.search.vectorhighlight.FieldFragList$WeightedFragInfo",6,0.15,1.33,31,0.31,8412.17,10,4,4,13,0,120.08,0,39,0,1,120.08,0.00,0.00,0.38,0,6.00,2,918.02,0,2,0,java.lang.Object,0.00,7,0,8,0,7,4,0,0,206,2
"org.apache.lucene.search.vectorhighlight.FieldFragList$WeightedFragInfo$SubInfo",4,0.11,1.25,20,0.17,3926.00,7,3,4,8,0,121.32,3,25,0,1,121.32,0.00,0.00,0.25,0,10.00,2,505.28,0,2,0,java.lang.Object,0.00,4,0,5,0,4,2,0,3,123,2
"org.apache.lucene.search.vectorhighlight.FieldPhraseList",3,1.00,4.67,40,0.55,39821.83,4,1,5,20,12,64.40,19,54,10,1,96.63,0.00,0.00,0.33,1,4.00,10,1644.98,0,0,2,java.lang.Object,0.00,17,0,14,0,17,3,0,5,305,1
"org.apache.lucene.search.vectorhighlight.FieldPhraseList$WeightedPhraseInfo",6,0.00,2.33,55,0.71,36564.65,10,4,5,24,0,105.40,4,65,0,1,105.40,0.00,0.00,0.25,2,6.00,5,2118.45,0,1,0,java.lang.Object,0.00,18,0,14,0,18,5,0,4,429,2
"org.apache.lucene.search.vectorhighlight.FieldPhraseList$WeightedPhraseInfo$Toffs",5,0.12,1.00,16,0.13,2424.75,7,2,5,9,0,132.05,0,23,0,1,132.05,0.00,0.00,0.40,0,6.00,1,392.38,0,1,0,java.lang.Object,0.00,4,0,5,0,4,4,0,0,106,2
"org.apache.lucene.search.vectorhighlight.FieldPhraseListTest",13,0.00,1.00,119,2.03,46042.53,13,0,2,24,5,147.34,38,133,0,3,107.46,0.00,0.67,0.00,0,0.00,1,6093.97,7,0,5,org.apache.lucene.search.vectorhighlight.AbstractTestCase,0.00,11,2,13,0,11,13,0,11,1189,1
"org.apache.lucene.search.vectorhighlight.FieldQuery",15,0.07,4.00,149,2.22,118096.05,20,5,19,59,27,86.53,85,179,18,1,104.40,0.00,0.00,0.13,7,87.00,13,6666.42,0,4,9,java.lang.Object,0.00,44,0,60,0,44,11,0,19,1272,1
"org.apache.lucene.search.vectorhighlight.FieldQuery$QueryPhraseMap",13,0.03,1.85,68,0.76,26629.22,19,6,19,34,6,118.71,7,84,0,1,118.71,0.00,0.00,0.14,3,99.00,5,2274.65,0,3,6,java.lang.Object,0.00,21,0,24,0,21,10,0,7,483,2
"org.apache.lucene.search.vectorhighlight.FieldQueryTest",28,0.00,1.00,621,10.61,907474.75,28,0,19,75,12,106.02,95,665,0,3,85.40,0.00,0.67,0.00,1,0.00,1,31824.38,8,0,12,org.apache.lucene.search.vectorhighlight.AbstractTestCase,0.00,47,2,28,0,47,28,0,76,5862,1
"org.apache.lucene.search.vectorhighlight.FieldTermStack",5,0.00,2.40,43,0.55,28267.43,7,2,12,26,18,59.09,52,52,9,1,107.56,0.00,0.00,0.50,0,0.00,8,1662.19,0,1,9,java.lang.Object,0.00,21,0,12,0,21,4,0,31,302,1
"org.apache.lucene.search.vectorhighlight.FieldTermStack$TermInfo",7,0.04,1.00,24,0.22,4349.67,11,4,12,11,0,131.21,0,25,0,1,131.21,0.00,0.00,0.29,0,16.00,1,656.32,0,2,0,java.lang.Object,0.00,4,0,7,0,4,5,1,0,169,2
"org.apache.lucene.search.vectorhighlight.FieldTermStackTest",12,0.00,1.00,103,1.63,35330.16,12,0,4,22,6,160.00,13,116,0,3,110.00,0.00,0.67,0.00,2,0.00,1,4888.62,7,0,6,org.apache.lucene.search.vectorhighlight.AbstractTestCase,0.00,10,2,12,0,10,12,0,13,969,1
"org.apache.lucene.search.vectorhighlight.FragListBuilder",1,0.00,1.00,2,0.01,54.79,1,0,0,1,12,193.91,27,3,10,1,146.08,0.00,0.00,0.00,0,1.00,1,36.53,0,1,2,,0.00,0,0,1,0,0,0,0,3,13,1
"org.apache.lucene.search.vectorhighlight.FragmentsBuilder",4,0.00,1.00,5,0.12,1002.81,4,0,3,4,12,122.73,55,12,9,1,152.11,0.00,0.00,0.00,0,4.00,1,347.18,0,4,3,,0.00,0,0,4,0,0,0,0,5,86,1
"org.apache.lucene.search.vectorhighlight.IndexTimeSynonymTest",23,0.00,1.00,171,2.97,63396.60,23,0,9,44,9,112.38,16,207,0,3,112.38,0.00,0.67,0.00,5,0.00,1,8921.27,3,2,9,org.apache.lucene.search.vectorhighlight.AbstractTestCase,0.00,21,2,23,0,21,21,0,16,1739,1
"org.apache.lucene.search.vectorhighlight.IndexTimeSynonymTest$TokenArrayAnalyzer",2,1.00,1.00,7,0.06,916.46,3,1,9,4,2,132.25,0,11,0,2,132.25,0.00,0.50,0.00,0,2.00,1,185.09,0,0,2,org.apache.lucene.analysis.Analyzer,0.00,2,1,2,0,2,2,0,0,49,3
"org.apache.lucene.search.vectorhighlight.IndexTimeSynonymTest$TokenArrayAnalyzer$Tokenizer",2,0.00,1.50,11,0.12,2124.04,4,2,9,3,2,121.00,0,15,0,1,121.00,0.00,0.00,0.50,0,2.00,2,359.17,1,0,2,java.lang.Object,0.00,1,0,3,0,1,2,0,0,83,0
"org.apache.lucene.search.vectorhighlight.ScoreOrderFragmentsBuilder",5,0.00,1.00,13,0.11,1749.50,5,0,4,7,5,160.35,15,20,3,2,139.74,0.00,0.50,0.00,0,5.00,1,338.42,0,1,2,org.apache.lucene.search.vectorhighlight.BaseFragmentsBuilder,0.00,2,1,5,0,2,4,0,4,94,1
"org.apache.lucene.search.vectorhighlight.ScoreOrderFragmentsBuilder$ScoreComparator",1,0.00,5.00,5,0.11,4822.85,1,0,4,1,0,165.55,1,11,0,1,115.55,0.00,0.00,0.00,0,1.00,5,318.47,0,0,0,java.lang.Object,0.00,0,0,5,0,0,1,1,1,76,2
"org.apache.lucene.search.vectorhighlight.ScoreOrderFragmentsBuilderTest",2,0.00,1.00,18,0.29,6418.81,2,0,5,14,12,107.79,1,21,0,3,107.79,0.00,0.67,0.00,0,0.00,1,858.65,1,1,12,org.apache.lucene.search.vectorhighlight.AbstractTestCase,0.00,12,2,2,0,12,1,0,1,168,1
"org.apache.lucene.search.vectorhighlight.SimpleBoundaryScanner",7,0.04,2.00,40,0.43,17684.85,11,4,3,13,4,167.97,8,45,3,1,117.97,0.00,0.00,0.29,0,20.00,5,1293.69,0,0,1,java.lang.Object,0.00,6,0,14,0,6,7,1,8,286,1
"org.apache.lucene.search.vectorhighlight.SimpleBoundaryScannerTest",2,0.00,1.00,25,0.33,11338.70,3,1,1,9,2,151.19,2,29,0,2,101.19,0.00,0.50,1.00,0,0.00,1,999.88,0,0,2,org.apache.lucene.util.LuceneTestCase,0.00,7,1,2,0,7,2,0,2,207,1
"org.apache.lucene.search.vectorhighlight.SimpleFragListBuilder",3,0.12,5.33,41,0.59,47103.29,7,4,4,15,8,146.02,4,58,5,1,96.02,0.00,0.00,0.33,0,6.00,13,1770.75,0,1,3,java.lang.Object,0.00,12,0,16,0,12,2,1,2,323,1
"org.apache.lucene.search.vectorhighlight.SimpleFragListBuilderTest",14,0.00,1.14,120,2.29,56866.15,14,0,2,33,11,108.86,1,138,0,3,108.86,0.00,0.67,0.00,1,0.00,2,6880.59,6,1,11,org.apache.lucene.search.vectorhighlight.AbstractTestCase,0.00,19,2,16,0,19,13,0,1,1338,1
"org.apache.lucene.search.vectorhighlight.SimpleFragmentsBuilder",5,0.00,1.00,11,0.08,1101.25,5,0,2,5,4,161.94,16,18,2,2,141.32,0.00,0.50,0.00,0,5.00,1,248.27,0,1,2,org.apache.lucene.search.vectorhighlight.BaseFragmentsBuilder,0.00,0,1,5,0,0,4,0,4,75,1
"org.apache.lucene.search.vectorhighlight.SimpleFragmentsBuilderTest",12,0.00,1.08,106,1.62,33049.14,12,0,14,43,20,110.21,4,121,0,3,110.21,0.00,0.67,0.00,1,0.00,2,4861.83,7,1,20,org.apache.lucene.search.vectorhighlight.AbstractTestCase,0.00,31,2,13,0,31,11,0,4,945,1
"org.apache.lucene.search.vectorhighlight.SingleFragListBuilder",1,0.00,5.00,13,0.19,7359.31,1,0,5,9,5,48.63,9,18,2,1,98.63,0.00,0.00,0.00,0,1.00,5,558.35,0,1,3,java.lang.Object,0.00,8,0,5,0,8,0,1,1,108,1
"org.apache.lucene.search.vectorhighlight.SingleFragListBuilderTest",4,0.00,1.00,20,0.35,5535.81,4,0,3,16,9,120.43,16,25,0,3,120.19,0.00,0.67,0.00,1,0.00,1,1051.57,1,1,9,org.apache.lucene.search.vectorhighlight.AbstractTestCase,0.00,12,2,4,0,12,3,0,1,218,1
"org.apache.solr.update.processor.BufferingRequestProcessor",6,0.10,1.00,16,0.21,4102.69,10,4,7,8,10,137.45,1,30,5,2,137.45,0.00,0.50,0.17,0,22.00,1,637.32,0,0,5,org.apache.solr.update.processor.UpdateRequestProcessor,0.15,2,1,6,0,2,6,0,1,158,1
"org.apache.solr.update.processor.ConcatFieldUpdateProcessorFactory",3,1.00,1.33,11,0.13,2138.83,4,1,11,8,13,86.54,33,22,0,3,130.67,0.00,0.67,0.33,0,4.00,2,399.17,1,2,13,org.apache.solr.update.processor.FieldMutatingUpdateProcessorFactory,0.00,5,2,4,0,5,1,0,1,95,2
"org.apache.solr.update.processor.ConcatFieldUpdateProcessorFactory$FieldMutatingUpdateProcessor",1,0.00,2.00,6,0.08,2302.52,1,0,11,8,1,115.34,0,8,0,1,115.34,0.00,0.00,0.00,0,0.00,2,251.93,0,1,1,java.lang.Object,0.00,7,0,2,0,7,0,0,0,58,0
"org.apache.solr.update.processor.ConcatFieldUpdateProcessorFactory$FieldMutatingUpdateProcessor.FieldNameSelector",1,0.00,4.00,9,0.12,3948.45,1,0,11,6,4,127.38,3,12,0,1,106.76,0.00,0.00,0.00,0,1.00,4,368.81,0,0,4,java.lang.Object,0.00,5,0,4,0,5,1,0,3,78,0
"org.apache.solr.update.processor.CustomUpdateRequestProcessorFactory",2,1.00,1.00,6,0.06,689.28,3,1,5,2,6,173.11,4,13,1,2,133.22,0.00,0.50,0.00,0,2.00,1,170.60,0,1,5,org.apache.solr.update.processor.UpdateRequestProcessorFactory,0.00,0,1,2,0,0,1,0,2,46,1
"org.apache.solr.update.processor.DetectedLanguage",3,0.25,1.00,10,0.06,553.64,5,2,0,3,4,85.36,27,14,4,1,135.36,0.00,0.00,0.33,0,5.00,1,171.47,0,2,0,java.lang.Object,0.00,0,0,3,0,0,1,0,4,51,1
"org.apache.solr.update.processor.DistributedUpdateProcessor",18,0.15,5.83,396,6.77,425497.98,44,26,44,142,37,43.79,138,520,6,2,86.08,0.00,0.50,0.18,8,22.00,19,20300.39,3,4,32,org.apache.solr.update.processor.UpdateRequestProcessor,0.08,124,1,105,0,124,14,0,134,3230,1
"org.apache.solr.update.processor.DistributedUpdateProcessor$RetryNode",5,0.00,2.80,34,0.40,14133.49,8,3,44,13,2,114.56,0,48,0,2,114.56,0.00,0.50,0.33,0,7.00,7,1194.08,2,1,2,org.apache.solr.update.SolrCmdDistributor.StdNode,0.00,8,1,14,0,8,4,0,0,264,2
"org.apache.solr.update.processor.DistributedUpdateProcessorFactory",2,0.00,1.00,4,0.05,586.21,2,0,3,3,10,140.34,0,11,4,2,140.34,0.00,0.50,0.00,0,2.00,1,135.21,0,1,6,org.apache.solr.update.processor.UpdateRequestProcessorFactory,0.00,1,1,2,0,1,1,0,0,38,1
"org.apache.solr.update.processor.FieldLengthUpdateProcessorFactory",3,0.00,1.00,7,0.08,953.34,3,0,4,4,8,91.96,24,18,0,3,140.07,0.00,0.67,0.00,0,3.00,1,227.04,1,2,8,org.apache.solr.update.processor.FieldMutatingUpdateProcessorFactory,0.00,1,2,3,0,1,1,0,2,61,2
"org.apache.solr.update.processor.FieldLengthUpdateProcessorFactory$FieldValueMutatingUpdateProcessor",1,0.00,2.00,5,0.04,1090.48,1,0,4,3,0,120.85,0,7,0,1,120.85,0.00,0.00,0.00,0,1.00,2,134.09,0,1,0,java.lang.Object,0.00,2,0,2,0,2,0,0,0,36,0
"org.apache.solr.update.processor.FieldMutatingUpdateProcessor",5,0.38,3.20,51,0.76,43059.15,7,2,22,26,20,58.31,55,89,10,2,102.44,1.00,0.33,0.20,0,8.00,6,2292.94,1,3,10,org.apache.solr.update.processor.UpdateRequestProcessor,0.00,21,1,16,1,21,2,0,12,431,2
"org.apache.solr.update.processor.FieldMutatingUpdateProcessor$ConfigurableFieldNameSelector",4,0.07,3.25,34,0.43,11972.64,9,5,22,12,2,130.28,12,50,0,1,109.67,0.00,0.00,0.25,0,6.00,6,1282.04,0,0,2,java.lang.Object,0.00,8,0,13,0,8,4,1,6,274,3
"org.apache.solr.update.processor.FieldMutatingUpdateProcessor$FieldNameSelector",1,0.00,1.00,2,0.01,71.22,1,0,22,1,0,145.18,0,3,0,1,145.18,0.00,0.00,0.00,0,1.00,1,35.61,0,0,0,,0.00,0,0,1,0,0,1,0,0,13,2
"org.apache.solr.update.processor.FieldMutatingUpdateProcessor$FieldNameSelector_0",1,0.00,1.00,3,0.02,126.16,1,0,22,1,0,136.66,0,4,0,1,136.66,0.00,0.00,0.00,0,1.00,1,46.05,0,0,0,java.lang.Object,0.00,0,0,1,0,0,1,0,0,15,0
"org.apache.solr.update.processor.FieldMutatingUpdateProcessor$FieldNameSelector_1",1,0.00,1.00,3,0.02,126.16,1,0,22,1,0,136.66,0,4,0,1,136.66,0.00,0.00,0.00,0,1.00,1,46.05,0,0,0,java.lang.Object,0.00,0,0,1,0,0,1,0,0,15,0
"org.apache.solr.update.processor.FieldMutatingUpdateProcessor$FieldNameSelector_2",1,0.00,1.00,3,0.02,343.56,1,0,22,2,0,133.23,0,4,0,1,133.23,0.00,0.00,0.00,0,1.00,1,67.21,0,0,0,java.lang.Object,0.00,1,0,1,0,1,1,0,0,20,0
"org.apache.solr.update.processor.FieldMutatingUpdateProcessor$FieldNameSelector_3",1,0.00,1.00,3,0.03,685.94,1,0,22,3,0,130.87,0,5,0,1,130.87,0.00,0.00,0.00,0,1.00,1,97.86,0,0,0,java.lang.Object,0.00,2,0,1,0,2,1,0,0,27,0
"org.apache.solr.update.processor.FieldMutatingUpdateProcessorFactory",6,0.07,3.67,67,1.09,63586.10,9,3,20,27,18,80.02,89,116,7,2,100.16,11.00,0.08,0.28,2,10.00,7,3260.56,0,4,11,org.apache.solr.update.processor.UpdateRequestProcessorFactory,0.00,21,1,22,11,21,2,1,8,607,2
"org.apache.solr.update.processor.FieldMutatingUpdateProcessorFactory$SelectorParams",0,0.00,0.00,5,0.09,2481.74,4,4,20,2,0,171.00,0,6,0,1,171.00,0.00,0.00,0.00,0,0.00,0,257.84,0,0,0,java.lang.Object,0.00,2,0,0,0,2,0,0,0,57,2
"org.apache.solr.update.processor.FieldMutatingUpdateProcessorTest",26,0.00,1.19,245,4.68,168881.95,26,0,23,59,13,155.34,30,469,0,3,105.34,0.00,0.67,0.00,4,50.00,2,14031.96,7,4,13,org.apache.solr.SolrTestCaseJ4,0.00,33,2,31,0,33,22,0,16,2637,1
"org.apache.solr.update.processor.FieldValueMutatingUpdateProcessor",3,1.00,2.33,20,0.26,12004.72,4,1,3,12,8,81.19,18,29,5,3,113.41,0.00,0.67,0.33,1,4.00,5,790.35,0,2,3,org.apache.solr.update.processor.FieldMutatingUpdateProcessor,0.00,9,2,7,0,9,1,0,3,164,2
"org.apache.solr.update.processor.FieldValueMutatingUpdateProcessor$Object",1,0.00,1.00,3,0.01,72.00,1,0,3,1,0,138.58,0,4,0,1,138.58,0.00,0.00,0.00,0,1.00,1,32.00,0,1,0,java.lang.Object,0.00,0,0,1,0,0,0,0,0,12,0
"org.apache.solr.update.processor.FieldValueSubsetUpdateProcessorFactory",2,0.00,1.00,4,0.04,548.99,2,0,5,3,11,122.70,10,9,4,3,140.57,2.00,0.29,0.00,0,2.00,1,132.58,0,1,7,org.apache.solr.update.processor.FieldMutatingUpdateProcessorFactory,0.00,1,2,2,4,1,1,0,2,38,2
"org.apache.solr.update.processor.FieldValueSubsetUpdateProcessorFactory$FieldMutatingUpdateProcessor",1,0.00,2.00,6,0.08,2274.70,1,0,5,8,1,115.38,0,8,0,1,115.38,0.00,0.00,0.00,0,1.00,2,232.15,0,1,1,java.lang.Object,0.00,7,0,2,0,7,0,0,0,55,0
"org.apache.solr.update.processor.FirstFieldValueUpdateProcessorFactory",2,0.00,1.00,5,0.07,1196.83,2,0,4,5,3,100.34,24,11,0,4,137.90,0.00,0.75,0.00,0,2.00,1,210.90,0,2,3,org.apache.solr.update.processor.FieldValueSubsetUpdateProcessorFactory,0.00,3,3,2,0,3,0,0,2,54,2
"org.apache.solr.update.processor.HTMLStripFieldUpdateProcessorFactory",2,0.00,1.00,5,0.05,639.24,2,0,10,3,8,91.94,17,13,0,3,140.05,0.00,0.67,0.00,0,2.00,1,150.89,0,1,8,org.apache.solr.update.processor.FieldMutatingUpdateProcessorFactory,0.00,1,2,2,0,1,1,0,1,41,2
"org.apache.solr.update.processor.HTMLStripFieldUpdateProcessorFactory$FieldValueMutatingUpdateProcessor",1,0.00,3.00,13,0.16,5744.58,1,0,10,10,1,149.59,1,19,0,1,99.59,0.00,0.00,0.00,0,1.00,3,469.47,0,1,1,java.lang.Object,0.00,9,0,3,0,9,0,0,1,95,0
"org.apache.solr.update.processor.LangDetectLanguageIdentifierUpdateProcessor",2,0.00,2.50,18,0.25,9664.82,2,0,9,12,7,126.80,7,26,2,3,106.18,0.00,0.67,0.00,0,2.00,4,737.48,0,1,5,org.apache.solr.update.processor.LanguageIdentifierUpdateProcessor,0.00,10,2,5,0,10,1,0,2,141,1
"org.apache.solr.update.processor.LangDetectLanguageIdentifierUpdateProcessorFactory",4,0.20,3.00,42,0.68,26315.62,9,5,17,20,11,71.16,25,65,0,2,103.38,0.00,0.50,0.35,1,6.00,6,2039.38,0,0,11,org.apache.solr.update.processor.UpdateRequestProcessorFactory,0.00,16,1,12,0,16,4,2,5,370,1
"org.apache.solr.update.processor.LangDetectLanguageIdentifierUpdateProcessorFactoryTest",3,0.00,1.00,25,0.41,10618.13,3,0,3,9,5,159.37,4,32,0,4,109.37,0.00,0.75,0.00,0,5.00,1,1241.89,1,2,5,org.apache.solr.update.processor.LanguageIdentifierUpdateProcessorFactoryTestCase,0.10,6,3,3,0,6,1,0,2,223,1
"org.apache.solr.update.processor.LangIdParams",0,0.00,0.00,27,0.39,6399.79,26,26,0,0,3,171.00,36,28,3,1,171.00,0.00,0.00,0.00,0,0.00,0,1175.47,0,0,0,,0.00,0,0,0,0,0,0,0,21,199,1
"org.apache.solr.update.processor.LanguageIdentifierUpdateProcessor",12,0.13,3.92,196,3.13,193915.49,37,25,18,61,16,74.76,63,242,5,2,92.63,2.00,0.25,0.16,9,14.00,13,9392.45,1,7,11,org.apache.solr.update.processor.UpdateRequestProcessor,0.00,49,1,47,2,49,5,1,18,1571,2
"org.apache.solr.update.processor.LanguageIdentifierUpdateProcessorFactoryTestCase",13,0.02,1.15,133,1.92,53617.16,18,5,12,33,12,105.19,8,154,2,3,105.19,1.00,0.40,0.22,2,17.00,2,5751.05,5,4,10,org.apache.solr.SolrTestCaseJ4,0.04,20,2,15,2,20,9,0,8,1068,2
"org.apache.solr.update.processor.LastFieldValueUpdateProcessorFactory",2,0.00,2.50,15,0.17,7788.67,2,0,6,6,3,81.61,26,20,0,4,110.99,0.00,0.75,0.00,0,2.00,4,513.70,0,2,3,org.apache.solr.update.processor.FieldValueSubsetUpdateProcessorFactory,0.00,4,3,5,0,4,0,0,4,109,2
"org.apache.solr.update.processor.LogUpdateProcessor",7,0.42,4.71,89,1.36,55389.76,17,10,15,45,12,149.69,13,104,1,2,99.69,0.00,0.50,0.46,0,0.00,9,4092.35,0,0,12,org.apache.solr.update.processor.UpdateRequestProcessor,0.14,38,1,33,0,38,7,0,11,747,0
"org.apache.solr.update.processor.LogUpdateProcessorFactory",2,1.00,2.00,8,0.12,2363.34,3,1,15,6,15,124.42,9,14,3,2,124.19,0.00,0.50,0.50,0,2.00,2,345.81,0,0,13,org.apache.solr.update.processor.UpdateRequestProcessorFactory,0.00,4,1,4,0,4,2,0,1,80,1
"org.apache.solr.update.processor.Lookup3Signature",3,0.50,1.00,7,0.15,3993.73,4,1,1,5,2,135.17,0,13,0,2,135.17,0.00,0.50,0.67,0,1.00,1,454.49,0,0,2,org.apache.solr.update.processor.Signature,0.33,2,1,3,0,2,3,0,0,110,1
"org.apache.solr.update.processor.MD5Signature",3,0.33,1.33,15,0.17,3738.84,6,3,5,12,2,120.48,1,24,1,2,120.48,1.00,0.33,0.56,0,0.00,2,496.30,0,0,1,org.apache.solr.update.processor.Signature,0.33,9,1,4,1,9,3,0,1,114,1
"org.apache.solr.update.processor.MD5Signature$ThreadLocal<MessageDigest>",1,0.00,2.00,5,0.05,948.63,1,0,5,3,0,121.32,0,9,0,1,121.32,0.00,0.00,0.00,0,0.00,2,138.59,0,1,0,java.lang.Object,0.00,2,0,2,0,2,0,0,0,35,0
"org.apache.solr.update.processor.MaxFieldValueUpdateProcessorFactory",2,0.00,1.50,9,0.12,3394.81,2,0,6,6,4,85.45,25,21,0,4,123.01,0.00,0.75,0.00,0,2.00,2,362.02,0,2,4,org.apache.solr.update.processor.FieldValueSubsetUpdateProcessorFactory,0.00,4,3,3,0,4,0,0,1,81,2
"org.apache.solr.update.processor.MinFieldValueUpdateProcessorFactory",2,0.00,1.50,9,0.12,3394.81,2,0,6,6,4,85.45,25,21,0,4,123.01,0.00,0.75,0.00,0,2.00,2,362.02,0,2,4,org.apache.solr.update.processor.FieldValueSubsetUpdateProcessorFactory,0.00,4,3,3,0,4,0,0,1,81,2
"org.apache.solr.update.processor.RegexReplaceProcessorFactory",3,0.10,2.00,22,0.32,9850.13,8,5,11,10,9,61.63,28,39,0,3,111.63,0.00,0.67,0.27,0,4.00,4,961.79,1,2,9,org.apache.solr.update.processor.FieldMutatingUpdateProcessorFactory,0.00,7,2,6,0,7,1,0,2,194,2
"org.apache.solr.update.processor.RegexReplaceProcessorFactory$FieldValueMutatingUpdateProcessor",1,0.00,2.00,6,0.06,1348.72,1,0,11,2,0,117.17,0,8,0,1,117.17,0.00,0.00,0.00,0,0.00,2,166.77,0,1,0,java.lang.Object,0.00,1,0,2,0,1,0,0,0,42,0
"org.apache.solr.update.processor.RemoveBlankFieldUpdateProcessorFactory",2,0.00,1.00,5,0.05,591.68,2,0,3,3,6,96.18,23,13,0,3,140.31,0.00,0.67,0.00,0,2.00,1,156.72,1,1,6,org.apache.solr.update.processor.FieldMutatingUpdateProcessorFactory,0.00,1,2,2,0,1,1,0,2,43,2
"org.apache.solr.update.processor.RemoveBlankFieldUpdateProcessorFactory$FieldValueMutatingUpdateProcessor",1,0.00,2.00,5,0.05,1206.64,1,0,3,2,0,120.50,0,8,0,1,120.50,0.00,0.00,0.00,0,1.00,2,143.19,0,1,0,java.lang.Object,0.00,1,0,2,0,1,0,0,0,37,0
"org.apache.solr.update.processor.RunUpdateProcessor",7,0.22,1.29,34,0.34,6042.89,10,3,4,18,10,125.36,3,54,1,2,125.36,0.00,0.50,0.52,0,0.00,2,1012.02,6,0,9,org.apache.solr.update.processor.UpdateRequestProcessor,0.14,11,1,9,0,11,7,0,1,240,0
"org.apache.solr.update.processor.RunUpdateProcessorFactory",1,0.00,1.00,3,0.03,455.69,1,0,4,2,9,114.39,5,8,4,2,132.27,0.00,0.50,0.00,0,1.00,1,99.51,0,1,5,org.apache.solr.update.processor.UpdateRequestProcessorFactory,0.00,1,1,1,0,1,0,0,1,27,1
"org.apache.solr.update.processor.Signature",3,0.00,1.00,4,0.02,149.83,3,0,1,3,4,157.62,0,6,3,1,157.62,0.00,0.00,0.00,0,3.00,1,74.91,0,0,1,java.lang.Object,0.00,0,0,3,3,0,3,0,0,27,2
"org.apache.solr.update.processor.SignatureUpdateProcessorFactory",9,0.00,1.56,42,0.49,13147.23,16,7,19,20,17,123.52,1,68,2,2,123.52,0.00,0.50,0.14,2,35.00,4,1464.52,0,4,15,org.apache.solr.update.processor.UpdateRequestProcessorFactory,0.00,11,1,14,0,11,5,1,1,308,1
"org.apache.solr.update.processor.SignatureUpdateProcessorFactory$SignatureUpdateProcessor",2,1.00,6.50,43,0.68,51232.07,3,1,19,19,10,86.53,0,54,0,2,86.53,0.00,0.50,0.50,0,2.00,12,2041.49,0,0,10,org.apache.solr.update.processor.UpdateRequestProcessor,0.00,17,1,13,0,17,2,0,0,331,0
"org.apache.solr.update.processor.SignatureUpdateProcessorFactoryTest",8,0.71,1.88,115,1.40,53544.18,9,1,18,42,14,147.98,8,129,0,3,97.98,0.00,0.67,0.38,2,8.00,7,4211.08,7,0,14,org.apache.solr.SolrTestCaseJ4,0.04,34,2,15,0,34,8,0,4,780,1
"org.apache.solr.update.processor.SignatureUpdateProcessorFactoryTest$SolrQueryRequestBase",0,0.00,0.00,1,0.01,69.74,0,0,18,0,0,171.00,0,2,0,1,171.00,0.00,0.00,0.00,0,0.00,0,34.87,0,0,0,java.lang.Object,0.00,0,0,0,0,0,0,0,0,11,0
"org.apache.solr.update.processor.SignatureUpdateProcessorFactoryTest$Thread",1,0.00,3.00,9,0.09,2429.11,1,0,18,5,0,148.38,2,12,0,1,108.49,0.00,0.00,0.00,0,1.00,3,260.22,0,0,0,java.lang.Object,0.00,4,0,3,0,4,1,0,2,54,0
"org.apache.solr.update.processor.SignatureUpdateProcessorFactoryTest$Thread_0",1,0.00,3.00,10,0.10,2773.29,1,0,18,6,0,126.95,3,13,0,1,106.33,0.00,0.00,0.00,0,1.00,3,287.81,0,0,0,java.lang.Object,0.00,5,0,3,0,5,1,0,3,59,0
"org.apache.solr.update.processor.TextProfileSignature",3,0.25,6.00,59,0.92,81645.88,5,2,6,27,2,37.97,28,80,0,3,87.96,0.00,0.67,0.67,0,1.00,16,2763.95,2,0,2,org.apache.solr.update.processor.MD5Signature,0.33,24,2,18,0,24,3,0,7,474,1
"org.apache.solr.update.processor.TextProfileSignature$Token",2,0.00,1.00,8,0.06,776.67,4,2,6,2,0,128.15,0,12,0,1,128.15,0.00,0.00,0.50,0,2.00,1,179.10,0,1,0,java.lang.Object,0.00,0,0,2,0,0,1,0,0,50,2
"org.apache.solr.update.processor.TextProfileSignature$TokenComparator",1,0.00,1.00,3,0.03,504.81,1,0,6,1,0,131.92,0,5,0,1,131.92,0.00,0.00,0.00,0,1.00,1,99.83,0,0,0,java.lang.Object,0.00,0,0,1,0,0,1,1,0,28,2
"org.apache.solr.update.processor.TikaLanguageIdentifierUpdateProcessor",2,0.00,2.00,16,0.29,14184.64,2,0,5,15,7,88.96,10,22,2,3,106.83,0.00,0.67,0.00,0,2.00,3,878.55,0,1,5,org.apache.solr.update.processor.LanguageIdentifierUpdateProcessor,0.00,13,2,4,0,13,1,0,3,162,1
"org.apache.solr.update.processor.TikaLanguageIdentifierUpdateProcessorFactory",3,0.50,2.67,23,0.28,11582.21,6,3,7,7,11,68.72,23,37,0,2,111.01,0.00,0.50,0.67,0,1.00,5,844.63,0,0,11,org.apache.solr.update.processor.UpdateRequestProcessorFactory,0.00,4,1,8,0,4,3,2,3,182,1
"org.apache.solr.update.processor.TikaLanguageIdentifierUpdateProcessorFactoryTest",1,0.00,1.00,3,0.04,720.56,1,0,1,3,4,130.70,0,6,0,4,130.70,0.00,0.75,0.00,0,0.00,1,127.88,0,1,4,org.apache.solr.update.processor.LanguageIdentifierUpdateProcessorFactoryTestCase,0.00,2,3,1,0,2,0,0,0,32,1
"org.apache.solr.update.processor.TrimFieldUpdateProcessorFactory",2,0.00,1.00,5,0.05,591.68,2,0,3,3,6,91.83,21,13,0,3,140.31,0.00,0.67,0.00,0,2.00,1,156.72,1,1,6,org.apache.solr.update.processor.FieldMutatingUpdateProcessorFactory,0.00,1,2,2,0,1,1,0,2,43,2
"org.apache.solr.update.processor.TrimFieldUpdateProcessorFactory$FieldValueMutatingUpdateProcessor",1,0.00,2.00,5,0.04,961.87,1,0,3,3,0,121.28,0,7,0,1,121.28,0.00,0.00,0.00,0,1.00,2,131.39,0,1,0,java.lang.Object,0.00,2,0,2,0,2,0,0,0,36,0
"org.apache.solr.update.processor.URLClassifyProcessor",13,0.03,2.15,97,1.42,40287.95,35,22,12,41,8,151.69,38,144,2,2,111.81,0.00,0.50,0.07,6,46.00,9,4269.26,1,4,6,org.apache.solr.update.processor.UpdateRequestProcessor,0.00,28,1,28,0,28,9,0,9,810,1
"org.apache.solr.update.processor.URLClassifyProcessorFactory",2,1.00,1.50,7,0.08,1228.67,3,1,4,4,8,181.15,3,15,1,2,131.15,0.00,0.50,0.50,0,2.00,2,234.80,0,1,7,org.apache.solr.update.processor.UpdateRequestProcessorFactory,0.00,2,1,3,0,2,1,0,1,59,1
"org.apache.solr.update.processor.URLClassifyProcessorTest",8,0.00,1.00,46,0.76,20949.74,9,1,10,24,5,118.01,0,64,0,3,118.01,0.00,0.67,1.00,0,0.00,1,2278.25,0,0,5,org.apache.solr.SolrTestCaseJ4,0.00,16,2,8,0,16,8,0,0,500,1
"org.apache.solr.update.processor.UniqFieldsUpdateProcessorFactory",2,0.00,2.00,14,0.18,4805.64,3,1,11,7,8,64.59,16,21,1,2,112.69,0.00,0.50,1.00,0,0.00,3,530.27,0,0,7,org.apache.solr.update.processor.UpdateRequestProcessorFactory,0.00,5,1,4,0,5,2,0,1,113,1
"org.apache.solr.update.processor.UniqFieldsUpdateProcessorFactory$UniqFieldsUpdateProcessor",2,1.00,4.00,22,0.26,10603.64,3,1,11,10,3,102.51,0,30,0,2,102.51,0.00,0.50,0.50,0,2.00,7,770.56,1,0,3,org.apache.solr.update.processor.UpdateRequestProcessor,0.00,8,1,8,0,8,2,0,0,152,1
"org.apache.solr.update.processor.UniqFieldsUpdateProcessorFactoryTest",4,0.00,1.00,37,0.60,16361.96,4,0,17,20,13,106.96,3,72,0,3,106.96,0.00,0.67,0.00,1,6.00,1,1812.00,8,0,13,org.apache.solr.SolrTestCaseJ4,0.04,16,2,4,0,16,4,0,1,333,1
"org.apache.solr.update.processor.UniqFieldsUpdateProcessorFactoryTest$SolrQueryRequestBase",0,0.00,0.00,1,0.01,69.74,0,0,17,0,0,171.00,0,2,0,1,171.00,0.00,0.00,0.00,0,0.00,0,34.87,0,0,0,java.lang.Object,0.00,0,0,0,0,0,0,0,0,11,0
"org.apache.solr.update.processor.UpdateRequestProcessor",7,0.17,1.86,16,0.18,2996.09,8,1,8,13,67,178.79,15,26,62,1,138.91,0.00,0.00,0.86,0,0.00,2,526.50,0,0,5,java.lang.Object,0.00,6,0,13,15,6,7,0,2,140,2
"org.apache.solr.update.processor.UpdateRequestProcessorChain",5,0.12,1.60,25,0.26,8122.91,7,2,6,12,18,140.15,19,32,12,1,119.53,0.00,0.00,0.40,0,2.00,3,793.13,0,0,7,java.lang.Object,0.00,7,0,8,0,7,5,1,1,177,2
"org.apache.solr.update.processor.UpdateRequestProcessorFactory",2,0.00,1.00,3,0.03,173.49,2,0,6,2,18,155.97,9,7,12,1,155.74,0.00,0.00,0.00,0,2.00,1,80.82,0,1,7,java.lang.Object,0.00,0,0,2,23,0,1,1,2,26,2
"org.apache.solr.update.processor.UpdateRequestProcessorFactoryTest",3,0.00,1.00,16,0.21,4189.53,3,0,3,8,5,160.05,6,17,0,3,120.16,0.00,0.67,0.00,0,4.00,1,619.96,0,2,5,org.apache.solr.util.AbstractSolrTestCase,0.17,5,2,3,0,5,1,0,4,130,1
"org.apache.lucene.benchmark.byTask.Benchmark",6,0.07,2.17,47,0.57,26485.53,9,3,5,28,8,78.37,38,65,5,1,110.60,0.00,0.00,0.39,1,2.00,5,1719.06,0,2,3,java.lang.Object,0.00,22,0,13,0,22,4,0,11,340,1
"org.apache.lucene.benchmark.byTask.PerfRunData",30,0.03,1.63,148,1.56,43565.63,47,17,27,71,85,123.76,122,201,68,1,123.53,0.00,0.00,0.09,4,582.00,4,4688.30,0,16,21,java.lang.Object,0.00,41,0,49,0,41,14,1,45,980,1
"org.apache.lucene.benchmark.byTask.TestPerfTasksLogic",32,0.00,1.53,311,6.10,178202.29,32,0,43,113,36,106.05,158,756,0,3,105.81,0.00,0.67,0.00,7,32.00,8,18288.42,4,5,36,org.apache.lucene.benchmark.BenchmarkTestCase,0.00,81,2,49,0,81,27,0,119,3203,1
"org.apache.lucene.benchmark.byTask.TestPerfTasksLogic$MyMergePolicy",1,0.00,1.00,4,0.02,179.59,2,1,43,1,1,130.79,0,6,0,4,130.79,0.00,0.75,1.00,0,0.00,1,63.86,0,0,1,org.apache.lucene.index.LogDocMergePolicy,0.00,0,3,1,0,0,1,0,0,20,2
"org.apache.lucene.benchmark.byTask.TestPerfTasksLogic$MyMergeScheduler",1,0.00,1.00,5,0.02,206.76,2,1,43,1,1,126.69,0,7,0,3,126.69,0.00,0.67,1.00,0,0.00,1,74.73,0,0,1,org.apache.lucene.index.SerialMergeScheduler,0.00,0,2,1,0,0,1,0,0,23,2
"org.apache.lucene.benchmark.byTask.TestPerfTasksParse",3,0.17,5.33,63,1.11,52556.78,6,3,18,34,13,127.76,6,79,0,2,87.88,0.00,0.50,0.22,0,1.00,8,3344.62,0,0,13,org.apache.lucene.util.LuceneTestCase,0.00,31,1,16,0,31,3,0,6,572,1
"org.apache.lucene.benchmark.byTask.TestPerfTasksParse$FileFilter",1,0.00,1.00,3,0.03,388.04,1,0,18,4,0,132.82,0,2,0,1,132.82,0.00,0.00,0.00,0,1.00,1,93.95,0,0,0,java.lang.Object,0.00,3,0,1,0,3,1,0,0,26,0
"org.apache.lucene.benchmark.byTask.TestPerfTasksParse$MockContentSource",2,0.00,1.00,4,0.03,277.32,2,0,18,2,3,142.90,0,7,0,3,142.90,0.00,0.67,0.00,0,2.00,1,84.28,0,1,3,org.apache.lucene.benchmark.byTask.feeds.ContentSource,0.19,0,2,2,0,0,1,0,0,27,2
"org.apache.lucene.benchmark.byTask.TestPerfTasksParse$MockQueryMaker",1,0.00,1.00,3,0.02,300.08,1,0,18,1,2,133.69,0,5,0,2,133.69,0.00,0.50,0.00,0,1.00,1,69.84,0,1,2,org.apache.lucene.benchmark.byTask.feeds.AbstractQueryMaker,0.25,0,1,1,0,0,0,0,0,21,2
"org.apache.solr.handler.clustering.carrot.Bindable",1,1.00,5.00,19,0.35,12025.29,4,3,14,13,0,91.04,4,35,0,2,90.80,0.00,0.50,0.67,0,0.00,5,1036.84,0,0,0,org.carrot2.core.ProcessingComponentBase,0.00,12,1,5,0,12,1,1,1,194,1
"org.apache.solr.handler.clustering.carrot.Bindable$ILexicalData",2,0.00,2.50,11,0.09,1783.25,2,0,22,5,0,161.37,4,16,0,1,121.48,0.00,0.00,0.00,0,2.00,4,272.65,0,0,0,java.lang.Object,0.00,3,0,5,0,3,2,0,4,65,0
"org.apache.solr.handler.clustering.carrot.CarrotClusteringEngine",11,0.03,4.91,215,4.37,301139.12,17,6,54,116,26,45.70,84,281,3,3,87.99,0.00,0.67,0.14,8,36.00,21,13121.59,1,9,23,org.apache.solr.handler.clustering.SearchClusteringEngine,0.00,105,2,54,0,105,2,0,57,2074,1
"org.apache.solr.handler.clustering.carrot.CarrotClusteringEngine$LocalSolrQueryRequest",1,0.00,1.00,3,0.03,347.48,1,0,54,2,1,133.19,0,5,0,1,133.19,0.00,0.00,0.00,0,1.00,1,95.04,0,1,1,java.lang.Object,0.00,1,0,1,0,1,0,0,0,27,0
"org.apache.solr.handler.clustering.carrot.CarrotClusteringEngine$SolrResourceLocator",5,0.00,1.60,28,0.39,13139.41,7,2,54,14,4,117.89,4,47,0,1,117.89,0.00,0.00,0.50,0,2.00,4,1162.43,2,2,4,java.lang.Object,0.00,9,0,8,0,9,3,1,4,237,2
"org.apache.solr.handler.clustering.carrot.CarrotClusteringEngine$SolrResourceLocator$IResource",4,0.00,1.00,9,0.08,1076.55,4,0,54,5,0,190.64,4,17,0,1,140.64,0.00,0.00,0.00,0,4.00,1,226.86,2,2,0,java.lang.Object,0.00,1,0,4,0,1,2,0,4,64,0
"org.apache.solr.handler.clustering.carrot.CarrotClusteringEngineTest",37,0.00,1.27,233,4.48,134544.49,37,0,25,82,19,113.88,19,349,0,4,113.88,0.00,0.75,0.00,10,184.00,3,13435.11,0,11,19,org.apache.solr.handler.clustering.AbstractClusteringTestCase,0.00,45,3,47,0,45,26,0,17,2548,1
"org.apache.solr.handler.clustering.carrot.CarrotParams",0,0.00,0.00,16,0.26,9895.62,15,15,2,1,3,171.00,16,20,3,1,171.00,0.00,0.00,0.00,0,0.00,0,778.82,0,0,0,,0.00,1,0,0,0,1,0,0,1,141,1
"org.apache.solr.handler.clustering.carrot.LuceneCarrot2StemmerFactory",1,1.00,1.00,8,0.10,1951.81,2,1,25,4,19,73.84,12,15,1,1,111.40,0.00,0.00,0.00,0,1.00,1,303.58,0,1,18,java.lang.Object,0.00,3,0,1,0,3,0,1,3,69,1
"org.apache.solr.handler.clustering.carrot.LuceneCarrot2StemmerFactory$SnowballStemmerFactory",1,0.00,4.00,30,0.54,20885.42,2,1,25,5,16,107.85,19,43,0,1,81.56,0.00,0.00,1.00,0,0.00,4,1612.04,0,1,16,java.lang.Object,0.00,4,0,4,0,4,0,0,4,299,3
"org.apache.solr.handler.clustering.carrot.LuceneCarrot2StemmerFactory$SnowballStemmerFactory$ArabicStemmerFactory",1,0.00,2.00,12,0.12,1880.84,1,0,25,2,2,62.51,7,25,0,1,104.80,0.00,0.00,0.00,0,1.00,2,350.46,0,1,2,java.lang.Object,0.00,1,0,2,0,1,0,0,2,86,2
"org.apache.solr.handler.clustering.carrot.LuceneCarrot2StemmerFactory$SnowballStemmerFactory$ArabicStemmerFactory$IdentityStemmer",1,1.00,1.00,4,0.04,743.95,2,1,25,2,0,125.93,0,7,0,1,125.93,0.00,0.00,0.00,0,1.00,1,111.58,0,1,0,java.lang.Object,0.00,1,0,1,0,1,0,1,0,31,2
"org.apache.solr.handler.clustering.carrot.LuceneCarrot2StemmerFactory$SnowballStemmerFactory$ArabicStemmerFactory$LuceneStemmerAdapter",3,0.33,2.67,28,0.39,18411.02,6,3,25,10,2,105.35,1,31,0,1,105.35,0.00,0.00,0.56,0,1.00,4,1179.95,0,1,2,java.lang.Object,0.00,7,0,8,0,7,2,1,1,244,2
"org.apache.solr.handler.clustering.carrot.LuceneCarrot2StemmerFactory$SnowballStemmerFactory$SnowballStemmerAdapter",2,1.00,1.50,10,0.07,1220.79,3,1,25,6,1,122.90,0,14,0,1,122.90,0.00,0.00,0.50,0,2.00,2,220.84,0,1,1,java.lang.Object,0.00,4,0,3,0,4,1,1,0,59,2
"org.apache.solr.handler.clustering.carrot.LuceneCarrot2TokenizerFactory",1,1.00,1.00,7,0.09,1720.01,2,1,14,4,4,132.13,18,14,1,1,114.00,0.00,0.00,0.00,0,1.00,1,270.21,0,1,3,java.lang.Object,0.00,3,0,1,0,3,0,1,4,62,1
"org.apache.solr.handler.clustering.carrot.LuceneCarrot2TokenizerFactory$ChineseTokenizerFactory",1,0.00,2.00,11,0.09,1181.30,1,0,14,3,0,107.80,0,24,0,1,107.80,0.00,0.00,0.00,0,1.00,2,270.76,0,1,0,java.lang.Object,0.00,2,0,2,0,2,0,0,0,69,3
"org.apache.solr.handler.clustering.carrot.LuceneCarrot2TokenizerFactory$ChineseTokenizerFactory$ChineseTokenizer",4,0.28,2.25,35,0.50,13510.07,10,6,14,19,3,159.34,4,49,0,1,109.34,0.00,0.00,0.38,0,0.00,4,1487.54,0,0,3,java.lang.Object,0.00,15,0,9,0,15,4,1,4,296,3
"org.apache.lucene.codecs.lucene.Bytes",3,1.00,6.33,45,0.75,41282.64,4,1,28,17,24,126.02,93,61,5,1,94.11,0.00,0.00,0.00,0,3.00,9,2261.67,0,2,19,java.lang.Object,0.00,14,0,19,0,14,1,0,14,409,2
"org.apache.lucene.codecs.lucene.Bytes$BytesReaderBase",5,0.15,1.40,36,0.42,14320.85,10,5,28,11,8,162.18,6,54,0,2,112.18,0.00,0.50,0.32,0,0.00,3,1254.13,1,3,8,org.apache.lucene.index.DocValues,0.29,6,1,7,0,6,2,0,2,254,2
"org.apache.lucene.codecs.lucene.Bytes$BytesSortedSourceBase",6,0.05,1.17,30,0.45,13729.00,14,8,28,15,5,118.44,0,44,0,2,118.44,0.00,0.50,0.17,0,14.00,2,1339.06,0,1,5,org.apache.lucene.index.SortedSource,0.00,9,1,7,0,9,5,0,0,277,2
"org.apache.lucene.codecs.lucene.Bytes$BytesSourceBase",1,5.00,1.00,16,0.22,6770.70,7,6,28,5,2,95.92,0,20,0,2,95.92,0.00,0.50,0.17,0,0.00,1,660.43,0,0,2,org.apache.lucene.index.Source,0.00,4,1,1,0,4,1,0,0,134,2
"org.apache.lucene.codecs.lucene.Bytes$BytesWriterBase",6,0.20,1.67,41,0.43,9468.95,14,8,28,11,9,116.67,0,59,0,2,116.67,0.00,0.50,0.29,0,10.00,3,1293.22,0,4,9,org.apache.lucene.util.packed.Writer,0.00,5,1,10,0,5,2,0,0,270,2
"org.apache.lucene.codecs.lucene.Bytes$DerefBytesWriterBase",14,0.00,2.43,127,1.64,91712.64,20,6,28,35,13,105.15,3,159,0,2,105.15,0.00,0.50,0.17,5,50.00,6,4933.37,0,0,13,org.apache.lucene.codecs.lucene40.values.BytesWriterBase,0.00,21,1,34,0,21,14,0,3,968,2
"org.apache.lucene.codecs.lucene.Bytes$Mode",0,0.00,0.00,2,0.01,71.32,0,0,28,0,0,171.00,3,5,0,1,171.00,0.00,0.00,0.00,0,0.00,0,28.53,0,0,0,java.lang.Object,0.00,0,0,0,0,0,0,0,1,9,2
"org.apache.lucene.codecs.lucene.DirectSource",5,0.17,2.20,41,0.45,11424.01,8,3,5,15,6,110.68,4,65,4,2,110.68,4.00,0.17,0.47,1,0.00,4,1338.94,0,1,2,org.apache.lucene.index.DocValues.Source,0.00,10,1,11,4,10,4,0,1,285,1
"org.apache.lucene.codecs.lucene.DirectSource$ByteToLong",1,0.00,1.00,3,0.03,363.26,1,0,5,2,1,133.04,0,6,0,2,133.04,0.00,0.50,0.00,0,1.00,1,88.73,0,0,1,org.apache.lucene.codecs.lucene40.values.ToNumeric,0.00,1,1,1,0,1,1,0,0,25,3
"org.apache.lucene.codecs.lucene.DirectSource$IntToLong",2,0.00,1.00,5,0.05,594.56,2,0,5,4,1,140.30,0,9,0,2,140.30,0.00,0.50,0.00,0,2.00,1,157.26,0,0,1,org.apache.lucene.codecs.lucene40.values.ToNumeric,0.00,2,1,2,0,2,2,0,0,43,3
"org.apache.lucene.codecs.lucene.DirectSource$LongToLong",2,0.00,1.00,5,0.05,594.56,2,0,5,4,1,140.30,0,9,0,2,140.30,0.00,0.50,0.00,0,2.00,1,157.26,0,0,1,org.apache.lucene.codecs.lucene40.values.ToNumeric,0.00,2,1,2,0,2,2,0,0,43,3
"org.apache.lucene.codecs.lucene.DirectSource$ShortToLong",1,0.00,1.00,3,0.03,363.26,1,0,5,2,1,133.04,0,6,0,2,133.04,0.00,0.50,0.00,0,1.00,1,88.73,0,0,1,org.apache.lucene.codecs.lucene40.values.ToNumeric,0.00,1,1,1,0,1,1,0,0,25,3
"org.apache.lucene.codecs.lucene.DirectSource$ToNumeric",2,0.00,1.00,4,0.03,227.00,2,0,5,2,1,143.59,0,6,0,1,143.59,0.00,0.00,0.00,1,2.00,1,89.01,0,0,1,java.lang.Object,0.00,0,0,2,0,0,2,0,0,28,3
"org.apache.lucene.codecs.lucene.DocValuesWriterBase",6,0.07,1.00,20,0.23,3784.57,12,6,13,9,14,151.77,20,30,4,2,131.15,3.00,0.20,0.11,0,10.00,1,698.67,0,3,10,org.apache.lucene.codecs.PerDocConsumer,0.00,3,1,6,3,3,3,0,5,168,2
"org.apache.lucene.codecs.lucene.FixedDerefBytesImpl",0,0.00,0.00,8,0.08,1134.78,3,3,13,0,8,171.00,5,9,0,1,171.00,0.00,0.00,0.00,0,0.00,0,252.17,0,0,8,java.lang.Object,0.00,0,0,0,0,0,0,0,3,55,0
"org.apache.lucene.codecs.lucene.FixedDerefBytesImpl$DirectFixedDerefSource",2,0.00,1.00,10,0.12,1896.59,4,2,13,5,3,121.48,0,15,0,3,121.48,0.00,0.67,0.50,0,2.00,1,353.85,0,0,3,org.apache.lucene.codecs.lucene40.values.DirectSource,0.43,3,2,2,0,3,2,0,0,84,2
"org.apache.lucene.codecs.lucene.FixedDerefBytesImpl$FixedDerefReader",4,0.33,1.00,13,0.16,1917.96,6,2,13,9,2,132.09,0,22,0,2,132.09,0.00,0.50,0.75,0,0.00,1,468.05,0,0,2,org.apache.lucene.codecs.lucene40.values.Bytes.BytesReaderBase,0.00,5,1,4,0,5,4,0,0,112,2
"org.apache.lucene.codecs.lucene.FixedDerefBytesImpl$FixedDerefSource",2,0.50,1.00,10,0.15,2995.00,4,2,13,6,4,119.92,0,15,0,2,119.92,0.00,0.50,0.75,0,0.00,1,447.04,0,1,4,org.apache.lucene.codecs.lucene40.values.Bytes.BytesSourceBase,0.00,4,1,2,0,4,1,0,0,100,2
"org.apache.lucene.codecs.lucene.FixedDerefBytesImpl$Writer",2,0.00,2.00,18,0.23,9261.58,2,0,13,10,5,106.38,0,22,0,2,106.38,0.00,0.50,0.00,0,2.00,3,703.61,0,0,5,org.apache.lucene.codecs.lucene40.values.Bytes.DerefBytesWriterBase,0.00,8,1,4,0,8,2,0,0,138,2
"org.apache.lucene.codecs.lucene.FixedSortedBytesImpl",0,0.00,0.00,8,0.08,979.63,3,3,22,0,11,171.00,5,9,0,1,171.00,0.00,0.00,0.00,0,0.00,0,248.80,0,0,11,java.lang.Object,0.00,0,0,0,0,0,0,0,3,55,0
"org.apache.lucene.codecs.lucene.FixedSortedBytesImpl$DirectFixedSortedSource",6,0.08,1.17,30,0.32,7543.86,11,5,22,13,3,120.48,0,46,0,2,120.48,0.00,0.50,0.27,0,10.00,2,973.92,0,2,3,org.apache.lucene.index.SortedSource,0.00,7,1,7,0,7,4,0,0,217,2
"org.apache.lucene.codecs.lucene.FixedSortedBytesImpl$FixedSortedSource",3,0.25,1.00,12,0.14,2619.26,5,2,22,5,2,125.38,0,20,0,2,125.38,0.00,0.50,0.33,0,5.00,1,421.48,0,1,2,org.apache.lucene.codecs.lucene40.values.Bytes.BytesSortedSourceBase,0.00,2,1,3,0,2,2,0,0,100,2
"org.apache.lucene.codecs.lucene.FixedSortedBytesImpl$Reader",4,0.56,1.00,15,0.20,3040.91,7,3,22,9,3,130.52,0,26,0,2,130.52,0.00,0.50,0.75,0,0.00,1,599.89,0,2,3,org.apache.lucene.codecs.lucene40.values.Bytes.BytesReaderBase,0.00,5,1,4,0,5,2,0,0,135,2
"org.apache.lucene.codecs.lucene.FixedSortedBytesImpl$Writer",3,0.50,2.33,47,0.74,37457.04,4,1,22,25,10,144.68,3,58,0,2,94.68,0.00,0.50,0.67,0,2.00,3,2220.03,0,0,10,org.apache.lucene.codecs.lucene40.values.Bytes.DerefBytesWriterBase,0.00,22,1,7,0,22,3,0,3,386,2
"org.apache.lucene.codecs.lucene.FixedStraightBytesImpl",0,0.00,0.00,10,0.11,1996.89,3,3,22,0,15,171.00,6,11,0,1,171.00,0.00,0.00,0.00,0,0.00,0,344.92,0,0,15,java.lang.Object,0.00,0,0,0,0,0,0,0,4,71,0
"org.apache.lucene.codecs.lucene.FixedStraightBytesImpl$DirectFixedStraightSource",2,1.00,1.00,8,0.08,1242.72,3,1,22,3,2,126.54,0,12,0,3,126.54,0.00,0.67,0.50,0,2.00,1,232.53,0,0,2,org.apache.lucene.codecs.lucene40.values.DirectSource,0.43,1,2,2,0,1,2,0,0,59,3
"org.apache.lucene.codecs.lucene.FixedStraightBytesImpl$FixedBytesWriterBase",8,0.14,1.88,52,0.69,26668.95,13,5,22,20,8,114.09,1,67,0,2,114.09,0.00,0.50,0.32,1,0.00,5,2057.31,0,0,8,org.apache.lucene.codecs.lucene40.values.Bytes.BytesWriterBase,0.00,12,1,15,0,12,8,0,1,418,2
"org.apache.lucene.codecs.lucene.FixedStraightBytesImpl$FixedStraightReader",6,0.10,1.17,17,0.23,3550.39,8,2,22,12,2,137.91,0,29,0,2,137.91,0.00,0.50,0.42,0,2.00,2,691.37,0,2,2,org.apache.lucene.codecs.lucene40.values.Bytes.BytesReaderBase,0.00,6,1,7,0,6,4,0,0,164,2
"org.apache.lucene.codecs.lucene.FixedStraightBytesImpl$FixedStraightSource",2,1.00,1.00,7,0.10,1762.10,3,1,22,4,3,130.01,0,13,0,2,130.01,0.00,0.50,0.50,0,2.00,1,291.72,0,1,3,org.apache.lucene.codecs.lucene40.values.Bytes.BytesSourceBase,0.00,2,1,2,0,2,1,0,0,70,3
"org.apache.lucene.codecs.lucene.FixedStraightBytesImpl$SingleByteSource",4,0.33,1.00,17,0.16,2912.26,5,1,22,6,3,126.00,0,27,0,2,126.00,0.00,0.50,0.75,0,0.00,1,478.56,0,2,3,org.apache.lucene.index.Source,0.00,2,1,4,0,2,2,0,0,114,3
"org.apache.lucene.codecs.lucene.FixedStraightBytesImpl$Writer",8,0.21,2.75,80,0.97,58109.02,10,2,22,19,9,103.06,5,112,0,2,103.06,0.00,0.50,0.31,2,20.00,8,2909.31,1,0,9,org.apache.lucene.codecs.lucene40.values.FixedBytesWriterBase,0.00,11,1,22,0,11,8,0,5,546,1
"org.apache.lucene.codecs.lucene.Floats",3,3.00,1.00,15,0.21,3779.26,6,3,13,6,14,141.13,9,25,4,1,120.51,0.00,0.00,0.00,0,3.00,1,618.54,0,2,10,java.lang.Object,0.00,3,0,3,0,3,1,0,1,138,1
"org.apache.lucene.codecs.lucene.Floats$FloatsReader",2,0.00,1.00,11,0.16,3537.36,3,1,13,6,5,119.35,0,18,0,2,119.35,0.00,0.50,1.00,0,0.00,1,487.64,0,1,5,FixedStraightBytesImpl.FixedStraightReader,0.00,4,1,2,0,4,1,0,0,103,2
"org.apache.lucene.codecs.lucene.Floats$FloatsWriter",4,0.17,1.00,19,0.27,4790.66,6,2,13,13,7,124.30,1,28,0,2,124.30,0.00,0.50,0.62,0,0.00,1,803.35,2,0,7,FixedStraightBytesImpl.Writer,0.00,9,1,4,0,9,4,0,1,176,2
"org.apache.lucene.codecs.lucene.Ints",5,3.00,1.40,25,0.37,9391.26,8,3,13,10,14,169.07,5,47,4,1,119.07,0.00,0.00,0.00,0,5.00,2,1120.69,0,3,10,java.lang.Object,0.00,5,0,7,0,5,2,0,1,239,2
"org.apache.lucene.codecs.lucene.Ints$IntsReader",2,0.00,1.00,12,0.15,2797.76,3,1,13,6,5,117.20,0,20,0,2,117.20,0.00,0.50,1.00,0,0.00,1,436.79,0,1,5,FixedStraightBytesImpl.FixedStraightReader,0.00,4,1,2,0,4,1,0,0,95,2
"org.apache.lucene.codecs.lucene.Ints$IntsWriter",5,0.25,1.00,19,0.29,4657.92,6,1,13,14,7,129.82,1,30,0,2,129.82,0.00,0.50,0.80,0,0.00,1,875.43,2,0,7,FixedStraightBytesImpl.Writer,0.00,9,1,5,0,9,5,0,1,194,1
"org.apache.lucene.codecs.lucene.PackedIntValues",0,0.00,0.00,9,0.10,1409.45,5,5,17,0,13,171.00,9,10,0,1,171.00,0.00,0.00,0.00,0,0.00,0,304.31,0,0,13,java.lang.Object,0.00,0,0,0,0,0,0,0,2,64,0
"org.apache.lucene.codecs.lucene.PackedIntValues$PackedIntsReader",5,0.25,2.00,37,0.47,14012.11,9,4,17,16,10,112.17,4,57,0,2,112.17,0.00,0.50,0.45,0,0.00,3,1407.02,1,3,10,org.apache.lucene.index.DocValues,0.57,11,1,10,0,11,2,0,1,281,1
"org.apache.lucene.codecs.lucene.PackedIntValues$PackedIntsSource",3,0.50,1.67,17,0.20,4603.24,6,3,17,9,4,169.72,3,23,0,2,119.72,0.00,0.50,0.67,0,1.00,2,611.93,0,1,4,org.apache.lucene.index.Source,0.00,6,1,5,0,6,2,0,3,138,1
"org.apache.lucene.codecs.lucene.PackedIntValues$PackedIntsWriter",4,0.42,3.75,64,1.02,72641.29,8,4,17,22,9,142.24,5,86,0,2,92.24,0.00,0.50,0.56,1,0.00,5,3074.08,1,0,9,org.apache.lucene.codecs.lucene40.values.FixedStraightBytesImpl.FixedBytesWriterBase,0.00,18,1,15,0,18,4,0,5,543,1
"org.apache.lucene.codecs.lucene.TestDocValues",19,1.00,2.89,356,5.69,425906.10,20,1,21,67,14,89.67,11,353,0,2,89.67,0.00,0.50,0.05,4,36.00,16,17060.81,0,2,14,org.apache.lucene.util.LuceneTestCase,0.00,48,1,55,0,48,17,0,11,2832,1
"org.apache.lucene.codecs.lucene.TestDocValues$DocValueHolder",8,0.29,1.00,20,0.13,1536.32,11,3,21,8,5,141.79,0,37,0,1,141.79,0.00,0.00,0.08,0,20.00,1,394.39,0,7,5,java.lang.Object,0.00,0,0,8,0,0,1,1,0,113,2
"org.apache.lucene.codecs.lucene.VarDerefBytesImpl",0,0.00,0.00,8,0.08,1114.15,3,3,13,0,8,171.00,15,9,0,1,171.00,0.00,0.00,0.00,0,0.00,0,247.59,0,0,8,java.lang.Object,0.00,0,0,0,0,0,0,0,5,54,0
"org.apache.lucene.codecs.lucene.VarDerefBytesImpl$DirectVarDerefSource",2,1.00,1.50,12,0.17,4936.66,3,1,13,6,3,115.17,1,18,0,3,115.17,0.00,0.67,0.50,0,2.00,2,495.18,0,0,3,org.apache.lucene.codecs.lucene40.values.DirectSource,0.43,4,2,3,0,4,2,0,1,106,2
"org.apache.lucene.codecs.lucene.VarDerefBytesImpl$VarDerefReader",3,0.50,1.00,9,0.12,1440.62,4,1,13,7,2,132.09,0,16,0,2,132.09,0.00,0.50,0.67,0,1.00,1,359.21,0,0,2,org.apache.lucene.codecs.lucene40.values.Bytes.BytesReaderBase,0.00,4,1,3,0,4,3,0,0,86,2
"org.apache.lucene.codecs.lucene.VarDerefBytesImpl$VarDerefSource",2,0.00,1.00,7,0.10,1498.86,3,1,13,6,4,130.56,0,14,0,2,130.56,0.00,0.50,1.00,0,0.00,1,302.88,0,1,4,org.apache.lucene.codecs.lucene40.values.Bytes.BytesSourceBase,0.00,4,1,2,0,4,1,0,0,72,2
"org.apache.lucene.codecs.lucene.VarDerefBytesImpl$Writer",3,0.00,1.33,23,0.31,14655.55,3,0,13,12,5,160.36,4,28,0,2,110.36,0.00,0.50,0.00,0,4.00,2,933.14,0,0,5,org.apache.lucene.codecs.lucene40.values.Bytes.DerefBytesWriterBase,0.00,9,1,4,0,9,3,0,4,180,1
"org.apache.lucene.codecs.lucene.VarSortedBytesImpl",0,0.00,0.00,8,0.09,1363.55,3,3,22,0,12,171.00,6,9,0,1,171.00,0.00,0.00,0.00,0,0.00,0,269.34,0,0,12,java.lang.Object,0.00,0,0,0,0,0,0,0,4,58,1
"org.apache.lucene.codecs.lucene.VarSortedBytesImpl$DirectSortedSource",6,0.16,1.17,35,0.42,12424.97,11,5,22,16,3,118.78,4,50,0,2,118.78,0.00,0.50,0.33,0,6.00,2,1267.82,0,2,3,org.apache.lucene.index.SortedSource,0.00,10,1,7,0,10,4,0,4,269,3
"org.apache.lucene.codecs.lucene.VarSortedBytesImpl$Reader",3,0.50,1.00,9,0.15,2260.48,4,1,22,6,3,130.55,0,18,0,2,130.55,0.00,0.50,0.67,0,2.00,1,459.28,0,2,3,org.apache.lucene.codecs.lucene40.values.Bytes.BytesReaderBase,0.00,3,1,3,0,3,1,0,0,104,2
"org.apache.lucene.codecs.lucene.VarSortedBytesImpl$VarSortedSource",3,0.50,1.00,13,0.17,3863.07,4,1,22,8,2,124.05,1,20,0,2,124.05,0.00,0.50,0.67,0,1.00,1,507.36,0,1,2,org.apache.lucene.codecs.lucene40.values.Bytes.BytesSortedSourceBase,0.00,5,1,3,0,5,2,0,1,115,3
"org.apache.lucene.codecs.lucene.VarSortedBytesImpl$Writer",4,0.67,2.00,62,0.98,54612.21,5,1,22,27,10,134.29,9,74,0,2,94.41,0.00,0.50,0.50,0,6.00,4,2931.01,0,0,10,org.apache.lucene.codecs.lucene40.values.Bytes.DerefBytesWriterBase,0.00,23,1,8,0,23,4,0,9,496,2
"org.apache.lucene.codecs.lucene.VarStraightBytesImpl",0,0.00,0.00,8,0.09,1316.53,3,3,24,0,16,171.00,4,9,0,1,171.00,0.00,0.00,0.00,0,0.00,0,260.06,0,0,16,java.lang.Object,0.00,0,0,0,0,0,0,0,2,56,0
"org.apache.lucene.codecs.lucene.VarStraightBytesImpl$DirectVarStraightSource",2,1.00,1.00,11,0.14,3373.93,3,1,24,6,3,119.51,1,16,0,3,119.51,0.00,0.67,0.50,0,2.00,1,425.21,0,0,3,org.apache.lucene.codecs.lucene40.values.DirectSource,0.43,4,2,2,0,4,2,0,1,97,3
"org.apache.lucene.codecs.lucene.VarStraightBytesImpl$VarStraightReader",3,1.00,1.00,9,0.11,1407.06,4,1,24,6,2,132.17,0,16,0,2,132.17,0.00,0.50,0.00,0,4.00,1,339.97,0,2,2,org.apache.lucene.codecs.lucene40.values.Bytes.BytesReaderBase,0.00,3,1,3,0,3,1,0,0,83,2
"org.apache.lucene.codecs.lucene.VarStraightBytesImpl$VarStraightSource",2,0.00,1.00,8,0.13,2933.75,3,1,24,7,4,123.61,0,14,0,2,123.61,0.00,0.50,1.00,0,0.00,1,403.40,0,1,4,org.apache.lucene.codecs.lucene40.values.Bytes.BytesSourceBase,0.00,5,1,2,0,5,1,0,0,92,3
"org.apache.lucene.codecs.lucene.VarStraightBytesImpl$Writer",7,0.44,3.29,131,1.65,126640.33,13,6,24,36,15,140.38,10,160,0,2,90.38,0.00,0.50,0.55,1,0.00,7,4945.00,1,0,15,org.apache.lucene.codecs.lucene40.values.Bytes.BytesWriterBase,0.00,29,1,23,0,29,7,0,10,857,1
"org.apache.lucene.codecs.lucene.Writer",3,0.50,1.33,22,0.52,39667.35,5,2,8,8,10,77.58,39,50,2,2,106.96,0.00,0.50,0.17,0,4.00,2,1557.15,0,2,8,org.apache.lucene.codecs.DocValuesConsumer,0.22,5,1,4,0,5,1,0,3,279,1
"org.apache.lucene.codecs.sep.IntIndexInput",3,0.00,1.00,6,0.05,369.35,3,0,4,3,13,183.20,6,7,11,1,143.31,0.00,0.00,0.00,0,3.00,1,135.12,0,1,2,java.lang.Object,0.00,0,0,3,3,0,2,1,2,43,2
"org.apache.lucene.codecs.sep.IntIndexInput$Index",4,0.00,1.00,5,0.05,413.38,4,0,4,4,1,155.14,1,7,0,1,155.14,0.00,0.00,0.00,0,4.00,1,152.55,0,1,1,java.lang.Object,0.00,0,0,4,0,0,3,0,1,47,3
"org.apache.lucene.codecs.sep.IntIndexInput$Reader",2,1.00,2.00,16,0.13,6465.90,3,1,4,4,1,159.52,3,17,0,1,109.52,0.00,0.00,0.50,0,2.00,3,400.60,0,1,1,java.lang.Object,0.00,2,0,4,0,2,1,0,3,89,3
"org.apache.lucene.codecs.sep.IntIndexOutput",3,0.00,1.00,5,0.04,326.68,3,0,3,3,9,175.57,11,6,8,1,154.96,0.00,0.00,0.00,0,3.00,1,122.43,0,1,1,java.lang.Object,0.00,0,0,3,3,0,2,1,3,39,2
"org.apache.lucene.codecs.sep.IntIndexOutput$Index",3,0.00,1.00,4,0.04,313.87,3,0,3,3,1,205.10,4,5,0,1,155.10,0.00,0.00,0.00,0,3.00,1,125.55,0,0,1,java.lang.Object,0.00,0,0,3,0,0,3,0,3,38,3
"org.apache.lucene.codecs.sep.IntStreamFactory",2,0.00,1.00,3,0.04,289.73,2,0,3,2,9,153.98,1,4,5,1,153.98,0.00,0.00,0.00,0,2.00,1,118.22,0,1,4,java.lang.Object,0.00,0,0,2,4,0,1,0,1,33,2
"org.apache.lucene.codecs.sep.SepDocValuesConsumer",5,0.12,2.00,31,0.52,23186.39,7,2,12,16,10,162.94,7,65,1,3,112.94,0.00,0.67,0.40,1,9.00,6,1572.96,0,1,9,org.apache.lucene.codecs.lucene40.values.DocValuesWriterBase,0.35,11,2,10,0,11,4,0,4,301,1
"org.apache.lucene.codecs.sep.SepDocValuesProducer",4,0.67,1.25,20,0.53,27501.10,5,1,15,9,10,154.54,8,44,1,3,114.66,0.00,0.67,0.50,0,4.00,2,1579.15,0,2,9,org.apache.lucene.codecs.PerDocProducerBase,0.19,5,2,5,0,5,2,0,2,299,1
"org.apache.lucene.codecs.sep.SepPostingsReader",9,0.16,4.11,121,1.78,84207.80,17,8,19,36,24,137.74,25,176,5,2,97.85,0.00,0.50,0.26,1,14.00,8,5337.14,0,3,19,org.apache.lucene.codecs.PostingsReaderBase,0.25,27,1,37,0,27,6,0,21,1022,1
"org.apache.lucene.codecs.sep.SepPostingsReader$SepDocsAndPositionsEnum",11,0.23,2.55,147,1.64,73801.33,38,27,19,33,8,119.71,36,194,0,4,99.10,0.00,0.75,0.25,1,4.00,6,4912.71,0,2,8,org.apache.lucene.index.DocsAndPositionsEnum,1.71,22,3,28,0,22,9,0,36,910,0
"org.apache.lucene.codecs.sep.SepPostingsReader$SepDocsEnum",6,0.42,3.17,87,0.93,30782.80,25,19,19,18,6,138.65,15,121,0,3,98.77,0.00,0.67,0.40,1,0.00,7,2802.91,0,1,6,org.apache.lucene.index.DocsEnum,1.09,12,2,19,0,12,5,0,15,530,0
"org.apache.lucene.codecs.sep.SepPostingsReader$SepTermState",3,0.50,2.67,37,0.39,17060.26,10,7,19,7,4,140.84,8,50,0,4,100.95,0.00,0.75,0.48,0,1.00,6,1175.35,2,2,4,org.apache.lucene.codecs.BlockTermState,0.80,4,3,8,0,4,1,0,8,252,3
"org.apache.lucene.codecs.sep.SepPostingsWriter",11,0.19,3.18,192,2.75,157787.17,44,33,16,50,20,92.34,49,243,5,3,92.10,0.00,0.67,0.20,0,0.00,9,8246.07,0,0,15,org.apache.lucene.codecs.PostingsWriterBase,0.71,39,2,35,0,39,11,0,37,1423,2
"org.apache.lucene.codecs.sep.SepPostingsWriter$PendingTerm",1,5.00,1.00,12,0.12,2782.76,6,5,16,1,0,103.62,0,14,0,1,103.62,0.00,0.00,0.00,0,1.00,1,367.59,0,0,0,java.lang.Object,0.00,0,0,1,0,0,1,0,0,91,2
"org.apache.lucene.codecs.sep.SepSkipListReader",11,0.25,2.82,104,1.15,56095.86,23,12,5,16,5,155.97,16,145,2,2,105.97,0.00,0.50,0.31,0,22.00,8,3464.58,3,3,3,org.apache.lucene.codecs.MultiLevelSkipListReader,0.18,5,1,31,0,5,8,0,9,689,0
"org.apache.lucene.codecs.sep.SepSkipListWriter",7,0.26,3.00,91,1.07,55045.13,21,14,5,14,4,66.30,43,111,1,2,98.52,0.00,0.50,0.30,0,5.00,6,3198.57,1,0,3,org.apache.lucene.codecs.MultiLevelSkipListWriter,0.00,7,1,21,0,7,7,0,36,620,0
"org.apache.lucene.facet.index.streaming.CategoryAttributesStream",3,0.00,2.00,19,0.19,4339.91,6,3,4,8,10,79.36,37,28,8,3,116.93,0.00,0.67,0.33,0,4.00,4,555.19,0,0,2,org.apache.lucene.analysis.TokenStream,0.55,5,2,6,0,5,3,0,3,129,1
"org.apache.lucene.facet.index.streaming.CategoryAttributesStreamTest",1,0.00,7.00,30,0.39,25292.86,1,0,10,16,5,130.78,25,37,0,3,80.78,0.00,0.67,0.00,0,0.00,7,1159.56,0,0,5,org.apache.lucene.facet.index.CategoryContainerTestBase,0.00,15,2,7,0,15,1,0,5,203,1
"org.apache.lucene.facet.index.streaming.CategoryListTokenizer",5,0.00,1.00,9,0.07,690.76,5,0,3,5,14,111.85,35,17,11,5,154.15,0.75,0.50,0.00,1,5.00,1,205.29,1,0,3,org.apache.lucene.facet.index.streaming.CategoryTokenizerBase,0.53,0,4,5,3,0,5,0,7,63,2
"org.apache.lucene.facet.index.streaming.CategoryParentsStream",4,0.11,6.00,64,0.88,53585.18,10,6,14,28,15,102.30,69,88,7,4,93.17,0.00,0.75,0.08,1,6.00,10,2625.21,0,0,10,org.apache.lucene.analysis.TokenFilter,0.25,24,3,24,0,24,4,0,17,497,1
"org.apache.lucene.facet.index.streaming.CategoryParentsStreamTest",4,0.00,2.75,59,0.75,26059.47,4,0,18,20,16,68.60,53,85,0,3,97.98,0.00,0.67,0.00,0,0.00,4,2238.22,0,0,16,org.apache.lucene.facet.index.CategoryContainerTestBase,0.00,16,2,11,0,16,4,0,11,414,1
"org.apache.lucene.facet.index.streaming.CategoryParentsStreamTest$DefaultFacetIndexingParams",2,0.00,1.00,5,0.03,405.51,2,0,18,4,4,141.60,0,9,0,1,141.60,0.00,0.00,0.00,0,2.00,1,97.95,0,2,4,java.lang.Object,0.00,2,0,2,0,2,0,0,0,30,0
"org.apache.lucene.facet.index.streaming.CategoryParentsStreamTest$MyCategoryListTokenizer",2,0.00,3.00,11,0.11,3031.85,2,0,18,6,4,119.63,0,21,0,6,119.63,0.00,0.83,0.00,0,2.00,5,329.11,0,0,4,org.apache.lucene.facet.index.streaming.CategoryListTokenizer,0.29,4,5,6,0,4,2,0,0,76,2
"org.apache.lucene.facet.index.streaming.CategoryTokenizer",3,0.00,1.67,14,0.16,4314.40,3,0,6,9,10,73.56,29,22,4,5,123.56,0.25,0.67,0.00,1,4.00,3,471.43,0,0,6,org.apache.lucene.facet.index.streaming.CategoryTokenizerBase,0.29,6,4,5,1,6,3,0,4,101,1
"org.apache.lucene.facet.index.streaming.CategoryTokenizerBase",2,5.00,1.00,13,0.14,2489.03,7,5,9,4,10,143.88,38,17,2,4,117.60,2.00,0.30,0.00,0,2.00,1,434.27,0,0,8,org.apache.lucene.analysis.TokenFilter,0.29,2,3,2,6,2,2,0,8,101,2
"org.apache.lucene.facet.index.streaming.CategoryTokenizerTest",2,0.00,3.00,37,0.58,21656.21,2,0,16,28,10,81.79,31,50,0,3,92.15,0.00,0.67,0.00,0,2.00,4,1737.76,0,0,10,org.apache.lucene.facet.index.CategoryContainerTestBase,0.00,26,2,6,0,26,2,0,6,300,1
"org.apache.lucene.facet.index.streaming.CountingListTokenizer",5,0.25,2.20,46,0.69,29189.14,7,2,12,33,10,73.34,31,68,1,6,105.56,0.00,0.83,0.30,1,6.00,6,2082.20,1,1,9,org.apache.lucene.facet.index.streaming.CategoryListTokenizer,0.50,28,5,11,0,28,4,0,5,380,1
"org.apache.lucene.analysis.payloads.AbstractEncoder",1,0.00,1.00,3,0.03,379.39,1,0,1,1,5,133.13,4,5,3,1,132.89,0.00,0.00,0.00,1,1.00,1,82.56,0,1,2,java.lang.Object,0.00,0,0,1,3,0,0,1,1,24,2
"org.apache.lucene.analysis.payloads.DelimitedPayloadTokenFilter",2,0.40,2.50,25,0.29,12170.67,7,5,5,8,8,58.44,14,28,3,4,100.73,0.00,0.75,0.40,0,2.00,4,875.75,0,0,5,org.apache.lucene.analysis.TokenFilter,0.29,6,3,5,0,6,2,0,3,178,2
"org.apache.lucene.analysis.payloads.DelimitedPayloadTokenFilterTest",6,0.00,1.67,93,1.67,63674.19,6,0,7,28,10,95.31,0,102,0,2,95.31,0.00,0.50,0.00,1,6.00,3,5008.19,0,0,10,org.apache.lucene.util.LuceneTestCase,0.00,22,1,10,0,22,6,0,0,906,1
"org.apache.lucene.analysis.payloads.FloatEncoder",1,0.00,1.00,7,0.09,1790.78,1,0,1,6,7,71.57,7,9,3,2,113.86,0.00,0.50,0.00,0,1.00,1,271.25,0,1,4,org.apache.lucene.analysis.payloads.AbstractEncoder,0.00,5,1,1,0,5,0,1,2,60,1
"org.apache.lucene.analysis.payloads.IdentityEncoder",3,1.00,1.33,13,0.18,5868.22,4,1,4,13,5,172.56,5,18,2,2,122.56,0.00,0.50,0.33,0,4.00,2,549.25,0,1,3,org.apache.lucene.analysis.payloads.AbstractEncoder,0.00,10,1,4,0,10,2,1,2,119,1
"org.apache.lucene.analysis.payloads.IntegerEncoder",1,0.00,1.00,7,0.08,1787.95,1,0,2,5,7,71.57,7,9,2,2,113.86,0.00,0.50,0.00,0,1.00,1,251.55,0,1,5,org.apache.lucene.analysis.payloads.AbstractEncoder,0.00,4,1,1,0,4,0,1,2,57,1
"org.apache.lucene.analysis.payloads.NumericPayloadTokenFilter",2,0.75,2.00,15,0.17,2957.24,6,4,6,8,8,154.24,5,21,2,4,114.35,0.00,0.75,0.62,0,0.00,3,504.71,0,0,6,org.apache.lucene.analysis.TokenFilter,0.29,6,3,4,0,6,2,0,2,113,1
"org.apache.lucene.analysis.payloads.NumericPayloadTokenFilterTest",1,0.00,3.00,23,0.50,27588.56,1,0,9,16,9,134.98,1,27,0,3,84.98,0.00,0.67,0.00,0,1.00,3,1501.19,0,0,9,org.apache.lucene.analysis.BaseTokenStreamTestCase,0.00,15,2,3,0,15,1,0,1,256,1
"org.apache.lucene.analysis.payloads.NumericPayloadTokenFilterTest$WordTokenFilter",2,0.00,2.00,11,0.11,1946.33,4,2,9,6,4,121.24,0,17,0,4,121.24,0.00,0.75,0.50,0,2.00,3,341.98,0,0,4,org.apache.lucene.analysis.TokenFilter,0.29,4,3,4,0,4,2,0,0,82,2
"org.apache.lucene.analysis.payloads.PayloadEncoder",2,0.00,1.00,3,0.02,107.12,2,0,1,2,7,125.16,13,4,6,1,157.39,0.00,0.00,0.00,0,2.00,1,66.19,0,2,1,,0.00,0,0,2,0,0,0,0,2,23,1
"org.apache.lucene.analysis.payloads.PayloadHelper",7,0.00,1.00,19,0.32,9172.28,7,0,0,9,8,117.35,35,28,8,1,135.22,0.00,0.00,0.00,4,7.00,1,957.98,0,0,0,java.lang.Object,0.00,2,0,7,0,2,7,0,4,227,1
"org.apache.lucene.analysis.payloads.TokenOffsetPayloadTokenFilter",2,0.00,1.50,15,0.17,4835.46,4,2,6,8,8,133.35,6,20,2,4,112.74,0.00,0.75,0.50,0,2.00,2,516.80,0,0,6,org.apache.lucene.analysis.TokenFilter,0.29,6,3,3,0,6,2,0,1,111,1
"org.apache.lucene.analysis.payloads.TokenOffsetPayloadTokenFilterTest",1,0.00,2.00,18,0.31,14107.25,1,0,7,12,7,91.34,0,21,0,3,91.34,0.00,0.67,0.00,0,1.00,2,942.05,0,0,7,org.apache.lucene.analysis.BaseTokenStreamTestCase,0.00,11,2,2,0,11,1,0,0,167,1
"org.apache.lucene.analysis.payloads.TypeAsPayloadTokenFilter",2,0.00,2.00,13,0.15,4399.05,4,2,6,8,7,136.11,6,19,2,4,115.49,0.00,0.75,0.50,0,2.00,3,462.96,0,0,5,org.apache.lucene.analysis.TokenFilter,0.29,6,3,4,0,6,2,0,1,101,1
"org.apache.lucene.analysis.payloads.TypeAsPayloadTokenFilterTest",1,0.00,2.00,17,0.35,15015.86,1,0,9,17,8,92.05,0,20,0,3,92.05,0.00,0.67,0.00,0,1.00,2,1047.86,0,0,8,org.apache.lucene.analysis.BaseTokenStreamTestCase,0.00,16,2,2,0,16,1,0,0,186,1
"org.apache.lucene.analysis.payloads.TypeAsPayloadTokenFilterTest$WordTokenFilter",2,0.00,1.50,11,0.12,2166.66,4,2,9,7,4,120.94,0,16,0,4,120.94,0.00,0.75,0.50,0,2.00,2,363.22,0,0,4,org.apache.lucene.analysis.TokenFilter,0.29,5,3,3,0,5,2,0,0,85,2
"org.apache.solr.velocity.VelocityResponseWriterTest",3,0.00,1.00,15,0.19,3348.91,3,0,9,11,4,120.93,1,23,0,3,120.93,0.00,0.67,0.00,0,3.00,1,580.56,5,0,4,org.apache.solr.SolrTestCaseJ4,0.04,8,2,3,0,8,3,0,1,126,1
"org.apache.lucene.util.ArrayUtil",55,0.00,2.07,311,4.44,249877.90,55,0,2,64,128,116.19,230,408,125,1,115.96,0.00,0.00,0.00,9,55.00,7,13317.55,0,2,3,java.lang.Object,0.00,9,0,114,0,9,53,0,61,2753,2
"org.apache.lucene.util.ArrayUtil$SorterTemplate",4,0.67,1.00,12,0.13,2705.31,5,1,2,5,0,130.92,0,20,0,1,130.92,0.00,0.00,0.50,0,4.00,1,400.66,0,0,0,java.lang.Object,0.00,1,0,4,0,1,4,0,0,103,0
"org.apache.lucene.util.ArrayUtil$SorterTemplate_0",4,0.67,1.00,12,0.13,2606.88,5,1,2,5,0,131.04,0,20,0,1,131.04,0.00,0.00,0.50,0,4.00,1,390.98,0,0,0,java.lang.Object,0.00,1,0,4,0,1,4,0,0,101,0
"org.apache.lucene.util.Attribute",0,0.00,0.00,1,0.00,12.00,0,0,0,0,35,171.00,19,2,35,1,171.00,0.00,0.00,0.00,0,0.00,0,8.00,0,0,0,,0.00,0,0,0,0,0,0,0,2,4,1
"org.apache.lucene.util.AttributeImpl",5,0.00,2.60,30,0.42,19149.41,5,0,4,23,53,69.41,59,39,50,1,113.54,0.00,0.00,0.00,1,5.00,8,1272.09,1,2,3,java.lang.Object,0.00,18,0,13,31,18,3,2,9,243,2
"org.apache.lucene.util.AttributeImpl$AttributeReflector",1,0.00,5.00,7,0.12,3324.00,1,0,4,5,0,111.37,0,10,0,1,111.37,0.00,0.00,0.00,0,1.00,5,353.00,0,0,0,java.lang.Object,0.00,4,0,5,0,4,1,0,0,73,0
"org.apache.lucene.util.AttributeReflector",1,0.00,1.00,2,0.02,236.00,1,0,0,1,13,190.57,26,3,13,1,141.08,0.00,0.00,0.00,0,1.00,1,72.00,0,0,0,,0.00,0,0,1,0,0,1,0,3,20,1
"org.apache.lucene.util.AttributeSource",0,0.00,0.00,2,0.01,70.18,0,0,9,0,76,171.00,13,2,76,1,171.00,0.00,0.00,0.00,0,0.00,0,28.07,0,0,1,java.lang.Object,0.00,0,0,0,193,0,0,0,3,10,1
"org.apache.lucene.util.AttributeSource$AttributeFactory",23,0.11,2.96,166,2.35,117529.91,29,6,9,71,5,92.15,131,210,0,1,110.02,0.00,0.00,0.07,6,134.00,10,7064.49,0,7,5,java.lang.Object,0.00,48,0,68,0,48,16,0,33,1424,3
"org.apache.lucene.util.AttributeSource$AttributeFactory$AttributeReflector",1,0.00,5.00,7,0.12,3324.00,1,0,9,5,0,111.37,0,10,0,1,111.37,0.00,0.00,0.00,0,1.00,5,353.00,0,0,0,java.lang.Object,0.00,4,0,5,0,4,1,0,0,73,0
"org.apache.lucene.util.AttributeSource$AttributeFactory$DefaultAttributeFactory",3,1.00,4.33,16,0.37,20619.45,4,1,9,14,3,114.37,1,32,0,2,114.37,0.00,0.50,0.33,1,4.00,8,1124.20,0,1,3,org.apache.lucene.util.AttributeFactory,0.00,11,1,13,0,11,2,0,1,221,3
"org.apache.lucene.util.AttributeSource$AttributeFactory$Iterator<AttributeImpl>",3,0.50,1.33,11,0.08,1916.67,4,1,9,5,1,131.04,0,15,0,1,131.04,0.00,0.00,0.67,0,1.00,2,252.66,0,0,1,java.lang.Object,0.00,2,0,4,0,2,3,0,0,66,0
"org.apache.lucene.util.AttributeSource$AttributeFactory$State",1,0.00,2.00,9,0.09,2942.78,3,2,9,4,1,107.93,0,13,0,1,107.93,0.00,0.00,1.00,0,0.00,2,256.35,0,1,1,java.lang.Object,0.00,3,0,2,0,3,0,1,0,63,3
"org.apache.lucene.util.BitUtil",16,0.40,3.56,447,8.36,2337244.73,18,2,0,16,6,28.17,166,562,6,1,76.64,0.00,0.00,0.12,1,60.00,8,25068.50,0,0,0,java.lang.Object,0.00,0,0,57,0,0,16,0,97,4680,2
"org.apache.lucene.util.Bits",2,1.00,1.00,6,0.05,1274.49,3,1,0,2,256,101.74,26,7,256,1,131.12,0.00,0.00,0.00,0,2.00,1,155.26,0,0,0,,0.00,0,0,2,0,0,2,0,4,43,1
"org.apache.lucene.util.Bits$MatchAllBits",3,1.00,1.00,8,0.05,467.73,4,1,0,3,1,142.50,0,12,0,1,142.50,0.00,0.00,0.33,0,4.00,1,138.60,0,0,1,java.lang.Object,0.00,0,0,3,0,0,3,1,0,42,2
"org.apache.lucene.util.Bits$MatchNoBits",3,1.00,1.00,8,0.05,467.73,4,1,0,3,1,142.50,0,12,0,1,142.50,0.00,0.00,0.33,0,4.00,1,138.60,0,0,1,java.lang.Object,0.00,0,0,3,0,0,3,1,0,42,2
"org.apache.lucene.util.BitsSlice",3,0.33,1.33,16,0.18,5285.75,6,3,0,5,2,87.08,18,21,1,1,119.30,0.00,0.00,0.56,0,0.00,2,535.42,0,0,1,java.lang.Object,0.00,2,0,4,0,2,3,1,3,124,2
"org.apache.lucene.util.ByteBlockPool",11,0.29,2.00,138,1.81,117777.55,23,12,5,18,24,80.98,63,158,21,1,98.85,0.00,0.00,0.35,1,0.00,4,5436.95,0,0,3,java.lang.Object,0.00,7,0,22,0,7,11,0,33,1054,2
"org.apache.lucene.util.ByteBlockPool$Allocator",4,1.00,1.00,10,0.11,2235.45,5,1,5,6,0,138.14,0,14,0,1,138.14,0.00,0.00,0.25,1,6.00,1,338.34,0,0,0,java.lang.Object,0.00,2,0,4,0,2,4,0,0,88,3
"org.apache.lucene.util.ByteBlockPool$DirectAllocator",3,0.00,1.00,6,0.05,376.94,3,0,5,3,0,143.24,0,11,0,2,143.24,0.00,0.50,0.00,0,4.00,1,135.67,0,0,0,org.apache.lucene.util.Allocator,0.00,0,1,3,0,0,3,0,0,42,3
"org.apache.lucene.util.ByteBlockPool$DirectTrackingAllocator",4,0.67,1.25,17,0.15,3706.77,5,1,5,5,1,125.13,0,21,0,2,125.13,0.00,0.50,0.50,0,6.00,2,448.60,0,0,1,org.apache.lucene.util.Allocator,0.00,1,1,5,0,1,4,0,0,110,2
"org.apache.lucene.util.BytesRef",19,0.06,1.53,101,1.04,40657.04,25,6,1,35,724,118.84,77,128,721,1,118.60,0.00,0.00,0.23,2,107.00,4,3119.40,0,6,4,java.lang.Object,0.00,16,0,29,0,16,13,2,25,697,2
"org.apache.lucene.util.BytesRef$Deprecated",2,0.00,4.00,23,0.30,32434.90,2,0,1,2,1,80.81,10,31,0,1,98.68,0.00,0.00,0.00,0,2.00,7,894.02,0,0,1,java.lang.Object,0.00,0,0,8,0,0,2,1,10,173,2
"org.apache.lucene.util.BytesRef$UTF8SortedAsUnicodeComparator",2,0.00,2.00,15,0.21,12642.30,2,0,1,3,1,159.39,2,20,0,1,109.39,0.00,0.00,0.00,0,2.00,3,616.85,0,0,1,java.lang.Object,0.00,1,0,4,0,1,2,1,2,124,2
"org.apache.lucene.util.BytesRefHash",18,0.21,2.50,209,2.79,280448.54,30,12,7,38,25,50.82,157,255,19,1,98.93,0.00,0.00,0.28,3,0.00,8,8368.37,0,0,6,java.lang.Object,0.00,20,0,45,0,20,18,0,39,1509,2
"org.apache.lucene.util.BytesRefHash$BytesStartArray",4,0.00,1.00,5,0.03,217.18,4,0,7,4,1,139.47,23,6,0,1,157.34,0.00,0.00,0.00,0,4.00,1,89.97,0,0,1,java.lang.Object,0.00,0,0,4,0,0,4,0,4,33,3
"org.apache.lucene.util.BytesRefHash$DirectBytesStartArray",5,0.00,1.00,16,0.16,3142.89,8,3,7,8,3,131.17,3,27,0,2,131.17,0.00,0.50,0.33,0,5.00,1,489.54,0,0,3,org.apache.lucene.util.BytesStartArray,0.00,3,1,5,0,3,5,0,3,123,2
"org.apache.lucene.util.BytesRefHash$SorterTemplate",4,0.11,1.00,18,0.28,8859.55,7,3,7,6,1,122.20,0,29,0,1,122.20,0.00,0.00,0.42,0,0.00,1,852.30,0,0,1,java.lang.Object,0.00,2,0,4,0,2,4,0,0,192,0
"org.apache.lucene.util.BytesRefHash$SuppressWarnings",1,0.00,1.00,3,0.02,192.67,1,0,7,1,0,135.21,0,6,0,2,135.21,0.00,0.50,0.00,0,1.00,1,66.78,0,0,0,java.lang.RuntimeException,0.00,0,1,1,0,0,1,0,0,21,2
"org.apache.lucene.util.BytesRefHash$TrackingDirectBytesStartArray",5,0.25,1.20,23,0.26,7641.35,8,3,7,8,3,123.43,0,35,0,2,123.43,0.00,0.50,0.53,0,0.00,2,789.24,0,0,3,org.apache.lucene.util.BytesStartArray,0.00,3,1,6,0,3,5,0,0,181,2
"org.apache.lucene.util.BytesRefIterator",2,0.00,1.00,5,0.03,597.46,2,0,2,3,21,91.80,21,7,20,1,140.28,0.00,0.00,0.00,0,2.00,1,99.00,0,1,1,,0.00,1,0,2,0,1,1,0,4,31,1
"org.apache.lucene.util.BytesRefIterator$BytesRefIterator",2,0.00,1.00,5,0.03,340.93,2,0,2,2,1,142.20,0,8,0,1,142.20,0.00,0.00,0.00,0,2.00,1,92.66,0,1,1,java.lang.Object,0.00,0,0,2,0,0,1,0,0,28,0
"org.apache.lucene.util.CharsRef",19,0.08,1.63,103,1.11,44389.26,24,5,1,27,67,138.90,63,137,65,1,118.29,0.00,0.00,0.27,2,33.00,5,3340.99,0,5,2,java.lang.Object,0.00,8,0,31,0,8,14,3,16,739,2
"org.apache.lucene.util.CharsRef$Deprecated",2,0.00,4.00,24,0.30,28570.33,2,0,1,3,1,118.32,6,32,0,1,97.71,0.00,0.00,0.00,0,2.00,7,903.96,0,0,1,java.lang.Object,0.00,1,0,8,0,1,2,1,6,172,2
"org.apache.lucene.util.CloseableThreadLocal",6,0.15,2.17,48,0.46,15508.91,10,4,6,20,4,67.97,42,61,4,1,110.26,0.00,0.00,0.38,4,2.00,4,1382.65,0,0,0,java.lang.Object,0.00,14,0,13,1,14,6,1,15,297,1
"org.apache.lucene.util.CodecUtil",4,0.67,2.25,25,0.38,19574.43,5,1,6,15,43,152.62,8,36,37,1,112.73,0.00,0.00,0.50,0,4.00,5,1149.10,0,0,6,java.lang.Object,0.00,11,0,9,0,11,4,0,3,228,2
"org.apache.lucene.util.CollectionUtil",9,0.00,2.33,32,0.59,22617.67,9,0,4,15,6,108.36,49,43,5,1,126.23,0.00,0.00,0.00,1,9.00,3,1771.08,0,2,1,java.lang.Object,0.00,6,0,21,0,6,7,0,12,375,2
"org.apache.lucene.util.CollectionUtil$SorterTemplate",4,0.67,1.00,10,0.12,1922.80,5,1,4,7,0,138.65,0,18,0,1,138.65,0.00,0.00,0.50,0,4.00,1,370.86,0,0,0,java.lang.Object,0.00,3,0,4,0,3,4,0,0,97,0
"org.apache.lucene.util.CollectionUtil$SorterTemplate_0",4,0.67,1.00,10,0.12,1833.48,5,1,4,7,0,138.81,0,18,0,1,138.81,0.00,0.00,0.50,0,4.00,1,361.00,0,0,0,java.lang.Object,0.00,3,0,4,0,3,4,0,0,95,0
"org.apache.lucene.util.CommandLineUtil",6,0.00,2.50,23,0.49,20411.36,6,0,5,18,5,107.31,34,44,3,1,125.18,0.00,0.00,0.00,3,6.00,6,1459.65,0,5,2,java.lang.Object,0.00,12,0,15,0,12,1,0,7,295,2
"org.apache.lucene.util.Constants",2,17.00,1.00,52,0.85,31831.90,19,17,2,7,15,36.65,21,66,14,1,85.13,0.00,0.00,0.00,0,2.00,1,2537.06,0,1,1,java.lang.Object,0.00,5,0,2,0,5,1,0,19,456,2
"org.apache.lucene.util.Counter",4,0.00,1.25,9,0.07,1104.42,4,0,1,6,41,96.37,45,12,41,1,140.50,0.00,0.00,0.00,1,4.00,2,219.72,0,2,0,java.lang.Object,0.00,2,0,5,2,2,2,0,6,65,2
"org.apache.lucene.util.Counter$AtomicCounter",2,0.00,1.00,6,0.06,1066.55,3,1,1,5,1,131.73,0,11,0,2,131.73,0.00,0.50,1.00,0,0.00,1,177.91,0,0,1,org.apache.lucene.util.Counter,0.67,3,1,2,0,3,2,0,0,49,3
"org.apache.lucene.util.Counter$SerialCounter",2,0.00,1.00,6,0.05,672.65,3,1,1,2,1,133.30,0,11,0,2,133.30,0.00,0.50,1.00,0,0.00,1,149.14,0,0,1,org.apache.lucene.util.Counter,0.67,0,1,2,0,0,2,0,0,42,3
"org.apache.lucene.util.Deprecated",8,0.29,3.25,120,2.36,163601.80,10,2,1,24,2,132.80,22,176,0,2,92.91,0.00,0.50,0.25,0,14.00,10,7066.67,0,2,2,LuceneTestCase,0.00,16,1,26,0,16,6,0,5,1272,1
"org.apache.lucene.util.Deprecated$CodingCase",2,0.14,1.50,17,0.19,4164.69,9,7,1,2,0,111.09,0,20,0,1,111.09,0.00,0.00,0.07,0,2.00,2,558.74,0,0,0,java.lang.Object,0.00,0,0,3,0,0,2,0,0,131,1
"org.apache.lucene.util.DocIdBitSet",7,0.67,1.00,17,0.13,1682.96,8,1,3,10,11,141.02,6,30,8,2,141.02,0.00,0.50,0.43,0,10.00,1,393.45,0,2,3,org.apache.lucene.search.DocIdSet,0.00,3,1,7,0,3,5,1,4,110,1
"org.apache.lucene.util.DocIdBitSet$DocIdBitSetIterator",4,0.17,1.50,16,0.15,3811.82,6,2,3,5,1,124.99,3,24,0,2,124.99,0.00,0.50,0.62,0,0.00,2,456.34,0,0,1,org.apache.lucene.search.DocIdSetIterator,0.86,1,1,6,0,1,4,0,3,112,2
"org.apache.lucene.util.DoubleBarrelLRUCache",3,0.80,2.67,41,0.43,17956.52,8,5,3,11,3,55.35,33,52,3,2,99.48,0.00,0.50,0.73,1,0.00,4,1278.69,0,0,0,DoubleBarrelLRUCache.CloneableKey,V>,0.00,8,1,8,0,8,3,0,14,266,2
"org.apache.lucene.util.DoubleBarrelLRUCache$CloneableKey",1,0.00,1.00,2,0.01,128.77,1,0,3,1,0,143.16,0,4,0,1,143.16,0.00,0.00,0.00,0,1.00,1,42.51,0,1,0,java.lang.Object,0.00,0,0,1,0,0,0,0,0,15,3
"org.apache.lucene.util.DummyConcurrentLock",6,1.00,1.00,11,0.07,869.96,7,1,4,8,0,153.98,5,15,0,1,153.98,0.00,0.00,0.00,0,6.00,1,200.16,0,1,0,java.lang.Object,0.00,2,0,6,0,2,5,1,2,63,2
"org.apache.lucene.util.English",5,0.00,9.20,108,1.34,117364.17,5,0,0,8,25,68.88,28,156,25,1,86.75,0.00,0.00,0.00,1,5.00,42,4021.91,0,2,0,java.lang.Object,0.00,3,0,46,0,3,3,0,11,645,2
"org.apache.lucene.util.FailOnNonBulkMergesInfoStream",3,0.00,1.00,6,0.06,784.35,3,0,1,4,3,140.73,2,13,2,2,140.73,0.00,0.50,0.00,0,3.00,1,171.95,0,0,1,org.apache.lucene.util.InfoStream,0.00,1,1,3,0,1,3,0,2,49,1
"org.apache.lucene.util.FieldCacheSanityChecker",8,0.86,3.88,115,2.00,151331.65,9,1,11,56,9,56.69,100,138,5,1,94.26,0.00,0.00,0.25,4,16.00,10,5997.06,0,3,4,java.lang.Object,0.00,48,0,31,0,48,5,0,34,1040,2
"org.apache.lucene.util.FieldCacheSanityChecker$Insanity",5,0.17,1.80,31,0.32,12014.75,8,3,11,11,0,155.10,14,34,0,1,115.22,0.00,0.00,0.20,3,14.00,3,949.07,0,3,0,java.lang.Object,0.00,6,0,9,0,6,2,0,4,206,3
"org.apache.lucene.util.FieldCacheSanityChecker$InsanityType",2,0.25,1.00,9,0.10,2072.31,6,4,11,3,0,87.23,24,14,0,1,124.80,0.00,0.00,0.12,0,2.00,1,285.41,0,1,0,java.lang.Object,0.00,1,0,2,0,1,1,0,3,72,3
"org.apache.lucene.util.FieldCacheSanityChecker$ReaderField",4,0.00,1.25,14,0.17,4188.97,6,2,11,7,0,129.37,0,23,0,1,129.37,0.00,0.00,0.50,1,4.00,2,498.39,0,1,0,java.lang.Object,0.00,3,0,5,0,3,3,0,0,123,3
"org.apache.lucene.util.FixedBitSet",31,0.03,2.00,211,2.65,168004.62,33,2,4,43,57,152.30,86,273,52,2,112.41,0.00,0.50,0.53,6,0.00,6,7954.62,0,3,5,org.apache.lucene.search.DocIdSet,0.00,12,1,62,0,12,28,1,52,1623,2
"org.apache.lucene.util.IOUtils",12,0.33,5.33,119,1.37,95283.63,15,3,13,25,143,56.20,103,174,143,1,104.31,0.00,0.00,0.03,2,22.00,12,4121.30,0,3,1,java.lang.Object,0.00,13,0,64,0,13,9,0,17,830,2
"org.apache.lucene.util.InfoStream",4,0.33,1.25,12,0.12,2967.05,6,2,1,6,21,170.43,10,18,21,1,130.55,0.00,0.00,0.25,0,4.00,2,347.59,0,1,0,java.lang.Object,0.00,2,0,5,4,2,3,1,6,89,2
"org.apache.lucene.util.InfoStream$NoOutput",3,0.00,1.00,6,0.05,618.63,3,0,1,3,1,141.55,0,12,0,2,141.55,0.00,0.50,0.00,0,3.00,1,157.79,0,0,1,org.apache.lucene.util.InfoStream,0.00,0,1,3,0,0,3,0,0,46,3
"org.apache.lucene.util.IntsRef",12,0.16,2.17,89,0.90,43447.01,16,4,0,21,50,151.16,30,109,49,1,111.27,0.00,0.00,0.40,1,0.00,5,2699.54,0,3,1,java.lang.Object,0.00,9,0,26,0,9,9,2,5,581,2
"org.apache.lucene.util.LineFileDocs",7,0.07,3.00,78,1.11,51610.40,14,7,17,43,24,151.44,12,100,16,1,101.44,0.00,0.00,0.20,2,11.00,8,3334.23,0,1,8,java.lang.Object,0.00,36,0,21,0,36,6,1,9,600,1
"org.apache.lucene.util.LineFileDocs$DocState",1,0.00,2.00,29,0.33,8372.86,8,7,17,11,7,85.40,0,32,0,1,85.40,0.00,0.00,1.00,0,0.00,2,977.46,0,0,7,java.lang.Object,0.00,10,0,2,0,10,1,0,0,190,3
"org.apache.lucene.util.LuceneJUnitDividingSelector",3,0.67,2.67,26,0.30,10713.78,6,3,4,8,0,159.11,3,36,0,2,109.11,0.00,0.50,0.78,0,0.00,4,892.82,2,0,0,org.apache.tools.ant.types.selectors.BaseExtendSelector,0.00,5,1,8,0,5,3,0,3,187,1
"org.apache.lucene.util.LuceneJUnitResultFormatter",15,0.03,2.07,99,1.29,61389.54,23,8,16,43,4,95.49,79,151,1,1,113.36,0.00,0.00,0.10,5,60.00,11,3866.25,0,3,3,java.lang.Object,0.00,28,0,31,0,28,12,1,30,743,1
"org.apache.lucene.util.LuceneTestCaseRunner",4,0.17,7.00,75,1.28,66806.98,6,2,31,43,1,111.09,12,105,0,2,90.47,0.00,0.50,0.38,1,4.00,10,3849.40,1,1,1,org.junit.runners.BlockJUnit4ClassRunner,0.00,39,1,28,0,39,3,0,12,656,1
"org.apache.lucene.util.LuceneTestCaseRunner$Comparator<FrameworkMethod>",1,0.00,1.00,3,0.04,604.64,1,0,31,3,0,131.30,0,5,0,1,131.30,0.00,0.00,0.00,0,1.00,1,117.32,0,0,0,java.lang.Object,0.00,2,0,1,0,2,1,0,0,32,0
"org.apache.lucene.util.LuceneTestCaseRunner$Filter",2,0.00,1.00,5,0.05,749.50,2,0,31,4,0,139.50,0,7,0,1,139.50,0.00,0.00,0.00,0,2.00,1,144.62,0,1,0,java.lang.Object,0.00,2,0,2,0,2,1,0,0,39,0
"org.apache.lucene.util.LuceneTestCaseRunner$RunListener",1,0.00,2.00,4,0.05,748.87,1,0,31,2,0,125.75,0,7,0,1,125.75,0.00,0.00,0.00,0,1.00,2,145.55,0,0,0,java.lang.Object,0.00,1,0,2,0,1,1,0,0,34,0
"org.apache.lucene.util.MapOfSets",4,0.00,1.75,24,0.28,9185.58,5,1,4,11,1,97.50,21,31,1,1,115.38,0.00,0.00,1.00,0,0.00,3,843.05,0,1,0,java.lang.Object,0.00,7,0,7,0,7,3,0,5,184,1
"org.apache.lucene.util.MultiBits",6,0.20,2.00,56,0.79,44288.33,9,3,1,16,4,154.78,9,64,2,1,104.78,0.00,0.00,0.50,1,0.00,4,2359.45,0,2,2,java.lang.Object,0.00,10,0,12,0,10,4,1,2,472,2
"org.apache.lucene.util.MultiBits$SubResult",0,0.00,0.00,3,0.02,166.05,2,2,1,0,1,171.00,0,4,0,1,171.00,0.00,0.00,0.00,0,0.00,0,55.35,0,0,1,java.lang.Object,0.00,0,0,0,0,0,0,0,0,16,3
"org.apache.lucene.util.MutableBits",1,0.00,1.00,2,0.01,60.50,1,0,0,1,8,145.27,16,3,8,2,145.74,0.00,0.50,0.00,0,1.00,1,35.16,0,0,0,,0.00,0,1,1,0,0,1,0,1,13,1
"org.apache.lucene.util.NamedSPILoader",4,0.00,1.75,22,0.32,10977.87,6,2,6,16,2,167.72,7,30,2,2,117.72,0.00,0.50,0.50,0,0.00,3,972.99,0,2,0,NamedSPILoader.NamedSPI,0.00,12,1,7,0,12,2,1,4,208,2
"org.apache.lucene.util.NamedSPILoader$NamedSPI",1,0.00,1.00,2,0.01,35.86,1,0,6,1,0,147.53,0,3,0,1,147.53,0.00,0.00,0.00,0,1.00,1,21.93,0,1,0,,0.00,0,0,1,0,0,0,0,0,10,2
"org.apache.lucene.util.NamedThreadFactory",3,0.20,1.67,17,0.27,5690.56,8,5,3,14,2,101.12,16,24,2,1,119.00,0.00,0.00,0.33,0,1.00,2,799.72,0,2,0,java.lang.Object,0.00,11,0,5,0,11,1,1,3,173,1
"org.apache.lucene.util.NullInfoStream",3,0.00,1.00,8,0.07,1061.61,3,0,1,3,1,179.58,6,15,0,2,139.70,0.00,0.50,0.00,0,3.00,1,198.94,0,0,1,org.apache.lucene.util.InfoStream,0.00,0,1,3,0,0,3,0,2,56,1
"org.apache.lucene.util.NumericUtils",15,0.16,2.87,123,1.95,165553.21,20,5,7,24,26,61.11,178,170,21,1,105.23,0.00,0.00,0.05,2,59.00,9,5862.92,0,0,8,java.lang.Object,0.00,9,0,43,0,9,15,0,40,1106,2
"org.apache.lucene.util.NumericUtils$IntRangeBuilder",2,0.00,1.00,8,0.09,1801.28,2,0,7,5,1,125.51,8,11,0,1,125.28,0.00,0.00,0.00,1,2.00,1,257.52,0,0,1,java.lang.Object,0.00,3,0,2,0,3,2,0,2,66,3
"org.apache.lucene.util.NumericUtils$LongRangeBuilder",2,0.00,1.00,8,0.09,1696.26,2,0,7,5,1,125.72,8,11,0,1,125.48,0.00,0.00,0.00,1,2.00,1,261.10,0,0,1,java.lang.Object,0.00,3,0,2,0,3,2,0,2,66,3
"org.apache.lucene.util.OpenBitSet",61,0.04,2.02,401,5.19,319551.80,64,3,3,76,45,94.65,316,483,40,2,112.52,1.00,0.33,0.37,9,0.00,8,15565.07,1,3,6,org.apache.lucene.search.DocIdSet,0.00,15,1,123,1,15,58,2,138,3216,1
"org.apache.lucene.util.OpenBitSetDISI",6,0.00,1.83,29,0.29,7397.27,6,0,2,6,6,106.19,35,41,4,3,124.06,0.00,0.67,0.00,1,6.00,3,865.43,5,0,2,org.apache.lucene.util.OpenBitSet,0.00,0,2,11,0,0,6,0,7,201,1
"org.apache.lucene.util.OpenBitSetIterator",6,0.38,2.83,61,1.37,46155.55,14,8,1,8,8,52.86,57,102,7,2,102.86,0.00,0.50,0.44,1,0.00,5,4122.46,0,0,2,org.apache.lucene.search.DocIdSetIterator,0.67,2,1,17,0,2,6,0,22,631,1
"org.apache.lucene.util.PagedBytes",9,0.36,3.44,123,1.46,92731.08,19,10,6,20,23,118.18,28,156,19,1,97.56,0.00,0.00,0.42,1,0.00,6,4384.73,0,3,4,java.lang.Object,0.00,11,0,31,0,11,6,0,11,834,2
"org.apache.lucene.util.PagedBytes$PagedBytesDataInput",7,0.33,1.43,38,0.36,14651.20,10,3,6,10,1,118.69,4,56,0,2,118.69,0.00,0.50,0.62,2,0.00,3,1070.34,0,1,1,org.apache.lucene.store.DataInput,0.33,3,1,10,0,3,6,0,3,240,2
"org.apache.lucene.util.PagedBytes$PagedBytesDataOutput",3,0.00,3.67,39,0.42,38399.98,3,0,6,4,1,96.81,2,53,0,2,96.81,0.00,0.50,0.00,0,0.00,6,1254.07,0,0,1,org.apache.lucene.store.DataOutput,0.29,1,1,11,0,1,3,0,2,243,2
"org.apache.lucene.util.PagedBytes$Reader",8,0.46,2.12,111,1.63,164324.82,13,5,6,12,2,47.21,67,123,0,1,95.31,0.00,0.00,0.60,0,0.00,4,4887.23,0,0,2,java.lang.Object,0.00,4,0,17,0,4,8,0,17,925,3
"org.apache.lucene.util.PrintStreamInfoStream",6,0.07,1.17,18,0.21,3413.50,9,3,4,13,3,131.47,4,29,2,2,131.47,0.00,0.50,0.28,0,10.00,2,635.22,0,0,1,org.apache.lucene.util.InfoStream,0.00,7,1,7,0,7,6,0,2,157,1
"org.apache.lucene.util.PriorityQueue",14,0.13,1.93,95,0.83,40505.46,17,3,0,14,47,66.09,142,117,47,1,114.56,0.00,0.00,0.45,5,0.00,6,2490.87,0,1,0,java.lang.Object,0.00,0,0,27,35,0,13,0,39,558,2
"org.apache.lucene.util.RamUsageEstimator",0,0.00,0.00,2,0.01,90.00,0,0,5,0,69,171.00,12,2,69,1,171.00,0.00,0.00,0.00,0,0.00,0,30.00,0,0,0,java.lang.Object,0.00,0,0,0,0,0,0,0,2,10,2
"org.apache.lucene.util.RamUsageEstimator$JvmFeature",2,0.90,30.00,237,5.67,1291869.90,23,21,5,80,2,96.88,160,313,0,1,47.18,0.00,0.00,0.50,0,2.00,59,16996.26,1,1,2,java.lang.Object,0.00,78,0,60,0,78,1,0,76,2123,2
"org.apache.lucene.util.RamUsageEstimator$JvmFeature$ClassCache",1,2.00,1.00,6,0.05,779.87,3,2,5,1,0,119.20,0,8,0,1,119.20,0.00,0.00,0.00,0,1.00,1,148.02,0,0,0,java.lang.Object,0.00,0,0,1,0,0,1,0,0,40,3
"org.apache.lucene.util.RamUsageEstimator$JvmFeature$IdentityHashSet",14,0.03,1.79,86,0.96,40665.27,20,6,5,19,0,114.80,65,109,0,1,114.57,0.00,0.00,0.19,6,86.00,4,2882.58,0,1,0,java.lang.Object,0.00,5,0,25,0,5,13,1,19,608,2
"org.apache.lucene.util.RamUsageEstimator$JvmFeature$IdentityHashSet$Iterator<KType>",4,0.33,1.75,18,0.18,5903.62,6,2,5,6,0,123.46,0,28,0,1,123.46,0.00,0.00,0.25,0,8.00,3,543.45,0,1,0,java.lang.Object,0.00,2,0,7,0,2,3,0,0,129,0
"org.apache.lucene.util.RamUsageEstimator$JvmFeature$SuppressWarnings",0,0.00,0.00,2,0.02,257.00,1,1,5,0,0,171.00,0,4,0,1,171.00,0.00,0.00,0.00,0,0.00,0,57.11,0,0,0,java.lang.Object,0.00,0,0,0,0,0,0,0,0,15,3
"org.apache.lucene.util.RamUsageEstimator$JvmFeature$SuppressWarnings_0",0,0.00,0.00,2,0.02,281.30,2,2,5,0,0,171.00,0,4,0,1,171.00,0.00,0.00,0.00,0,0.00,0,62.51,0,0,0,java.lang.Object,0.00,0,0,0,0,0,0,0,0,16,3
"org.apache.lucene.util.ReaderUtil",5,0.00,3.00,36,0.46,43051.18,5,0,7,8,35,58.24,46,58,30,1,108.24,0.00,0.00,0.00,0,5.00,5,1378.06,0,1,5,java.lang.Object,0.00,3,0,15,0,3,4,0,20,290,2
"org.apache.lucene.util.ReaderUtil$Gather",1,0.00,1.00,3,0.03,300.11,1,0,7,2,1,133.69,0,5,0,1,133.69,0.00,0.00,0.00,0,1.00,1,80.14,0,0,1,java.lang.Object,0.00,1,0,1,0,1,1,0,0,23,0
"org.apache.lucene.util.ReaderUtil$Gather_0",5,0.50,1.40,22,0.21,9254.27,6,1,7,7,3,122.73,1,26,0,1,122.73,0.00,0.00,0.60,2,2.00,3,620.09,0,0,3,java.lang.Object,0.00,2,0,7,0,2,5,0,1,142,3
"org.apache.lucene.util.ReaderUtil$Slice",2,0.25,1.00,11,0.11,2147.98,6,4,7,2,0,121.06,0,15,0,1,121.06,0.00,0.00,0.38,0,2.00,1,328.38,0,1,0,java.lang.Object,0.00,0,0,2,0,0,1,0,0,85,2
"org.apache.lucene.util.RecyclingByteBlockAllocator",9,0.12,1.67,64,0.69,38603.47,14,5,2,15,6,68.46,67,78,3,2,110.75,0.00,0.50,0.31,0,6.00,4,2082.93,0,0,3,ByteBlockPool.Allocator,0.00,6,1,15,0,6,9,0,9,427,2
"org.apache.lucene.util.RollingCharBuffer",6,0.43,2.17,66,0.83,61717.48,12,6,2,9,4,100.62,29,80,2,1,100.38,0.00,0.00,0.53,2,0.00,6,2480.83,0,0,2,java.lang.Object,0.00,3,0,13,0,3,6,0,18,490,2
"org.apache.lucene.util.ScorerDocQueue",16,0.20,1.50,94,0.88,40118.98,20,4,3,23,3,138.68,63,116,1,1,118.07,0.00,0.00,0.44,5,0.00,4,2629.31,0,2,2,java.lang.Object,0.00,7,0,24,0,7,14,0,33,597,1
"org.apache.lucene.util.ScorerDocQueue$HeapedScorerDoc",3,0.25,1.00,10,0.06,590.42,5,2,3,4,1,135.14,0,9,0,1,135.14,0.00,0.00,0.33,0,4.00,1,184.69,0,0,1,java.lang.Object,0.00,1,0,3,0,1,3,0,0,56,1
"org.apache.lucene.util.SentinelIntSet",9,0.22,2.44,72,0.80,54238.48,13,4,1,12,19,157.34,14,80,18,1,107.34,0.00,0.00,0.44,5,0.00,6,2390.17,0,0,1,java.lang.Object,0.00,3,0,22,0,3,9,0,6,501,1
"org.apache.lucene.util.SetOnce",4,0.00,1.25,16,0.13,2346.76,6,2,1,7,4,78.21,40,22,4,1,126.69,0.00,0.00,0.50,0,0.00,2,396.73,0,0,0,java.lang.Object,0.00,3,0,5,0,3,4,0,7,99,2
"org.apache.lucene.util.SetOnce$AlreadySetException",1,0.00,1.00,3,0.02,116.92,1,0,1,1,0,136.92,0,5,0,2,136.92,0.00,0.50,0.00,0,1.00,1,46.46,0,0,0,java.lang.RuntimeException,0.00,0,1,1,0,0,1,0,0,16,3
"org.apache.lucene.util.SlowRAMDirectory",5,0.08,2.00,26,0.31,8557.44,8,3,6,11,7,159.19,12,39,2,3,119.31,0.00,0.67,0.27,0,2.00,4,940.98,2,2,5,org.apache.lucene.store.RAMDirectory,0.00,6,2,10,0,6,3,0,4,209,1
"org.apache.lucene.util.SlowRAMDirectory$SlowIndexInput",10,0.06,1.20,32,0.29,5991.85,12,2,6,20,1,131.29,0,33,0,3,131.29,0.00,0.67,0.55,0,0.00,2,866.68,0,1,1,org.apache.lucene.store.IndexInput,0.75,10,2,12,0,10,9,0,0,220,1
"org.apache.lucene.util.SlowRAMDirectory$SlowIndexOutput",8,0.07,1.25,27,0.24,5199.93,10,2,6,16,1,131.00,0,30,0,3,131.00,0.00,0.67,0.56,0,0.00,2,734.93,0,0,1,org.apache.lucene.store.IndexOutput,0.84,8,2,10,0,8,8,0,0,184,1
"org.apache.lucene.util.SmallFloat",6,0.00,3.00,42,0.66,31568.65,6,0,0,8,5,59.92,59,56,5,1,109.92,0.00,0.00,0.00,0,6.00,4,1981.84,0,0,0,java.lang.Object,0.00,2,0,18,0,2,6,0,24,399,1
"org.apache.lucene.util.SmartRandom",2,1.00,1.50,9,0.07,1056.93,3,1,1,4,0,147.62,6,14,0,2,127.01,0.00,0.50,0.50,0,2.00,2,213.87,1,0,0,java.util.Random,0.00,2,1,3,0,2,2,0,3,55,1
"org.apache.lucene.util.SortedVIntList",10,0.05,1.40,49,0.45,11155.73,17,7,4,16,3,124.70,49,63,1,2,124.47,0.00,0.50,0.10,0,26.00,2,1345.70,0,1,2,org.apache.lucene.search.DocIdSet,0.00,6,1,14,0,6,9,0,11,312,1
"org.apache.lucene.util.SortedVIntList$DocIdSetIterator",4,0.44,2.00,28,0.22,6013.84,7,3,4,4,0,114.30,1,36,0,1,114.30,0.00,0.00,0.67,1,0.00,3,654.83,0,0,0,java.lang.Object,0.00,0,0,8,0,0,4,0,1,154,0
"org.apache.lucene.util.SortedVIntList$SortedVIntListBuilder",3,0.50,2.00,19,0.20,9671.38,4,1,4,7,1,164.19,4,27,0,1,114.19,0.00,0.00,0.67,0,0.00,4,585.58,0,0,1,java.lang.Object,0.00,4,0,6,0,4,3,0,4,122,1
"org.apache.lucene.util.SorterTemplate",12,0.45,3.08,119,1.25,106557.96,14,2,0,13,4,124.67,41,143,4,1,104.05,0.00,0.00,0.08,8,32.00,10,3745.47,0,0,0,java.lang.Object,0.00,1,0,37,0,1,12,0,12,786,2
"org.apache.lucene.util.StoreClassNameRule",2,1.00,2.00,11,0.10,2530.04,3,1,3,7,0,170.34,3,17,0,1,120.34,0.00,0.00,0.50,0,2.00,2,311.53,0,2,0,java.lang.Object,0.00,5,0,4,0,5,0,1,1,73,1
"org.apache.lucene.util.StoreClassNameRule$Statement",1,0.00,1.00,6,0.04,786.04,1,0,3,2,0,119.17,0,10,0,1,119.17,0.00,0.00,0.00,0,0.00,1,120.59,0,0,0,java.lang.Object,0.00,1,0,1,0,1,1,0,0,31,0
"org.apache.lucene.util.StressRamUsageEstimator",6,1.00,3.17,80,1.03,40721.18,7,1,10,28,1,138.89,16,92,0,2,99.01,0.00,0.50,0.17,2,10.00,5,3083.47,0,0,1,LuceneTestCase,0.00,22,1,19,0,22,6,0,10,576,1
"org.apache.lucene.util.StressRamUsageEstimator$Entry",1,1.00,1.00,9,0.06,1425.84,3,2,10,2,0,110.57,0,12,0,1,110.57,0.00,0.00,0.50,0,0.00,1,175.74,0,1,0,java.lang.Object,0.00,1,0,1,0,1,0,0,0,48,1
"org.apache.lucene.util.StringHelper",7,0.00,2.00,33,0.44,25794.86,7,0,2,9,39,78.01,55,47,38,1,120.30,0.00,0.00,0.00,1,7.00,4,1332.62,0,1,1,java.lang.Object,0.00,2,0,14,0,2,6,0,6,289,2
"org.apache.lucene.util.StringHelper$Comparator<String>",1,0.00,8.00,16,0.20,14054.74,1,0,2,5,0,132.83,2,23,0,1,92.94,0.00,0.00,0.00,0,1.00,8,614.89,0,0,0,java.lang.Object,0.00,4,0,8,0,4,1,0,2,125,0
"org.apache.lucene.util.SuppressWarnings",1,0.00,1.00,4,0.08,1328.49,1,0,0,2,3,170.49,77,23,3,1,123.95,0.00,0.00,0.00,0,1.00,1,228.60,0,0,0,java.lang.Object,0.00,1,0,1,0,1,1,0,14,56,1
"org.apache.lucene.util.SystemPropertiesInvariantRule",4,1.00,1.00,10,0.11,1917.00,5,1,12,7,3,159.28,12,16,3,1,138.66,0.00,0.00,0.00,0,4.00,1,338.86,0,1,0,java.lang.Object,0.00,3,0,4,0,3,3,1,4,88,1
"org.apache.lucene.util.SystemPropertiesInvariantRule$Statement",2,0.00,6.00,48,0.90,89223.28,2,0,12,25,1,132.49,2,71,0,1,82.49,0.00,0.00,0.00,0,2.00,9,2689.85,0,0,1,java.lang.Object,0.00,23,0,12,0,23,2,0,2,476,0
"org.apache.lucene.util.SystemPropertiesRestoreRule",6,1.00,2.67,38,0.50,24236.88,7,1,4,21,9,133.96,21,53,9,1,113.35,0.00,0.00,0.00,0,6.00,6,1501.12,0,2,0,java.lang.Object,0.00,15,0,16,0,15,4,1,11,312,1
"org.apache.lucene.util.SystemPropertiesRestoreRule$Statement",1,0.00,2.00,8,0.10,3947.61,1,0,4,6,0,158.83,1,13,0,1,108.83,0.00,0.00,0.00,0,0.00,2,309.19,0,0,0,java.lang.Object,0.00,5,0,2,0,5,1,0,1,66,0
"org.apache.lucene.util.TermContext",9,0.00,1.67,56,0.71,33776.12,13,4,10,22,51,81.49,60,73,42,1,113.71,0.00,0.00,0.25,1,19.00,5,2124.93,0,2,9,java.lang.Object,0.00,13,0,15,0,13,7,0,15,425,2
"org.apache.lucene.util.TestArrayUtil",13,0.00,2.69,175,2.20,106956.19,13,0,2,39,2,148.39,18,182,0,2,98.39,0.00,0.50,0.00,2,13.00,8,6609.90,0,2,2,LuceneTestCase,0.00,26,1,35,0,26,11,0,18,1314,1
"org.apache.lucene.util.TestArrayUtil$Item",3,0.50,1.00,9,0.08,1153.37,5,2,2,4,0,132.85,0,14,0,1,132.85,0.00,0.00,0.17,0,4.00,1,231.60,0,1,0,java.lang.Object,0.00,1,0,3,0,1,2,1,0,65,1
"org.apache.lucene.util.TestAttributeSource",5,0.00,2.00,93,1.38,62745.23,5,0,3,30,9,131.63,10,109,0,2,91.74,0.00,0.50,0.00,0,5.00,4,4142.05,0,0,9,LuceneTestCase,0.00,25,1,10,0,25,5,0,10,761,1
"org.apache.lucene.util.TestBitUtil",8,0.00,2.00,96,1.07,65824.35,8,0,0,16,1,99.75,2,100,0,2,99.75,0.00,0.50,0.00,3,8.00,3,3215.49,0,0,1,LuceneTestCase,0.00,8,1,16,0,8,8,0,2,654,1
"org.apache.lucene.util.TestByteBlockPool",1,0.00,4.00,36,0.51,26623.39,1,0,7,24,5,86.91,17,39,0,2,77.78,0.00,0.50,0.00,0,1.00,4,1525.83,0,0,5,LuceneTestCase,0.00,23,1,4,0,23,1,0,2,250,1
"org.apache.lucene.util.TestBytesRef",3,0.00,1.33,24,0.27,6140.21,3,0,0,10,1,93.30,17,26,0,2,111.17,0.00,0.50,0.00,0,3.00,2,814.55,0,0,1,LuceneTestCase,0.00,7,1,4,0,7,3,0,2,177,1
"org.apache.lucene.util.TestBytesRefHash",11,0.00,3.55,254,3.38,255089.63,13,2,11,53,4,106.15,34,263,0,2,85.54,0.00,0.50,0.50,2,0.00,5,10127.65,1,2,4,LuceneTestCase,0.00,42,1,39,0,42,9,0,12,1756,1
"org.apache.lucene.util.TestCharsRef",3,0.00,2.33,46,0.55,20486.58,3,0,1,21,2,78.87,16,42,0,2,96.74,0.00,0.50,0.00,0,3.00,3,1644.23,0,0,2,LuceneTestCase,0.00,18,1,7,0,18,3,0,1,319,1
"org.apache.lucene.util.TestCloseableThreadLocal",3,1.00,1.00,14,0.15,2818.80,4,1,0,10,1,175.13,4,19,0,2,125.13,0.00,0.50,0.33,0,4.00,1,463.29,0,0,1,LuceneTestCase,0.00,7,1,3,0,7,3,0,4,111,1
"org.apache.lucene.util.TestCloseableThreadLocal$InitValueThreadLocal",1,0.00,1.00,3,0.02,222.62,1,0,0,1,1,134.72,0,6,0,2,134.72,0.00,0.50,0.00,0,0.00,1,65.07,0,1,1,org.apache.lucene.util.CloseableThreadLocal,0.29,0,1,1,0,0,0,0,0,20,1
"org.apache.lucene.util.TestCollectionUtil",6,0.00,1.67,84,1.00,46871.42,6,0,5,18,1,147.47,7,83,0,2,97.47,0.00,0.50,0.00,1,6.00,2,3010.64,0,1,1,LuceneTestCase,0.00,12,1,10,0,12,5,0,7,622,1
"org.apache.lucene.util.TestDoubleBarrelLRUCache",4,0.33,3.25,68,0.71,57433.30,6,2,1,15,1,131.98,8,55,0,2,92.09,0.00,0.50,0.25,1,6.00,7,2129.01,0,0,1,org.apache.lucene.util.LuceneTestCase,0.00,11,1,13,0,11,4,0,8,419,1
"org.apache.lucene.util.TestDoubleBarrelLRUCache$CacheThread",2,0.50,3.50,30,0.35,17834.06,6,4,1,8,1,95.73,0,41,0,2,95.73,0.00,0.50,0.50,0,2.00,6,1046.59,0,0,1,java.lang.Thread,0.00,6,1,7,0,6,2,0,0,199,1
"org.apache.lucene.util.TestDoubleBarrelLRUCache$CloneableInteger",4,0.33,1.00,10,0.09,1343.94,5,1,1,6,0,139.88,0,18,0,2,139.88,0.00,0.50,0.75,1,0.00,1,284.06,0,1,0,DoubleBarrelLRUCache.CloneableKey,0.00,2,1,4,0,2,3,0,0,78,2
"org.apache.lucene.util.TestDoubleBarrelLRUCache$CloneableObject",4,0.33,1.00,10,0.09,1312.38,5,1,1,6,0,139.96,0,18,0,2,139.96,0.00,0.50,0.75,1,0.00,1,282.44,0,1,0,DoubleBarrelLRUCache.CloneableKey,0.00,2,1,4,0,2,3,0,0,78,2
"org.apache.lucene.util.TestFieldCacheSanityChecker",5,0.54,1.60,86,1.36,58811.27,12,7,13,30,11,142.94,5,103,0,2,92.94,0.00,0.50,0.57,0,0.00,3,4069.65,2,0,11,LuceneTestCase,0.00,25,1,8,0,25,5,0,5,719,1
"org.apache.lucene.util.TestFixedBitSet",15,0.00,2.80,215,2.93,322898.21,15,0,3,55,2,143.89,21,211,0,2,93.89,0.00,0.50,0.00,10,15.00,6,8784.07,0,2,2,LuceneTestCase,0.00,40,1,42,0,40,13,0,16,1620,1
"org.apache.lucene.util.TestIOUtils",1,0.00,10.00,36,0.54,26718.23,1,0,4,18,2,117.44,2,52,0,2,77.56,0.00,0.50,0.00,0,1.00,10,1626.37,0,0,2,LuceneTestCase,0.00,17,1,10,0,17,1,0,2,285,1
"org.apache.lucene.util.TestIOUtils$BrokenCloseable",2,1.00,1.00,6,0.05,720.92,3,1,4,3,0,133.07,0,10,0,1,133.07,0.00,0.00,0.50,0,2.00,1,150.05,0,0,0,java.lang.Object,0.00,1,0,2,0,1,2,1,0,42,2
"org.apache.lucene.util.TestIOUtils$TestException",1,0.00,1.00,3,0.01,94.05,1,0,4,1,0,137.66,0,5,0,2,137.66,0.00,0.50,0.00,0,1.00,1,42.11,0,0,0,java.lang.Exception,0.00,0,1,1,0,0,1,0,0,15,2
"org.apache.lucene.util.TestIdentityHashSet",1,0.00,3.00,23,0.32,14407.75,1,0,3,10,0,137.20,1,26,0,2,87.20,0.00,0.50,0.00,0,1.00,3,948.20,0,0,0,LuceneTestCase,0.00,9,1,3,0,9,1,0,1,173,1
"org.apache.lucene.util.TestNamedSPILoader",3,0.00,1.33,11,0.10,1252.88,3,0,2,10,1,100.28,19,16,0,2,132.50,0.00,0.50,0.00,0,3.00,2,297.45,0,0,1,LuceneTestCase,0.00,7,1,4,0,7,3,0,4,76,1
"org.apache.lucene.util.TestNumericUtils",16,2.00,3.31,216,4.48,291031.20,18,2,4,53,6,116.24,55,395,2,2,95.63,0.00,0.50,0.00,4,16.00,8,13438.46,0,0,4,LuceneTestCase,0.00,37,1,53,0,37,16,0,55,2447,1
"org.apache.lucene.util.TestNumericUtils$NumericUtils.IntRangeBuilder",1,0.00,5.00,15,0.24,15087.12,1,0,4,8,0,114.47,3,16,0,1,93.85,0.00,0.00,0.00,0,1.00,5,717.00,0,0,0,java.lang.Object,0.00,7,0,5,0,7,1,0,3,133,0
"org.apache.lucene.util.TestNumericUtils$NumericUtils.LongRangeBuilder",1,0.00,5.00,15,0.25,16009.71,1,0,4,9,0,114.27,3,16,0,1,93.65,0.00,0.00,0.00,0,1.00,5,751.04,0,0,0,java.lang.Object,0.00,8,0,5,0,8,1,0,3,137,0
"org.apache.lucene.util.TestOpenBitSet",17,0.00,2.24,231,3.22,304516.17,17,0,2,67,3,145.77,20,234,0,2,95.77,0.00,0.50,0.00,13,17.00,6,9664.11,0,2,3,LuceneTestCase,0.00,50,1,38,0,50,15,0,15,1781,1
"org.apache.lucene.util.TestPagedBytes",3,0.00,4.67,93,1.48,110901.67,3,0,5,28,4,129.04,4,90,0,2,79.04,0.00,0.50,0.00,0,3.00,8,4436.96,0,0,4,LuceneTestCase,0.00,25,1,14,0,25,3,0,4,731,1
"org.apache.lucene.util.TestPriorityQueue",5,0.00,1.40,59,0.63,23943.94,5,0,1,18,1,153.10,9,63,0,2,103.10,0.00,0.50,0.00,1,5.00,3,1897.11,0,0,1,LuceneTestCase,0.00,13,1,7,0,13,5,0,9,391,1
"org.apache.lucene.util.TestPriorityQueue$IntegerQueue",2,0.00,1.00,5,0.04,579.81,2,0,1,2,1,140.38,0,9,0,2,140.38,0.00,0.50,0.00,0,2.00,1,129.83,0,0,1,org.apache.lucene.util.PriorityQueue,0.00,0,1,2,0,0,2,0,0,38,2
"org.apache.lucene.util.TestRamUsageEstimator",3,0.00,2.33,48,0.80,40496.42,3,0,2,13,3,93.36,0,79,0,2,93.36,0.00,0.50,0.00,0,3.00,5,2385.46,0,0,3,LuceneTestCase,0.00,10,1,7,0,10,3,0,0,489,1
"org.apache.lucene.util.TestRamUsageEstimator$HolderSubclass2",0,0.00,0.00,1,0.01,49.13,0,0,2,0,0,171.00,1,2,0,2,171.00,0.00,0.50,0.00,0,0.00,0,19.65,0,0,0,Holder,0.00,0,1,0,0,0,0,0,1,7,2
"org.apache.lucene.util.TestRamUsageEstimator$SuppressWarnings",2,6.00,1.00,9,0.07,954.73,8,6,2,2,0,127.45,0,11,0,1,127.45,0.00,0.00,0.00,0,2.00,1,211.04,0,0,0,java.lang.Object,0.00,0,0,2,0,0,2,0,0,54,2
"org.apache.lucene.util.TestRamUsageEstimator$SuppressWarnings_0",0,0.00,0.00,3,0.03,320.00,2,2,2,0,0,171.00,0,5,0,2,171.00,0.00,0.50,0.00,0,0.00,0,80.00,0,0,0,Holder,0.00,0,1,0,0,0,0,0,0,20,2
"org.apache.lucene.util.TestRamUsageEstimatorOnWildAnimals",1,0.00,5.00,21,0.21,10583.45,1,0,1,4,1,89.85,4,25,0,2,89.62,0.00,0.50,0.00,0,1.00,5,624.97,0,0,1,LuceneTestCase,0.00,3,1,5,0,3,1,0,2,123,1
"org.apache.lucene.util.TestRamUsageEstimatorOnWildAnimals$ListElement",0,0.00,0.00,2,0.01,105.28,1,1,1,0,0,171.00,0,3,0,1,171.00,0.00,0.00,0.00,0,0.00,0,28.07,0,0,0,java.lang.Object,0.00,0,0,0,0,0,0,0,0,10,2
"org.apache.lucene.util.TestRecyclingByteBlockAllocator",5,0.00,2.80,104,1.43,99993.99,5,0,6,24,1,88.60,23,101,0,2,88.36,0.00,0.50,0.00,1,5.00,5,4277.83,1,1,1,LuceneTestCase,0.00,19,1,14,0,19,4,0,5,748,1
"org.apache.lucene.util.TestRollingCharBuffer",1,0.00,16.00,53,0.84,103068.34,1,0,1,17,1,87.18,3,66,0,2,66.57,0.00,0.50,0.00,0,1.00,16,2515.96,0,0,1,LuceneTestCase,0.00,16,1,16,0,16,1,0,3,405,1
"org.apache.lucene.util.TestSentinelIntSet",2,0.00,3.00,41,0.55,33309.86,2,0,2,17,1,128.86,5,40,0,2,88.97,0.00,0.50,0.00,0,2.00,4,1655.59,0,0,1,LuceneTestCase,0.00,15,1,6,0,15,2,0,2,302,1
"org.apache.lucene.util.TestSetOnce",4,0.00,2.25,35,0.51,22318.99,4,0,3,18,1,107.62,0,42,0,2,107.62,0.00,0.50,0.00,0,4.00,6,1542.66,0,0,1,LuceneTestCase,0.00,14,1,9,0,14,4,0,0,304,1
"org.apache.lucene.util.TestSetOnce$SetOnceThread",2,0.67,2.00,12,0.15,2521.35,5,3,3,11,1,157.28,4,20,0,2,117.40,0.00,0.50,0.67,0,0.00,3,436.38,0,0,1,java.lang.Thread,0.00,9,1,4,0,9,2,0,4,97,3
"org.apache.lucene.util.TestSmallFloat",5,0.00,3.40,72,1.04,50226.60,5,0,0,17,1,52.32,59,83,0,2,96.45,0.00,0.50,0.00,2,5.00,5,3109.45,0,0,1,LuceneTestCase,0.00,12,1,17,0,12,5,0,28,580,1
"org.apache.lucene.util.TestSortedVIntList",28,0.11,1.57,130,1.39,61436.47,33,5,3,40,2,122.13,7,158,0,2,122.13,0.00,0.50,0.09,8,216.00,5,4176.22,0,0,2,LuceneTestCase,0.00,12,1,44,0,12,28,0,7,941,1
"org.apache.lucene.util.TestTwoPhaseCommitTool",5,0.00,2.60,62,0.70,30902.30,5,0,4,16,2,140.56,13,67,0,2,100.67,0.00,0.50,0.00,0,5.00,5,2107.15,1,0,2,LuceneTestCase,0.00,11,1,13,0,11,5,0,13,417,1
"org.apache.lucene.util.TestTwoPhaseCommitTool$TwoPhaseCommitImpl",6,0.00,1.50,30,0.27,5869.45,13,7,4,10,1,121.28,0,41,0,1,121.28,0.00,0.00,0.14,2,14.00,2,817.32,0,0,1,java.lang.Object,0.00,4,0,9,0,4,6,1,0,193,2
"org.apache.lucene.util.TestUnicodeUtil",4,0.00,3.50,80,1.29,79673.07,4,0,0,31,5,114.61,79,88,0,2,88.33,0.00,0.50,0.00,0,4.00,6,3856.99,0,0,5,LuceneTestCase,0.00,27,1,14,0,27,4,0,5,673,1
"org.apache.lucene.util.TestVersion",1,0.00,2.00,8,0.10,2721.97,1,0,0,6,0,110.10,0,10,0,2,110.10,0.00,0.50,0.00,0,1.00,2,309.83,0,0,0,LuceneTestCase,0.00,5,1,2,0,5,1,0,0,72,1
"org.apache.lucene.util.TestVersionComparator",1,0.00,1.00,21,0.38,23077.28,1,0,1,5,1,107.93,3,23,0,2,87.32,0.00,0.50,0.00,0,1.00,1,1143.95,0,0,1,LuceneTestCase,0.00,4,1,1,0,4,1,0,1,226,1
"org.apache.lucene.util.TestVirtualMethod",4,0.17,2.00,40,0.59,20284.98,6,2,0,13,4,86.49,22,55,3,2,104.36,2.00,0.25,0.38,0,4.00,5,1761.81,0,0,1,LuceneTestCase,0.00,9,1,8,2,9,4,0,7,364,1
"org.apache.lucene.util.TestVirtualMethod$TestClass1",2,0.00,1.00,3,0.03,183.18,2,0,0,2,1,155.55,0,6,0,3,155.55,0.00,0.67,0.00,0,2.00,1,78.91,0,0,1,org.apache.lucene.util.TestVirtualMethod,0.50,0,2,2,0,0,2,0,0,26,1
"org.apache.lucene.util.TestVirtualMethod$TestClass2",1,0.00,1.00,2,0.02,107.10,1,0,0,1,0,193.79,1,4,0,2,143.79,0.00,0.50,0.00,0,1.00,1,47.21,0,0,0,org.apache.lucene.util.TestClass1,0.00,0,1,1,0,0,1,0,1,16,1
"org.apache.lucene.util.TestVirtualMethod$TestClass3",1,0.00,1.00,2,0.02,107.10,1,0,0,1,0,143.79,0,4,0,2,143.79,0.00,0.50,0.00,0,1.00,1,47.21,0,0,0,org.apache.lucene.util.TestClass2,0.00,0,1,1,0,0,1,0,0,16,1
"org.apache.lucene.util.TestVirtualMethod$TestClass4",0,0.00,0.00,1,0.01,31.02,0,0,0,0,1,171.00,0,2,0,3,171.00,0.00,0.67,0.00,0,0.00,0,15.51,0,0,1,org.apache.lucene.util.TestVirtualMethod,0.00,0,2,0,0,0,0,0,0,6,1
"org.apache.lucene.util.TestVirtualMethod$TestClass5",0,0.00,0.00,1,0.01,31.02,0,0,0,0,0,171.00,0,2,0,2,171.00,0.00,0.50,0.00,0,0.00,0,15.51,0,0,0,org.apache.lucene.util.TestClass4,0.00,0,1,0,0,0,0,0,0,6,1
"org.apache.lucene.util.TestWeakIdentityMap",2,0.00,5.00,100,1.35,154835.86,2,0,6,29,1,50.88,10,97,0,2,68.76,0.00,0.50,0.00,0,2.00,7,4056.30,0,0,1,LuceneTestCase,0.00,27,1,10,0,27,2,0,10,691,1
"org.apache.lucene.util.TestWeakIdentityMap$Runnable",1,0.00,7.00,20,0.25,11621.25,1,0,6,12,0,140.01,1,26,0,1,90.01,0.00,0.00,0.00,0,1.00,7,750.80,0,0,0,java.lang.Object,0.00,11,0,7,0,11,1,0,1,137,0
"org.apache.lucene.util.ThreadInterruptedException",1,0.00,1.00,3,0.02,124.13,1,0,0,1,30,176.01,21,5,30,2,136.71,0.00,0.50,0.00,0,1.00,1,49.65,0,0,0,java.lang.RuntimeException,0.00,0,1,1,0,0,1,0,2,17,2
"org.apache.lucene.util.ThreeLongs",3,0.00,1.00,12,0.18,4881.93,6,3,0,7,1,80.96,23,17,1,1,123.25,0.00,0.00,0.33,0,4.00,1,532.66,0,2,0,java.lang.Object,0.00,4,0,3,0,4,1,0,2,127,0
"org.apache.lucene.util.ThrottledIndexOutput",16,0.05,1.25,69,0.75,18914.82,26,10,3,28,5,124.29,4,108,2,3,124.29,0.00,0.67,0.15,3,52.00,3,2242.88,0,1,3,org.apache.lucene.store.IndexOutput,0.73,12,2,20,0,12,15,0,2,517,1
"org.apache.lucene.util.ToStringUtils",3,0.00,2.00,14,0.15,4839.82,3,0,0,6,29,80.83,23,16,29,1,123.12,0.00,0.00,0.00,0,3.00,3,437.17,0,1,0,java.lang.Object,0.00,3,0,6,0,3,2,0,4,99,2
"org.apache.lucene.util.TwoPhaseCommit",5,0.00,1.00,6,0.05,456.14,5,0,2,5,7,111.44,58,7,7,1,155.56,0.00,0.00,0.00,0,5.00,1,160.16,0,0,0,,0.00,0,0,5,0,0,5,0,7,51,1
"org.apache.lucene.util.TwoPhaseCommitTool",2,0.00,5.50,32,0.29,19519.17,2,0,2,7,2,114.43,66,40,1,1,94.28,0.00,0.00,0.00,1,2.00,7,864.47,0,0,1,java.lang.Object,0.00,5,0,11,0,5,2,0,15,180,2
"org.apache.lucene.util.TwoPhaseCommitTool$CommitFailException",1,0.00,1.00,4,0.03,257.28,1,0,2,2,1,129.56,0,6,0,2,129.56,0.00,0.50,0.00,0,1.00,1,86.26,0,0,1,java.io.IOException,0.00,1,1,1,0,1,1,0,0,25,2
"org.apache.lucene.util.TwoPhaseCommitTool$PrepareCommitFailException",1,0.00,1.00,4,0.03,257.28,1,0,2,2,1,129.56,0,6,0,2,129.56,0.00,0.50,0.00,0,1.00,1,86.26,0,0,1,java.io.IOException,0.00,1,1,1,0,1,1,0,0,25,2
"org.apache.lucene.util.TwoPhaseCommitTool$TwoPhaseCommitWrapper",6,0.10,1.00,16,0.16,2627.96,8,2,2,9,1,138.97,0,23,0,1,138.97,0.00,0.00,0.42,2,10.00,1,467.37,0,0,1,java.lang.Object,0.00,3,0,6,0,3,6,1,0,124,3
"org.apache.lucene.util.UncaughtExceptionsRule",6,0.20,1.33,24,0.21,4176.79,9,3,10,12,1,176.09,11,35,0,1,126.09,0.00,0.00,0.17,0,14.00,3,628.12,0,1,1,java.lang.Object,0.00,6,0,8,0,6,5,1,5,152,1
"org.apache.lucene.util.UncaughtExceptionsRule$Statement",1,0.00,5.00,19,0.19,9156.44,1,0,10,10,0,131.62,2,26,0,1,91.73,0.00,0.00,0.00,0,0.00,5,561.48,0,0,0,java.lang.Object,0.00,9,0,5,0,9,1,0,2,106,0
"org.apache.lucene.util.UncaughtExceptionsRule$SuppressWarnings",1,0.00,1.00,3,0.03,375.83,1,0,10,1,0,132.92,0,6,0,2,132.92,0.00,0.50,0.00,0,1.00,1,100.96,0,0,0,java.lang.RuntimeException,0.00,0,1,1,0,0,1,0,0,28,2
"org.apache.lucene.util.UncaughtExceptionsRule$Thread.UncaughtExceptionHandler",1,0.00,4.00,20,0.27,9637.25,1,0,10,16,0,130.66,2,25,0,1,90.78,0.00,0.00,0.00,0,0.00,4,821.19,0,0,0,java.lang.Object,0.00,15,0,4,0,15,1,0,2,146,0
"org.apache.lucene.util.UncaughtExceptionsRule$UncaughtExceptionEntry",1,2.00,1.00,6,0.04,570.78,3,2,10,1,0,120.27,0,8,0,1,120.27,0.00,0.00,0.00,0,1.00,1,130.51,0,0,0,java.lang.Object,0.00,0,0,1,0,0,1,0,0,37,2
"org.apache.lucene.util.UnicodeUtil",12,0.06,5.67,265,5.51,790506.12,29,17,0,27,79,108.86,233,336,76,1,82.58,0.00,0.00,0.11,1,84.00,8,16537.26,0,2,4,java.lang.Object,0.00,15,0,68,0,15,10,0,69,2838,2
"org.apache.lucene.util.UnsafeByteArrayInputStream",10,0.14,1.10,28,0.25,3710.71,14,4,3,10,2,91.41,84,44,2,2,139.52,0.00,0.50,0.38,1,0.00,2,752.88,0,0,0,java.io.InputStream,0.00,0,1,11,0,0,10,0,9,196,1
"org.apache.lucene.util.UnsafeByteArrayInputStreamTest",5,0.00,3.20,95,1.10,75853.11,5,0,5,15,1,110.72,17,96,0,2,90.11,0.00,0.50,0.00,0,5.00,5,3304.62,0,0,1,org.apache.lucene.util.LuceneTestCase,0.00,10,1,16,0,10,5,0,2,628,1
"org.apache.lucene.util.UnsafeByteArrayOutputStream",11,0.03,1.36,40,0.38,10361.55,14,3,2,13,3,79.71,106,57,3,2,129.71,0.00,0.50,0.30,2,26.00,3,1151.04,0,0,0,java.io.OutputStream,0.00,2,1,15,0,2,11,0,20,271,1
"org.apache.lucene.util.UnsafeByteArrayOutputStreamTest",7,0.00,4.29,170,1.69,123715.18,7,0,4,14,1,125.62,18,139,0,2,85.73,0.00,0.50,0.00,0,7.00,7,5065.44,0,0,1,org.apache.lucene.util.LuceneTestCase,0.00,7,1,30,0,7,7,0,3,974,1
"org.apache.lucene.util.Vint8",6,1.00,3.83,81,1.26,120847.86,7,1,4,9,4,94.77,98,96,4,1,95.24,0.00,0.00,0.00,0,6.00,5,3772.56,0,0,0,java.lang.Object,0.00,3,0,23,0,3,6,0,11,746,1
"org.apache.lucene.util.Vint8$Position",2,1.00,1.00,5,0.03,236.45,3,1,4,2,0,125.58,11,8,0,1,143.45,0.00,0.00,0.00,0,2.00,1,79.51,0,0,0,java.lang.Object,0.00,0,0,2,0,0,2,0,4,26,2
"org.apache.lucene.util.Vint8Test",5,0.25,2.20,57,0.84,42369.45,8,3,6,15,1,56.91,55,65,0,2,101.04,0.00,0.50,0.53,0,0.00,3,2513.54,0,0,1,org.apache.lucene.util.LuceneTestCase,0.00,10,1,11,0,10,5,0,9,502,1
"org.apache.lucene.util.VirtualMethod",5,0.00,3.80,36,0.63,26981.99,10,5,4,22,3,72.22,63,53,2,1,109.78,0.00,0.00,0.20,2,14.00,8,1899.90,0,0,1,java.lang.Object,0.00,17,0,19,0,17,5,0,8,374,2
"org.apache.lucene.util.WeakIdentityMap",11,0.15,1.27,35,0.38,7874.00,13,2,6,23,5,170.55,22,49,5,1,130.67,0.00,0.00,0.36,2,0.00,3,1147.33,0,2,0,java.lang.Object,0.00,12,0,14,0,12,9,0,3,287,2
"org.apache.lucene.util.WeakIdentityMap$IdentityWeakReference",3,0.00,2.33,16,0.16,4123.63,5,2,6,6,0,120.02,1,23,0,2,120.02,0.00,0.50,0.50,0,1.00,4,478.97,0,0,0,java.lang.ref.WeakReference,0.00,3,1,7,0,3,3,0,1,113,3
"org.apache.lucene.util._TestUtil",37,0.15,3.73,449,8.91,611271.72,43,6,41,148,179,137.11,86,621,146,1,97.23,0.00,0.00,0.02,12,142.00,20,26733.33,0,24,33,java.lang.Object,0.00,111,0,138,0,111,13,0,56,4315,1
"org.apache.lucene.util._TestUtil$AttributeReflector",1,0.00,2.00,3,0.05,847.12,1,0,41,3,0,129.99,0,4,0,1,129.99,0.00,0.00,0.00,0,1.00,2,143.71,0,0,0,java.lang.Object,0.00,2,0,2,0,2,1,0,0,34,0
"org.apache.lucene.util._TestUtil$Lucene40Codec",1,0.00,1.00,3,0.02,175.12,1,0,41,1,1,135.54,0,5,0,1,135.54,0.00,0.00,0.00,0,1.00,1,54.60,0,1,1,java.lang.Object,0.00,0,0,1,0,0,0,0,0,17,0
"org.apache.lucene.util._TestUtil$TempFileLocker",0,0.00,0.00,1,0.01,38.77,0,0,41,0,0,171.00,0,1,0,1,171.00,0.00,0.00,0.00,0,0.00,0,15.51,0,0,0,java.lang.Object,0.00,0,0,0,0,0,0,0,0,6,2
"org.apache.lucene.analysis.lv.LatvianAnalyzer",5,0.50,1.20,21,0.25,5941.93,7,2,15,15,14,76.18,42,31,1,3,124.29,0.00,0.67,0.10,0,8.00,2,759.17,0,2,13,org.apache.lucene.analysis.util.StopwordAnalyzerBase,0.00,10,2,6,0,10,3,0,8,174,2
"org.apache.lucene.analysis.lv.LatvianAnalyzer$DefaultSetHolder",0,0.00,0.00,6,0.07,1089.77,1,1,15,0,4,171.00,2,11,0,1,171.00,0.00,0.00,0.00,0,0.00,0,202.05,0,0,4,java.lang.Object,0.00,0,0,0,0,0,0,0,2,47,2
"org.apache.lucene.analysis.lv.LatvianStemFilter",2,0.33,2.00,14,0.16,3794.18,5,3,6,9,10,113.74,9,20,4,4,113.50,0.00,0.75,0.50,0,2.00,3,481.98,0,0,6,org.apache.lucene.analysis.TokenFilter,0.29,7,3,4,0,7,2,0,1,107,2
"org.apache.lucene.analysis.lv.LatvianStemmer",3,1.00,7.00,70,1.36,103771.18,4,1,1,5,1,93.15,51,100,1,1,84.01,0.00,0.00,0.33,0,4.00,14,4089.23,0,0,0,java.lang.Object,0.00,2,0,21,0,2,3,0,11,746,1
"org.apache.lucene.analysis.lv.LatvianStemmer$Affix",1,3.00,1.00,8,0.06,700.70,4,3,1,2,0,135.52,3,10,0,1,114.90,0.00,0.00,0.00,0,1.00,1,178.75,0,0,0,java.lang.Object,0.00,1,0,1,0,1,1,0,3,48,1
"org.apache.lucene.analysis.lv.TestLatvianAnalyzer",4,0.00,1.00,15,0.16,2494.63,4,0,4,7,4,181.19,7,21,0,3,131.19,0.00,0.67,0.00,0,4.00,1,481.49,3,0,4,org.apache.lucene.analysis.BaseTokenStreamTestCase,0.00,3,2,4,0,3,4,0,6,114,1
"org.apache.lucene.analysis.lv.TestLatvianStemmer",10,0.00,1.00,187,1.80,58715.40,10,0,7,12,5,127.88,203,199,0,3,94.50,0.00,0.67,0.00,0,10.00,1,5398.20,2,0,5,org.apache.lucene.analysis.BaseTokenStreamTestCase,0.00,2,2,10,0,2,10,0,188,1128,1
"org.apache.lucene.analysis.lv.TestLatvianStemmer$Analyzer",1,0.00,1.00,4,0.05,1009.20,1,0,7,4,3,124.89,0,6,0,1,124.89,0.00,0.00,0.00,0,1.00,1,159.62,0,1,3,java.lang.Object,0.00,3,0,1,0,3,0,0,0,38,0
"org.apache.lucene.analysis.lv.TestLatvianStemmer$Analyzer_0",1,0.00,1.00,4,0.05,753.46,1,0,7,4,3,125.89,0,6,0,1,125.89,0.00,0.00,0.00,0,1.00,1,135.44,0,1,3,java.lang.Object,0.00,3,0,1,0,3,0,0,0,34,0
"org.apache.solr.common.params.AnalysisParams",0,0.00,0.00,7,0.09,1895.90,6,6,0,0,6,171.00,25,8,6,1,171.00,0.00,0.00,0.00,0,0.00,0,276.48,0,0,0,,0.00,0,0,0,0,0,0,0,8,62,1
"org.apache.solr.common.params.AppendedSolrParams",3,0.00,1.67,17,0.22,13890.62,3,0,0,5,2,155.83,8,25,1,3,115.94,0.00,0.67,0.00,0,1.00,3,647.21,0,2,2,org.apache.solr.common.params.DefaultSolrParams,0.08,2,2,5,0,2,1,0,2,146,1
"org.apache.solr.common.params.CommonParams",0,0.00,0.00,30,0.53,9195.78,28,28,1,0,101,171.00,53,30,101,1,171.00,0.00,0.00,0.00,0,0.00,0,1577.18,0,0,0,,0.00,0,0,0,0,0,0,0,32,260,1
"org.apache.solr.common.params.CommonParams$EchoParamStyle",1,11.00,5.00,23,0.32,8657.14,12,11,1,4,0,46.54,7,32,0,1,88.83,0.00,0.00,0.00,0,1.00,5,973.44,0,1,0,java.lang.Object,0.00,3,0,5,0,3,0,0,3,178,1
"org.apache.solr.common.params.CoreAdminParams",0,0.00,0.00,19,0.29,5066.16,17,17,1,0,10,171.00,21,20,10,1,171.00,0.00,0.00,0.00,0,0.00,0,884.19,0,0,0,,0.00,0,0,0,0,0,0,0,17,161,1
"org.apache.solr.common.params.CoreAdminParams$CoreAdminAction",1,0.00,3.00,7,0.09,1479.52,1,0,1,3,0,114.26,0,27,0,1,114.26,0.00,0.00,0.00,0,1.00,3,255.76,0,1,0,java.lang.Object,0.00,2,0,3,0,2,0,0,0,58,1
"org.apache.solr.common.params.DefaultSolrParams",5,0.38,1.40,21,0.25,8085.78,7,2,2,10,3,173.20,6,31,2,2,123.20,1.00,0.33,0.80,0,0.00,2,750.17,0,4,2,org.apache.solr.common.params.SolrParams,0.06,5,1,7,1,5,1,0,2,181,1
"org.apache.solr.common.params.DisMaxParams",0,0.00,0.00,11,0.13,1707.05,10,10,0,0,3,171.00,23,12,3,1,171.00,0.00,0.00,0.00,0,0.00,0,403.82,0,0,0,,0.00,0,0,0,0,0,0,0,11,84,1
"org.apache.solr.common.params.EventParams",0,0.00,0.00,4,0.04,529.87,3,3,0,0,2,171.00,21,5,2,1,171.00,0.00,0.00,0.00,0,0.00,0,121.11,0,0,0,,0.00,0,0,0,0,0,0,0,3,31,1
"org.apache.solr.common.params.FacetParams",0,0.00,0.00,37,0.78,21454.60,35,35,3,0,16,171.00,179,37,15,1,171.00,0.00,0.00,0.00,0,0.00,0,2348.26,0,0,1,,0.00,0,0,0,0,0,0,0,33,377,1
"org.apache.solr.common.params.FacetParams$FacetRangeOther",2,0.00,1.50,8,0.09,1722.21,2,0,3,6,1,175.34,3,15,0,1,125.34,0.00,0.00,0.00,0,2.00,2,263.81,1,2,1,java.lang.Object,0.00,4,0,3,0,4,0,0,1,64,1
"org.apache.solr.common.params.FacetParams$FacetRangeOther$Deprecated",2,0.00,1.50,8,0.09,1788.93,2,0,3,6,1,75.21,19,14,0,1,125.21,0.00,0.00,0.00,0,2.00,2,277.19,1,1,1,java.lang.Object,0.00,4,0,3,0,4,1,0,1,67,1
"org.apache.solr.common.params.FacetParams$FacetRangeOther$Deprecated$FacetRangeInclude",3,0.00,2.33,16,0.25,9549.79,3,0,3,13,1,157.03,8,27,0,1,117.15,0.00,0.00,0.00,0,3.00,4,736.83,1,3,1,java.lang.Object,0.00,10,0,7,0,10,0,0,5,155,1
"org.apache.solr.common.params.GroupParams",0,0.00,0.00,17,0.32,7226.97,16,16,0,0,8,171.00,22,18,8,1,171.00,0.00,0.00,0.00,0,0.00,0,959.83,0,0,0,,0.00,0,0,0,0,0,0,0,13,178,1
"org.apache.solr.common.params.HighlightParams",0,0.00,0.00,37,0.88,21625.30,36,36,0,0,18,171.00,6,38,18,1,171.00,0.00,0.00,0.00,0,0.00,0,2632.03,0,0,0,,0.00,0,0,0,0,0,0,0,3,414,1
"org.apache.solr.common.params.MapSolrParams",6,0.40,1.83,28,0.36,14529.48,7,1,4,16,23,121.75,4,38,22,2,121.75,0.00,0.50,0.67,0,0.00,5,1070.76,0,5,2,org.apache.solr.common.params.SolrParams,0.05,10,1,11,0,10,1,0,2,225,1
"org.apache.solr.common.params.ModifiableSolrParams",16,0.27,1.94,92,1.11,63842.45,17,1,6,35,84,156.30,35,129,83,2,116.42,1.00,0.33,0.75,3,0.00,6,3339.23,0,10,1,org.apache.solr.common.params.SolrParams,0.04,19,1,31,1,19,6,0,14,702,1
"org.apache.solr.common.params.ModifiableSolrParamsTest",8,0.14,1.12,62,0.74,19775.98,9,1,1,14,1,112.73,6,83,0,2,112.73,0.00,0.50,0.88,1,0.00,2,2230.79,2,0,1,org.apache.lucene.util.LuceneTestCase,0.00,6,1,9,0,6,8,0,1,485,1
"org.apache.solr.common.params.MoreLikeThisParams",0,0.00,0.00,17,0.30,7456.10,15,15,1,0,5,171.00,11,18,5,1,171.00,0.00,0.00,0.00,0,0.00,0,911.30,0,0,0,,0.00,0,0,0,0,0,0,0,9,169,1
"org.apache.solr.common.params.MoreLikeThisParams$TermStyle",1,0.00,4.00,10,0.09,1872.37,1,0,1,3,0,107.61,0,19,0,1,107.61,0.00,0.00,0.00,0,1.00,4,256.19,0,1,0,java.lang.Object,0.00,2,0,4,0,2,0,0,0,58,1
"org.apache.solr.common.params.MultiMapSolrParams",7,0.50,2.00,40,0.53,24837.10,8,1,4,20,16,116.81,4,52,15,2,116.81,1.00,0.33,0.57,0,3.00,6,1575.95,0,5,2,org.apache.solr.common.params.SolrParams,0.05,13,1,14,1,13,2,0,2,323,1
"org.apache.solr.common.params.QueryElevationParams",0,0.00,0.00,7,0.06,590.92,6,6,0,0,2,171.00,37,8,2,1,171.00,0.00,0.00,0.00,0,0.00,0,174.17,0,0,0,,0.00,0,0,0,0,0,0,0,5,41,1
"org.apache.solr.common.params.RequiredSolrParams",15,0.07,1.40,50,0.67,22734.46,16,1,2,26,3,178.08,21,90,2,2,128.08,0.00,0.50,0.93,0,0.00,3,2022.73,0,8,2,org.apache.solr.common.params.SolrParams,0.04,11,1,21,0,11,7,0,9,468,1
"org.apache.solr.common.params.ShardParams",0,0.00,0.00,10,0.13,1980.41,9,9,0,0,17,171.00,11,11,17,1,171.00,0.00,0.00,0.00,0,0.00,0,404.17,0,0,0,,0.00,0,0,0,0,0,0,0,9,85,1
"org.apache.solr.common.params.SolrParamTest",2,0.00,2.50,108,2.02,218539.16,2,0,4,28,3,28.93,24,120,0,2,66.49,0.00,0.50,0.00,0,2.00,3,6052.29,0,0,3,org.apache.lucene.util.LuceneTestCase,0.00,26,1,5,0,26,2,0,23,921,1
"org.apache.solr.common.params.SolrParamTest$Runnable",1,0.00,1.00,3,0.01,103.35,1,0,4,2,0,137.34,0,0,0,1,137.34,0.00,0.00,0.00,0,1.00,1,44.54,0,0,0,java.lang.Object,0.00,1,0,1,0,1,1,0,0,15,0
"org.apache.solr.common.params.SolrParamTest$Runnable_0",1,0.00,1.00,3,0.01,103.35,1,0,4,2,0,137.34,0,0,0,1,137.34,0.00,0.00,0.00,0,1.00,1,44.54,0,0,0,java.lang.Object,0.00,1,0,1,0,1,1,0,0,15,0
"org.apache.solr.common.params.SolrParamTest$Runnable_1",1,0.00,1.00,3,0.01,103.35,1,0,4,2,0,137.34,0,0,0,1,137.34,0.00,0.00,0.00,0,1.00,1,44.54,0,0,0,java.lang.Object,0.00,1,0,1,0,1,1,0,0,15,0
"org.apache.solr.common.params.SolrParamTest$Runnable_10",1,0.00,1.00,3,0.02,115.78,1,0,4,2,0,136.95,0,0,0,1,136.95,0.00,0.00,0.00,0,1.00,1,49.51,0,0,0,java.lang.Object,0.00,1,0,1,0,1,1,0,0,16,0
"org.apache.solr.common.params.SolrParamTest$Runnable_2",1,0.00,1.00,3,0.01,103.35,1,0,4,2,0,137.34,0,0,0,1,137.34,0.00,0.00,0.00,0,1.00,1,44.54,0,0,0,java.lang.Object,0.00,1,0,1,0,1,1,0,0,15,0
"org.apache.solr.common.params.SolrParamTest$Runnable_3",1,0.00,1.00,3,0.01,103.35,1,0,4,2,0,137.34,0,0,0,1,137.34,0.00,0.00,0.00,0,1.00,1,44.54,0,0,0,java.lang.Object,0.00,1,0,1,0,1,1,0,0,15,0
"org.apache.solr.common.params.SolrParamTest$Runnable_4",1,0.00,1.00,3,0.01,103.35,1,0,4,2,0,137.34,0,0,0,1,137.34,0.00,0.00,0.00,0,1.00,1,44.54,0,0,0,java.lang.Object,0.00,1,0,1,0,1,1,0,0,15,0
"org.apache.solr.common.params.SolrParamTest$Runnable_5",1,0.00,1.00,3,0.01,103.35,1,0,4,2,0,137.34,0,0,0,1,137.34,0.00,0.00,0.00,0,1.00,1,44.54,0,0,0,java.lang.Object,0.00,1,0,1,0,1,1,0,0,15,0
"org.apache.solr.common.params.SolrParamTest$Runnable_6",1,0.00,1.00,3,0.01,103.35,1,0,4,2,0,137.34,0,0,0,1,137.34,0.00,0.00,0.00,0,1.00,1,44.54,0,0,0,java.lang.Object,0.00,1,0,1,0,1,1,0,0,15,0
"org.apache.solr.common.params.SolrParamTest$Runnable_7",1,0.00,1.00,3,0.01,103.35,1,0,4,2,0,137.34,0,0,0,1,137.34,0.00,0.00,0.00,0,1.00,1,44.54,0,0,0,java.lang.Object,0.00,1,0,1,0,1,1,0,0,15,0
"org.apache.solr.common.params.SolrParamTest$Runnable_8",1,0.00,1.00,3,0.01,103.35,1,0,4,2,0,137.34,0,0,0,1,137.34,0.00,0.00,0.00,0,1.00,1,44.54,0,0,0,java.lang.Object,0.00,1,0,1,0,1,1,0,0,15,0
"org.apache.solr.common.params.SolrParamTest$Runnable_9",1,0.00,1.00,3,0.02,115.78,1,0,4,2,0,136.95,0,0,0,1,136.95,0.00,0.00,0.00,0,1.00,1,49.51,0,0,0,java.lang.Object,0.00,1,0,1,0,1,1,0,0,16,0
"org.apache.solr.common.params.SolrParams",31,0.00,2.35,144,2.02,69987.96,31,0,8,54,207,171.94,49,205,203,1,121.94,0.00,0.00,0.00,5,31.00,3,6068.84,0,22,9,java.lang.Object,0.00,23,0,73,8,23,9,1,32,1304,2
"org.apache.solr.common.params.SpatialParams",0,0.00,0.00,7,0.08,1210.08,6,6,0,0,2,171.00,31,8,2,1,171.00,0.00,0.00,0.00,0,0.00,0,254.75,0,0,0,,0.00,0,0,0,0,0,0,0,6,58,1
"org.apache.solr.common.params.SpellingParams",0,0.00,0.00,15,0.27,6112.79,14,14,0,0,10,171.00,75,16,10,1,171.00,0.00,0.00,0.00,0,0.00,0,818.68,0,0,0,,0.00,0,0,0,0,0,0,0,14,156,1
"org.apache.solr.common.params.StatsParams",0,0.00,0.00,4,0.05,840.00,3,3,0,0,6,171.00,3,5,6,1,171.00,0.00,0.00,0.00,0,0.00,0,140.00,0,0,0,,0.00,0,0,0,0,0,0,0,1,35,1
"org.apache.solr.common.params.TermVectorParams",0,0.00,0.00,10,0.16,3495.91,9,9,0,0,3,171.00,45,11,3,1,171.00,0.00,0.00,0.00,0,0.00,0,485.54,0,0,0,,0.00,0,0,0,0,0,0,0,10,101,1
"org.apache.solr.common.params.TermsParams",0,0.00,0.00,13,0.22,5274.68,11,11,1,0,5,171.00,32,13,5,1,171.00,0.00,0.00,0.00,0,0.00,0,651.20,0,0,0,,0.00,0,0,0,0,0,0,0,9,128,1
"org.apache.solr.common.params.TermsParams$TermsRegexpFlag",2,0.14,1.00,13,0.19,3980.79,9,7,1,2,0,83.77,13,24,0,1,115.99,0.00,0.00,0.07,0,2.00,1,576.30,0,0,0,java.lang.Object,0.00,0,0,2,0,0,2,0,4,131,2
"org.apache.solr.common.params.UpdateParams",0,0.00,0.00,14,0.19,2872.40,13,13,0,0,23,171.00,19,16,23,1,171.00,0.00,0.00,0.00,0,0.00,0,574.48,0,0,0,,0.00,0,0,0,0,0,0,0,12,112,1
"org.apache.solr.request.JSONWriterTest",4,0.00,1.00,60,0.92,26216.89,4,0,18,32,13,147.07,4,75,0,3,97.08,0.00,0.67,0.00,0,4.00,1,2747.44,1,0,13,org.apache.solr.SolrTestCaseJ4,0.00,28,2,4,0,28,4,0,2,486,1
"org.apache.solr.request.LocalSolrQueryRequest",5,1.00,1.80,25,0.49,25175.11,6,1,8,15,39,165.64,5,30,33,2,115.64,0.00,0.50,0.00,0,5.00,5,1472.60,0,1,6,org.apache.solr.request.SolrQueryRequestBase,0.00,10,1,9,0,10,4,0,3,289,1
"org.apache.solr.request.PerSegmentSingleValuedFaceting",3,0.36,7.00,113,1.78,227839.00,14,11,21,43,19,73.86,13,125,1,1,73.62,0.00,0.00,0.33,0,1.00,19,5330.64,0,1,19,java.lang.Object,0.00,40,0,21,0,40,2,0,13,800,0
"org.apache.solr.request.PerSegmentSingleValuedFaceting$Callable<SegFacet>",1,0.00,1.00,4,0.02,274.98,1,0,21,2,0,129.33,0,5,0,1,129.33,0.00,0.00,0.00,0,1.00,1,73.43,0,0,0,java.lang.Object,0.00,1,0,1,0,1,1,0,0,22,0
"org.apache.solr.request.PerSegmentSingleValuedFaceting$CountSortedFacetCollector",3,0.50,3.33,29,0.43,16018.73,9,6,21,12,5,145.66,6,36,0,2,105.77,0.00,0.50,0.50,0,2.00,5,1302.78,0,1,5,org.apache.solr.request.FacetCollector,0.00,9,1,10,0,9,2,0,6,257,0
"org.apache.solr.request.PerSegmentSingleValuedFaceting$FacetCollector",2,0.00,1.00,3,0.02,164.03,2,0,21,2,1,155.93,1,4,0,1,155.93,0.00,0.00,0.00,0,2.00,1,69.75,0,1,1,java.lang.Object,0.00,0,0,2,0,0,1,0,1,23,1
"org.apache.solr.request.PerSegmentSingleValuedFaceting$IndexSortedFacetCollector",3,0.20,2.33,23,0.24,6319.62,8,5,21,8,3,113.11,0,32,0,2,113.11,0.00,0.50,0.33,0,1.00,4,707.72,0,1,3,org.apache.solr.request.FacetCollector,0.00,5,1,7,0,5,2,0,0,157,0
"org.apache.solr.request.PerSegmentSingleValuedFaceting$PriorityQueue<SegFacet>",1,0.00,1.00,3,0.05,735.49,1,0,21,2,0,130.63,0,5,0,1,130.63,0.00,0.00,0.00,0,1.00,1,135.41,0,0,0,java.lang.Object,0.00,1,0,1,0,1,1,0,0,35,0
"org.apache.solr.request.PerSegmentSingleValuedFaceting$SegFacet",2,0.38,12.50,75,1.18,158256.66,10,8,21,13,5,55.48,10,94,0,1,73.35,0.00,0.00,0.31,0,2.00,24,3538.25,0,0,5,java.lang.Object,0.00,11,0,25,0,11,2,0,10,582,0
"org.apache.solr.request.ServletSolrParams",2,0.00,2.00,9,0.09,2883.15,2,0,2,5,4,163.39,4,13,3,3,123.51,0.00,0.67,0.00,0,2.00,3,273.92,0,1,1,org.apache.solr.common.params.MultiMapSolrParams,0.00,3,2,4,0,3,1,0,2,68,1
"org.apache.solr.request.SimpleFacets",19,0.11,9.58,579,12.28,1638704.38,32,13,29,184,56,28.04,191,805,6,1,76.51,0.00,0.00,0.18,4,18.00,40,36827.15,0,11,52,java.lang.Object,0.00,165,0,182,0,165,8,0,109,5506,1
"org.apache.solr.request.SimpleFacets$CountPair",4,0.33,2.50,15,0.25,8852.33,6,2,29,8,0,126.65,0,22,0,2,126.65,0.00,0.50,0.75,1,0.00,6,736.72,0,0,0,java.lang.Comparable,0.00,4,1,10,0,4,4,1,0,172,2
"org.apache.solr.request.SimpleFacets$DateRangeEndpointCalculator",5,1.00,1.20,17,0.23,4336.61,6,1,29,12,3,130.02,0,31,0,2,130.02,0.00,0.50,0.20,0,8.00,2,685.47,0,4,3,org.apache.solr.request.RangeEndpointCalculator,0.00,7,1,6,0,7,1,0,0,159,2
"org.apache.solr.request.SimpleFacets$DoubleRangeEndpointCalculator",3,0.00,1.00,7,0.08,1590.14,3,0,29,7,1,138.32,0,12,0,2,138.32,0.00,0.50,0.00,0,3.00,1,253.62,0,2,1,org.apache.solr.request.RangeEndpointCalculator,0.00,4,1,3,0,4,1,0,0,68,2
"org.apache.solr.request.SimpleFacets$Executor",1,0.00,1.00,3,0.02,131.59,1,0,29,2,0,136.51,0,4,0,1,136.51,0.00,0.00,0.00,0,1.00,1,47.86,0,0,0,java.lang.Object,0.00,1,0,1,0,1,1,0,0,16,0
"org.apache.solr.request.SimpleFacets$FloatRangeEndpointCalculator",3,0.00,1.00,7,0.08,1590.14,3,0,29,7,1,138.32,0,12,0,2,138.32,0.00,0.50,0.00,0,3.00,1,253.62,0,2,1,org.apache.solr.request.RangeEndpointCalculator,0.00,4,1,3,0,4,1,0,0,68,2
"org.apache.solr.request.SimpleFacets$IntegerRangeEndpointCalculator",3,0.00,1.00,7,0.08,1590.14,3,0,29,7,1,138.32,0,12,0,2,138.32,0.00,0.50,0.00,0,3.00,1,253.62,0,2,1,org.apache.solr.request.RangeEndpointCalculator,0.00,4,1,3,0,4,1,0,0,68,2
"org.apache.solr.request.SimpleFacets$LongRangeEndpointCalculator",3,0.00,1.00,7,0.08,1590.14,3,0,29,7,1,138.32,0,12,0,2,138.32,0.00,0.50,0.00,0,3.00,1,253.62,0,2,1,org.apache.solr.request.RangeEndpointCalculator,0.00,4,1,3,0,4,1,0,0,68,2
"org.apache.solr.request.SimpleFacets$RangeEndpointCalculator",8,0.71,1.38,22,0.33,6758.52,9,1,29,11,2,136.89,37,44,0,2,136.65,0.00,0.50,0.38,3,14.00,2,994.78,0,3,2,java.lang.Comparable,0.00,3,1,11,0,3,5,0,7,229,3
"org.apache.solr.request.SimpleFacetsTest",50,0.31,1.80,316,10.51,576529.00,53,3,11,71,4,159.85,65,1643,0,3,109.85,0.00,0.67,0.03,20,234.00,15,31525.90,8,0,4,org.apache.solr.SolrTestCaseJ4,0.00,21,2,90,0,21,50,0,64,5281,1
"org.apache.solr.request.SolrQueryRequest",11,0.00,1.00,12,0.06,330.79,11,0,6,11,240,199.25,31,13,236,1,159.36,0.00,0.00,0.00,0,11.00,1,171.53,0,7,5,,0.00,0,0,11,0,0,4,0,12,68,1
"org.apache.solr.request.SolrQueryRequestBase",14,0.01,1.36,43,0.38,7166.96,21,7,8,23,17,171.68,29,61,10,1,131.80,0.00,0.00,0.13,0,130.00,3,1125.16,0,8,7,java.lang.Object,0.00,9,0,19,1,9,6,1,13,284,2
"org.apache.solr.request.SolrRequestHandler",2,0.00,1.00,3,0.02,103.29,2,0,3,2,28,157.04,33,4,24,2,157.51,0.00,0.50,0.00,0,2.00,1,63.69,0,0,4,,0.00,0,1,2,0,0,2,0,3,22,1
"org.apache.solr.request.SolrRequestInfo",10,0.02,1.70,51,0.49,12445.09,16,6,8,26,20,120.43,3,71,16,1,120.43,0.00,0.00,0.15,0,58.00,4,1478.72,0,4,5,java.lang.Object,0.00,16,0,17,0,16,6,0,3,330,1
"org.apache.solr.request.TestBinaryResponseWriter",4,0.00,1.25,39,0.66,14471.80,4,0,14,35,10,147.22,9,48,0,3,107.33,0.00,0.67,0.00,0,4.00,2,1986.56,3,2,10,org.apache.solr.util.AbstractSolrTestCase,0.16,31,2,5,0,31,2,0,2,346,1
"org.apache.solr.request.TestFaceting",10,0.33,2.40,126,2.27,169055.20,12,2,10,35,7,147.25,17,194,0,3,97.25,0.00,0.67,0.20,4,26.00,8,6822.21,10,1,7,org.apache.solr.SolrTestCaseJ4,0.08,25,2,24,0,25,9,0,15,1184,1
"org.apache.solr.request.TestRemoteStreaming",9,0.00,1.11,54,0.66,14008.84,9,0,19,35,8,166.81,15,73,0,4,116.81,0.00,0.75,0.00,3,9.00,2,1987.02,2,2,8,org.apache.solr.SolrJettyTestBase,0.00,26,3,10,0,26,7,0,12,420,1
"org.apache.solr.request.TestRemoteStreaming$QueryRequest",1,0.00,1.00,3,0.02,154.44,1,0,19,1,0,185.97,1,5,0,1,135.97,0.00,0.00,0.00,0,1.00,1,48.15,0,1,0,java.lang.Object,0.00,0,0,1,0,0,0,0,1,16,0
"org.apache.solr.request.TestWriterPerf",10,0.04,1.90,90,1.46,60720.57,15,5,11,38,8,155.46,16,113,0,3,105.46,0.00,0.67,0.16,4,34.00,8,4394.85,5,4,8,org.apache.solr.util.AbstractSolrTestCase,0.28,28,2,19,0,28,6,0,16,770,1
"org.apache.solr.request.UnInvertedField",11,0.10,8.27,334,5.88,914646.54,18,7,28,88,32,47.29,147,384,5,2,76.67,0.00,0.50,0.23,2,0.00,33,17651.77,4,6,28,org.apache.lucene.index.DocTermOrds,0.08,77,1,91,0,77,5,0,98,2599,1
"org.apache.solr.request.UnInvertedField$PrimUtils.IntComparator",3,0.00,1.00,7,0.09,2044.59,3,0,28,3,0,137.46,0,13,0,1,137.46,0.00,0.00,0.00,0,3.00,1,274.78,0,0,0,java.lang.Object,0.00,0,0,3,0,0,3,0,0,73,0
"org.apache.solr.request.UnInvertedField$TopTerm",1,1.00,1.00,5,0.03,326.20,3,2,28,1,0,145.75,3,9,0,1,125.13,0.00,0.00,0.50,0,0.00,1,102.15,0,0,0,java.lang.Object,0.00,0,0,1,0,0,1,0,3,30,1
"org.apache.lucene.analysis.cn.smart.hhmm.AbstractDictionary",6,3.00,2.00,62,0.76,34784.63,9,3,1,10,3,113.03,106,71,3,1,103.90,0.00,0.00,0.00,0,6.00,3,2267.14,0,1,0,java.lang.Object,0.00,4,0,12,2,4,5,0,46,462,1
"org.apache.lucene.analysis.cn.smart.hhmm.BiSegGraph",8,0.05,2.88,114,1.57,132665.38,11,3,6,37,7,76.90,46,132,1,1,94.78,0.00,0.00,0.38,4,4.00,8,4712.72,0,3,6,java.lang.Object,0.00,29,0,23,0,29,5,0,18,838,0
"org.apache.lucene.analysis.cn.smart.hhmm.BigramDictionary",11,0.09,3.45,130,1.65,123058.45,18,7,13,36,4,120.60,37,175,2,2,99.99,0.00,0.50,0.22,5,7.00,8,4962.30,2,1,2,org.apache.lucene.analysis.cn.smart.hhmm.AbstractDictionary,0.00,25,1,38,0,25,10,0,23,944,0
"org.apache.lucene.analysis.cn.smart.hhmm.HHMMSegmenter",3,1.00,7.33,104,1.66,362717.58,4,1,5,20,8,53.25,42,130,1,1,73.39,0.00,0.00,0.33,2,4.00,19,4968.61,0,1,7,java.lang.Object,0.00,17,0,22,0,17,2,0,24,806,1
"org.apache.lucene.analysis.cn.smart.hhmm.PathNode",3,0.50,3.33,21,0.28,9423.85,5,2,0,5,2,111.90,13,38,2,1,111.66,0.00,0.00,0.83,0,0.00,6,846.13,0,0,0,java.lang.Object,0.00,2,0,10,0,2,3,1,3,186,0
"org.apache.lucene.analysis.cn.smart.hhmm.SegGraph",7,0.00,2.29,55,0.60,25356.99,9,2,4,16,3,93.39,40,70,2,1,111.26,0.00,0.00,0.50,2,0.00,4,1813.27,0,4,1,java.lang.Object,0.00,9,0,16,0,9,3,0,8,380,0
"org.apache.lucene.analysis.cn.smart.hhmm.SegToken",3,0.75,4.33,39,0.44,18953.76,9,6,2,5,8,61.62,38,52,7,1,99.18,0.00,0.00,0.67,0,1.00,10,1315.25,0,0,1,java.lang.Object,0.00,2,0,13,0,2,3,0,11,280,1
"org.apache.lucene.analysis.cn.smart.hhmm.SegTokenFilter",1,0.00,10.00,20,0.28,28192.25,1,0,2,1,4,126.20,21,27,2,1,86.90,0.00,0.00,0.00,0,1.00,10,849.20,0,1,3,java.lang.Object,0.00,0,0,10,0,0,0,0,6,160,1
"org.apache.lucene.analysis.cn.smart.hhmm.SegTokenPair",3,0.62,3.67,34,0.41,17552.87,7,4,1,6,2,84.32,16,46,2,1,102.19,0.00,0.00,0.67,0,1.00,8,1216.27,0,0,0,java.lang.Object,0.00,3,0,11,0,3,3,0,5,254,0
"org.apache.lucene.analysis.cn.smart.hhmm.WordDictionary",19,0.16,3.74,255,3.44,315453.20,25,6,14,48,5,53.62,136,325,2,2,95.91,0.00,0.50,0.32,11,0.00,8,10319.29,2,1,3,org.apache.lucene.analysis.cn.smart.hhmm.AbstractDictionary,0.00,29,1,71,0,29,18,0,55,1978,0
"org.apache.lucene.queryparser.flexible.standard.processors.AllowLeadingWildcardProcessor",5,0.00,2.20,20,0.28,10179.24,5,0,11,14,10,162.19,11,41,1,2,122.30,0.00,0.50,0.00,0,5.00,5,831.94,2,4,9,org.apache.lucene.queryparser.flexible.core.processors.QueryNodeProcessorImpl,0.00,9,1,11,0,9,1,0,3,180,1
"org.apache.lucene.queryparser.flexible.standard.processors.AnalyzerQueryNodeProcessor",5,2.00,7.20,137,1.87,330064.14,7,2,26,38,21,36.91,35,177,1,2,79.20,0.00,0.50,0.00,0,5.00,29,5624.47,2,4,20,org.apache.lucene.queryparser.flexible.core.processors.QueryNodeProcessorImpl,0.00,33,1,36,0,33,1,0,14,881,1
"org.apache.lucene.queryparser.flexible.standard.processors.BooleanSingleChildOptimizationQueryNodeProcessor",4,0.00,2.00,18,0.21,8910.25,4,0,8,8,7,161.90,9,33,1,2,122.02,0.00,0.50,0.00,0,4.00,5,635.02,0,3,6,org.apache.lucene.queryparser.flexible.core.processors.QueryNodeProcessorImpl,0.00,4,1,8,0,4,1,0,2,136,1
"org.apache.lucene.queryparser.flexible.standard.processors.BoostQueryNodeProcessor",3,0.00,2.33,17,0.25,10335.35,3,0,10,9,9,137.49,9,30,1,2,116.88,0.00,0.50,0.00,0,3.00,5,737.37,1,3,8,org.apache.lucene.queryparser.flexible.core.processors.QueryNodeProcessorImpl,0.00,6,1,7,0,6,0,0,1,150,1
"org.apache.lucene.queryparser.flexible.standard.processors.DefaultPhraseSlopQueryNodeProcessor",6,2.00,1.83,27,0.28,6898.08,8,2,9,8,8,164.19,12,46,1,2,124.30,0.00,0.50,0.00,0,6.00,3,833.85,3,4,7,org.apache.lucene.queryparser.flexible.core.processors.QueryNodeProcessorImpl,0.00,2,1,11,0,2,2,0,2,193,1
"org.apache.lucene.queryparser.flexible.standard.processors.FuzzyQueryNodeProcessor",3,0.00,2.33,17,0.23,9379.83,3,0,9,10,8,117.44,12,28,1,2,117.21,0.00,0.50,0.00,0,3.00,5,692.44,1,3,7,org.apache.lucene.queryparser.flexible.core.processors.QueryNodeProcessorImpl,0.00,7,1,7,0,7,0,0,1,143,1
"org.apache.lucene.queryparser.flexible.standard.processors.GroupQueryNodeProcessor",7,4.00,3.86,80,0.95,51874.75,11,4,17,24,14,141.25,17,103,3,1,101.37,0.00,0.00,0.00,4,7.00,10,2845.05,0,3,12,java.lang.Object,0.00,17,0,27,0,17,4,1,3,565,1
"org.apache.lucene.queryparser.flexible.standard.processors.LowercaseExpandedTermsQueryNodeProcessor",5,0.00,1.60,17,0.24,7971.16,5,0,13,10,12,167.76,11,34,1,2,127.87,0.00,0.50,0.00,0,5.00,3,726.61,2,4,11,org.apache.lucene.queryparser.flexible.core.processors.QueryNodeProcessorImpl,0.00,5,1,8,0,5,1,0,2,160,1
"org.apache.lucene.queryparser.flexible.standard.processors.MatchAllDocsQueryNodeProcessor",4,0.00,1.50,12,0.15,4426.07,4,0,8,9,8,169.02,8,24,1,2,129.14,0.00,0.50,0.00,0,4.00,3,436.65,0,3,7,org.apache.lucene.queryparser.flexible.core.processors.QueryNodeProcessorImpl,0.00,5,1,6,0,5,1,0,2,105,1
"org.apache.lucene.queryparser.flexible.standard.processors.MultiFieldQueryNodeProcessor",5,1.00,2.60,37,0.45,28998.79,6,1,10,14,8,130.24,16,55,1,2,109.62,0.00,0.50,0.00,0,5.00,8,1351.50,2,3,7,org.apache.lucene.queryparser.flexible.core.processors.QueryNodeProcessorImpl,0.00,9,1,13,0,9,2,0,3,260,1
"org.apache.lucene.queryparser.flexible.standard.processors.MultiTermRewriteMethodProcessor",3,1.00,1.67,13,0.16,4156.51,4,1,8,6,12,144.30,11,24,6,2,123.68,0.00,0.50,0.00,0,3.00,3,484.42,1,3,6,org.apache.lucene.queryparser.flexible.core.processors.QueryNodeProcessorImpl,0.00,3,1,5,0,3,0,0,6,109,1
"org.apache.lucene.queryparser.flexible.standard.processors.NumericQueryNodeProcessor",4,0.00,3.50,36,0.60,39527.13,4,0,17,24,14,71.44,24,67,1,2,103.66,0.00,0.50,0.00,0,4.00,11,1795.01,1,3,13,org.apache.lucene.queryparser.flexible.core.processors.QueryNodeProcessorImpl,0.00,20,1,14,0,20,1,0,3,304,1
"org.apache.lucene.queryparser.flexible.standard.processors.NumericRangeQueryNodeProcessor",4,0.00,6.00,47,0.90,71230.33,4,0,18,27,15,98.50,18,82,1,2,98.27,0.00,0.50,0.00,0,4.00,21,2697.85,1,3,14,org.apache.lucene.queryparser.flexible.core.processors.QueryNodeProcessorImpl,0.00,23,1,24,0,23,1,0,3,440,1
"org.apache.lucene.queryparser.flexible.standard.processors.OpenRangeQueryNodeProcessor",4,1.00,1.75,21,0.31,14436.50,5,1,7,11,7,116.78,0,36,1,2,116.78,0.00,0.50,0.25,0,6.00,4,934.04,0,3,6,org.apache.lucene.queryparser.flexible.core.processors.QueryNodeProcessorImpl,0.00,7,1,7,0,7,1,0,0,195,1
"org.apache.lucene.queryparser.flexible.standard.processors.PhraseSlopQueryNodeProcessor",4,0.00,1.50,12,0.13,4452.59,4,0,7,5,7,169.00,8,24,1,2,129.12,0.00,0.50,0.00,0,4.00,3,403.60,0,3,6,org.apache.lucene.queryparser.flexible.core.processors.QueryNodeProcessorImpl,0.00,1,1,6,0,1,1,0,2,100,1
"org.apache.lucene.queryparser.flexible.standard.processors.RemoveEmptyNonLeafQueryNodeProcessor",5,1.00,2.00,28,0.34,17957.05,6,1,8,15,7,156.66,13,46,1,2,116.77,0.00,0.50,0.00,0,5.00,4,1029.25,1,4,6,org.apache.lucene.queryparser.flexible.core.processors.QueryNodeProcessorImpl,0.00,10,1,10,0,10,1,0,2,217,1
"org.apache.lucene.queryparser.flexible.standard.processors.StandardQueryNodeProcessorPipeline",1,0.00,1.00,23,0.22,2901.55,1,0,8,21,27,92.47,16,26,3,2,92.94,1.00,0.33,0.00,0,1.00,1,653.41,1,0,26,org.apache.lucene.queryparser.flexible.core.processors.QueryNodeProcessorPipeline,0.00,20,1,1,1,20,1,0,1,136,1
"org.apache.lucene.queryparser.flexible.standard.processors.TermRangeQueryNodeProcessor",4,0.00,3.25,47,0.72,36314.06,4,0,15,24,9,68.49,26,67,1,2,100.71,0.00,0.50,0.00,0,4.00,10,2165.47,1,3,8,org.apache.lucene.queryparser.flexible.core.processors.QueryNodeProcessorImpl,0.00,20,1,13,0,20,1,0,7,359,1
"org.apache.lucene.queryparser.flexible.standard.processors.WildcardQueryNodeProcessor",6,0.00,3.50,41,0.59,36093.95,6,0,13,13,14,132.54,23,58,2,2,111.92,0.00,0.50,0.00,2,6.00,9,1765.23,0,3,12,org.apache.lucene.queryparser.flexible.core.processors.QueryNodeProcessorImpl,0.00,7,1,21,0,7,3,0,14,356,1
"org.apache.lucene.util.packed.Direct16",9,0.00,1.33,39,0.37,13751.81,11,2,4,12,4,173.40,12,49,2,2,123.40,0.00,0.50,0.50,0,0.00,4,1098.03,0,1,2,PackedInts.ReaderImpl,0.00,3,1,12,0,3,8,1,3,253,0
"org.apache.lucene.util.packed.Direct32",9,0.00,1.22,34,0.32,9880.31,11,2,4,12,4,179.21,11,46,2,2,129.21,0.00,0.50,0.50,0,0.00,3,967.03,0,0,2,PackedInts.ReaderImpl,0.00,3,1,11,0,3,9,1,2,230,0
"org.apache.lucene.util.packed.Direct64",9,0.00,1.11,31,0.28,5743.58,11,2,4,12,4,181.09,11,42,2,2,131.09,0.00,0.50,0.50,0,0.00,2,827.89,0,0,2,PackedInts.ReaderImpl,0.00,3,1,10,0,3,9,1,2,204,0
"org.apache.lucene.util.packed.Direct8",9,0.00,1.33,39,0.37,13751.81,11,2,4,12,4,173.40,12,50,2,2,123.40,0.00,0.50,0.50,0,0.00,4,1098.03,0,1,2,PackedInts.ReaderImpl,0.00,3,1,12,0,3,8,1,3,253,0
"org.apache.lucene.util.packed.DirectReader",6,0.11,1.50,48,0.60,39123.98,13,7,2,10,3,107.18,5,62,1,1,107.18,0.00,0.00,0.24,0,14.00,3,1793.01,0,1,2,java.lang.Object,0.00,4,0,9,0,4,5,1,5,353,1
"org.apache.lucene.util.packed.GrowableWriter",11,0.07,1.45,52,0.50,16925.89,14,3,0,24,5,163.24,22,65,4,1,123.36,0.00,0.00,0.39,2,0.00,4,1485.14,0,3,1,java.lang.Object,0.00,13,0,16,0,13,8,1,2,336,1
"org.apache.lucene.util.packed.Packed32",10,0.15,1.40,103,1.49,104381.49,23,13,4,15,4,59.68,71,127,2,2,101.97,0.00,0.50,0.21,1,0.00,3,4470.15,0,1,2,PackedInts.ReaderImpl,0.00,5,1,14,0,5,9,1,28,906,0
"org.apache.lucene.util.packed.Packed64",10,0.15,1.20,99,1.46,97041.85,23,13,4,13,5,61.68,70,117,3,2,103.97,0.00,0.50,0.21,1,0.00,2,4370.60,0,1,2,PackedInts.ReaderImpl,0.00,3,1,12,0,3,9,1,28,882,0
"org.apache.lucene.util.packed.PackedInts",9,0.12,2.00,69,0.90,38323.47,12,3,7,24,52,62.26,91,98,39,1,110.74,0.00,0.00,0.22,1,18.00,4,2713.48,0,5,14,java.lang.Object,0.00,15,0,18,0,15,4,0,18,553,1
"org.apache.lucene.util.packed.PackedInts$Mutable",2,0.00,1.00,3,0.02,88.15,2,0,7,2,0,158.29,8,4,0,2,158.05,0.00,0.50,0.00,0,2.00,1,54.46,0,0,0,,0.00,0,1,2,0,0,2,0,2,20,2
"org.apache.lucene.util.packed.PackedInts$Reader",5,0.00,1.00,6,0.02,75.37,5,0,7,5,0,143.85,28,7,0,1,161.72,0.00,0.00,0.00,0,5.00,1,61.44,0,1,0,,0.00,0,0,5,0,0,4,0,5,28,2
"org.apache.lucene.util.packed.PackedInts$ReaderImpl",6,0.30,1.00,17,0.12,2548.89,8,2,7,7,0,139.07,1,24,0,1,139.07,0.00,0.00,0.25,0,14.00,1,346.47,0,1,0,java.lang.Object,0.00,1,0,6,0,1,5,1,1,95,3
"org.apache.lucene.util.packed.PackedInts$ReaderIterator",5,0.00,1.00,6,0.03,139.41,5,0,7,5,0,209.62,7,7,0,2,159.62,0.00,0.50,0.00,0,5.00,1,85.97,0,0,0,,0.00,0,1,5,0,0,5,0,5,34,2
"org.apache.lucene.util.packed.PackedInts$Writer",3,3.00,1.00,14,0.13,2968.58,6,3,7,5,2,124.95,0,17,0,1,124.95,0.00,0.00,0.00,0,4.00,1,397.39,0,0,2,java.lang.Object,0.00,2,0,3,0,2,3,0,0,97,3
"org.apache.lucene.util.packed.PackedReaderIterator",7,0.24,1.71,63,0.70,47449.46,14,7,2,11,2,105.11,5,74,1,1,105.11,0.00,0.00,0.35,1,6.00,3,2114.17,0,0,1,java.lang.Object,0.00,4,0,12,0,4,7,1,5,417,1
"org.apache.lucene.util.packed.PackedWriter",4,0.42,2.25,40,0.45,27604.65,8,4,2,6,2,85.41,23,53,1,2,103.28,0.00,0.50,0.56,1,0.00,3,1352.51,0,1,2,PackedInts.Writer,0.00,2,1,9,0,2,3,0,17,272,0
"org.apache.lucene.util.packed.TestPackedInts",13,0.00,3.23,191,2.99,292232.88,13,0,6,71,10,93.71,11,236,0,2,93.71,0.00,0.50,0.00,4,13.00,12,8982.03,0,1,10,org.apache.lucene.util.LuceneTestCase,0.00,58,1,42,0,58,12,0,6,1591,1
"org.apache.lucene.spatial.prefix.BaseRecursivePrefixTreeStrategyTestCase",3,1.00,1.33,17,0.18,3367.52,4,1,7,10,6,120.84,2,21,1,4,120.84,0.33,0.60,0.33,0,5.00,2,542.67,3,1,5,org.apache.lucene.spatial.StrategyTestCase,0.24,7,3,4,1,7,2,0,2,120,2
"org.apache.lucene.spatial.prefix.PointPrefixTreeFieldCacheProvider",2,0.00,1.50,9,0.12,2257.73,4,2,5,6,5,174.41,2,13,1,3,124.41,0.00,0.67,0.50,0,2.00,2,369.30,0,1,4,org.apache.lucene.spatial.util.ShapeFieldCacheProvider,0.00,4,2,3,0,4,1,0,2,85,1
"org.apache.lucene.spatial.prefix.PrefixCellsTokenizer",4,1.00,3.25,36,0.38,25254.33,5,1,4,8,2,155.21,5,52,0,4,105.21,0.00,0.75,0.25,0,6.00,10,1151.36,1,0,2,org.apache.lucene.analysis.Tokenizer,0.44,4,3,13,0,4,4,0,3,228,0
"org.apache.lucene.spatial.prefix.PrefixTreeStrategy",7,0.06,1.86,57,0.79,25730.52,13,6,21,31,15,159.09,12,74,2,3,109.09,1.00,0.40,0.21,1,3.00,5,2355.80,0,4,13,org.apache.lucene.spatial.SpatialStrategy,0.00,24,2,13,2,24,3,0,12,470,2
"org.apache.lucene.spatial.prefix.PrefixTreeStrategy$CellTokenStream",2,0.33,2.50,20,0.22,5558.37,5,3,21,8,3,106.37,0,28,0,3,106.37,0.00,0.67,0.50,0,2.00,4,654.30,0,0,3,org.apache.lucene.analysis.TokenStream,0.30,6,2,5,0,6,2,0,0,137,2
"org.apache.lucene.spatial.prefix.RecursivePrefixTreeFilter",6,0.32,4.17,76,1.31,109468.52,11,5,14,39,15,48.76,50,98,2,2,96.86,0.00,0.50,0.47,1,0.00,13,3930.16,0,2,13,org.apache.lucene.search.Filter,0.00,33,1,25,0,33,4,0,27,683,1
"org.apache.lucene.spatial.prefix.RecursivePrefixTreeStrategy",5,0.50,1.20,19,0.28,6316.86,6,1,11,18,10,128.74,2,30,1,4,128.74,0.00,0.75,0.60,1,2.00,2,842.26,1,3,9,org.apache.lucene.spatial.prefix.PrefixTreeStrategy,0.00,13,3,6,0,13,2,0,2,184,1
"org.apache.lucene.spatial.prefix.RecursivePrefixTreeStrategyTestCase",2,0.00,1.00,5,0.04,490.25,2,0,3,2,1,140.95,0,10,0,5,140.95,0.00,0.80,0.00,0,2.00,1,115.89,1,1,1,org.apache.lucene.spatial.prefix.BaseRecursivePrefixTreeStrategyTestCase,0.53,0,4,2,0,0,1,0,0,34,1
"org.apache.lucene.spatial.prefix.TermQueryPrefixTreeStrategy",3,0.00,1.67,16,0.28,10492.86,3,0,10,16,11,116.90,1,25,1,4,116.90,0.00,0.75,0.00,1,4.00,3,854.63,0,2,10,org.apache.lucene.spatial.prefix.PrefixTreeStrategy,0.00,13,3,5,0,13,1,0,1,163,1
"org.apache.lucene.spatial.prefix.TestSpatialPrefixField",2,0.00,1.00,16,0.17,4360.32,2,0,4,3,0,78.80,13,26,0,2,111.02,0.00,0.50,0.00,1,2.00,1,518.14,0,0,0,org.apache.lucene.util.LuceneTestCase,0.00,1,1,2,0,1,2,0,11,107,1
"org.apache.lucene.spatial.prefix.TestTermQueryPrefixGridStrategy",1,0.00,1.00,11,0.18,3653.51,1,0,14,11,7,55.99,8,14,0,3,104.10,0.00,0.67,0.00,0,1.00,1,528.70,1,0,7,org.apache.lucene.spatial.SpatialTestCase,0.00,10,2,1,0,10,1,0,8,100,1
"org.apache.lucene.util.encoding.ChunksIntEncoder",4,0.53,1.50,29,0.24,5436.60,9,5,2,9,4,85.33,55,35,2,2,114.71,3.00,0.20,0.60,1,0.00,2,729.50,2,0,2,org.apache.lucene.util.encoding.IntEncoder,0.22,5,1,6,3,5,4,0,7,168,2
"org.apache.lucene.util.encoding.DGapIntDecoder",4,0.17,1.25,15,0.13,2889.72,6,2,2,7,3,98.42,24,24,2,2,130.64,0.00,0.50,0.62,0,0.00,2,394.81,0,1,1,org.apache.lucene.util.encoding.IntDecoder,0.33,3,1,5,0,3,3,0,2,101,1
"org.apache.lucene.util.encoding.DGapIntEncoder",5,0.75,1.00,14,0.13,2049.29,6,1,2,9,9,106.98,32,24,5,3,139.20,0.00,0.67,0.40,0,1.00,1,384.28,1,1,4,org.apache.lucene.util.encoding.IntEncoderFilter,0.46,4,2,5,0,4,4,0,3,102,1
"org.apache.lucene.util.encoding.EightFlagsIntDecoder",3,0.50,2.33,34,0.31,11383.42,7,4,2,7,3,59.65,33,41,1,2,103.77,0.00,0.50,0.58,0,1.00,5,940.20,1,1,2,org.apache.lucene.util.encoding.IntDecoder,0.40,4,1,7,0,4,2,0,8,207,1
"org.apache.lucene.util.encoding.EightFlagsIntEncoder",4,1.00,1.50,16,0.17,3858.31,5,1,1,6,5,80.82,46,26,2,3,124.95,0.00,0.67,0.25,0,8.00,3,510.33,1,2,3,org.apache.lucene.util.encoding.ChunksIntEncoder,0.23,2,2,6,0,2,2,0,4,117,1
"org.apache.lucene.util.encoding.EncodingSpeed",3,0.31,3.67,91,20.98,383524.21,11,8,14,28,9,27.28,24,588,0,1,75.39,0.00,0.00,0.33,2,6.00,9,62949.82,0,0,9,java.lang.Object,0.00,25,0,11,0,25,3,0,6,5617,1
"org.apache.lucene.util.encoding.EncodingTest",12,0.41,1.58,80,10.25,212838.58,14,2,17,52,10,158.41,20,355,0,2,108.41,0.00,0.50,0.12,4,28.00,3,30741.26,0,0,10,org.apache.lucene.util.LuceneTestCase,0.00,40,1,19,0,40,12,0,5,3084,1
"org.apache.lucene.util.encoding.FourFlagsIntDecoder",3,0.50,2.33,35,0.33,12444.53,7,4,2,7,4,59.34,33,42,2,2,103.47,1.00,0.33,0.58,0,1.00,5,988.99,1,1,2,org.apache.lucene.util.encoding.IntDecoder,0.40,4,1,7,1,4,2,0,8,215,1
"org.apache.lucene.util.encoding.FourFlagsIntEncoder",4,1.00,1.50,16,0.22,5818.82,5,1,1,6,6,103.40,56,31,3,3,123.54,0.50,0.50,0.25,0,8.00,3,665.18,1,1,3,org.apache.lucene.util.encoding.ChunksIntEncoder,0.23,2,2,6,1,2,3,0,5,147,1
"org.apache.lucene.util.encoding.IntDecoder",2,2.00,1.00,6,0.05,582.92,4,2,2,2,18,142.93,34,8,18,1,133.79,0.00,0.00,0.00,0,2.00,1,143.20,0,0,0,java.lang.Object,0.00,0,0,2,6,0,2,0,6,40,2
"org.apache.lucene.util.encoding.IntEncoder",5,1.00,1.20,10,0.07,833.25,6,1,2,6,15,151.36,85,15,14,1,142.23,0.00,0.00,0.20,0,8.00,2,209.82,0,1,1,java.lang.Object,0.00,1,0,6,10,1,4,0,7,63,2
"org.apache.lucene.util.encoding.IntEncoderFilter",3,0.50,1.00,8,0.07,940.85,4,1,2,5,4,95.98,33,14,3,2,140.11,3.00,0.20,0.67,0,1.00,1,195.97,0,0,1,org.apache.lucene.util.encoding.IntEncoder,0.25,2,1,3,3,2,3,0,4,56,2
"org.apache.lucene.util.encoding.NOnesIntDecoder",4,0.00,2.25,23,0.21,8309.57,6,2,2,4,3,76.32,30,35,2,3,118.62,0.00,0.67,0.50,0,2.00,6,617.10,3,1,1,org.apache.lucene.util.encoding.FourFlagsIntDecoder,0.67,0,2,9,0,0,3,0,5,144,1
"org.apache.lucene.util.encoding.NOnesIntEncoder",6,0.10,1.67,26,0.24,7270.80,8,2,2,7,6,74.14,55,42,3,4,124.14,0.00,0.75,0.42,0,6.00,4,730.18,4,1,3,org.apache.lucene.util.encoding.FourFlagsIntEncoder,0.84,1,3,10,0,1,5,0,10,174,1
"org.apache.lucene.util.encoding.SimpleIntDecoder",2,1.00,2.50,18,0.23,13507.16,3,1,2,4,3,75.66,26,27,2,2,105.04,0.00,0.50,0.50,0,2.00,4,702.04,0,1,1,org.apache.lucene.util.encoding.IntDecoder,0.50,2,1,5,0,2,1,0,4,135,1
"org.apache.lucene.util.encoding.SimpleIntEncoder",3,0.00,1.00,10,0.11,2588.41,3,0,1,5,5,81.61,31,17,2,2,130.08,0.00,0.50,0.00,0,4.00,1,334.21,0,2,3,org.apache.lucene.util.encoding.IntEncoder,0.50,2,1,3,0,2,1,0,3,84,1
"org.apache.lucene.util.encoding.SortingIntEncoder",6,0.00,1.50,31,0.31,10554.35,9,3,3,12,7,119.51,25,43,4,3,119.28,0.00,0.67,0.33,0,2.00,3,941.62,2,1,3,org.apache.lucene.util.encoding.IntEncoderFilter,0.64,6,2,9,0,6,5,0,3,214,1
"org.apache.lucene.util.encoding.UniqueValuesIntEncoder",5,0.25,1.20,16,0.15,2880.97,7,2,2,8,8,99.20,30,27,5,3,131.42,0.00,0.67,0.30,0,1.00,2,456.55,1,1,3,org.apache.lucene.util.encoding.IntEncoderFilter,0.46,3,2,6,0,3,4,0,4,117,2
"org.apache.lucene.util.encoding.VInt8IntDecoder",2,1.00,3.00,18,0.16,7074.75,3,1,1,4,4,63.08,22,27,3,2,107.21,0.00,0.50,0.50,0,2.00,5,484.27,0,1,1,org.apache.lucene.util.encoding.IntDecoder,0.50,2,1,6,0,2,1,0,2,101,1
"org.apache.lucene.util.encoding.VInt8IntEncoder",3,0.00,2.33,26,0.39,37153.69,3,0,1,5,8,84.75,43,34,5,2,104.89,0.00,0.50,0.00,0,4.00,5,1172.02,0,2,3,org.apache.lucene.util.encoding.IntEncoder,0.50,2,1,7,0,2,1,0,2,245,1
"org.apache.solr.client.solrj.request.AbstractUpdateRequest",14,0.23,1.57,51,0.59,12732.38,16,2,7,23,15,129.80,9,74,9,2,129.80,3.00,0.20,0.29,2,26.00,4,1765.48,0,7,6,org.apache.solr.client.solrj.SolrRequest,0.08,9,1,22,3,9,7,0,4,411,2
"org.apache.solr.client.solrj.request.AbstractUpdateRequest$ACTION",0,0.00,0.00,2,0.01,23.26,0,0,7,0,0,171.00,0,4,0,1,171.00,0.00,0.00,0.00,0,0.00,0,15.51,0,0,0,java.lang.Object,0.00,0,0,0,0,0,0,0,0,6,1
"org.apache.solr.client.solrj.request.ContentStreamUpdateRequest",4,0.33,1.00,11,0.11,1370.60,5,1,7,7,5,107.59,25,17,2,3,139.81,0.00,0.67,0.75,1,0.00,1,319.73,0,1,3,org.apache.solr.client.solrj.request.AbstractUpdateRequest,0.10,3,2,4,0,3,3,0,4,83,1
"org.apache.solr.client.solrj.request.CoreAdminRequest",18,0.29,1.22,86,1.08,26232.31,21,3,14,51,19,173.58,19,131,10,2,123.58,6.00,0.12,0.06,1,34.00,3,3233.04,0,13,9,org.apache.solr.client.solrj.SolrRequest,0.13,33,1,22,6,33,5,0,15,705,1
"org.apache.solr.client.solrj.request.CoreAdminRequest$Create",17,0.02,1.53,66,0.62,21251.56,25,8,14,22,5,128.72,0,64,0,3,128.72,0.00,0.67,0.11,0,120.00,10,1850.37,0,8,5,org.apache.solr.client.solrj.request.CoreAdminRequest,0.06,5,2,26,0,5,9,0,0,409,2
"org.apache.solr.client.solrj.request.CoreAdminRequest$MergeIndexes",6,0.20,1.83,28,0.27,8809.73,8,2,14,10,4,123.46,0,39,0,3,123.46,0.00,0.67,0.33,0,10.00,6,815.92,0,3,4,org.apache.solr.client.solrj.request.CoreAdminRequest,0.08,4,2,11,0,4,3,0,0,182,2
"org.apache.solr.client.solrj.request.CoreAdminRequest$Persist",4,0.33,1.50,16,0.14,3445.05,5,1,14,8,4,125.34,0,24,0,3,125.34,0.00,0.67,0.75,0,0.00,3,419.59,0,2,4,org.apache.solr.client.solrj.request.CoreAdminRequest,0.09,4,2,6,0,4,2,0,0,100,2
"org.apache.solr.client.solrj.request.CoreAdminRequest$RequestRecovery",2,0.00,1.50,10,0.10,2379.78,2,0,14,6,4,120.61,0,15,0,3,120.61,0.00,0.67,0.00,0,0.00,2,295.37,0,1,4,org.apache.solr.client.solrj.request.CoreAdminRequest,0.09,4,2,3,0,4,1,0,0,68,2
"org.apache.solr.client.solrj.request.CoreAdminRequest$Unload",4,0.67,1.00,13,0.10,1401.68,5,1,14,5,4,133.16,0,19,0,3,133.16,0.00,0.67,0.50,0,6.00,1,302.19,1,1,4,org.apache.solr.client.solrj.request.CoreAdminRequest,0.09,1,2,4,0,1,3,0,0,81,2
"org.apache.solr.client.solrj.request.CoreAdminRequest$WaitForState",12,0.04,1.50,45,0.37,10282.14,17,5,14,16,4,130.01,0,65,0,3,130.01,0.00,0.67,0.17,0,58.00,7,1117.64,0,6,4,org.apache.solr.client.solrj.request.CoreAdminRequest,0.07,4,2,18,0,4,6,0,0,263,2
"org.apache.solr.client.solrj.request.DirectXmlRequest",5,0.25,1.00,18,0.18,3524.21,7,2,9,11,9,180.77,6,30,2,2,130.77,0.00,0.50,0.30,0,10.00,1,546.15,0,3,7,org.apache.solr.client.solrj.SolrRequest,0.24,6,1,5,0,6,2,0,1,132,1
"org.apache.solr.client.solrj.request.DocumentAnalysisRequest",13,0.17,1.23,50,0.48,10392.77,16,3,14,31,12,98.07,85,68,3,2,130.30,0.00,0.50,0.18,1,59.00,3,1446.79,0,10,9,org.apache.solr.client.solrj.SolrRequest,0.16,18,1,16,0,18,3,0,16,338,1
"org.apache.solr.client.solrj.request.FieldAnalysisRequest",18,0.04,1.50,78,0.73,19639.93,23,5,12,34,11,92.30,113,108,3,2,124.53,0.00,0.50,0.17,1,102.00,4,2203.75,0,15,8,org.apache.solr.client.solrj.SolrRequest,0.13,16,1,27,0,16,3,0,21,501,1
"org.apache.solr.client.solrj.request.JavaBinUpdateRequestCodec",4,0.00,5.25,66,0.99,67118.45,4,0,10,33,10,50.14,30,81,3,1,92.43,0.00,0.00,0.00,2,4.00,10,2963.26,0,3,7,java.lang.Object,0.00,29,0,21,0,29,1,0,6,533,1
"org.apache.solr.client.solrj.request.JavaBinUpdateRequestCodec$JavaBinCodec",3,1.00,3.67,37,0.46,22486.25,4,1,10,14,6,139.82,6,43,0,1,99.93,0.00,0.00,0.33,1,4.00,6,1391.19,1,3,6,java.lang.Object,0.00,11,0,11,0,11,0,0,6,265,0
"org.apache.solr.client.solrj.request.JavaBinUpdateRequestCodec$StreamingUpdateHandler",1,0.00,1.00,2,0.01,66.01,1,0,10,1,2,145.44,0,3,0,1,145.44,0.00,0.00,0.00,0,1.00,1,40.14,0,0,2,,0.00,0,0,1,0,0,1,0,0,14,2
"org.apache.solr.client.solrj.request.LukeRequest",11,0.13,1.36,39,0.40,10326.36,14,3,12,22,9,179.72,14,64,1,2,129.72,0.00,0.50,0.21,0,36.00,4,1211.19,0,3,8,org.apache.solr.client.solrj.SolrRequest,0.17,11,1,15,0,11,8,0,8,279,1
"org.apache.solr.client.solrj.request.QueryRequest",7,0.50,1.86,30,0.31,9594.71,8,1,9,14,21,173.70,10,53,15,2,123.70,0.00,0.50,0.57,0,3.00,4,943.75,1,4,7,org.apache.solr.client.solrj.SolrRequest,0.32,7,1,13,0,7,3,0,4,214,1
"org.apache.solr.client.solrj.request.RequestWriter",7,1.00,1.43,27,0.32,7754.03,8,1,9,23,8,179.15,8,40,3,1,129.15,0.00,0.00,0.14,2,12.00,3,974.67,0,4,5,java.lang.Object,0.00,16,0,10,1,16,3,0,1,227,1
"org.apache.solr.client.solrj.request.RequestWriter$LazyContentStream",9,0.38,1.22,25,0.18,2725.63,11,2,9,17,2,140.19,0,38,0,1,140.19,0.00,0.00,0.17,1,19.00,3,547.77,0,7,2,java.lang.Object,0.00,8,0,11,0,8,2,1,0,152,1
"org.apache.solr.client.solrj.request.SolrPing",4,0.67,1.00,15,0.15,2931.69,5,1,8,10,7,180.64,5,26,2,2,130.64,0.00,0.50,0.50,0,4.00,1,436.87,0,3,6,org.apache.solr.client.solrj.SolrRequest,0.25,6,1,4,0,6,1,0,1,105,1
"org.apache.solr.client.solrj.request.TestUpdateRequestCodec",3,0.00,2.67,93,1.54,85173.42,3,0,15,36,5,80.31,14,107,0,2,80.08,0.00,0.50,0.00,1,3.00,3,4610.84,0,0,5,org.apache.lucene.util.LuceneTestCase,0.00,33,1,8,0,33,3,0,8,747,1
"org.apache.solr.client.solrj.request.TestUpdateRequestCodec$Iterable<String>",1,0.00,1.00,3,0.02,300.08,1,0,15,2,0,133.69,0,2,0,1,133.69,0.00,0.00,0.00,0,1.00,1,69.84,0,1,0,java.lang.Object,0.00,1,0,1,0,1,0,0,0,21,0
"org.apache.solr.client.solrj.request.TestUpdateRequestCodec$JavaBinUpdateRequestCodec.StreamingUpdateHandler",1,0.00,1.00,4,0.04,314.66,1,0,15,4,2,128.87,0,5,0,1,128.87,0.00,0.00,0.00,0,1.00,1,111.51,0,0,2,java.lang.Object,0.00,3,0,1,0,3,1,0,0,30,0
"org.apache.solr.client.solrj.request.TestUpdateRequestCodec$JavaBinUpdateRequestCodec.StreamingUpdateHandler_0",1,0.00,1.00,4,0.04,314.66,1,0,15,4,2,128.87,0,5,0,1,128.87,0.00,0.00,0.00,0,1.00,1,111.51,0,0,2,java.lang.Object,0.00,3,0,1,0,3,1,0,0,30,0
"org.apache.solr.client.solrj.request.UpdateRequest",19,0.04,2.37,113,1.29,54444.35,23,4,13,37,33,157.39,43,168,26,3,117.50,0.00,0.67,0.21,3,136.00,15,3859.60,0,14,7,org.apache.solr.client.solrj.request.AbstractUpdateRequest,0.27,18,2,45,0,18,5,0,21,803,1
"org.apache.solr.client.solrj.request.UpdateRequest$Deprecated",0,0.00,0.00,2,0.01,99.06,0,0,13,0,0,171.00,0,4,0,1,171.00,0.00,0.00,0.00,0,0.00,0,31.70,0,0,0,java.lang.Object,0.00,0,0,0,0,0,0,0,0,10,1
"org.apache.solr.client.solrj.request.UpdateRequestExt",16,0.02,2.69,126,1.56,77268.23,19,3,12,42,8,110.24,11,168,3,3,110.24,0.00,0.67,0.35,2,30.00,14,4666.23,0,12,5,org.apache.solr.client.solrj.request.AbstractUpdateRequest,0.07,26,2,43,0,26,4,0,9,910,1
"org.apache.solr.client.solrj.request.UpdateRequestExt$SolrDoc",1,0.00,1.00,6,0.05,472.65,4,3,12,1,1,120.91,0,10,0,1,120.91,0.00,0.00,1.00,0,0.00,1,149.36,0,1,1,java.lang.Object,0.00,0,0,1,0,0,0,0,0,39,1
"org.apache.lucene.analysis.cjk.CJKAnalyzer",4,1.00,1.25,19,0.22,6243.18,5,1,11,12,12,81.05,28,27,2,3,123.34,0.00,0.67,0.00,0,6.00,2,666.13,0,2,10,org.apache.lucene.analysis.util.StopwordAnalyzerBase,0.00,8,2,5,0,8,2,0,6,148,2
"org.apache.lucene.analysis.cjk.CJKAnalyzer$DefaultSetHolder",0,0.00,0.00,6,0.05,732.71,1,1,11,0,2,171.00,2,10,0,1,171.00,0.00,0.00,0.00,0,0.00,0,149.07,0,0,2,java.lang.Object,0.00,0,0,0,0,0,0,0,2,37,2
"org.apache.lucene.analysis.cjk.CJKBigramFilter",10,0.22,2.90,139,1.68,88963.87,36,26,8,27,15,50.00,88,159,8,4,98.10,0.00,0.75,0.24,6,0.00,9,5052.52,1,0,7,org.apache.lucene.analysis.TokenFilter,0.36,17,3,29,0,17,10,0,50,948,2
"org.apache.lucene.analysis.cjk.CJKWidthFilter",3,0.12,3.33,33,1.01,70186.71,7,4,5,8,9,55.18,21,59,5,4,97.47,0.00,0.75,0.33,0,5.00,6,3036.14,0,0,4,org.apache.lucene.analysis.TokenFilter,0.27,5,3,10,0,5,3,0,6,508,2
"org.apache.lucene.analysis.cjk.Deprecated",16,0.00,1.12,95,2.48,79121.00,16,0,4,18,3,115.81,15,210,0,3,115.81,0.00,0.67,0.00,3,16.00,2,7430.92,3,1,3,org.apache.lucene.analysis.BaseTokenStreamTestCase,0.00,2,2,18,0,2,15,0,6,1415,1
"org.apache.lucene.analysis.cjk.Deprecated$TestToken",0,0.00,0.00,5,0.02,128.13,4,4,4,0,0,171.00,0,6,0,1,171.00,0.00,0.00,0.00,0,0.00,0,66.44,0,0,0,java.lang.Object,0.00,0,0,0,0,0,0,0,0,20,0
"org.apache.lucene.analysis.cjk.TestCJKAnalyzer",17,0.19,1.00,127,1.87,45919.10,18,1,16,22,15,162.45,19,165,0,3,112.45,0.00,0.67,0.82,0,0.00,1,5620.01,4,0,15,org.apache.lucene.analysis.BaseTokenStreamTestCase,0.00,5,2,17,0,5,17,0,11,1136,1
"org.apache.lucene.analysis.cjk.TestCJKAnalyzer$Analyzer",2,0.00,1.00,6,0.08,1233.22,2,0,16,7,5,131.23,0,10,0,1,131.23,0.00,0.00,0.00,0,2.00,1,225.98,0,2,5,java.lang.Object,0.00,5,0,2,0,5,0,0,0,56,0
"org.apache.lucene.analysis.cjk.TestCJKAnalyzer$Analyzer_0",1,0.00,1.00,7,0.09,1943.41,1,0,16,6,6,113.58,0,9,0,1,113.58,0.00,0.00,0.00,0,1.00,1,284.90,0,1,6,java.lang.Object,0.00,5,0,1,0,5,0,0,0,61,0
"org.apache.lucene.analysis.cjk.TestCJKAnalyzer$Analyzer_1",1,0.00,1.00,4,0.05,753.46,1,0,16,4,3,125.89,0,6,0,1,125.89,0.00,0.00,0.00,0,1.00,1,135.44,0,1,3,java.lang.Object,0.00,3,0,1,0,3,0,0,0,34,0
"org.apache.lucene.analysis.cjk.TestCJKAnalyzer$FakeStandardTokenizer",2,1.00,1.50,10,0.09,1647.63,3,1,16,4,4,121.87,0,15,0,4,121.87,0.00,0.75,0.50,0,2.00,2,267.70,0,0,4,org.apache.lucene.analysis.TokenFilter,0.29,2,3,3,0,2,2,0,0,65,2
"org.apache.lucene.analysis.cjk.TestCJKWidthFilter",4,0.00,1.00,16,0.16,2066.31,4,0,7,6,5,167.06,11,26,0,3,127.18,0.00,0.67,0.00,0,4.00,1,468.17,3,0,5,org.apache.lucene.analysis.BaseTokenStreamTestCase,0.00,2,2,4,0,2,4,0,3,115,1
"org.apache.lucene.analysis.cjk.TestCJKWidthFilter$Analyzer",1,0.00,1.00,4,0.05,1009.20,1,0,7,4,3,124.89,0,6,0,1,124.89,0.00,0.00,0.00,0,1.00,1,159.62,0,1,3,java.lang.Object,0.00,3,0,1,0,3,0,0,0,38,0
"org.apache.lucene.analysis.cjk.TestCJKWidthFilter$Analyzer_0",1,0.00,1.00,4,0.05,753.46,1,0,7,4,3,125.89,0,6,0,1,125.89,0.00,0.00,0.00,0,1.00,1,135.44,0,1,3,java.lang.Object,0.00,3,0,1,0,3,0,0,0,34,0
"org.apache.lucene.search.spell.Dictionary",1,0.00,1.00,2,0.01,38.26,1,0,2,1,8,98.83,10,3,7,1,147.31,0.00,0.00,0.00,0,1.00,1,25.51,0,1,1,,0.00,0,0,1,0,0,0,0,2,11,1
"org.apache.lucene.search.spell.DirectSpellChecker",24,0.02,2.00,142,2.29,180130.31,35,11,20,69,21,71.96,172,191,2,1,114.25,0.00,0.00,0.08,1,252.00,13,6855.25,0,3,19,java.lang.Object,0.00,45,0,48,0,45,21,0,44,1194,1
"org.apache.lucene.search.spell.DirectSpellChecker$ScoreTerm",3,0.00,4.00,23,0.31,11021.42,8,5,20,8,0,111.08,1,33,0,1,111.08,0.00,0.00,0.20,0,0.00,7,934.87,0,0,0,java.lang.Object,0.00,5,0,12,0,5,3,1,1,206,2
"org.apache.lucene.search.spell.HighFrequencyDictionary",2,3.00,1.00,11,0.09,1212.32,5,3,8,3,11,105.14,10,14,4,1,123.01,0.00,0.00,0.00,0,2.00,1,263.57,0,1,7,java.lang.Object,0.00,1,0,2,0,1,1,1,1,68,1
"org.apache.lucene.search.spell.HighFrequencyDictionary$HighFrequencyIterator",5,0.19,2.00,30,0.27,7127.19,9,4,8,11,5,116.98,0,43,0,1,116.98,0.00,0.00,0.40,1,0.00,4,815.42,0,2,5,java.lang.Object,0.00,6,0,10,0,6,3,1,0,188,1
"org.apache.lucene.search.spell.JaroWinklerDistance",4,1.00,4.50,74,0.95,150753.20,5,1,1,9,5,108.41,15,75,4,1,87.79,0.00,0.00,0.25,1,6.00,13,2842.95,0,0,1,java.lang.Object,0.00,5,0,18,0,5,4,1,3,516,1
"org.apache.lucene.search.spell.LevensteinDistance",2,0.00,4.00,43,0.47,67213.86,2,0,0,7,7,133.54,54,43,6,1,85.71,0.00,0.00,0.00,0,2.00,7,1395.97,0,0,1,java.lang.Object,0.00,5,0,8,0,5,2,1,19,256,2
"org.apache.lucene.search.spell.LuceneDictionary",2,0.00,1.50,12,0.10,1996.93,4,2,5,4,7,138.88,7,16,2,1,118.26,0.00,0.00,0.50,0,2.00,2,307.87,0,1,5,java.lang.Object,0.00,2,0,3,0,2,1,1,1,75,1
"org.apache.lucene.search.spell.LuceneLevenshteinDistance",2,0.00,5.50,53,0.75,146509.50,2,0,1,7,3,79.05,33,51,1,1,79.52,0.00,0.00,0.00,0,2.00,9,2252.26,0,1,2,java.lang.Object,0.00,5,0,11,0,5,1,1,16,409,2
"org.apache.lucene.search.spell.NGramDistance",3,1.00,6.33,83,0.94,209721.28,4,1,0,9,4,97.17,54,82,3,1,79.03,0.00,0.00,0.33,0,4.00,17,2823.53,0,0,1,java.lang.Object,0.00,6,0,19,0,6,3,1,21,502,1
"org.apache.lucene.search.spell.PlainTextDictionary",4,0.33,1.00,11,0.09,1002.26,5,1,5,8,6,180.77,11,16,2,1,140.88,0.00,0.00,0.75,0,0.00,1,275.29,0,1,4,java.lang.Object,0.00,4,0,4,0,4,3,1,2,76,1
"org.apache.lucene.search.spell.PlainTextDictionary$FileIterator",2,0.00,2.50,23,0.20,6984.67,4,2,5,6,3,104.04,0,33,0,1,104.04,0.00,0.00,0.50,0,2.00,4,595.18,0,2,3,java.lang.Object,0.00,4,0,5,0,4,0,1,0,125,1
"org.apache.lucene.search.spell.SpellChecker",31,0.02,2.23,241,3.16,234453.14,43,12,31,83,37,60.64,274,306,8,1,108.75,0.00,0.00,0.06,11,361.00,18,9490.10,0,10,29,java.lang.Object,0.00,52,0,69,1,52,21,1,79,1748,1
"org.apache.lucene.search.spell.SpellChecker$ReaderUtil.Gather",1,0.00,2.00,4,0.06,1346.02,1,0,31,4,2,123.74,0,7,0,1,123.74,0.00,0.00,0.00,0,0.00,2,193.88,0,0,2,java.lang.Object,0.00,3,0,2,0,3,1,0,0,45,0
"org.apache.lucene.search.spell.StringDistance",1,0.00,1.00,2,0.01,60.60,1,0,0,1,17,193.56,27,3,17,1,145.73,0.00,0.00,0.00,0,1.00,1,35.00,0,0,0,,0.00,0,0,1,0,0,1,0,3,13,1
"org.apache.lucene.search.spell.SuggestMode",0,0.00,0.00,2,0.01,29.48,0,0,0,0,7,171.00,23,4,6,1,171.00,0.00,0.00,0.00,0,0.00,0,19.65,0,0,1,java.lang.Object,0.00,0,0,0,0,0,0,1,3,7,1
"org.apache.lucene.search.spell.SuggestWord",0,0.00,0.00,4,0.02,179.25,3,3,0,0,12,171.00,32,5,12,1,171.00,0.00,0.00,0.00,0,0.00,0,71.70,0,0,0,java.lang.Object,0.00,0,0,0,0,0,0,0,5,20,2
"org.apache.lucene.search.spell.SuggestWordFrequencyComparator",1,0.00,5.00,11,0.12,5042.84,1,0,1,2,4,149.90,23,17,3,1,102.63,0.00,0.00,0.00,0,1.00,5,348.35,0,0,1,java.lang.Object,0.00,1,0,5,0,1,1,1,5,83,1
"org.apache.lucene.search.spell.SuggestWordQueue",3,0.00,1.00,12,0.13,2781.93,5,2,2,5,8,107.30,16,17,5,2,125.18,0.00,0.50,0.50,0,1.00,1,393.72,0,0,3,org.apache.lucene.util.PriorityQueue,0.00,2,1,3,0,2,3,0,3,95,2
"org.apache.lucene.search.spell.SuggestWordScoreComparator",1,0.00,5.00,11,0.12,5042.84,1,0,1,2,2,60.33,7,17,1,1,102.63,0.00,0.00,0.00,0,1.00,5,348.35,0,0,1,java.lang.Object,0.00,1,0,5,0,1,1,1,4,83,1
"org.apache.lucene.search.spell.TermFreqIterator",1,0.00,1.00,3,0.02,218.94,1,0,4,1,16,92.48,7,4,14,2,134.77,0.00,0.50,0.00,0,1.00,1,54.79,0,0,2,,0.00,0,1,1,0,0,1,0,2,18,1
"org.apache.lucene.search.spell.TermFreqIterator$TermFreqIteratorWrapper",4,0.67,1.00,10,0.07,989.20,5,1,4,6,3,140.92,0,16,0,1,140.92,0.00,0.00,0.50,0,4.00,1,215.07,0,2,3,java.lang.Object,0.00,2,0,4,0,2,2,1,0,62,2
"org.apache.lucene.search.spell.TestDirectSpellChecker",6,0.00,2.33,170,2.83,147374.38,6,0,10,32,13,132.25,11,193,0,2,82.25,0.00,0.50,0.00,0,6.00,4,8493.91,0,0,13,org.apache.lucene.util.LuceneTestCase,0.00,26,1,14,0,26,6,0,11,1419,1
"org.apache.lucene.search.spell.TestJaroWinklerDistance",1,0.00,1.00,23,0.36,12643.14,2,1,1,4,2,87.90,0,25,0,2,87.90,0.00,0.50,1.00,0,0.00,1,1078.65,0,0,2,org.apache.lucene.util.LuceneTestCase,0.00,3,1,1,0,3,1,0,0,196,1
"org.apache.lucene.search.spell.TestLevenshteinDistance",2,0.00,1.00,26,0.34,8526.29,3,1,1,6,2,100.86,0,29,0,2,100.86,0.00,0.50,1.00,0,0.00,1,1033.78,0,0,2,org.apache.lucene.util.LuceneTestCase,0.00,4,1,2,0,4,2,0,0,199,1
"org.apache.lucene.search.spell.TestLuceneDictionary",8,0.60,1.88,102,1.33,39656.30,13,5,12,35,12,101.50,6,123,0,2,101.50,0.00,0.50,0.72,0,0.00,3,3979.75,2,0,12,org.apache.lucene.util.LuceneTestCase,0.00,27,1,15,0,27,8,0,2,762,1
"org.apache.lucene.search.spell.TestNGramDistance",4,0.00,1.00,100,1.48,51227.16,4,0,1,8,2,86.51,0,105,0,2,86.51,0.00,0.50,0.00,0,4.00,1,4432.45,0,0,2,org.apache.lucene.util.LuceneTestCase,0.00,4,1,4,0,4,4,0,0,766,1
"org.apache.lucene.search.spell.TestPlainTextDictionary",1,0.00,1.00,14,0.20,5403.99,1,0,4,11,3,99.09,4,16,0,2,98.85,0.00,0.50,0.00,0,1.00,1,608.63,0,0,3,org.apache.lucene.util.LuceneTestCase,0.00,10,1,1,0,10,1,0,1,114,1
"org.apache.lucene.search.spell.TestSpellChecker",16,0.17,2.12,273,3.85,179242.70,20,4,20,69,19,113.66,54,338,1,2,93.04,0.00,0.50,0.41,8,0.00,6,11560.65,2,0,18,org.apache.lucene.util.LuceneTestCase,0.00,53,1,34,0,53,16,0,49,2101,1
"org.apache.lucene.search.spell.TestSpellChecker$SpellCheckWorker",2,0.33,2.50,17,0.12,2221.28,5,3,20,4,2,113.12,0,26,0,1,113.12,0.00,0.00,0.50,0,2.00,4,355.64,0,0,2,java.lang.Object,0.00,2,0,5,0,2,2,1,0,86,1
"org.apache.lucene.search.spell.TestSpellChecker$SpellCheckerMock",4,0.00,1.00,11,0.11,1556.15,4,0,20,5,5,139.38,0,18,0,2,139.38,0.00,0.50,0.00,0,4.00,1,333.71,1,1,5,org.apache.lucene.search.spell.SpellChecker,0.00,1,1,4,0,1,3,0,0,86,0
"org.apache.lucene.codecs.mocksep.MockSepDocValuesFormat",3,0.00,1.00,7,0.09,1454.90,3,0,10,6,8,188.62,5,14,0,2,138.62,0.00,0.50,0.00,0,3.00,1,256.24,0,2,8,org.apache.lucene.codecs.DocValuesFormat,0.00,3,1,3,0,3,1,0,2,66,1
"org.apache.lucene.codecs.mocksep.MockSepPostingsFormat",4,0.00,2.00,43,0.53,23329.12,4,0,20,19,23,153.88,6,80,4,2,103.88,0.00,0.50,0.00,0,4.00,3,1575.84,0,2,19,org.apache.lucene.codecs.PostingsFormat,0.00,15,1,8,0,15,2,0,1,310,1
"org.apache.lucene.codecs.mocksep.MockSingleIntFactory",2,0.00,1.00,5,0.07,1143.20,2,0,6,4,10,138.06,1,10,3,2,138.06,0.00,0.50,0.00,0,2.00,1,219.41,0,2,7,org.apache.lucene.codecs.sep.IntStreamFactory,0.00,2,1,2,0,2,0,0,1,54,1
"org.apache.lucene.codecs.mocksep.MockSingleIntIndexInput",4,0.33,1.00,13,0.15,2645.96,5,1,7,10,8,180.99,7,23,1,2,130.99,0.00,0.50,0.75,0,0.00,1,450.89,0,1,7,org.apache.lucene.codecs.sep.IntIndexInput,0.86,6,1,4,0,6,3,0,1,113,1
"org.apache.lucene.codecs.mocksep.MockSingleIntIndexInput$Index",5,0.00,1.20,17,0.17,3446.03,6,1,7,8,1,130.81,0,31,0,2,130.81,0.00,0.50,1.00,0,0.00,2,516.70,0,2,1,IntIndexInput.Index,0.00,3,1,6,0,3,3,0,0,131,0
"org.apache.lucene.codecs.mocksep.MockSingleIntIndexInput$Reader",2,1.00,1.00,6,0.05,775.89,3,1,7,3,1,182.82,3,10,0,2,132.82,0.00,0.50,0.50,0,2.00,1,156.29,0,0,1,IntIndexInput.Reader,0.00,1,1,2,0,1,2,0,3,43,2
"org.apache.lucene.codecs.mocksep.MockSingleIntIndexOutput",5,0.06,1.20,22,0.23,4365.06,9,4,7,12,8,175.34,6,35,2,2,125.34,0.00,0.50,0.30,0,0.00,2,686.99,0,1,6,org.apache.lucene.codecs.sep.IntIndexOutput,0.75,7,1,6,0,7,4,0,2,159,1
"org.apache.lucene.codecs.mocksep.MockSingleIntIndexOutput$Index",4,0.33,1.50,17,0.16,3427.85,6,2,7,6,1,125.35,0,29,0,2,125.35,0.00,0.50,0.75,0,0.00,2,487.67,0,1,1,IntIndexOutput.Index,0.00,2,1,6,0,2,3,0,0,121,1
"org.apache.lucene.queryparser.flexible.core.config.AbstractQueryConfig",5,1.00,2.00,22,0.28,7902.69,6,1,1,10,3,75.09,43,34,2,1,123.19,0.00,0.00,0.00,2,5.00,3,850.85,0,0,1,java.lang.Object,0.00,5,0,10,4,5,5,0,6,190,2
"org.apache.lucene.queryparser.flexible.core.config.ConfigurationKey",2,0.00,1.00,4,0.03,729.29,2,0,0,3,5,129.24,30,6,5,1,139.60,0.00,0.00,0.00,0,2.00,1,103.70,0,1,0,java.lang.Object,0.00,1,0,2,0,1,1,0,3,32,2
"org.apache.lucene.queryparser.flexible.core.config.FieldConfig",3,1.00,1.33,10,0.09,1389.59,4,1,0,4,12,83.67,30,17,11,2,132.14,0.00,0.50,0.00,0,3.00,2,265.96,1,2,1,org.apache.lucene.queryparser.flexible.core.config.AbstractQueryConfig,0.00,1,1,4,0,1,1,0,4,69,1
"org.apache.lucene.queryparser.flexible.core.config.FieldConfigListener",1,0.00,1.00,2,0.01,30.51,1,0,0,1,5,185.12,30,3,4,1,148.08,0.00,0.00,0.00,0,1.00,1,25.51,0,0,1,,0.00,0,0,1,0,0,1,0,3,11,1
"org.apache.lucene.queryparser.flexible.core.config.QueryConfigHandler",2,1.00,1.50,10,0.10,2263.90,3,1,3,7,29,138.92,36,13,25,2,120.79,2.00,0.25,0.00,0,2.00,2,314.68,0,0,5,org.apache.lucene.queryparser.flexible.core.config.AbstractQueryConfig,0.00,5,1,3,2,5,2,0,3,75,2
"org.apache.lucene.util.mutable.MutableValue",10,1.00,1.50,23,0.26,8786.52,11,1,0,15,61,136.50,1,33,61,1,136.50,0.00,0.00,0.10,3,18.00,5,790.25,0,3,0,java.lang.Object,0.00,5,0,15,7,5,7,1,1,196,2
"org.apache.lucene.util.mutable.MutableValueBool",6,0.20,2.17,23,0.26,7149.50,7,1,0,7,6,128.80,0,36,5,2,128.80,0.00,0.50,0.83,0,0.00,5,781.94,0,1,1,org.apache.lucene.util.mutable.MutableValue,0.50,1,1,13,0,1,5,0,0,188,1
"org.apache.lucene.util.mutable.MutableValueDate",2,0.00,1.50,8,0.08,1652.07,2,0,1,4,5,125.48,0,13,3,3,125.48,0.00,0.67,0.00,0,2.00,2,226.48,0,1,2,org.apache.lucene.util.mutable.MutableValueLong,0.33,2,2,3,0,2,1,0,0,58,1
"org.apache.lucene.util.mutable.MutableValueDouble",6,0.20,1.67,26,0.29,7468.68,7,1,0,9,9,124.05,0,39,8,2,124.05,0.00,0.50,0.83,0,0.00,4,874.00,0,2,1,org.apache.lucene.util.mutable.MutableValue,0.38,3,1,10,0,3,4,0,0,207,1
"org.apache.lucene.util.mutable.MutableValueFloat",6,0.20,1.67,24,0.26,7255.12,7,1,0,9,13,124.15,0,37,12,2,124.15,0.00,0.50,0.83,0,0.00,4,794.30,0,1,1,org.apache.lucene.util.mutable.MutableValue,0.50,3,1,10,0,3,5,0,0,189,1
"org.apache.lucene.util.mutable.MutableValueInt",6,0.20,1.83,25,0.29,9715.01,7,1,0,7,11,123.13,1,39,10,2,123.13,0.00,0.50,0.83,0,0.00,5,870.11,0,1,1,org.apache.lucene.util.mutable.MutableValue,0.50,1,1,11,0,1,5,0,1,205,1
"org.apache.lucene.util.mutable.MutableValueLong",6,0.20,1.83,25,0.28,8436.66,7,1,0,7,11,123.61,0,38,10,2,123.61,1.00,0.33,0.83,0,0.00,5,835.73,0,1,1,org.apache.lucene.util.mutable.MutableValue,0.50,1,1,11,1,1,5,0,0,199,1
"org.apache.lucene.util.mutable.MutableValueStr",6,0.00,1.67,24,0.28,7551.84,7,1,1,13,10,124.01,0,37,8,2,124.01,0.00,0.50,1.00,0,0.00,4,837.76,0,1,2,org.apache.lucene.util.mutable.MutableValue,0.50,7,1,10,0,7,5,0,0,198,1
"org.apache.lucene.facet.index.CategoryContainer",18,0.59,1.94,94,0.93,27092.77,19,1,13,42,13,101.88,104,125,8,1,119.75,0.00,0.00,0.44,6,34.00,5,2784.45,0,8,5,java.lang.Object,0.00,24,0,35,0,24,10,2,19,623,1
"org.apache.lucene.facet.index.CategoryContainerTest",10,0.00,2.30,121,1.49,54618.75,10,0,15,32,10,101.36,45,158,0,3,101.12,0.00,0.67,0.00,0,0.00,4,4477.84,0,0,10,org.apache.lucene.facet.index.CategoryContainerTestBase,0.00,22,2,23,0,22,10,0,11,838,1
"org.apache.lucene.facet.index.CategoryContainerTestBase",1,0.00,2.00,14,0.15,4057.43,3,2,4,4,3,99.20,16,15,1,2,99.67,5.00,0.14,1.00,0,0.00,2,446.86,0,0,2,org.apache.lucene.util.LuceneTestCase,0.00,3,1,2,5,3,1,0,1,93,2
"org.apache.lucene.facet.index.CategoryDocumentBuilder",10,0.06,1.60,54,0.66,16976.27,14,4,24,35,31,118.91,163,81,13,1,119.38,0.00,0.00,0.20,6,30.00,3,1970.70,0,7,18,java.lang.Object,0.00,25,0,16,1,25,3,0,32,409,1
"org.apache.lucene.facet.index.CategoryListPayloadStream",4,0.33,1.25,17,0.14,1959.14,6,2,3,10,4,95.09,27,24,3,1,127.31,0.00,0.00,0.75,0,0.00,2,412.09,0,0,1,java.lang.Object,0.00,6,0,5,0,6,4,0,7,107,1
"org.apache.lucene.facet.index.CategoryListPayloadStreamTest",1,0.00,1.00,32,0.48,22820.64,1,0,10,14,7,113.92,20,38,0,2,80.53,0.00,0.50,0.00,0,1.00,1,1435.07,0,0,7,org.apache.lucene.util.LuceneTestCase,0.00,13,1,1,0,13,1,0,2,263,1
"org.apache.lucene.facet.index.DummyProperty",4,0.00,1.25,11,0.08,1002.13,4,0,1,5,7,141.06,19,21,6,1,140.83,0.00,0.00,0.00,0,4.00,2,235.09,1,1,1,java.lang.Object,0.00,1,0,5,0,1,3,1,2,66,1
"org.apache.lucene.facet.index.FacetsPayloadProcessorProvider",2,1.00,2.00,13,0.13,2213.13,4,2,17,4,11,99.76,79,20,1,2,117.84,0.00,0.50,1.00,0,0.00,3,385.35,0,1,10,org.apache.lucene.index.PayloadProcessorProvider,0.00,2,1,4,0,2,1,0,4,91,1
"org.apache.lucene.facet.index.FacetsPayloadProcessorProvider$FacetsDirPayloadProcessor",2,0.50,2.00,13,0.17,3956.40,4,2,17,8,4,136.47,6,18,0,2,115.86,0.00,0.50,0.75,0,0.00,2,511.75,0,1,4,org.apache.lucene.index.ReaderPayloadProcessor,0.00,6,1,4,0,6,1,0,2,111,2
"org.apache.lucene.facet.index.FacetsPayloadProcessorProvider$FacetsPayloadProcessor",2,1.00,1.50,23,0.29,8052.13,6,4,17,12,4,143.56,5,28,0,2,103.67,0.00,0.50,0.75,0,0.00,2,881.39,0,0,4,org.apache.lucene.index.PayloadProcessor,0.00,10,1,3,0,10,2,0,2,176,2
"org.apache.lucene.facet.index.FacetsPayloadProcessorProviderTest",3,0.50,2.67,56,0.77,27744.70,4,1,23,41,19,74.85,17,59,0,2,92.72,0.00,0.50,0.67,2,1.00,4,2324.25,0,0,19,org.apache.lucene.util.LuceneTestCase,0.00,38,1,8,0,38,3,0,2,414,1
"org.apache.solr.client.solrj.embedded.AbstractEmbeddedSolrServerTestCase",8,0.00,1.38,33,0.43,10008.01,12,4,10,25,7,124.08,2,48,2,2,124.08,2.00,0.25,0.25,3,12.00,4,1303.38,2,4,5,org.apache.lucene.util.LuceneTestCase,0.00,17,1,11,2,17,4,0,2,277,2
"org.apache.solr.client.solrj.embedded.EmbeddedSolrServer",6,0.20,4.50,77,1.25,92895.53,9,3,31,50,32,65.18,39,123,6,2,97.40,0.00,0.50,0.50,1,0.00,17,3755.72,0,3,26,org.apache.solr.client.solrj.SolrServer,0.00,44,1,27,0,44,3,0,11,623,1
"org.apache.solr.client.solrj.embedded.EmbeddedSolrServer$BinaryResponseWriter.Resolver",1,0.00,1.00,8,0.11,2619.55,1,0,31,10,3,150.28,2,10,0,1,110.40,0.00,0.00,0.00,0,1.00,1,343.94,0,0,3,java.lang.Object,0.00,9,0,1,0,9,1,0,2,76,0
"org.apache.solr.client.solrj.embedded.EmbeddedSolrServer$JavaBinCodec",2,0.00,1.50,12,0.16,4950.42,2,0,31,12,2,115.16,1,17,0,1,115.16,0.00,0.00,0.00,0,2.00,2,480.29,1,0,2,java.lang.Object,0.00,10,0,3,0,10,2,0,1,105,0
"org.apache.solr.client.solrj.embedded.JettySolrRunner",15,0.01,2.20,105,1.16,41381.76,27,12,17,49,20,152.09,30,144,19,1,112.20,0.00,0.00,0.09,2,55.00,9,3479.33,0,1,1,java.lang.Object,0.00,34,0,33,0,34,14,0,14,694,1
"org.apache.solr.client.solrj.embedded.JettySolrRunner$LifeCycle.Listener",5,0.00,1.80,19,0.24,4416.61,5,0,17,11,2,129.87,2,26,0,1,129.87,0.00,0.00,0.00,0,11.00,5,715.68,0,0,2,java.lang.Object,0.00,6,0,9,0,6,5,0,2,158,0
"org.apache.solr.client.solrj.embedded.JettySolrRunner$NoLog",17,0.44,1.12,28,0.31,5084.81,19,2,17,20,0,151.48,0,59,0,1,151.48,0.00,0.00,0.09,1,58.00,2,918.26,0,3,0,java.lang.Object,0.00,3,0,19,0,3,14,1,0,251,0
"org.apache.solr.client.solrj.embedded.JettySolrRunner$Servlet404",1,0.00,1.00,3,0.04,610.98,1,0,17,3,0,131.26,0,7,0,2,131.26,0.00,0.50,0.00,0,1.00,1,132.02,0,0,0,javax.servlet.http.HttpServlet,0.00,2,1,1,0,2,1,0,0,33,2
"org.apache.solr.client.solrj.embedded.JettyWebappTest",3,0.38,1.33,31,0.47,11758.74,7,4,15,30,2,145.22,8,45,0,2,105.34,0.00,0.50,0.50,0,0.00,2,1408.98,2,0,2,org.apache.lucene.util.LuceneTestCase,0.00,27,1,4,0,27,3,0,5,261,1
"org.apache.solr.client.solrj.embedded.LargeVolumeBinaryJettyTest",1,0.00,1.00,3,0.03,411.02,1,0,3,1,2,132.85,4,6,0,5,132.62,0.00,0.80,0.00,0,1.00,1,91.51,1,0,2,org.apache.solr.client.solrj.LargeVolumeTestBase,0.00,0,4,1,0,0,1,0,1,25,1
"org.apache.solr.client.solrj.embedded.LargeVolumeEmbeddedTest",1,0.00,1.00,3,0.04,532.41,1,0,3,1,2,131.73,0,6,0,5,131.73,0.00,0.80,0.00,0,1.00,1,109.52,1,0,2,org.apache.solr.client.solrj.LargeVolumeTestBase,0.00,0,4,1,0,0,1,0,0,29,1
"org.apache.solr.client.solrj.embedded.LargeVolumeJettyTest",1,0.00,1.00,3,0.03,411.02,1,0,3,1,2,132.62,0,6,0,5,132.62,0.00,0.80,0.00,0,1.00,1,91.51,1,0,2,org.apache.solr.client.solrj.LargeVolumeTestBase,0.00,0,4,1,0,0,1,0,0,25,1
"org.apache.solr.client.solrj.embedded.MergeIndexesEmbeddedTest",6,0.00,1.00,20,0.20,3304.74,6,0,4,13,4,181.62,7,33,0,5,131.62,0.00,0.80,0.00,0,0.00,1,602.43,2,5,4,org.apache.solr.client.solrj.MergeIndexesExampleTestBase,0.42,7,4,6,0,7,1,0,2,148,1
"org.apache.solr.client.solrj.embedded.MultiCoreEmbeddedTest",5,0.00,1.00,15,0.15,2489.14,5,0,3,9,3,181.96,7,30,0,5,131.96,0.00,0.80,0.00,0,0.00,1,462.25,2,4,3,org.apache.solr.client.solrj.MultiCoreExampleTestBase,0.36,4,4,5,0,4,1,0,2,115,1
"org.apache.solr.client.solrj.embedded.MultiCoreExampleJettyTest",8,0.00,1.25,64,0.84,29244.12,11,3,14,37,11,149.09,17,89,0,5,109.20,0.00,0.80,0.33,3,16.00,2,2532.74,3,5,11,org.apache.solr.client.solrj.MultiCoreExampleTestBase,0.42,29,4,10,0,29,3,0,10,480,1
"org.apache.solr.client.solrj.embedded.SolrExampleEmbeddedTest",1,0.00,1.00,3,0.04,532.41,1,0,3,1,2,99.51,6,6,0,5,131.73,0.00,0.80,0.00,0,1.00,1,109.52,1,0,2,org.apache.solr.client.solrj.SolrExampleTests,0.00,0,4,1,0,0,1,0,1,29,1
"org.apache.solr.client.solrj.embedded.SolrExampleJettyTest",2,0.00,1.50,8,0.09,1691.73,2,0,6,5,3,125.63,8,17,0,5,125.40,0.00,0.80,0.00,0,2.00,2,272.62,1,0,3,org.apache.solr.client.solrj.SolrExampleTests,0.00,3,4,3,0,3,2,0,3,64,1
"org.apache.solr.client.solrj.embedded.SolrExampleStreamingBinaryTest",2,0.00,1.50,14,0.15,3876.91,2,0,8,11,7,163.49,3,23,0,5,113.49,0.00,0.80,0.00,0,2.00,2,452.72,1,1,7,org.apache.solr.client.solrj.SolrExampleTests,0.05,9,4,3,0,9,1,0,3,96,1
"org.apache.solr.client.solrj.embedded.SolrExampleStreamingBinaryTest$StreamingUpdateSolrServer",1,0.00,1.00,3,0.02,244.57,1,0,8,2,0,134.39,0,5,0,1,134.39,0.00,0.00,0.00,0,1.00,1,73.43,0,0,0,java.lang.Object,0.00,1,0,1,0,1,1,0,0,22,0
"org.apache.solr.client.solrj.embedded.SolrExampleStreamingTest",2,0.00,1.50,12,0.12,2990.75,2,0,6,7,5,117.12,8,21,0,5,116.88,0.00,0.80,0.00,0,2.00,2,361.39,1,1,5,org.apache.solr.client.solrj.SolrExampleTests,0.05,5,4,3,0,5,1,0,4,80,1
"org.apache.solr.client.solrj.embedded.SolrExampleStreamingTest$StreamingUpdateSolrServer",1,0.00,1.00,2,0.02,105.56,1,0,6,1,0,193.84,1,4,0,1,143.84,0.00,0.00,0.00,0,1.00,1,51.35,0,0,0,java.lang.Object,0.00,0,0,1,0,0,1,0,1,17,0
"org.apache.solr.client.solrj.embedded.TestEmbeddedSolrServer",4,2.00,1.50,23,0.30,7813.65,6,2,11,17,4,118.92,0,31,0,3,118.92,0.00,0.67,0.00,1,0.00,3,899.73,1,1,4,org.apache.solr.client.solrj.embedded.AbstractEmbeddedSolrServerTestCase,0.50,13,2,6,0,13,3,0,0,198,1
"org.apache.solr.client.solrj.embedded.TestSolrProperties",6,0.04,1.33,101,1.85,101320.00,11,5,29,53,13,74.85,34,131,0,3,92.73,0.00,0.67,0.17,2,6.00,3,5546.50,3,3,13,org.apache.solr.client.solrj.embedded.AbstractEmbeddedSolrServerTestCase,0.43,47,2,8,0,47,3,0,31,872,1
"org.apache.lucene.benchmark.byTask.feeds.demohtml.Entities",3,0.25,3.67,289,4.33,62668.95,5,2,2,17,1,112.74,4,300,1,1,62.74,0.00,0.00,0.67,1,0.00,5,12988.68,0,2,0,java.lang.Object,0.00,14,0,11,0,14,1,0,4,1578,1
"org.apache.lucene.benchmark.byTask.feeds.demohtml.HTMLParser",38,0.07,4.84,546,6.17,345749.72,76,38,3,81,9,96.71,34,647,3,1,96.71,0.00,0.00,0.10,16,338.00,15,18524.45,0,5,7,java.lang.Object,0.00,43,0,184,0,43,33,1,34,3441,1
"org.apache.lucene.benchmark.byTask.feeds.demohtml.HTMLParser$JJCalls",0,0.00,0.00,5,0.03,253.51,4,4,3,0,1,171.00,0,6,0,1,171.00,0.00,0.00,0.00,0,0.00,0,78.87,0,0,1,java.lang.Object,0.00,0,0,0,0,0,0,0,0,22,2
"org.apache.lucene.benchmark.byTask.feeds.demohtml.HTMLParser$LookaheadSuccess",0,0.00,0.00,1,0.01,145.30,0,0,3,0,0,171.00,0,1,0,2,171.00,0.00,0.50,0.00,0,0.00,0,41.51,0,0,0,java.lang.Error,0.00,0,1,0,0,0,0,0,0,12,3
"org.apache.lucene.benchmark.byTask.feeds.demohtml.HTMLParser$MyPipedInputStream",3,0.00,1.00,7,0.05,452.47,3,0,3,4,0,142.62,0,11,0,2,142.62,0.00,0.50,0.00,0,3.00,1,139.88,0,0,0,java.io.PipedInputStream,0.00,1,1,3,0,1,3,0,0,42,1
"org.apache.lucene.benchmark.byTask.feeds.demohtml.HTMLParserConstants",0,0.00,0.00,40,0.61,7906.55,39,39,0,0,2,171.00,43,73,2,1,171.00,0.00,0.00,0.00,0,0.00,0,1834.18,0,0,0,,0.00,0,0,0,0,0,0,0,40,271,1
"org.apache.lucene.benchmark.byTask.feeds.demohtml.HTMLParserTokenManager",51,0.07,8.69,960,12.93,1736149.91,70,19,3,62,4,87.99,12,1623,1,1,87.99,0.00,0.00,0.13,24,216.00,124,38803.15,0,0,3,java.lang.Object,0.00,11,0,443,0,11,51,1,12,6474,1
"org.apache.lucene.benchmark.byTask.feeds.demohtml.ParseException",5,0.30,3.20,92,1.07,80794.24,10,5,0,14,3,61.39,69,112,2,2,90.77,0.00,0.50,0.44,0,0.00,10,3210.28,1,2,1,java.lang.Exception,0.00,9,1,16,0,9,3,0,11,572,1
"org.apache.lucene.benchmark.byTask.feeds.demohtml.ParserThread",2,0.00,2.50,16,0.19,5142.33,3,1,1,9,2,160.25,2,27,1,2,110.25,0.00,0.50,1.00,0,0.00,4,558.48,0,0,2,java.lang.Thread,0.00,7,1,5,0,7,2,0,2,116,0
"org.apache.lucene.benchmark.byTask.feeds.demohtml.SimpleCharStream",36,0.09,1.89,204,2.72,162256.64,52,16,0,44,2,166.01,45,352,2,1,116.01,0.00,0.00,0.15,6,144.00,10,8153.78,0,1,0,java.lang.Object,0.00,8,0,68,0,8,35,0,34,1701,1
"org.apache.lucene.benchmark.byTask.feeds.demohtml.SuppressWarnings",6,0.20,1.50,48,0.66,33774.42,11,5,0,14,0,59.58,51,72,0,2,107.69,0.00,0.50,0.03,1,10.00,3,1967.96,1,3,0,java.lang.Error,0.00,8,1,9,0,8,3,0,14,375,1
"org.apache.lucene.benchmark.byTask.feeds.demohtml.Tags",0,0.00,0.00,33,0.35,7423.82,1,1,3,2,0,171.00,4,35,0,1,171.00,0.00,0.00,0.00,0,0.00,0,1058.57,0,0,0,java.lang.Object,0.00,2,0,0,0,2,0,0,2,208,2
"org.apache.lucene.benchmark.byTask.feeds.demohtml.TestHtmlParser",12,0.00,1.08,57,0.72,12674.54,12,0,5,25,1,124.71,2,92,0,2,124.71,0.00,0.50,0.00,1,12.00,2,2171.45,0,0,1,org.apache.lucene.util.LuceneTestCase,0.00,13,1,13,0,13,12,0,2,475,1
"org.apache.lucene.benchmark.byTask.feeds.demohtml.Token",7,0.12,1.00,24,0.16,1989.42,15,8,0,8,5,83.88,67,38,5,1,133.88,0.00,0.00,0.02,1,12.00,1,468.86,0,4,0,java.lang.Object,0.00,1,0,7,0,1,3,0,15,131,1
"org.apache.lucene.codecs.lucene.Lucene40WithOrds",4,0.33,2.00,46,0.54,23693.93,7,3,19,18,18,142.17,10,82,1,2,102.29,0.00,0.50,0.08,0,6.00,3,1632.99,0,2,17,org.apache.lucene.codecs.PostingsFormat,0.00,14,1,8,0,14,2,0,10,327,1
"org.apache.lucene.facet.search.sampling.BaseSampleTestTopK",5,0.38,2.00,48,0.72,27362.59,7,2,16,28,20,73.59,32,63,3,4,105.81,1.00,0.43,0.20,3,7.00,5,2149.26,4,3,17,org.apache.lucene.facet.search.BaseTestTopK,0.00,23,3,10,3,23,2,0,13,389,2
"org.apache.lucene.facet.search.sampling.BaseSampleTestTopK$FacetsCollector",1,0.00,2.00,5,0.07,1535.09,1,0,16,3,4,119.68,0,9,0,1,119.68,0.00,0.00,0.00,0,1.00,2,212.37,0,1,4,java.lang.Object,0.00,2,0,2,0,2,0,0,0,48,0
"org.apache.lucene.facet.search.sampling.RandomSampler",3,1.00,2.00,29,0.37,28369.02,4,1,5,10,7,61.65,23,34,2,2,103.94,0.00,0.50,0.33,0,4.00,4,1117.23,0,0,5,org.apache.lucene.facet.search.sampling.Sampler,0.00,7,1,6,0,7,3,0,6,211,1
"org.apache.lucene.facet.search.sampling.RepeatableSampler",8,0.24,5.00,131,1.72,106479.13,11,3,8,28,8,73.09,119,161,2,2,93.24,0.00,0.50,0.12,4,22.00,9,5156.19,0,0,6,org.apache.lucene.facet.search.sampling.Sampler,0.00,20,1,40,0,20,8,0,14,954,1
"org.apache.lucene.facet.search.sampling.RepeatableSampler$IntPriorityQueue",4,4.00,1.25,19,0.20,4314.70,8,4,8,5,1,87.04,48,27,0,2,124.61,0.00,0.50,0.00,0,4.00,2,614.68,2,1,1,org.apache.lucene.util.PriorityQueue,0.00,1,1,5,0,1,3,0,13,146,2
"org.apache.lucene.facet.search.sampling.RepeatableSampler$IntPriorityQueue$Algorithm",0,0.00,0.00,2,0.01,23.26,0,0,8,0,0,171.00,10,4,0,1,171.00,0.00,0.00,0.00,0,0.00,0,15.51,0,0,0,java.lang.Object,0.00,0,0,0,0,0,0,0,4,6,1
"org.apache.lucene.facet.search.sampling.RepeatableSampler$IntPriorityQueue$MI",1,1.00,1.00,3,0.01,109.36,2,1,8,1,0,137.15,0,4,0,1,137.15,0.00,0.00,0.00,0,1.00,1,39.62,0,0,0,java.lang.Object,0.00,0,0,1,0,0,1,0,0,14,2
"org.apache.lucene.facet.search.sampling.RepeatableSampler$IntPriorityQueue$Sorted",0,0.00,0.00,2,0.01,23.26,0,0,8,0,0,171.00,3,4,0,1,171.00,0.00,0.00,0.00,0,0.00,0,15.51,0,0,0,java.lang.Object,0.00,0,0,0,0,0,0,0,1,6,1
"org.apache.lucene.facet.search.sampling.SampleFixer",1,0.00,1.00,2,0.02,88.11,1,0,3,1,4,170.69,32,3,2,1,144.45,0.00,0.00,0.00,0,1.00,1,46.05,0,0,2,,0.00,0,0,1,0,0,1,0,3,15,1
"org.apache.lucene.facet.search.sampling.Sampler",9,0.75,1.67,47,0.58,17168.81,10,1,11,35,22,70.50,93,68,9,1,118.98,0.00,0.00,0.33,2,18.00,3,1740.64,0,4,13,java.lang.Object,0.00,26,0,15,2,26,5,0,16,369,2
"org.apache.lucene.facet.search.sampling.Sampler$OverSampledFacetRequest",4,0.33,1.00,11,0.12,1946.44,5,1,11,8,5,138.61,0,22,0,2,138.61,0.00,0.50,0.75,0,0.00,1,373.18,0,1,5,org.apache.lucene.facet.search.params.FacetRequest,0.07,4,1,4,0,4,3,0,0,96,2
"org.apache.lucene.facet.search.sampling.Sampler$SampleResult",1,2.00,1.00,6,0.04,581.16,3,2,11,1,1,120.21,0,8,0,1,120.21,0.00,0.00,0.00,0,1.00,1,133.97,0,0,1,java.lang.Object,0.00,0,0,1,0,0,1,0,0,38,3
"org.apache.lucene.facet.search.sampling.SamplingAccumulator",5,0.12,1.60,36,0.44,14640.71,7,2,16,17,15,63.59,53,58,2,3,112.07,0.00,0.67,0.40,0,6.00,3,1322.63,3,2,13,org.apache.lucene.facet.search.StandardFacetsAccumulator,0.14,12,2,8,0,12,3,0,15,268,1
"org.apache.lucene.facet.search.sampling.SamplingAccumulatorTest",1,0.00,1.00,3,0.04,557.59,1,0,4,2,7,131.10,16,9,0,5,131.58,0.00,0.80,0.00,0,1.00,1,121.71,0,1,7,org.apache.lucene.facet.search.sampling.BaseSampleTestTopK,0.00,1,4,1,0,1,0,0,1,31,1
"org.apache.lucene.facet.search.sampling.SamplingParams",11,0.02,1.00,33,0.28,4572.41,21,10,0,11,4,82.58,99,49,4,1,132.58,0.00,0.00,0.08,0,49.00,1,853.90,0,0,0,java.lang.Object,0.00,0,0,11,0,0,11,0,18,216,1
"org.apache.lucene.facet.search.sampling.TakmiSampleFixer",6,0.20,3.00,56,0.59,29285.90,9,3,15,20,16,76.73,79,78,1,1,106.11,0.00,0.00,0.17,3,10.00,10,1762.06,0,0,15,java.lang.Object,0.00,14,0,18,0,14,6,1,24,368,0
"org.apache.lucene.queryparser.flexible.standard.config.FieldBoostMapFCListener",2,1.00,2.00,10,0.12,2473.76,3,1,5,5,4,102.54,11,15,1,1,120.42,0.00,0.00,0.00,0,2.00,3,360.49,0,0,3,java.lang.Object,0.00,3,0,4,0,3,2,1,1,82,1
"org.apache.lucene.queryparser.flexible.standard.config.FieldDateResolutionFCListener",2,1.00,2.50,13,0.16,5058.28,3,1,7,5,5,97.09,11,20,1,1,114.96,0.00,0.00,0.00,0,2.00,4,493.74,0,0,4,java.lang.Object,0.00,3,0,5,0,3,2,1,1,108,1
"org.apache.lucene.queryparser.flexible.standard.config.FuzzyConfig",5,0.38,1.00,12,0.08,848.20,7,2,1,5,5,142.21,0,17,4,1,142.21,0.00,0.00,0.20,0,11.00,1,231.90,0,0,1,java.lang.Object,0.00,0,0,5,0,0,5,0,0,68,1
"org.apache.lucene.queryparser.flexible.standard.config.NumberDateFormat",5,0.12,1.20,14,0.20,4091.26,7,2,6,9,1,176.68,10,27,1,2,136.79,0.00,0.50,0.40,0,0.00,2,608.28,0,4,0,java.text.NumberFormat,0.00,4,1,6,0,4,1,0,2,146,1
"org.apache.lucene.queryparser.flexible.standard.config.NumericConfig",8,0.24,1.62,31,0.28,8183.42,11,3,3,9,9,87.10,62,48,8,1,129.39,0.00,0.00,0.12,4,26.00,4,829.88,0,2,1,java.lang.Object,0.00,1,0,13,0,1,6,0,8,203,1
"org.apache.lucene.queryparser.flexible.standard.config.NumericFieldConfigListener",2,1.00,2.50,12,0.13,2922.77,3,1,5,7,5,68.74,16,20,1,1,116.84,0.00,0.00,0.50,0,2.00,3,401.13,0,0,4,java.lang.Object,0.00,5,0,5,0,5,2,1,2,91,1
"org.apache.lucene.queryparser.flexible.standard.config.StandardQueryConfigHandler",1,0.00,1.00,18,0.25,4807.12,1,0,14,8,16,84.82,15,20,5,3,95.18,0.00,0.67,0.00,0,1.00,1,745.29,2,0,12,org.apache.lucene.queryparser.flexible.core.config.QueryConfigHandler,0.00,7,2,1,0,7,1,0,8,142,1
"org.apache.lucene.queryparser.flexible.standard.config.StandardQueryConfigHandler$ConfigurationKeys",0,0.00,0.00,17,0.49,23247.70,16,16,14,1,6,171.00,100,18,0,1,171.00,0.00,0.00,0.00,0,0.00,0,1463.74,0,0,6,java.lang.Object,0.00,1,0,0,0,1,0,0,16,265,3
"org.apache.lucene.queryparser.flexible.standard.config.StandardQueryConfigHandler$Operator",0,0.00,0.00,2,0.01,60.00,0,0,14,0,0,171.00,0,3,0,1,171.00,0.00,0.00,0.00,0,0.00,0,24.00,0,0,0,java.lang.Object,0.00,0,0,0,0,0,0,0,0,8,2
"org.apache.solr.uima.analysis.UIMAAnnotationsTokenizerFactory",2,1.00,1.00,9,0.09,1633.56,4,2,5,4,3,175.61,3,14,0,3,125.61,0.00,0.67,1.00,0,0.00,1,283.80,1,1,3,org.apache.solr.analysis.BaseTokenizerFactory,0.00,2,2,2,0,2,1,0,1,70,1
"org.apache.solr.uima.analysis.UIMAAnnotationsTokenizerFactoryTest",3,0.00,1.00,13,0.15,2285.66,3,0,4,9,2,125.85,2,20,0,3,125.85,0.00,0.67,0.00,0,4.00,1,439.21,4,0,2,org.apache.solr.SolrTestCaseJ4,0.00,6,2,3,0,6,3,0,1,104,1
"org.apache.solr.uima.analysis.UIMATypeAwareAnnotationsTokenizerFactory",2,1.33,1.00,11,0.12,2097.70,5,3,5,4,3,171.14,3,16,0,3,121.14,0.00,0.67,1.00,0,0.00,1,350.32,1,1,3,org.apache.solr.analysis.BaseTokenizerFactory,0.00,2,2,2,0,2,1,0,1,84,1
"org.apache.solr.uima.analysis.UIMATypeAwareAnnotationsTokenizerFactoryTest",3,0.00,1.00,22,0.23,4684.41,3,0,4,9,2,114.33,2,29,0,3,114.33,0.00,0.67,0.00,0,4.00,1,687.67,4,0,2,org.apache.solr.SolrTestCaseJ4,0.00,6,2,3,0,6,3,0,1,149,1
"org.apache.lucene.analysis.position.PositionFilter",4,0.00,1.50,21,0.17,3173.43,7,3,4,6,5,104.13,20,30,2,4,122.00,0.00,0.75,0.33,0,4.00,3,514.21,1,0,3,org.apache.lucene.analysis.TokenFilter,0.50,2,3,6,0,2,4,0,5,124,2
"org.apache.lucene.analysis.position.PositionFilterTest",4,0.28,1.00,20,0.46,14984.26,10,6,5,8,5,166.79,5,73,0,3,116.79,0.00,0.67,0.38,0,0.00,1,1370.40,1,0,5,org.apache.lucene.analysis.BaseTokenStreamTestCase,0.00,4,2,4,0,4,4,0,2,273,1
"org.apache.lucene.analysis.position.PositionFilterTest$TestTokenStream",3,0.17,1.33,16,0.14,2974.83,6,3,5,6,2,121.27,0,23,0,3,121.27,0.00,0.67,0.44,0,1.00,2,434.74,0,0,2,org.apache.lucene.analysis.TokenStream,0.55,3,2,4,0,3,3,0,0,101,1
"org.apache.lucene.queryparser.xml.builders.BooleanFilterBuilder",2,1.00,2.00,19,0.23,6827.98,3,1,10,12,9,57.42,19,21,1,1,107.42,0.00,0.00,0.50,0,2.00,3,687.32,0,1,8,java.lang.Object,0.00,10,0,4,0,10,1,1,2,134,1
"org.apache.lucene.queryparser.xml.builders.BooleanQueryBuilder",3,1.00,3.00,36,0.48,19055.41,4,1,9,19,8,58.25,22,43,2,1,100.54,0.00,0.00,0.33,1,4.00,5,1445.13,0,2,6,java.lang.Object,0.00,16,0,9,0,16,1,1,3,273,1
"org.apache.lucene.queryparser.xml.builders.BoostingQueryBuilder",2,0.00,1.00,16,0.21,5833.26,4,2,6,8,6,60.03,19,19,1,1,110.03,0.00,0.00,0.50,0,2.00,1,617.40,0,1,5,java.lang.Object,0.00,6,0,2,0,6,1,1,2,131,1
"org.apache.lucene.queryparser.xml.builders.BoostingTermBuilder",1,0.00,1.00,7,0.10,1996.32,1,0,7,8,8,139.77,19,9,1,2,113.49,0.00,0.50,0.00,0,1.00,1,297.27,0,1,7,org.apache.lucene.queryparser.xml.builders.SpanBuilderBase,0.00,7,1,1,0,7,0,0,2,64,1
"org.apache.lucene.queryparser.xml.builders.CachedFilterBuilder",2,0.50,3.00,33,0.38,17106.68,6,4,7,12,11,104.00,35,42,1,1,94.87,0.00,0.00,0.50,0,2.00,5,1150.68,0,1,10,java.lang.Object,0.00,10,0,6,0,10,1,1,6,224,1
"org.apache.lucene.queryparser.xml.builders.CachedFilterBuilder$LRUCache",2,1.00,1.00,7,0.10,1587.82,3,1,7,3,0,130.37,0,11,0,2,130.37,0.00,0.50,0.50,0,2.00,1,289.42,0,0,0,java.util.LinkedHashMap,0.00,1,1,2,0,1,2,0,0,69,1
"org.apache.lucene.queryparser.xml.builders.ConstantScoreQueryBuilder",2,1.00,1.00,9,0.10,1735.25,3,1,7,7,7,75.40,19,12,1,1,125.40,0.00,0.00,0.50,0,2.00,1,290.35,0,1,6,java.lang.Object,0.00,5,0,2,0,5,1,1,2,69,1
"org.apache.lucene.queryparser.xml.builders.DuplicateFilterBuilder",1,0.00,5.00,19,0.27,11106.03,1,0,6,8,6,117.35,19,23,1,1,91.07,0.00,0.00,0.00,0,1.00,5,817.32,0,1,5,java.lang.Object,0.00,7,0,5,0,7,0,1,2,152,1
"org.apache.lucene.queryparser.xml.builders.FilteredQueryBuilder",2,0.00,1.00,16,0.19,4615.13,4,2,8,9,8,66.70,22,19,1,1,110.83,0.00,0.00,0.50,0,2.00,1,575.09,0,1,7,java.lang.Object,0.00,7,0,2,0,7,1,1,3,125,1
"org.apache.lucene.queryparser.xml.builders.FuzzyLikeThisQueryBuilder",2,0.60,1.50,25,0.37,10771.96,7,5,9,11,8,51.27,19,26,1,1,101.27,0.00,0.00,0.50,0,2.00,2,1101.62,0,1,7,java.lang.Object,0.00,9,0,3,0,9,1,1,2,205,1
"org.apache.lucene.queryparser.xml.builders.LikeThisQueryBuilder",2,0.60,4.50,44,0.77,58702.48,7,5,13,27,9,65.25,28,52,1,1,85.40,0.00,0.00,0.50,0,2.00,8,2298.99,0,1,8,java.lang.Object,0.00,25,0,9,0,25,1,1,9,373,1
"org.apache.lucene.queryparser.xml.builders.MatchAllDocsQueryBuilder",1,0.00,1.00,3,0.02,212.34,1,0,5,2,5,161.16,19,5,1,1,134.88,0.00,0.00,0.00,0,1.00,1,67.32,0,1,4,java.lang.Object,0.00,1,0,1,0,1,0,1,2,20,1
"org.apache.lucene.queryparser.xml.builders.NumericRangeFilterBuilder",2,0.00,4.00,30,0.54,26448.65,4,2,11,16,11,88.59,74,46,2,1,94.36,0.00,0.00,0.50,0,2.00,7,1613.98,0,1,9,java.lang.Object,0.00,14,0,8,0,14,1,1,2,282,1
"org.apache.lucene.queryparser.xml.builders.NumericRangeFilterBuilder$NoMatchFilter",1,0.00,1.00,3,0.03,295.46,1,0,11,1,3,133.75,0,6,0,2,133.75,0.00,0.50,0.00,0,1.00,1,83.51,0,1,3,org.apache.lucene.search.Filter,0.00,0,1,1,0,0,0,0,0,23,1
"org.apache.lucene.queryparser.xml.builders.NumericRangeQueryBuilder",1,0.00,6.00,23,0.47,24992.14,1,0,7,14,8,64.90,60,36,2,1,85.16,0.00,0.00,0.00,0,1.00,6,1402.24,0,1,6,java.lang.Object,0.00,13,0,6,0,13,0,1,1,238,1
"org.apache.lucene.queryparser.xml.builders.RangeFilterBuilder",1,0.00,1.00,8,0.12,2564.12,1,0,6,5,6,136.75,19,10,1,1,110.47,0.00,0.00,0.00,0,1.00,1,362.30,0,1,5,java.lang.Object,0.00,4,0,1,0,4,0,1,2,76,1
"org.apache.lucene.queryparser.xml.builders.SpanBuilderBase",1,0.00,1.00,3,0.02,224.79,1,0,3,2,10,160.97,19,5,7,1,134.68,0.00,0.00,0.00,0,1.00,1,69.84,0,1,3,java.lang.Object,0.00,1,0,1,7,1,0,1,2,21,2
"org.apache.lucene.queryparser.xml.builders.SpanFirstBuilder",2,1.00,1.00,11,0.13,2696.59,3,1,5,7,7,70.28,19,14,1,2,120.28,0.00,0.50,0.50,0,2.00,1,382.57,0,1,6,org.apache.lucene.queryparser.xml.builders.SpanBuilderBase,0.00,5,1,2,0,5,1,0,2,86,1
"org.apache.lucene.queryparser.xml.builders.SpanNearBuilder",2,1.00,2.00,17,0.25,9348.70,3,1,8,12,7,58.26,19,19,1,2,108.26,0.00,0.50,0.50,0,2.00,3,762.07,0,1,6,org.apache.lucene.queryparser.xml.builders.SpanBuilderBase,0.00,10,1,4,0,10,1,0,2,144,1
"org.apache.lucene.queryparser.xml.builders.SpanNotBuilder",2,1.00,1.00,14,0.17,4715.65,3,1,5,8,7,68.79,22,17,1,2,112.92,0.00,0.50,0.50,0,2.00,1,508.28,0,1,6,org.apache.lucene.queryparser.xml.builders.SpanBuilderBase,0.00,6,1,2,0,6,1,0,3,111,1
"org.apache.lucene.queryparser.xml.builders.SpanOrBuilder",2,1.00,2.00,17,0.23,9075.37,3,1,8,11,7,58.36,19,19,1,2,108.36,0.00,0.50,0.50,0,2.00,3,681.91,0,1,6,org.apache.lucene.queryparser.xml.builders.SpanBuilderBase,0.00,9,1,4,0,9,1,0,2,134,1
"org.apache.lucene.queryparser.xml.builders.SpanOrTermsBuilder",2,1.00,2.00,23,0.37,15812.42,3,1,15,23,12,57.17,22,30,1,2,101.30,0.00,0.50,0.50,0,2.00,3,1105.18,0,1,11,org.apache.lucene.queryparser.xml.builders.SpanBuilderBase,0.00,21,1,4,0,21,1,0,3,194,1
"org.apache.lucene.queryparser.xml.builders.SpanQueryBuilder",1,0.00,1.00,2,0.01,88.08,1,0,4,1,9,144.46,0,3,6,2,144.46,0.00,0.50,0.00,0,1.00,1,44.04,0,1,3,,0.00,0,1,1,0,0,0,0,0,15,1
"org.apache.lucene.queryparser.xml.builders.SpanQueryBuilderFactory",3,0.50,1.33,11,0.14,3525.27,4,1,6,9,5,96.74,19,16,1,1,128.96,0.00,0.00,0.67,1,1.00,2,418.45,0,2,4,java.lang.Object,0.00,6,0,4,0,6,1,1,2,99,1
"org.apache.lucene.queryparser.xml.builders.SpanTermBuilder",1,0.00,1.00,7,0.09,1909.68,1,0,6,7,7,139.92,19,9,1,2,113.64,0.00,0.50,0.00,0,1.00,1,279.91,0,1,6,org.apache.lucene.queryparser.xml.builders.SpanBuilderBase,0.00,6,1,1,0,6,0,0,2,61,1
"org.apache.lucene.queryparser.xml.builders.TermQueryBuilder",1,0.00,1.00,7,0.09,1909.68,1,0,7,7,7,139.92,19,9,1,1,113.64,0.00,0.00,0.00,0,1.00,1,279.91,0,1,6,java.lang.Object,0.00,6,0,1,0,6,0,1,2,61,1
"org.apache.lucene.queryparser.xml.builders.TermsFilterBuilder",2,1.00,2.00,22,0.29,9737.24,3,1,13,17,11,73.58,27,29,1,1,102.96,0.00,0.00,0.50,0,2.00,3,858.29,0,1,10,java.lang.Object,0.00,15,0,4,0,15,1,1,4,159,1
"org.apache.lucene.queryparser.xml.builders.TermsQueryBuilder",2,1.00,2.00,24,0.39,13797.52,3,1,15,22,13,50.36,19,31,1,1,100.36,0.00,0.00,0.50,0,2.00,3,1155.07,0,1,12,java.lang.Object,0.00,20,0,4,0,20,1,1,2,201,1
"org.apache.lucene.queryparser.xml.builders.TestNumericRangeFilterBuilder",7,0.00,2.14,135,1.96,86235.19,7,0,17,58,9,90.91,0,148,0,2,90.91,0.00,0.50,0.00,1,7.00,3,5892.74,0,1,9,org.apache.lucene.util.LuceneTestCase,0.00,51,1,15,0,51,6,0,0,1072,1
"org.apache.lucene.queryparser.xml.builders.TestNumericRangeQueryBuilder",6,0.00,2.50,113,1.67,79741.10,6,0,12,44,4,91.49,0,119,0,2,91.49,0.00,0.50,0.00,1,6.00,3,5019.63,0,1,4,org.apache.lucene.util.LuceneTestCase,0.00,38,1,15,0,38,5,0,0,923,1
"org.apache.lucene.queryparser.xml.builders.UserInputQueryBuilder",4,0.11,1.50,25,0.27,9097.81,7,3,9,11,8,65.45,39,34,1,1,115.45,0.00,0.00,0.25,1,6.00,3,815.45,0,2,7,java.lang.Object,0.00,7,0,6,0,7,2,1,7,173,1
"org.apache.lucene.sandbox.queries.regex.JakartaRegexpCapabilities",5,0.10,1.60,34,0.32,7446.84,10,5,8,7,7,117.11,24,48,3,1,116.88,0.00,0.00,0.12,0,2.00,4,965.72,0,1,4,java.lang.Object,0.00,2,0,8,0,2,4,1,7,223,1
"org.apache.lucene.sandbox.queries.regex.JakartaRegexpCapabilities$JakartaRegexMatcher",3,0.25,2.33,21,0.24,9934.53,5,2,8,10,3,111.56,1,29,0,1,111.56,0.00,0.00,0.67,0,0.00,5,716.33,0,1,3,java.lang.Object,0.00,7,0,7,0,7,2,1,1,158,0
"org.apache.lucene.sandbox.queries.regex.JakartaRegexpCapabilities$JakartaRegexMatcher$CharacterIterator",4,0.00,1.00,9,0.08,1212.77,4,0,8,5,0,140.23,0,13,0,1,140.23,0.00,0.00,0.00,1,4.00,1,247.43,0,2,0,java.lang.Object,0.00,1,0,4,0,1,2,0,0,68,0
"org.apache.lucene.sandbox.queries.regex.JavaUtilRegexCapabilities",5,0.06,1.60,31,0.35,8728.06,14,9,5,7,7,98.46,26,42,3,1,116.34,0.00,0.00,0.07,0,2.00,4,1060.72,0,1,4,java.lang.Object,0.00,2,0,8,0,2,4,1,5,231,1
"org.apache.lucene.sandbox.queries.regex.JavaUtilRegexCapabilities$JavaUtilRegexMatcher",3,0.00,1.00,12,0.14,1846.82,6,3,5,9,3,126.58,0,16,0,1,126.58,0.00,0.00,0.33,0,1.00,1,412.05,0,1,3,java.lang.Object,0.00,6,0,3,0,6,2,1,0,100,0
"org.apache.lucene.sandbox.queries.regex.RegexCapabilities",1,0.00,1.00,3,0.01,57.34,1,0,1,1,7,187.18,27,4,6,1,139.35,0.00,0.00,0.00,0,1.00,1,38.23,0,0,1,,0.00,0,0,1,0,0,1,0,3,15,1
"org.apache.lucene.sandbox.queries.regex.RegexCapabilities$RegexMatcher",2,0.00,1.00,3,0.01,58.89,2,0,1,2,1,141.56,11,4,0,1,159.43,0.00,0.00,0.00,0,2.00,1,39.26,0,1,1,,0.00,0,0,2,0,0,1,0,2,16,1
"org.apache.lucene.sandbox.queries.regex.RegexQuery",8,0.07,2.50,47,0.52,21638.08,10,2,8,23,14,157.57,18,68,3,3,117.69,0.00,0.67,0.56,0,0.00,10,1555.30,3,4,11,org.apache.lucene.search.MultiTermQuery,0.11,15,2,20,0,15,4,1,4,347,1
"org.apache.lucene.sandbox.queries.regex.RegexQueryCapable",2,0.00,1.00,3,0.01,38.51,2,0,0,2,2,110.89,19,4,1,1,160.88,0.00,0.00,0.00,0,2.00,1,33.51,0,0,1,,0.00,0,0,2,0,0,2,0,2,15,1
"org.apache.lucene.sandbox.queries.regex.RegexTermsEnum",2,1.00,2.50,16,0.19,4142.59,4,2,6,8,7,93.11,10,22,1,3,110.99,0.00,0.67,1.00,0,0.00,3,561.90,1,0,6,org.apache.lucene.index.FilteredTermsEnum,0.00,6,2,5,0,6,2,0,3,121,1
"org.apache.lucene.sandbox.queries.regex.TestJakartaRegexpCapabilities",2,0.00,1.00,15,0.19,3415.36,2,0,2,10,2,153.91,4,18,0,2,114.02,0.00,0.50,0.00,0,2.00,1,567.10,0,0,2,org.apache.lucene.util.LuceneTestCase,0.00,8,1,2,0,8,2,0,2,127,1
"org.apache.lucene.sandbox.queries.regex.TestRegexQuery",16,0.08,1.06,58,0.73,13016.53,20,4,15,42,18,130.27,2,75,0,2,130.27,0.00,0.50,0.17,1,64.00,2,2183.27,2,1,18,org.apache.lucene.util.LuceneTestCase,0.00,26,1,17,0,26,15,0,2,494,1
"org.apache.lucene.sandbox.queries.regex.TestSpanRegexQuery",3,0.25,1.00,30,0.39,9494.69,5,2,17,22,15,146.02,6,37,0,2,106.13,0.00,0.50,0.67,0,1.00,1,1172.52,2,0,15,org.apache.lucene.util.LuceneTestCase,0.00,19,1,3,0,19,3,0,6,225,1
"org.apache.lucene.facet.taxonomy.writercache.lru.LruTaxonomyWriterCache",8,0.29,1.75,37,0.37,9676.58,9,1,2,20,4,91.92,52,51,0,1,124.14,0.00,0.00,0.75,0,0.00,3,1100.08,0,0,4,java.lang.Object,0.00,12,0,14,0,12,8,1,33,260,1
"org.apache.lucene.facet.taxonomy.writercache.lru.LruTaxonomyWriterCache$LRUType",0,0.00,0.00,2,0.01,23.26,0,0,2,0,1,171.00,0,1,0,1,171.00,0.00,0.00,0.00,0,0.00,0,15.51,0,0,1,java.lang.Object,0.00,0,0,0,0,0,0,1,0,6,1
"org.apache.lucene.facet.taxonomy.writercache.lru.NameHashIntCacheLRU",3,0.00,1.00,7,0.07,783.96,3,0,1,5,3,92.63,25,13,1,2,140.74,0.00,0.50,0.00,0,3.00,1,195.89,0,2,2,org.apache.lucene.facet.taxonomy.writercache.lru.NameIntCacheLRU,0.00,2,1,3,0,2,1,0,2,55,1
"org.apache.lucene.facet.taxonomy.writercache.lru.NameIntCacheLRU",13,0.04,1.38,53,0.47,10697.27,17,4,4,24,3,125.75,53,72,2,1,125.51,0.00,0.00,0.29,3,0.00,4,1416.86,0,4,1,java.lang.Object,0.00,11,0,18,1,11,9,0,19,334,0
"org.apache.lucene.misc.GetTermInfo",3,0.00,1.33,19,0.26,6568.27,3,0,5,14,6,165.60,3,27,1,1,115.60,0.00,0.00,0.00,2,3.00,2,782.43,0,0,5,java.lang.Object,0.00,11,0,4,0,11,3,0,1,162,1
"org.apache.lucene.misc.HighFreqTerms",6,0.50,4.17,95,1.31,92348.73,8,2,18,34,19,75.95,31,117,2,1,93.83,0.00,0.00,0.08,4,10.00,9,3924.53,0,2,17,java.lang.Object,0.00,28,0,25,0,28,4,0,8,701,1
"org.apache.lucene.misc.HighFreqTerms$ReaderUtil.Gather",1,0.00,5.00,11,0.17,6714.65,1,0,18,4,3,101.88,4,17,0,1,101.65,0.00,0.00,0.00,0,1.00,5,519.41,0,0,3,java.lang.Object,0.00,3,0,5,0,3,1,0,4,98,0
"org.apache.lucene.misc.IndexMergeTool",1,0.00,3.00,19,0.30,12978.96,1,0,8,12,4,90.89,4,22,0,1,90.66,0.00,0.00,0.00,0,1.00,3,895.83,0,0,4,java.lang.Object,0.00,11,0,3,0,11,1,0,1,159,1
"org.apache.lucene.misc.SweetSpotSimilarity",9,0.08,1.56,48,0.69,24181.51,18,9,3,17,5,73.69,100,84,2,4,117.82,0.00,0.75,0.19,1,43.00,3,2055.16,1,0,3,org.apache.lucene.search.similarities.DefaultSimilarity,0.10,8,3,14,0,8,9,0,9,443,1
"org.apache.lucene.misc.SweetSpotSimilarityTest",5,0.00,4.20,163,2.19,209940.35,5,0,7,23,7,118.00,12,173,0,2,78.12,0.00,0.50,0.00,1,5.00,11,6557.89,0,0,7,org.apache.lucene.util.LuceneTestCase,0.00,18,1,21,0,18,5,0,10,1112,1
"org.apache.lucene.misc.SweetSpotSimilarityTest$PerFieldSimilarityWrapper",1,0.00,5.00,3,0.09,1815.27,1,0,7,2,1,127.17,0,14,0,1,127.17,0.00,0.00,0.00,0,1.00,5,269.34,0,1,1,java.lang.Object,0.00,1,0,5,0,1,0,0,0,61,0
"org.apache.lucene.misc.SweetSpotSimilarityTest$SweetSpotSimilarity",1,0.00,1.00,3,0.02,227.10,1,0,7,2,0,134.65,0,5,0,1,134.65,0.00,0.00,0.00,0,1.00,1,61.77,0,0,0,java.lang.Object,0.00,1,0,1,0,1,1,0,0,19,0
"org.apache.lucene.misc.TermStats",4,0.00,1.00,18,0.17,2040.22,8,4,1,6,5,127.22,0,23,4,1,127.22,0.00,0.00,0.25,0,4.00,1,514.87,0,2,1,java.lang.Object,0.00,2,0,4,0,2,2,0,0,130,2
"org.apache.lucene.misc.TermStatsQueue",2,0.00,1.00,5,0.05,705.06,2,0,18,2,16,139.71,0,9,1,2,139.71,0.00,0.50,0.00,0,2.00,1,139.01,0,0,15,org.apache.lucene.util.PriorityQueue,0.00,0,1,2,0,0,2,0,0,40,1
"org.apache.lucene.misc.TestHighFreqTerms",17,0.02,2.06,180,2.13,92367.23,20,3,12,41,11,154.12,25,189,0,2,104.12,0.00,0.50,0.31,3,0.00,7,6403.59,0,1,11,org.apache.lucene.util.LuceneTestCase,0.00,24,1,35,0,24,16,0,19,1232,1
"org.apache.lucene.misc.TotalTermFreqComparatorSortDescending",1,0.00,3.00,8,0.07,2170.79,1,0,18,1,16,110.79,0,11,1,1,110.79,0.00,0.00,0.00,0,1.00,3,206.94,0,0,15,java.lang.Object,0.00,0,0,3,0,0,1,1,0,51,1
"org.apache.lucene.facet.example.ExampleResult",2,1.00,1.00,6,0.05,603.38,3,1,2,2,11,113.53,29,9,10,1,133.68,0.00,0.00,0.50,0,2.00,1,140.48,0,1,1,java.lang.Object,0.00,0,0,2,0,0,1,0,4,39,1
"org.apache.lucene.facet.example.ExampleUtils",1,1.00,2.00,6,0.07,941.57,3,2,1,4,11,151.78,20,9,11,1,118.40,0.00,0.00,0.50,0,0.00,2,208.76,0,0,0,java.lang.Object,0.00,3,0,2,0,3,1,0,3,51,1
"org.apache.lucene.facet.example.TestAdaptiveExample",1,0.00,1.00,7,0.10,1955.22,1,0,4,9,2,146.94,20,10,0,2,113.56,0.00,0.50,0.00,0,1.00,1,314.83,0,0,2,org.apache.lucene.util.LuceneTestCase,0.00,8,1,1,0,8,1,0,2,67,1
"org.apache.lucene.facet.example.TestAssociationExample",2,0.00,2.00,16,0.28,8446.47,4,2,5,15,3,60.13,20,20,0,2,108.60,0.00,0.50,0.50,1,2.00,3,826.99,0,0,3,org.apache.lucene.util.LuceneTestCase,0.00,13,1,4,0,13,2,0,2,164,1
"org.apache.lucene.facet.example.TestMultiCLExample",2,0.00,1.50,31,0.60,33651.70,2,0,8,18,5,45.28,20,49,1,2,93.76,0.00,0.50,0.00,1,2.00,2,1788.11,0,0,4,org.apache.lucene.util.LuceneTestCase,0.00,16,1,3,0,16,2,0,2,318,1
"org.apache.lucene.facet.example.TestSimpleExample",2,0.00,1.50,20,0.37,10545.78,2,0,7,20,4,66.73,25,25,0,2,104.29,0.00,0.50,0.00,0,2.00,2,1095.79,0,0,4,org.apache.lucene.util.LuceneTestCase,0.00,18,1,3,0,18,2,0,4,204,1
"org.apache.lucene.queryparser.classic.CharStream",12,0.00,1.00,13,0.06,250.78,12,0,0,12,5,128.38,79,14,5,1,160.60,0.00,0.00,0.00,0,12.00,1,172.56,0,1,0,,0.00,0,0,12,0,0,11,0,13,70,1
"org.apache.lucene.queryparser.classic.FastCharStream",14,0.14,1.43,56,0.55,20446.20,20,6,1,20,3,173.54,17,80,2,1,123.54,0.00,0.00,0.30,2,2.00,5,1644.78,0,1,1,java.lang.Object,0.00,6,0,20,0,6,13,1,13,372,2
"org.apache.lucene.queryparser.classic.MultiFieldQueryParser",12,0.18,3.58,128,2.04,116238.03,14,2,10,26,9,57.89,140,167,1,3,102.01,0.00,0.67,0.33,5,12.00,7,6105.40,6,9,8,org.apache.lucene.queryparser.classic.QueryParser,0.00,14,2,43,0,14,3,0,15,1128,1
"org.apache.lucene.queryparser.classic.ParseException",6,0.24,2.83,95,1.09,80990.82,11,5,0,15,115,56.80,76,116,114,2,94.36,0.00,0.50,0.40,0,0.00,10,3273.19,1,2,1,java.lang.Exception,0.00,9,1,17,0,9,4,0,12,589,1
"org.apache.lucene.queryparser.classic.QueryParser",28,0.11,5.79,484,6.02,520619.67,48,20,11,52,36,111.69,94,606,23,2,91.08,10.00,0.08,0.15,11,56.00,44,18046.74,2,8,13,org.apache.lucene.queryparser.classic.QueryParserBase,0.00,24,1,162,10,24,20,1,18,3202,1
"org.apache.lucene.queryparser.classic.QueryParser$JJCalls",0,0.00,0.00,5,0.03,253.51,4,4,11,0,1,171.00,0,6,0,1,171.00,0.00,0.00,0.00,0,0.00,0,78.87,0,0,1,java.lang.Object,0.00,0,0,0,0,0,0,0,0,22,2
"org.apache.lucene.queryparser.classic.QueryParser$LookaheadSuccess",0,0.00,0.00,1,0.01,145.30,0,0,11,0,0,171.00,0,1,0,2,171.00,0.00,0.50,0.00,0,0.00,0,41.51,0,0,0,java.lang.Error,0.00,0,1,0,0,0,0,0,0,12,3
"org.apache.lucene.queryparser.classic.QueryParser$Operator",0,0.00,0.00,2,0.01,39.30,0,0,11,0,1,171.00,0,1,0,1,171.00,0.00,0.00,0.00,0,0.00,0,19.65,0,0,1,java.lang.Object,0.00,0,0,0,0,0,0,1,0,7,2
"org.apache.lucene.queryparser.classic.QueryParserBase",62,0.01,2.65,455,6.16,523777.73,85,23,15,146,32,76.11,402,628,7,1,108.33,0.00,0.00,0.04,19,1870.00,30,18477.27,0,36,25,java.lang.Object,0.00,84,0,164,11,84,26,0,118,3412,2
"org.apache.lucene.queryparser.classic.QueryParserBase$MethodRemovedUseAnother",0,0.00,0.00,1,0.01,49.13,0,0,15,0,0,171.00,0,1,0,2,171.00,0.00,0.50,0.00,0,0.00,0,19.65,0,0,0,java.lang.Throwable,0.00,0,1,0,0,0,0,0,0,7,2
"org.apache.lucene.queryparser.classic.QueryParserConstants",0,0.00,0.00,37,0.58,7033.38,36,36,0,0,3,171.00,40,72,3,1,171.00,0.00,0.00,0.00,0,0.00,0,1729.25,0,0,0,,0.00,0,0,0,0,0,0,0,37,255,1
"org.apache.lucene.queryparser.classic.QueryParserTokenManager",30,0.06,10.93,588,9.22,1933925.30,51,21,11,40,11,84.88,12,1035,2,1,84.88,0.00,0.00,0.11,16,302.00,204,27656.61,0,2,9,java.lang.Object,0.00,10,0,328,0,10,28,1,12,4382,1
"org.apache.lucene.queryparser.classic.SuppressWarnings",6,0.20,1.50,48,0.66,33774.42,11,5,0,14,0,59.58,51,72,0,2,107.69,0.00,0.50,0.03,1,10.00,3,1967.96,1,3,0,java.lang.Error,0.00,8,1,9,0,8,3,0,14,375,1
"org.apache.lucene.queryparser.classic.TestMultiAnalyzer",3,1.00,1.00,45,0.86,24364.21,4,1,9,15,9,47.86,32,60,0,3,96.34,0.00,0.67,0.00,0,3.00,1,2581.87,0,0,9,org.apache.lucene.analysis.BaseTokenStreamTestCase,0.00,12,2,3,0,12,3,0,18,468,1
"org.apache.lucene.queryparser.classic.TestMultiAnalyzer$DumbQueryParser",3,0.00,1.00,7,0.09,1279.76,3,0,9,4,3,139.06,2,14,0,3,139.06,0.00,0.67,0.00,1,3.00,1,272.80,1,2,3,org.apache.lucene.queryparser.classic.QueryParser,0.00,1,2,3,0,1,1,0,2,70,3
"org.apache.lucene.queryparser.classic.TestMultiAnalyzer$DumbQueryWrapper",2,1.00,1.00,7,0.05,803.42,3,1,9,3,1,132.70,0,11,0,2,132.70,0.00,0.50,0.50,0,2.00,1,156.02,0,1,1,org.apache.lucene.search.Query,0.00,1,1,2,0,1,1,0,0,45,3
"org.apache.lucene.queryparser.classic.TestMultiAnalyzer$MultiAnalyzer",1,0.00,1.00,4,0.06,1028.22,1,0,9,4,1,124.82,0,7,0,2,124.82,0.00,0.50,0.00,0,1.00,1,167.13,0,1,1,org.apache.lucene.search.Analyzer,0.00,3,1,1,0,3,0,0,0,40,1
"org.apache.lucene.queryparser.classic.TestMultiAnalyzer$PosIncrementAnalyzer",1,0.00,1.00,4,0.06,1028.22,1,0,9,4,1,124.82,0,7,0,2,124.82,0.00,0.50,0.00,0,1.00,1,167.13,0,1,1,org.apache.lucene.search.Analyzer,0.00,3,1,1,0,3,0,0,0,40,1
"org.apache.lucene.queryparser.classic.TestMultiAnalyzer$TestFilter",3,0.57,2.33,43,0.44,13017.24,10,7,9,14,6,99.41,0,51,0,4,99.41,0.00,0.75,0.52,0,1.00,5,1317.35,1,0,6,org.apache.lucene.analysis.TokenFilter,0.53,11,3,7,0,11,3,0,0,261,2
"org.apache.lucene.queryparser.classic.TestMultiAnalyzer$TestPosIncrementFilter",2,1.00,2.50,17,0.17,3508.76,4,2,9,5,4,111.56,1,23,0,4,111.56,0.00,0.75,1.00,0,0.00,4,495.03,0,0,4,org.apache.lucene.analysis.TokenFilter,0.29,3,3,5,0,3,2,0,1,110,2
"org.apache.lucene.queryparser.classic.TestMultiFieldQueryParser",11,0.00,1.45,169,2.79,95763.94,11,0,15,37,12,135.90,25,192,0,2,96.02,0.00,0.50,0.00,1,11.00,2,8375.67,0,0,12,org.apache.lucene.util.LuceneTestCase,0.00,26,1,16,0,26,11,0,20,1521,1
"org.apache.lucene.queryparser.classic.TestMultiFieldQueryParser$AnalyzerReturningNull",2,1.00,1.50,9,0.09,1826.06,3,1,15,8,1,125.14,0,14,0,2,125.14,0.00,0.50,0.50,0,2.00,2,266.03,0,1,1,org.apache.lucene.index.Analyzer,0.00,6,1,3,0,6,1,0,0,66,2
"org.apache.lucene.queryparser.classic.TestMultiPhraseQueryParsing",1,0.00,1.00,17,0.27,10306.58,1,0,11,10,9,93.50,0,22,0,2,93.50,0.00,0.50,0.00,0,1.00,1,821.90,0,0,9,org.apache.lucene.util.LuceneTestCase,0.00,9,1,1,0,9,1,0,0,163,1
"org.apache.lucene.queryparser.classic.TestMultiPhraseQueryParsing$CannedAnalyzer",2,1.00,1.00,6,0.06,847.53,3,1,11,4,1,132.51,0,10,0,2,132.51,0.00,0.50,0.50,0,2.00,1,183.16,0,1,1,org.apache.lucene.analysis.Analyzer,0.00,2,1,2,0,2,1,0,0,49,2
"org.apache.lucene.queryparser.classic.TestMultiPhraseQueryParsing$CannedTokenizer",3,0.20,1.33,24,0.26,7177.72,8,5,11,7,3,110.64,0,31,0,4,110.64,0.00,0.75,0.33,0,4.00,2,786.99,1,0,3,org.apache.lucene.analysis.Tokenizer,0.24,4,3,4,0,4,3,0,0,169,2
"org.apache.lucene.queryparser.classic.TestMultiPhraseQueryParsing$TokenAndPos",1,2.00,1.00,6,0.04,607.65,3,2,11,1,0,120.05,0,8,0,1,120.05,0.00,0.00,0.00,0,1.00,1,132.64,0,0,0,java.lang.Object,0.00,0,0,1,0,0,1,0,0,37,2
"org.apache.lucene.queryparser.classic.TestQueryParser",1,0.00,2.00,6,0.09,2114.81,1,0,4,4,6,136.24,3,10,0,3,115.63,0.00,0.67,0.00,0,1.00,2,255.95,0,1,6,org.apache.lucene.queryparser.util.QueryParserTestBase,0.00,3,2,2,0,3,0,0,1,55,1
"org.apache.lucene.queryparser.classic.Token",7,0.12,1.00,24,0.16,1989.42,15,8,0,8,6,83.88,67,38,6,1,133.88,0.00,0.00,0.02,1,12.00,1,468.86,0,4,0,java.lang.Object,0.00,1,0,7,0,1,3,0,15,131,1
"org.apache.lucene.queryparser.flexible.precedence.PrecedenceQueryParser",2,0.00,1.00,6,0.04,310.49,2,0,4,3,5,85.95,19,9,1,3,135.95,0.00,0.67,0.00,0,2.00,1,118.08,2,0,4,org.apache.lucene.queryparser.flexible.standard.StandardQueryParser,0.00,1,2,2,0,1,2,0,3,36,1
"org.apache.lucene.queryparser.flexible.precedence.TestPrecedenceQueryParser",32,0.47,1.38,337,4.69,156333.23,34,2,28,65,21,154.58,47,420,0,2,104.58,0.00,0.50,0.05,9,118.00,2,14069.60,2,8,21,org.apache.lucene.util.LuceneTestCase,0.00,33,1,44,0,33,24,0,31,2675,1
"org.apache.lucene.queryparser.flexible.precedence.TestPrecedenceQueryParser$QPTestAnalyzer",1,0.00,1.00,4,0.06,1228.99,1,0,28,4,1,174.21,1,7,0,2,124.21,0.00,0.50,0.00,0,1.00,1,182.32,0,1,1,org.apache.lucene.queryparser.util.Analyzer,0.00,3,1,1,0,3,0,0,1,43,3
"org.apache.lucene.queryparser.flexible.precedence.TestPrecedenceQueryParser$QPTestFilter",3,0.20,2.33,28,0.33,10120.74,8,5,28,11,3,157.43,4,37,0,4,107.43,0.00,0.75,0.33,0,4.00,5,985.00,1,0,3,org.apache.lucene.analysis.TokenFilter,0.53,8,3,7,0,8,3,0,1,206,3
"org.apache.lucene.analysis.tokenattributes.CharTermAttribute",11,0.00,1.00,12,0.09,485.54,11,0,1,11,259,158.28,48,13,258,3,158.05,0.00,0.67,0.00,0,11.00,1,269.53,0,8,1,,0.00,0,2,11,0,0,3,0,10,92,1
"org.apache.lucene.analysis.tokenattributes.CharTermAttributeImpl",25,0.11,2.00,131,1.69,92299.39,29,4,7,49,15,166.68,31,182,7,2,116.68,4.00,0.17,0.36,4,0.00,12,5065.54,1,4,8,org.apache.lucene.util.AttributeImpl,0.13,24,1,50,4,24,21,3,21,1058,1
"org.apache.lucene.analysis.tokenattributes.FlagsAttribute",2,0.00,1.00,3,0.02,77.91,2,0,2,2,19,110.37,17,4,17,2,158.47,0.00,0.50,0.00,0,2.00,1,46.77,0,0,2,,0.00,0,1,2,0,0,2,0,3,18,1
"org.apache.lucene.analysis.tokenattributes.FlagsAttributeImpl",6,0.20,1.33,19,0.16,2564.38,7,1,1,7,4,172.30,17,32,2,2,132.42,0.00,0.50,0.83,0,0.00,3,465.77,0,0,2,org.apache.lucene.util.AttributeImpl,0.18,1,1,8,0,1,6,2,3,121,1
"org.apache.lucene.analysis.tokenattributes.KeywordAttribute",2,0.00,1.00,3,0.02,77.91,2,0,2,2,44,110.00,21,4,42,2,158.47,0.00,0.50,0.00,0,2.00,1,46.77,0,0,2,,0.00,0,1,2,0,0,2,0,3,18,1
"org.apache.lucene.analysis.tokenattributes.KeywordAttributeImpl",6,0.00,1.50,18,0.17,3321.15,7,1,2,8,5,152.12,21,32,2,2,131.51,0.00,0.50,1.00,0,0.00,3,509.29,0,0,3,org.apache.lucene.util.AttributeImpl,0.18,2,1,9,0,2,6,1,3,128,2
"org.apache.lucene.analysis.tokenattributes.OffsetAttribute",3,0.00,1.00,4,0.02,114.45,3,0,1,3,108,158.78,14,5,107,2,158.55,0.00,0.50,0.00,0,3.00,1,65.73,0,0,1,,0.00,0,1,3,0,0,3,0,4,25,1
"org.apache.lucene.analysis.tokenattributes.OffsetAttributeImpl",7,0.25,1.29,27,0.22,4781.06,9,2,1,8,4,170.71,14,41,2,2,130.82,0.00,0.50,0.71,0,0.00,3,664.08,0,0,2,org.apache.lucene.util.AttributeImpl,0.17,1,1,9,0,1,7,2,4,168,1
"org.apache.lucene.analysis.tokenattributes.PayloadAttribute",2,0.00,1.00,3,0.02,77.91,2,0,2,2,52,158.71,9,4,50,2,158.47,0.00,0.50,0.00,0,2.00,1,46.77,0,1,2,,0.00,0,1,2,0,0,1,0,3,18,1
"org.apache.lucene.analysis.tokenattributes.PayloadAttributeImpl",9,0.50,1.67,30,0.31,9018.85,10,1,2,13,5,179.45,15,48,2,2,129.45,0.00,0.50,0.56,0,4.00,4,932.84,1,2,3,org.apache.lucene.util.AttributeImpl,0.29,4,1,15,0,4,7,2,5,226,1
"org.apache.lucene.analysis.tokenattributes.PositionIncrementAttribute",2,0.00,1.00,3,0.02,77.91,2,0,1,2,100,158.00,33,4,99,2,158.47,0.00,0.50,0.00,0,2.00,1,46.77,0,0,1,,0.00,0,1,2,0,0,2,0,3,18,1
"org.apache.lucene.analysis.tokenattributes.PositionIncrementAttributeImpl",6,0.40,1.50,22,0.19,3849.26,7,1,2,8,5,113.13,31,37,2,2,131.00,0.00,0.50,0.67,0,0.00,3,568.85,0,0,3,org.apache.lucene.util.AttributeImpl,0.18,2,1,9,0,2,6,2,3,141,1
"org.apache.lucene.analysis.tokenattributes.PositionLengthAttribute",2,0.00,1.00,3,0.02,77.91,2,0,1,2,6,126.25,13,4,5,2,158.47,0.00,0.50,0.00,0,2.00,1,46.77,0,0,1,,0.00,0,1,2,0,0,2,0,3,18,1
"org.apache.lucene.analysis.tokenattributes.PositionLengthAttributeImpl",6,0.40,1.50,22,0.19,3849.26,7,1,1,8,4,181.00,7,37,2,2,131.00,0.00,0.50,0.67,0,0.00,3,568.85,0,0,2,org.apache.lucene.util.AttributeImpl,0.18,2,1,9,0,2,6,2,3,141,1
"org.apache.lucene.analysis.tokenattributes.TermToBytesRefAttribute",2,0.00,1.00,3,0.01,65.85,2,0,2,2,29,209.05,50,4,27,2,159.05,0.00,0.50,0.00,0,2.00,1,38.73,0,1,2,,0.00,0,1,2,0,0,1,0,3,16,1
"org.apache.lucene.analysis.tokenattributes.TestCharTermAttributeImpl",12,0.00,1.92,192,2.59,108863.64,12,0,9,51,5,115.38,42,211,0,2,94.77,0.00,0.50,0.00,0,12.00,5,7772.28,0,0,5,org.apache.lucene.util.LuceneTestCase,0.00,39,1,23,0,39,12,0,6,1495,1
"org.apache.lucene.analysis.tokenattributes.TestCharTermAttributeImpl$CharSequence",4,0.00,1.00,9,0.06,796.64,4,0,9,7,0,141.67,0,6,0,1,141.67,0.00,0.00,0.00,0,4.00,1,188.79,0,2,0,java.lang.Object,0.00,3,0,4,0,3,2,0,0,57,0
"org.apache.lucene.analysis.tokenattributes.TestCharTermAttributeImpl$HashMap<String,Object>",0,0.00,0.00,3,0.05,891.10,0,0,9,2,3,171.00,0,3,0,1,171.00,0.00,0.00,0.00,0,0.00,0,155.59,0,0,3,java.lang.Object,0.00,2,0,0,0,2,0,0,0,36,0
"org.apache.lucene.analysis.tokenattributes.TestSimpleAttributeImpl",1,0.00,1.00,9,0.25,5800.63,1,0,4,12,14,155.77,1,17,0,2,105.77,0.00,0.50,0.00,0,1.00,1,760.75,0,0,14,org.apache.lucene.util.LuceneTestCase,0.00,11,1,1,0,11,1,0,1,147,1
"org.apache.lucene.analysis.tokenattributes.TestSimpleAttributeImpl$HashMap<String,Object>",0,0.00,0.00,3,0.05,894.45,0,0,4,1,1,171.00,0,3,0,1,171.00,0.00,0.00,0.00,0,0.00,0,137.61,0,0,1,java.lang.Object,0.00,1,0,0,0,1,0,0,0,33,0
"org.apache.lucene.analysis.tokenattributes.TypeAttribute",2,1.00,1.00,4,0.03,268.92,3,1,1,2,58,163.62,7,5,57,2,143.01,0.00,0.50,0.00,0,2.00,1,86.77,0,1,1,,0.00,0,1,2,0,0,1,0,4,27,1
"org.apache.lucene.analysis.tokenattributes.TypeAttributeImpl",8,0.57,1.50,24,0.23,6365.20,9,1,1,10,4,130.27,6,39,2,2,130.27,0.00,0.50,0.50,1,10.00,4,681.10,0,1,2,org.apache.lucene.util.AttributeImpl,0.15,2,1,12,0,2,7,2,3,171,1
"org.apache.solr.handler.dataimport.AbstractDIHCacheTestCase",12,0.11,3.00,128,2.47,146044.39,17,5,18,54,5,101.27,7,153,1,1,101.27,0.00,0.00,0.10,4,30.00,11,7402.96,0,8,4,java.lang.Object,0.00,42,0,36,1,42,4,0,7,1338,1
"org.apache.solr.handler.dataimport.AbstractDIHCacheTestCase$ControlData",3,0.50,1.00,10,0.11,2159.12,4,1,18,6,0,130.70,0,15,0,1,130.70,0.00,0.00,0.67,0,1.00,1,337.16,0,1,0,java.lang.Object,0.00,3,0,3,0,3,2,2,0,86,0
"org.apache.solr.handler.dataimport.AbstractDataImportHandlerTestCase",11,0.00,1.73,70,1.10,37244.46,11,0,22,43,54,153.94,28,105,36,3,114.05,18.00,0.05,0.00,1,32.00,3,3295.61,2,4,18,org.apache.solr.SolrTestCaseJ4,0.08,32,2,19,36,32,7,0,6,665,2
"org.apache.solr.handler.dataimport.AbstractDataImportHandlerTestCase$TestContext",22,0.01,1.23,51,0.60,12208.41,28,6,22,40,5,138.11,0,98,0,2,138.11,0.00,0.50,0.17,0,0.00,2,1806.07,0,17,5,org.apache.solr.handler.dataimport.Context,0.56,18,1,27,0,18,5,0,0,462,1
"org.apache.solr.handler.dataimport.AbstractDataImportHandlerTestCase$TestUpdateRequestProcessor",8,0.10,1.00,35,0.30,4999.28,14,6,22,8,6,126.53,0,50,0,2,126.53,0.00,0.50,0.25,1,26.00,1,907.08,6,0,6,org.apache.solr.update.processor.UpdateRequestProcessor,0.13,0,1,8,0,0,8,0,0,227,2
"org.apache.solr.handler.dataimport.AbstractDataImportHandlerTestCase$TestUpdateRequestProcessorFactory",1,0.00,1.00,3,0.03,422.46,1,0,22,2,4,132.52,0,7,0,2,132.52,0.00,0.50,0.00,0,1.00,1,99.65,0,1,4,org.apache.solr.update.processor.UpdateRequestProcessorFactory,0.00,1,1,1,0,1,0,0,0,27,2
"org.apache.solr.handler.dataimport.BinContentStreamDataSource",3,0.33,2.67,18,0.21,5406.64,6,3,5,8,5,136.72,10,31,0,2,116.11,0.00,0.50,0.56,0,1.00,4,632.91,0,1,5,org.apache.solr.handler.dataimport.DataSource,0.33,5,1,8,0,5,2,0,2,140,1
"org.apache.solr.handler.dataimport.BinFileDataSource",3,0.50,1.33,11,0.13,2414.69,4,1,7,8,3,112.38,15,20,0,2,130.25,0.00,0.50,0.67,0,1.00,2,396.63,0,1,3,org.apache.solr.handler.dataimport.DataSource,0.33,5,1,4,0,5,2,0,1,91,1
"org.apache.solr.handler.dataimport.BinURLDataSource",5,0.21,2.40,40,0.51,15326.28,11,6,8,21,2,149.54,10,57,0,2,109.66,0.00,0.50,0.33,1,10.00,5,1543.48,0,2,2,org.apache.solr.handler.dataimport.DataSource,0.25,16,1,12,0,16,3,0,2,304,1
"org.apache.solr.handler.dataimport.CachePropertyUtil",2,0.00,4.00,19,0.23,10241.43,2,0,0,7,2,57.77,16,28,1,1,105.88,0.00,0.00,0.00,0,2.00,4,694.89,0,2,1,java.lang.Object,0.00,5,0,8,0,5,0,0,1,151,1
"org.apache.solr.handler.dataimport.ClobTransformer",2,1.00,5.50,34,0.49,29727.00,3,1,7,13,7,73.98,10,45,1,2,91.86,0.00,0.50,0.50,1,2.00,8,1482.75,0,2,6,org.apache.solr.handler.dataimport.Transformer,0.00,11,1,11,0,11,0,0,1,272,1
"org.apache.solr.handler.dataimport.ContentStreamDataSource",3,0.33,2.67,18,0.21,5406.64,6,3,5,8,5,136.72,10,31,0,2,116.11,0.00,0.50,0.56,0,1.00,4,632.91,0,1,5,org.apache.solr.handler.dataimport.DataSource,0.33,5,1,8,0,5,2,0,1,140,1
"org.apache.solr.handler.dataimport.Context",21,7.00,1.00,27,0.25,2466.86,28,7,3,21,90,122.48,144,28,88,1,154.70,0.00,0.00,0.00,0,21.00,1,742.56,0,14,4,java.lang.Object,0.00,0,0,21,2,0,7,0,26,221,2
"org.apache.solr.handler.dataimport.ContextImpl",25,0.03,2.48,113,1.49,50368.82,36,11,5,45,17,122.31,9,184,10,2,122.31,0.00,0.50,0.12,2,294.00,10,4463.59,0,15,8,org.apache.solr.handler.dataimport.Context,0.52,20,1,62,0,20,10,0,2,962,1
"org.apache.solr.handler.dataimport.DIHCache",9,0.00,1.00,10,0.09,599.58,9,0,2,9,6,114.35,65,11,5,1,156.64,0.00,0.00,0.00,0,9.00,1,257.06,0,2,1,,0.00,0,0,9,0,0,7,0,10,84,1
"org.apache.solr.handler.dataimport.DIHCacheSupport",10,0.06,3.10,111,1.66,67481.93,22,12,10,40,10,83.87,51,161,5,1,101.74,0.00,0.00,0.14,4,38.00,5,4965.75,0,6,5,java.lang.Object,0.00,30,0,31,0,30,4,0,8,953,1
"org.apache.solr.handler.dataimport.DIHLogLevels",0,0.00,0.00,2,0.03,112.59,0,0,0,0,5,171.00,16,3,5,1,171.00,0.00,0.00,0.00,0,0.00,0,75.06,0,0,0,java.lang.Object,0.00,0,0,0,0,0,0,0,1,18,1
"org.apache.solr.handler.dataimport.DIHPropertiesWriter",4,0.00,1.00,5,0.02,105.78,4,0,1,4,4,159.80,0,6,4,1,159.80,0.00,0.00,0.00,0,4.00,1,70.52,0,1,1,,0.00,0,0,4,0,0,3,0,0,28,1
"org.apache.solr.handler.dataimport.DIHWriter",9,0.00,1.00,10,0.06,337.10,9,0,3,9,5,126.39,57,11,3,1,158.61,0.00,0.00,0.00,0,9.00,1,191.28,0,0,2,,0.00,0,0,9,0,0,9,0,10,68,1
"org.apache.solr.handler.dataimport.DIHWriterBase",1,0.00,5.00,15,0.19,7083.58,3,2,3,8,2,96.44,0,21,1,1,96.44,0.00,0.00,1.00,0,0.00,5,567.37,0,0,1,java.lang.Object,0.00,7,0,5,3,7,1,1,0,114,2
"org.apache.solr.handler.dataimport.DataConfig",0,0.00,0.00,11,0.18,5599.28,6,6,9,3,7,171.00,15,11,6,1,171.00,0.00,0.00,0.00,0,0.00,0,529.66,0,0,1,java.lang.Object,0.00,3,0,0,0,3,0,0,1,105,1
"org.apache.solr.handler.dataimport.DataConfig$Document",2,4.00,1.50,13,0.15,3688.69,6,4,9,4,0,116.16,1,15,0,1,116.16,0.00,0.00,0.00,0,2.00,2,446.85,0,0,0,java.lang.Object,0.00,2,0,3,0,2,2,0,1,97,2
"org.apache.solr.handler.dataimport.DataConfig$Entity",5,0.17,4.20,66,0.93,44859.56,21,16,9,24,4,97.99,1,81,0,1,97.99,0.00,0.00,0.20,0,1.00,11,2789.47,0,2,4,java.lang.Object,0.00,19,0,21,0,19,3,0,1,495,2
"org.apache.solr.handler.dataimport.DataConfig$Field",9,0.01,3.22,111,1.55,67016.37,26,17,9,43,3,99.98,4,134,0,1,99.98,0.00,0.00,0.05,4,26.00,11,4645.67,0,5,3,java.lang.Object,0.00,34,0,29,0,34,4,0,2,868,2
"org.apache.solr.handler.dataimport.DataConfig$Field$HashMap<String,String>",1,0.00,2.00,4,0.05,1308.22,1,0,9,1,0,123.84,0,7,0,1,123.84,0.00,0.00,0.00,0,1.00,2,158.46,3,1,0,java.lang.Object,0.00,0,0,2,0,0,0,0,0,42,0
"org.apache.solr.handler.dataimport.DataConfig$Script",2,2.00,1.50,9,0.09,1512.39,4,2,9,5,0,125.78,0,13,0,1,125.78,0.00,0.00,0.00,0,2.00,2,264.52,0,0,0,java.lang.Object,0.00,3,0,3,0,3,2,0,0,64,2
"org.apache.solr.handler.dataimport.DataImportHandler",11,0.06,4.27,167,3.07,212173.88,18,7,28,74,25,132.93,27,229,0,2,93.05,0.00,0.50,0.19,4,27.00,19,9211.10,2,7,25,org.apache.solr.handler.RequestHandlerBase,0.43,63,1,47,0,63,4,1,10,1478,1
"org.apache.solr.handler.dataimport.DataImportHandler$SolrWriter",1,0.00,2.00,6,0.06,1160.42,1,0,28,1,1,117.68,0,10,0,1,117.68,0.00,0.00,0.00,0,0.00,2,176.05,1,0,1,java.lang.Object,0.00,0,0,2,0,0,1,0,0,42,0
"org.apache.solr.handler.dataimport.DataImportHandlerException",7,0.00,1.57,29,0.30,5876.11,14,7,0,9,43,175.41,9,39,43,2,125.41,0.00,0.50,0.14,0,0.00,2,913.54,0,0,1,java.lang.RuntimeException,0.00,2,1,11,0,2,7,0,1,214,1
"org.apache.solr.handler.dataimport.DataImporter",28,0.03,2.86,268,4.18,181265.49,57,29,26,136,43,105.15,26,364,27,1,105.15,0.00,0.00,0.07,11,424.00,11,12534.19,0,10,21,java.lang.Object,0.00,108,0,80,0,108,18,0,16,2199,1
"org.apache.solr.handler.dataimport.DataImporter$MSG",0,0.00,0.00,15,0.23,3423.57,14,14,26,0,0,171.00,0,16,0,1,171.00,0.00,0.00,0.00,0,0.00,0,682.44,0,0,0,java.lang.Object,0.00,0,0,0,0,0,0,0,0,131,2
"org.apache.solr.handler.dataimport.DataImporter$RequestParams",2,0.60,7.00,45,0.87,53568.12,17,15,26,11,4,135.61,2,59,0,1,85.61,0.00,0.00,0.37,0,2.00,13,2599.21,0,0,4,java.lang.Object,0.00,9,0,14,0,9,2,0,2,445,2
"org.apache.solr.handler.dataimport.DataImporter$Status",0,0.00,0.00,2,0.01,36.00,0,0,26,0,0,171.00,0,3,0,1,171.00,0.00,0.00,0.00,0,0.00,0,24.00,0,0,0,java.lang.Object,0.00,0,0,0,0,0,0,0,0,8,1
"org.apache.solr.handler.dataimport.DataImporter$Thread",1,0.00,1.00,3,0.02,143.17,1,0,26,2,0,136.23,0,5,0,1,136.23,0.00,0.00,0.00,0,1.00,1,52.97,0,0,0,java.lang.Object,0.00,1,0,1,0,1,1,0,0,17,0
"org.apache.solr.handler.dataimport.DataImporter$ThreadLocal<AtomicLong>",1,0.00,1.00,3,0.02,301.04,1,0,26,2,0,133.68,0,5,0,1,133.68,0.00,0.00,0.00,0,1.00,1,62.84,0,1,0,java.lang.Object,0.00,1,0,1,0,1,0,0,0,20,0
"org.apache.solr.handler.dataimport.DataImporter$ThreadLocal<SimpleDateFormat>",1,0.00,1.00,3,0.02,303.40,1,0,26,2,0,133.66,0,5,0,1,133.66,0.00,0.00,0.00,0,1.00,1,68.08,0,1,0,java.lang.Object,0.00,1,0,1,0,1,0,0,0,21,0
"org.apache.solr.handler.dataimport.DataSource",3,0.00,1.00,4,0.03,217.46,3,0,1,3,27,136.21,42,5,27,1,156.35,0.00,0.00,0.00,0,3.00,1,96.73,0,0,1,java.lang.Object,0.00,0,0,3,14,0,3,0,4,32,2
"org.apache.solr.handler.dataimport.DateFormatTransformer",2,0.33,6.50,39,0.62,36914.40,5,3,5,17,5,46.98,15,54,1,2,89.27,0.00,0.50,0.50,1,2.00,9,1854.80,0,2,4,org.apache.solr.handler.dataimport.Transformer,0.00,15,1,13,0,15,0,0,1,333,1
"org.apache.solr.handler.dataimport.DebugLogger",9,0.02,4.33,99,1.51,125298.48,14,5,8,33,10,149.19,17,130,3,1,99.19,0.00,0.00,0.18,2,13.00,20,4519.80,0,4,7,java.lang.Object,0.00,24,0,39,0,24,5,0,3,841,0
"org.apache.solr.handler.dataimport.DebugLogger$DataSource",3,0.00,1.67,17,0.22,7000.67,3,0,8,10,4,118.29,0,31,0,1,118.29,0.00,0.00,0.00,0,3.00,3,650.40,0,1,4,java.lang.Object,0.00,7,0,5,0,7,2,0,0,135,0
"org.apache.solr.handler.dataimport.DebugLogger$DebugInfo",1,5.00,5.00,20,0.22,9383.66,7,6,8,4,3,90.82,0,25,0,1,90.82,0.00,0.00,0.17,0,0.00,5,672.71,0,0,3,java.lang.Object,0.00,3,0,5,0,3,1,0,0,138,2
"org.apache.solr.handler.dataimport.DebugLogger$Stack<DebugInfo>",1,0.00,2.00,4,0.05,968.26,1,0,8,3,1,124.87,0,8,0,1,124.87,0.00,0.00,0.00,0,1.00,2,144.99,1,0,1,java.lang.Object,0.00,2,0,2,0,2,1,0,0,36,0
"org.apache.solr.handler.dataimport.DebugLogger$Transformer",1,0.00,3.00,16,0.20,10139.22,1,0,8,5,3,94.28,0,21,0,1,94.28,0.00,0.00,0.00,0,1.00,3,614.70,0,1,3,java.lang.Object,0.00,4,0,3,0,4,0,0,0,118,0
"org.apache.solr.handler.dataimport.Deprecated",0,0.00,0.00,1,0.01,90.00,0,0,0,0,1,171.00,17,2,0,3,171.00,0.00,0.67,0.00,0,0.00,0,27.00,0,0,1,org.apache.solr.handler.dataimport.URLDataSource,0.00,0,2,0,0,0,0,0,1,9,1
"org.apache.solr.handler.dataimport.DestroyCountCache",2,1.00,1.00,6,0.07,1193.20,3,1,4,5,3,131.34,0,9,1,2,131.34,0.00,0.50,0.50,0,2.00,1,206.01,1,0,2,org.apache.solr.handler.dataimport.SortedMapBackedCache,0.14,3,1,2,0,3,2,0,0,53,1
"org.apache.solr.handler.dataimport.DocBuilder",27,0.08,6.52,495,8.77,724944.94,50,23,11,170,28,138.87,44,710,11,1,88.87,0.00,0.00,0.12,20,209.00,37,26307.56,0,5,21,java.lang.Object,0.00,143,0,176,0,143,22,0,31,4330,1
"org.apache.solr.handler.dataimport.DocBuilder$DocWrapper",2,0.00,2.00,7,0.09,1906.78,3,1,11,5,1,129.58,1,10,0,2,129.58,0.00,0.50,1.00,0,0.00,2,271.67,0,1,1,org.apache.solr.common.SolrInputDocument,0.00,3,1,4,0,3,1,0,1,66,1
"org.apache.solr.handler.dataimport.DocBuilder$Object",1,0.00,1.00,3,0.02,253.76,1,0,11,3,0,134.27,0,5,0,1,134.27,0.00,0.00,0.00,0,1.00,1,67.21,0,1,0,java.lang.Object,0.00,2,0,1,0,2,0,0,0,20,0
"org.apache.solr.handler.dataimport.DocBuilder$Statistics",2,0.33,1.00,21,0.28,8383.92,8,6,11,7,0,105.17,0,24,0,1,105.17,0.00,0.00,0.33,0,2.00,1,850.13,0,2,0,java.lang.Object,0.00,5,0,2,0,5,0,0,0,198,2
"org.apache.solr.handler.dataimport.EntityProcessor",8,0.00,1.00,9,0.08,613.42,8,0,1,8,8,106.16,76,12,8,1,156.16,0.00,0.00,0.00,0,8.00,1,233.66,0,4,1,java.lang.Object,0.00,0,0,8,11,0,4,0,10,75,2
"org.apache.solr.handler.dataimport.EntityProcessorBase",9,0.06,2.00,62,0.70,19338.65,24,15,5,20,13,155.46,18,88,8,2,115.57,9.00,0.09,0.12,2,16.00,5,2087.39,0,5,5,org.apache.solr.handler.dataimport.EntityProcessor,0.71,11,1,18,9,11,4,0,4,430,1
"org.apache.solr.handler.dataimport.EntityProcessorWrapper",14,0.13,3.29,146,1.89,117549.43,23,9,11,57,17,102.52,7,200,9,2,102.52,0.00,0.50,0.23,3,10.00,18,5682.70,0,7,9,org.apache.solr.handler.dataimport.EntityProcessor,0.55,43,1,46,0,43,7,0,3,1040,1
"org.apache.solr.handler.dataimport.EntityProcessorWrapper$ArrayList<Transformer>",1,0.00,2.00,5,0.06,1574.25,1,0,11,2,1,119.59,0,8,0,1,119.59,0.00,0.00,0.00,0,0.00,2,189.11,1,0,1,java.lang.Object,0.00,1,0,2,0,1,1,0,0,45,0
"org.apache.solr.handler.dataimport.EntityProcessorWrapper$SuppressWarnings",2,0.50,1.50,15,0.17,3596.80,6,4,11,5,3,113.75,0,23,0,2,113.75,0.00,0.50,0.50,0,0.00,2,521.03,0,1,3,org.apache.solr.handler.dataimport.Transformer,0.00,3,1,3,0,3,1,0,0,114,1
"org.apache.solr.handler.dataimport.Evaluator",1,0.00,1.00,2,0.01,99.30,1,0,0,1,6,193.32,24,3,5,1,144.05,0.00,0.00,0.00,0,1.00,1,43.31,0,1,1,java.lang.Object,0.00,0,0,1,2,0,0,0,2,15,2
"org.apache.solr.handler.dataimport.EvaluatorBag",6,0.06,2.83,62,0.99,61887.29,13,7,16,35,12,51.85,55,81,5,1,101.85,0.00,0.00,0.10,0,10.00,9,2971.59,0,5,8,java.lang.Object,0.00,29,0,17,0,29,1,0,7,523,1
"org.apache.solr.handler.dataimport.EvaluatorBag$DateMathParser",1,0.00,1.00,3,0.03,341.91,1,0,16,2,0,133.25,0,6,0,1,133.25,0.00,0.00,0.00,0,1.00,1,79.19,0,1,0,java.lang.Object,0.00,1,0,1,0,1,0,0,0,25,0
"org.apache.solr.handler.dataimport.EvaluatorBag$Evaluator",1,0.00,2.00,7,0.12,3020.27,1,0,16,9,2,132.53,3,10,0,1,111.91,0.00,0.00,0.00,0,1.00,2,370.11,0,1,2,java.lang.Object,0.00,8,0,2,0,8,0,0,3,73,0
"org.apache.solr.handler.dataimport.EvaluatorBag$Evaluator_0",1,0.00,2.00,7,0.10,2436.19,1,0,16,8,3,112.65,0,10,0,1,112.65,0.00,0.00,0.00,0,1.00,2,300.57,0,1,3,java.lang.Object,0.00,7,0,2,0,7,0,0,0,62,0
"org.apache.solr.handler.dataimport.EvaluatorBag$Evaluator_1",1,0.00,3.00,10,0.15,5017.73,1,0,16,10,2,104.30,0,15,0,1,104.30,0.00,0.00,0.00,0,1.00,3,463.81,0,1,2,java.lang.Object,0.00,9,0,3,0,9,0,0,0,88,0
"org.apache.solr.handler.dataimport.EvaluatorBag$Evaluator_2",1,0.00,8.00,35,0.50,29194.87,1,0,16,15,2,77.76,0,47,0,1,77.76,0.00,0.00,0.00,0,0.00,8,1502.39,0,1,2,java.lang.Object,0.00,14,0,8,0,14,0,0,0,247,0
"org.apache.solr.handler.dataimport.EvaluatorBag$HashMap<String,Object>",1,0.00,4.00,11,0.17,6482.75,1,0,16,6,2,101.82,0,16,0,1,101.82,0.00,0.00,0.00,0,0.00,4,516.41,0,1,2,java.lang.Object,0.00,5,0,4,0,5,0,0,0,104,0
"org.apache.solr.handler.dataimport.EvaluatorBag$VariableWrapper",3,0.25,1.33,11,0.10,1686.97,5,2,16,5,1,131.48,0,16,0,1,131.48,0.00,0.00,0.67,0,1.00,2,285.71,0,2,1,java.lang.Object,0.00,2,0,4,0,2,1,0,0,75,2
"org.apache.solr.handler.dataimport.EventListener",1,0.00,1.00,2,0.01,41.48,1,0,0,1,4,109.47,12,3,3,1,147.03,0.00,0.00,0.00,0,1.00,1,27.65,0,0,1,,0.00,0,0,1,0,0,1,0,2,11,1
"org.apache.solr.handler.dataimport.FieldReaderDataSource",5,0.10,2.60,41,0.47,16057.71,10,5,9,18,7,109.71,21,60,2,2,109.48,0.00,0.50,0.28,2,6.00,7,1422.58,0,3,5,org.apache.solr.handler.dataimport.DataSource,0.25,13,1,13,0,13,2,0,5,289,1
"org.apache.solr.handler.dataimport.FieldStreamDataSource",3,0.25,2.67,29,0.40,14996.64,7,4,9,19,6,73.83,20,41,0,2,106.05,0.00,0.50,0.42,0,1.00,6,1212.19,0,1,6,org.apache.solr.handler.dataimport.DataSource,0.33,16,1,8,0,16,2,0,5,227,1
"org.apache.solr.handler.dataimport.FileDataSource",5,0.06,2.60,33,0.47,18837.93,9,4,6,20,4,63.59,48,52,1,2,113.59,0.00,0.50,0.30,2,9.00,6,1400.73,0,3,3,org.apache.solr.handler.dataimport.DataSource,0.25,15,1,13,0,15,2,0,5,292,1
"org.apache.solr.handler.dataimport.FileListEntityProcessor",6,0.20,4.67,105,1.70,69504.69,30,24,6,37,5,63.36,79,141,1,3,92.75,0.00,0.67,0.21,1,6.00,7,5092.09,2,3,4,org.apache.solr.handler.dataimport.EntityProcessorBase,0.13,31,2,28,0,31,3,0,15,915,1
"org.apache.solr.handler.dataimport.FileListEntityProcessor$FilenameFilter",1,0.00,6.00,11,0.14,5872.81,1,0,6,6,0,102.06,0,14,0,1,102.06,0.00,0.00,0.00,0,0.00,6,424.15,0,0,0,java.lang.Object,0.00,5,0,6,0,5,1,0,0,88,0
"org.apache.solr.handler.dataimport.HTMLStripTransformer",2,0.00,7.50,39,0.64,43209.33,4,2,8,22,5,88.94,8,56,0,2,88.70,0.00,0.50,0.50,1,2.00,9,1920.68,0,2,5,org.apache.solr.handler.dataimport.Transformer,0.00,20,1,15,0,20,0,0,2,340,1
"org.apache.solr.handler.dataimport.JdbcDataSource",10,0.08,3.40,95,1.64,77663.66,25,15,8,40,6,154.49,11,149,2,2,104.49,0.00,0.50,0.14,3,22.00,13,4918.82,1,4,5,org.apache.solr.handler.dataimport.DataSource,0.15,30,1,34,0,30,6,0,3,883,1
"org.apache.solr.handler.dataimport.JdbcDataSource$Callable<Connection>",1,0.00,16.00,49,0.95,66370.59,1,0,8,21,3,51.47,5,64,0,1,69.34,0.00,0.00,0.00,0,0.00,16,2845.38,0,1,3,java.lang.Object,0.00,20,0,16,0,20,0,0,5,427,0
"org.apache.solr.handler.dataimport.JdbcDataSource$ResultSetIterator",5,0.25,5.40,73,0.95,53232.95,9,4,8,32,0,96.15,1,107,0,1,96.15,0.00,0.00,0.45,1,0.00,14,2839.61,0,2,0,java.lang.Object,0.00,27,0,27,0,27,3,0,1,519,1
"org.apache.solr.handler.dataimport.JdbcDataSource$ResultSetIterator$Iterator<Map<String,Object>>",3,0.00,1.00,6,0.04,335.20,3,0,8,5,0,143.64,1,9,0,1,143.64,0.00,0.00,0.00,0,3.00,1,120.08,0,1,0,java.lang.Object,0.00,2,0,3,0,2,2,0,1,38,0
"org.apache.solr.handler.dataimport.LineEntityProcessor",3,0.57,4.33,37,0.51,22602.85,10,7,4,15,4,139.18,65,55,1,3,99.88,0.00,0.67,0.52,0,0.00,7,1539.05,2,1,3,org.apache.solr.handler.dataimport.EntityProcessorBase,0.45,12,2,13,0,12,2,0,13,298,1
"org.apache.solr.handler.dataimport.LogTransformer",1,0.00,12.00,19,0.38,17641.82,4,3,3,15,2,40.81,10,28,0,2,89.29,0.00,0.50,1.00,0,0.00,12,1140.19,0,1,2,org.apache.solr.handler.dataimport.Transformer,0.00,14,1,12,0,14,0,0,1,214,1
"org.apache.solr.handler.dataimport.MailEntityProcessor",13,0.11,4.92,237,4.46,246881.30,53,40,20,80,5,130.00,26,307,0,3,90.12,0.00,0.67,0.13,6,75.00,15,13393.46,1,3,5,org.apache.solr.handler.dataimport.EntityProcessorBase,0.20,67,2,64,0,67,10,0,19,2255,1
"org.apache.solr.handler.dataimport.MailEntityProcessor$CustomFilter",1,0.00,1.00,2,0.01,52.70,1,0,20,1,0,146.21,0,4,0,1,146.21,0.00,0.00,0.00,0,1.00,1,31.26,0,1,0,,0.00,0,0,1,0,0,0,0,0,12,2
"org.apache.solr.handler.dataimport.MailEntityProcessor$FolderIterator",6,0.10,4.00,66,0.85,52014.57,10,4,20,24,1,100.82,3,89,0,1,100.82,0.00,0.00,0.33,1,2.00,9,2537.62,0,0,1,java.lang.Object,0.00,18,0,24,0,18,6,1,3,477,0
"org.apache.solr.handler.dataimport.MailEntityProcessor$MailsSinceLastCheckFilter",2,0.00,1.00,6,0.04,397.09,3,1,20,3,0,135.11,0,9,0,1,135.11,0.00,0.00,1.00,0,0.00,1,125.91,0,1,0,java.lang.Object,0.00,1,0,2,0,1,1,1,0,36,0
"org.apache.solr.handler.dataimport.MailEntityProcessor$MessageIterator",6,0.34,3.17,64,0.78,31591.27,13,7,20,16,2,104.13,2,83,0,1,104.13,0.00,0.00,0.43,3,0.00,5,2327.66,0,1,2,java.lang.Object,0.00,10,0,19,0,10,5,1,2,457,0
"org.apache.solr.handler.dataimport.MockDataSource",5,0.25,1.00,11,0.18,4443.49,6,1,4,9,17,186.55,9,22,15,2,136.55,1.00,0.33,0.80,0,0.00,1,530.64,0,1,2,org.apache.solr.handler.dataimport.DataSource,0.25,4,1,5,1,4,4,0,1,132,1
"org.apache.solr.handler.dataimport.MockInitialContextFactory",3,0.17,1.33,16,0.22,4341.98,6,3,8,15,1,119.97,0,23,1,1,119.97,0.00,0.00,0.44,0,2.00,2,645.72,0,1,0,java.lang.Object,0.00,12,0,4,0,12,2,1,0,140,1
"org.apache.solr.handler.dataimport.MockInitialContextFactory$IAnswer<Object>",1,0.00,1.00,3,0.03,353.13,1,0,8,2,0,133.14,0,4,0,1,133.14,0.00,0.00,0.00,0,0.00,1,95.65,0,1,0,java.lang.Object,0.00,1,0,1,0,1,0,0,0,26,0
"org.apache.solr.handler.dataimport.MockSolrEntityProcessor",5,0.08,1.40,30,0.33,12005.92,8,3,4,14,5,115.28,1,35,1,4,115.28,0.00,0.75,0.27,1,13.00,3,999.63,0,2,4,org.apache.solr.handler.dataimport.SolrEntityProcessor,0.15,9,3,7,0,9,3,0,1,213,1
"org.apache.solr.handler.dataimport.NumberFormatTransformer",3,0.29,6.00,59,1.02,72454.19,10,7,9,31,6,56.15,18,81,1,2,88.37,0.00,0.50,0.33,2,5.00,11,3046.06,0,3,5,org.apache.solr.handler.dataimport.Transformer,0.00,28,1,18,0,28,0,0,1,530,1
"org.apache.solr.handler.dataimport.PlainTextEntityProcessor",2,0.33,3.50,30,0.44,21897.88,5,3,11,16,3,115.65,6,40,0,3,95.03,0.00,0.67,0.50,0,0.00,6,1313.04,1,1,3,org.apache.solr.handler.dataimport.EntityProcessorBase,0.32,14,2,7,0,14,1,0,1,237,1
"org.apache.solr.handler.dataimport.RegexTransformer",5,0.07,7.40,113,1.84,178113.53,12,7,5,37,9,105.24,17,146,6,2,84.62,0.00,0.50,0.20,4,14.00,18,5523.60,0,5,3,org.apache.solr.handler.dataimport.Transformer,0.00,32,1,37,0,32,0,0,1,946,1
"org.apache.solr.handler.dataimport.ScriptTransformer",4,0.00,3.00,31,0.41,15561.32,6,2,7,15,5,111.19,17,53,2,2,110.95,0.00,0.50,0.50,1,2.00,5,1217.25,0,2,3,org.apache.solr.handler.dataimport.Transformer,0.00,11,1,12,0,11,2,0,2,238,1
"org.apache.solr.handler.dataimport.SimplePropertiesWriter",5,0.20,3.20,48,0.64,24261.22,10,5,11,27,6,106.11,0,71,3,1,106.11,0.00,0.00,0.36,2,0.00,5,1912.32,0,2,4,java.lang.Object,0.00,22,0,16,0,22,3,1,0,381,1
"org.apache.solr.handler.dataimport.SolrEntityProcessor",5,0.16,4.80,84,1.21,53043.95,19,14,21,33,13,76.15,27,115,2,3,94.02,0.50,0.50,0.20,3,10.00,9,3639.80,2,3,11,org.apache.solr.handler.dataimport.EntityProcessorBase,0.14,28,2,24,1,28,2,0,7,642,1
"org.apache.solr.handler.dataimport.SolrEntityProcessor$SolrDocumentListIterator",7,0.00,1.14,29,0.30,7312.36,11,4,21,18,2,124.74,3,40,0,1,124.74,0.00,0.00,0.25,0,20.00,2,901.28,0,1,2,java.lang.Object,0.00,11,0,8,0,11,6,1,3,212,2
"org.apache.solr.handler.dataimport.SolrWriter",11,0.18,2.00,69,0.85,21708.29,16,5,11,36,20,115.86,8,112,9,2,115.86,2.00,0.25,0.36,0,0.00,3,2548.07,0,2,12,org.apache.solr.handler.dataimport.DIHWriterBase,0.00,25,1,22,2,25,9,1,2,539,1
"org.apache.solr.handler.dataimport.SortedMapBackedCache",12,0.05,2.25,71,0.83,30148.88,16,4,7,31,6,117.97,0,112,2,1,117.97,0.00,0.00,0.29,3,18.00,7,2501.92,0,2,4,java.lang.Object,0.00,19,0,27,1,19,10,1,0,523,1
"org.apache.solr.handler.dataimport.SortedMapBackedCache$Iterator<Map<String,Object>>",3,0.50,3.67,37,0.44,19153.82,6,3,7,9,0,100.48,0,53,0,1,100.48,0.00,0.00,0.67,0,1.00,5,1307.69,0,1,0,java.lang.Object,0.00,6,0,11,0,6,2,0,0,280,0
"org.apache.solr.handler.dataimport.SqlEntityProcessor",8,0.06,3.25,78,1.10,39150.25,17,9,6,34,9,145.96,18,112,5,3,106.08,0.00,0.67,0.17,3,0.00,7,3307.34,2,6,4,org.apache.solr.handler.dataimport.EntityProcessorBase,0.60,26,2,26,0,26,2,0,1,642,1
"org.apache.solr.handler.dataimport.TemplateString",6,0.10,2.33,47,0.61,22805.22,10,4,4,27,6,111.33,26,55,5,1,111.09,0.00,0.00,0.33,0,10.00,5,1819.22,0,4,1,java.lang.Object,0.00,21,0,14,0,21,2,0,3,382,1
"org.apache.solr.handler.dataimport.TemplateTransformer",2,0.00,4.50,30,0.51,24254.09,5,3,5,14,6,65.24,27,42,1,2,94.62,0.00,0.50,0.33,1,2.00,7,1536.17,0,2,5,org.apache.solr.handler.dataimport.Transformer,0.00,12,1,9,0,12,0,0,4,280,1
"org.apache.solr.handler.dataimport.TestCachedSqlEntityProcessor",6,0.00,4.00,158,2.88,169051.90,6,0,5,30,7,132.86,8,192,0,4,82.86,0.00,0.75,0.00,1,6.00,7,8652.09,2,0,7,org.apache.solr.handler.dataimport.AbstractDataImportHandlerTestCase,0.00,24,3,24,0,24,6,0,1,1465,1
"org.apache.solr.handler.dataimport.TestCachedSqlEntityProcessor$DoubleTransformer",1,0.00,1.00,6,0.08,2852.23,1,0,5,3,2,114.76,0,9,0,2,114.76,0.00,0.50,0.00,0,1.00,1,254.88,0,1,2,org.apache.solr.handler.dataimport.Transformer,0.00,2,1,1,0,2,0,0,0,59,2
"org.apache.solr.handler.dataimport.TestCachedSqlEntityProcessor$UppercaseTransformer",1,0.00,3.00,9,0.12,4544.68,1,0,5,4,2,106.35,0,14,0,2,106.35,0.00,0.50,0.00,0,1.00,3,359.65,0,1,2,org.apache.solr.handler.dataimport.Transformer,0.00,3,1,3,0,3,0,0,0,75,2
"org.apache.solr.handler.dataimport.TestClobTransformer",1,0.00,1.00,16,0.33,11689.31,1,0,7,15,6,45.95,8,18,0,4,94.05,0.00,0.75,0.00,0,1.00,1,987.93,1,0,6,org.apache.solr.handler.dataimport.AbstractDataImportHandlerTestCase,0.00,14,3,1,0,14,1,0,2,172,1
"org.apache.solr.handler.dataimport.TestClobTransformer$InvocationHandler",1,0.00,2.00,5,0.05,958.47,1,0,7,4,0,121.29,0,7,0,1,121.29,0.00,0.00,0.00,0,1.00,2,161.80,0,1,0,java.lang.Object,0.00,3,0,2,0,3,0,0,0,38,0
"org.apache.solr.handler.dataimport.TestContentStreamDataSource",5,0.19,1.40,60,0.85,24158.65,9,4,14,31,8,151.66,6,81,0,4,101.66,0.00,0.75,0.40,0,0.00,3,2562.04,3,1,8,org.apache.solr.handler.dataimport.AbstractDataImportHandlerTestCase,0.10,26,3,7,0,26,4,0,1,468,1
"org.apache.solr.handler.dataimport.TestContentStreamDataSource$SolrInstance",8,0.03,1.00,35,0.34,7101.60,13,5,14,16,0,125.32,4,45,0,1,125.32,0.00,0.00,0.18,2,18.00,1,1017.06,0,5,0,java.lang.Object,0.00,8,0,8,0,8,3,0,1,231,1
"org.apache.solr.handler.dataimport.TestContextImpl",4,0.00,1.00,29,0.53,13464.13,4,0,4,20,8,111.70,0,38,0,4,111.70,0.00,0.75,0.00,0,4.00,1,1597.98,0,0,8,org.apache.solr.handler.dataimport.AbstractDataImportHandlerTestCase,0.00,16,3,4,0,16,4,0,0,316,1
"org.apache.solr.handler.dataimport.TestDataConfig",3,1.00,1.00,16,0.28,4445.40,4,1,8,17,3,159.84,8,32,0,4,119.96,0.00,0.75,0.33,0,4.00,1,852.64,6,0,3,org.apache.solr.handler.dataimport.AbstractDataImportHandlerTestCase,0.00,14,3,3,0,14,3,0,1,173,1
"org.apache.solr.handler.dataimport.TestDateFormatTransformer",2,0.00,1.00,33,0.62,17693.10,2,0,3,16,6,95.24,8,46,0,4,95.00,0.00,0.75,0.00,0,2.00,1,1869.67,2,0,6,org.apache.solr.handler.dataimport.AbstractDataImportHandlerTestCase,0.00,14,3,2,0,14,2,0,1,333,1
"org.apache.solr.handler.dataimport.TestDocBuilder",7,0.17,1.86,140,2.72,95213.91,9,2,4,35,6,139.78,8,164,0,4,89.78,0.00,0.75,0.36,0,8.00,3,8151.87,2,0,6,org.apache.solr.handler.dataimport.AbstractDataImportHandlerTestCase,0.05,28,3,13,0,28,7,0,1,1353,1
"org.apache.solr.handler.dataimport.TestDocBuilder$SolrWriterImpl",5,0.06,1.00,15,0.15,2934.26,9,4,4,7,2,131.40,0,25,0,3,131.40,0.00,0.67,0.20,0,17.00,1,456.79,0,0,2,org.apache.solr.handler.dataimport.SolrWriter,0.53,2,2,5,0,2,5,0,0,115,1
"org.apache.solr.handler.dataimport.TestDocBuilder2",12,0.03,1.00,147,2.56,70989.15,19,7,8,26,3,101.04,11,248,0,4,101.04,0.00,0.75,0.12,0,82.00,1,7676.53,7,0,3,org.apache.solr.handler.dataimport.AbstractDataImportHandlerTestCase,0.00,14,3,12,0,14,12,0,4,1377,1
"org.apache.solr.handler.dataimport.TestDocBuilder2$AddDynamicFieldTransformer",1,0.00,1.00,4,0.04,738.67,1,0,8,2,2,175.95,1,7,0,2,125.95,0.00,0.50,0.00,0,1.00,1,132.02,0,1,2,org.apache.solr.handler.dataimport.Transformer,0.00,1,1,1,0,1,0,0,1,33,2
"org.apache.solr.handler.dataimport.TestDocBuilder2$EndEventListener",1,0.00,1.00,4,0.03,283.34,2,1,8,1,2,129.23,0,6,0,1,129.23,0.00,0.00,1.00,0,0.00,1,91.83,0,0,2,java.lang.Object,0.00,0,0,1,0,0,1,1,0,26,2
"org.apache.solr.handler.dataimport.TestDocBuilder2$MockDataSource2",0,0.00,0.00,1,0.01,49.13,0,0,8,0,1,171.00,0,2,0,3,171.00,0.00,0.67,0.00,0,0.00,0,19.65,0,0,1,org.apache.solr.handler.dataimport.MockDataSource,0.00,0,2,0,0,0,0,0,0,7,2
"org.apache.solr.handler.dataimport.TestDocBuilder2$MockTransformer",1,0.00,1.00,4,0.05,936.44,1,0,8,3,2,125.14,0,7,0,2,125.14,0.00,0.50,0.00,0,1.00,1,155.36,0,1,2,org.apache.solr.handler.dataimport.Transformer,0.00,2,1,1,0,2,0,0,0,37,2
"org.apache.solr.handler.dataimport.TestDocBuilder2$StartEventListener",1,0.00,1.00,4,0.03,283.34,2,1,8,1,2,129.23,0,6,0,1,129.23,0.00,0.00,1.00,0,0.00,1,91.83,0,0,2,java.lang.Object,0.00,0,0,1,0,0,1,1,0,26,2
"org.apache.solr.handler.dataimport.TestEntityProcessorBase",1,0.00,1.00,20,0.40,16570.02,1,0,5,14,5,41.14,8,27,0,4,89.24,0.00,0.75,0.00,0,1.00,1,1204.51,2,0,5,org.apache.solr.handler.dataimport.AbstractDataImportHandlerTestCase,0.00,13,3,1,0,13,1,0,1,219,1
"org.apache.solr.handler.dataimport.TestEntityProcessorBase$T1",1,0.00,1.00,4,0.04,720.56,1,0,5,2,2,126.04,0,7,0,2,126.04,0.00,0.50,0.00,0,1.00,1,127.88,0,1,2,org.apache.solr.handler.dataimport.Transformer,0.00,1,1,1,0,1,0,0,0,32,1
"org.apache.solr.handler.dataimport.TestEntityProcessorBase$T2",1,0.00,1.00,4,0.04,720.56,1,0,5,2,2,126.04,0,7,0,2,126.04,0.00,0.50,0.00,0,1.00,1,127.88,0,1,2,org.apache.solr.handler.dataimport.Transformer,0.00,1,1,1,0,1,0,0,0,32,1
"org.apache.solr.handler.dataimport.TestEntityProcessorBase$T3",1,0.00,1.00,4,0.03,474.00,1,0,5,2,0,127.47,0,6,0,1,127.47,0.00,0.00,0.00,0,1.00,1,92.00,0,1,0,java.lang.Object,0.00,1,0,1,0,1,0,0,0,25,1
"org.apache.solr.handler.dataimport.TestEphemeralCache",6,0.00,1.00,56,1.18,47356.49,6,0,8,14,3,104.71,0,100,0,4,104.71,0.00,0.75,0.00,3,6.00,1,3545.30,5,1,3,org.apache.solr.handler.dataimport.AbstractDataImportHandlerTestCase,0.00,8,3,6,0,8,5,0,0,641,1
"org.apache.solr.handler.dataimport.TestErrorHandling",7,0.07,1.14,45,0.74,18862.87,14,7,9,14,2,164.93,7,119,0,4,114.93,0.00,0.75,0.20,0,21.00,2,2217.85,10,0,2,org.apache.solr.handler.dataimport.AbstractDataImportHandlerTestCase,0.05,7,3,8,0,7,7,0,2,437,1
"org.apache.solr.handler.dataimport.TestErrorHandling$ExceptionTransformer",1,0.00,1.00,3,0.04,553.78,1,0,9,2,2,131.60,0,6,0,2,131.60,0.00,0.50,0.00,0,1.00,1,113.11,0,1,2,org.apache.solr.handler.dataimport.Transformer,0.00,1,1,1,0,1,0,0,0,29,2
"org.apache.solr.handler.dataimport.TestErrorHandling$StringDataSource",3,1.00,1.00,6,0.07,714.91,4,1,9,4,2,141.05,0,13,0,2,141.05,0.00,0.50,0.33,0,4.00,1,195.21,0,1,2,org.apache.solr.handler.dataimport.DataSource,0.33,1,1,3,0,1,2,0,0,54,2
"org.apache.solr.handler.dataimport.TestEvaluatorBag",7,0.04,1.14,66,1.09,28778.53,11,4,6,32,6,146.80,15,88,0,4,106.91,0.00,0.75,0.29,1,12.00,2,3280.12,1,0,6,org.apache.solr.handler.dataimport.AbstractDataImportHandlerTestCase,0.05,25,3,8,0,25,7,0,4,621,1
"org.apache.solr.handler.dataimport.TestFieldReader",1,0.00,1.00,14,0.28,5519.29,3,2,4,14,3,56.49,7,29,0,4,98.78,0.00,0.75,1.00,0,0.00,1,830.64,1,0,3,org.apache.solr.handler.dataimport.AbstractDataImportHandlerTestCase,0.00,13,3,1,0,13,1,0,1,156,1
"org.apache.solr.handler.dataimport.TestFileListEntityProcessor",5,0.00,2.40,104,2.04,94420.70,5,0,5,35,4,138.59,9,149,0,4,88.59,0.00,0.75,0.00,1,5.00,4,6120.50,3,1,4,org.apache.solr.handler.dataimport.AbstractDataImportHandlerTestCase,0.00,30,3,12,0,30,4,0,2,1012,1
"org.apache.solr.handler.dataimport.TestJdbcDataSource",6,0.40,1.33,88,1.40,41054.00,15,9,11,43,5,137.86,13,116,0,4,97.98,0.00,0.75,0.44,0,0.00,2,4186.18,3,0,5,org.apache.solr.handler.dataimport.AbstractDataImportHandlerTestCase,0.09,37,3,8,0,37,6,0,2,749,1
"org.apache.solr.handler.dataimport.TestLineEntityProcessor",6,0.40,2.67,59,1.22,41290.49,7,1,5,19,5,67.40,75,149,0,4,104.96,0.00,0.75,0.67,0,0.00,5,3648.25,2,2,5,org.apache.solr.handler.dataimport.AbstractDataImportHandlerTestCase,0.00,13,3,16,0,13,4,0,44,652,1
"org.apache.solr.handler.dataimport.TestLineEntityProcessor$DataSource<Reader>",3,0.00,1.00,5,0.05,447.58,3,0,5,4,1,153.88,0,11,0,1,153.88,0.00,0.00,0.00,0,3.00,1,144.54,0,1,1,java.lang.Object,0.00,1,0,3,0,1,2,0,0,43,0
"org.apache.solr.handler.dataimport.TestMailEntityProcessor",7,0.10,1.14,102,1.67,35824.47,12,5,8,22,3,138.89,19,128,0,4,99.01,0.00,0.75,0.29,1,0.00,2,5017.85,0,1,3,org.apache.solr.handler.dataimport.AbstractDataImportHandlerTestCase,0.00,15,3,8,0,15,6,0,10,905,1
"org.apache.solr.handler.dataimport.TestMailEntityProcessor$SolrWriterImpl",4,0.11,1.00,12,0.11,1569.14,7,3,8,6,2,132.78,0,20,0,3,132.78,0.00,0.67,0.25,0,10.00,1,327.50,0,0,2,org.apache.solr.handler.dataimport.SolrWriter,0.38,2,2,4,0,2,4,0,0,85,1
"org.apache.solr.handler.dataimport.TestNumberFormatTransformer",9,0.00,1.00,73,1.54,36641.16,11,2,6,21,6,108.89,8,112,0,4,108.89,0.00,0.75,0.50,0,0.00,1,4622.88,2,0,6,org.apache.solr.handler.dataimport.AbstractDataImportHandlerTestCase,0.00,12,3,9,0,12,9,0,1,861,1
"org.apache.solr.handler.dataimport.TestPlainTextEntityProcessor",1,0.00,1.00,10,0.17,2736.48,2,1,3,9,2,64.34,7,20,0,4,106.63,0.00,0.75,1.00,0,0.00,1,506.62,1,0,2,org.apache.solr.handler.dataimport.AbstractDataImportHandlerTestCase,0.00,8,3,1,0,8,1,0,1,105,1
"org.apache.solr.handler.dataimport.TestPlainTextEntityProcessor$DS",3,1.00,1.00,6,0.06,574.11,4,1,3,4,2,141.80,0,13,0,2,141.80,0.00,0.50,0.33,0,4.00,1,175.08,0,1,2,org.apache.solr.handler.dataimport.DataSource,0.33,1,1,3,0,1,2,0,0,50,2
"org.apache.solr.handler.dataimport.TestRegexTransformer",6,0.00,1.00,92,1.79,67503.51,6,0,9,23,4,95.46,26,112,0,4,95.23,0.00,0.75,0.00,1,6.00,1,5374.44,3,1,4,org.apache.solr.handler.dataimport.AbstractDataImportHandlerTestCase,0.00,17,3,6,0,17,5,0,21,962,1
"org.apache.solr.handler.dataimport.TestScriptTransformer",5,0.75,1.80,63,1.13,31488.52,6,1,11,32,6,150.69,9,105,0,4,100.69,0.00,0.75,0.40,1,7.00,2,3390.13,0,1,6,org.apache.solr.handler.dataimport.AbstractDataImportHandlerTestCase,0.00,27,3,9,0,27,4,0,1,605,1
"org.apache.solr.handler.dataimport.TestSolrEntityProcessorEndToEnd",16,0.07,1.81,139,1.93,49649.47,26,10,21,52,6,109.68,11,198,0,4,109.68,0.00,0.75,0.16,5,22.00,3,5778.64,7,5,6,org.apache.solr.handler.dataimport.AbstractDataImportHandlerTestCase,0.08,36,3,29,0,36,11,0,7,1161,1
"org.apache.solr.handler.dataimport.TestSolrEntityProcessorEndToEnd$SolrInstance",6,0.20,1.00,27,0.29,6558.22,8,2,21,16,0,124.61,0,35,0,1,124.61,0.00,0.00,0.33,2,2.00,1,865.94,0,4,0,java.lang.Object,0.00,10,0,6,0,10,2,0,0,190,2
"org.apache.solr.handler.dataimport.TestSolrEntityProcessorUnit",5,0.38,1.60,52,0.84,25719.60,7,2,3,26,3,104.36,3,58,0,4,104.36,0.00,0.75,0.20,2,7.00,3,2518.54,1,1,3,org.apache.solr.handler.dataimport.AbstractDataImportHandlerTestCase,0.00,21,3,8,0,21,4,0,1,478,1
"org.apache.solr.handler.dataimport.TestSortedMapBackedCache",3,0.00,4.00,72,1.31,90058.79,4,1,9,24,4,66.07,15,95,0,2,83.94,0.00,0.50,1.00,0,0.00,6,3931.59,6,0,4,org.apache.solr.handler.dataimport.AbstractDIHCacheTestCase,0.00,21,1,12,0,21,3,0,15,640,1
"org.apache.solr.handler.dataimport.TestSqlEntityProcessor",6,1.00,2.50,81,1.39,56576.19,7,1,2,28,7,147.94,8,101,0,4,97.94,0.00,0.75,0.17,1,10.00,3,4165.60,1,2,7,org.apache.solr.handler.dataimport.AbstractDataImportHandlerTestCase,0.00,22,3,15,0,22,4,0,1,751,1
"org.apache.solr.handler.dataimport.TestSqlEntityProcessor$DataSource<Iterator<Map<String,Object>>>",3,0.00,1.00,5,0.07,798.54,3,0,2,4,1,151.90,0,11,0,1,151.90,0.00,0.00,0.00,0,3.00,1,206.39,0,1,1,java.lang.Object,0.00,1,0,3,0,1,2,0,0,57,0
"org.apache.solr.handler.dataimport.TestSqlEntityProcessor$T",1,0.00,1.00,4,0.04,738.67,1,0,2,2,2,125.95,0,7,0,2,125.95,0.00,0.50,0.00,0,1.00,1,132.02,0,1,2,org.apache.solr.handler.dataimport.Transformer,0.00,1,1,1,0,1,0,0,0,33,2
"org.apache.solr.handler.dataimport.TestSqlEntityProcessor$T2",1,0.00,1.00,8,0.12,3830.71,1,0,2,3,2,109.10,0,11,0,2,109.10,0.00,0.50,0.00,0,0.00,1,353.32,0,1,2,org.apache.solr.handler.dataimport.Transformer,0.00,2,1,1,0,2,0,0,0,75,2
"org.apache.solr.handler.dataimport.TestSqlEntityProcessor$T3",1,0.00,1.00,4,0.03,485.22,1,0,2,2,0,127.39,0,6,0,1,127.39,0.00,0.00,0.00,0,1.00,1,95.61,0,1,0,java.lang.Object,0.00,1,0,1,0,1,0,0,0,26,2
"org.apache.solr.handler.dataimport.TestSqlEntityProcessor2",8,0.10,1.00,89,1.37,36659.08,11,3,8,12,2,153.32,9,146,0,4,103.32,0.00,0.75,0.25,0,20.00,1,4123.69,10,0,2,org.apache.solr.handler.dataimport.AbstractDataImportHandlerTestCase,0.05,4,3,8,0,4,8,0,1,786,1
"org.apache.solr.handler.dataimport.TestSqlEntityProcessor2$DateFormatValidatingEvaluator",1,0.00,3.00,14,0.20,5945.63,1,0,8,9,4,98.27,0,20,0,2,98.27,0.00,0.50,0.00,0,1.00,3,599.67,0,1,4,org.apache.solr.handler.dataimport.Evaluator,0.00,8,1,3,0,8,0,0,0,113,1
"org.apache.solr.handler.dataimport.TestSqlEntityProcessorDelta",13,0.20,1.15,159,2.36,63089.73,18,5,9,34,2,151.68,14,238,0,4,101.68,0.00,0.75,0.38,1,0.00,2,7076.28,11,0,2,org.apache.solr.handler.dataimport.AbstractDataImportHandlerTestCase,0.04,21,3,15,0,21,13,0,6,1311,1
"org.apache.solr.handler.dataimport.TestSqlEntityProcessorDelta2",11,0.25,1.00,131,1.92,46555.72,15,4,6,17,2,103.60,9,199,0,4,103.60,0.00,0.75,0.48,1,0.00,1,5769.26,10,0,2,org.apache.solr.handler.dataimport.AbstractDataImportHandlerTestCase,0.04,6,3,11,0,6,11,0,1,1087,1
"org.apache.solr.handler.dataimport.TestSqlEntityProcessorDelta3",9,0.14,1.00,110,1.76,43941.91,18,9,6,15,2,101.70,1,167,0,4,101.70,0.00,0.75,0.23,1,0.00,1,5278.10,10,0,2,org.apache.solr.handler.dataimport.AbstractDataImportHandlerTestCase,0.05,6,3,9,0,6,9,0,1,975,1
"org.apache.solr.handler.dataimport.TestSqlEntityProcessorDeltaPrefixedPk",6,0.24,1.00,59,0.86,18016.54,11,5,7,11,2,158.02,10,88,0,4,108.02,0.00,0.75,0.40,1,0.00,1,2588.55,10,0,2,org.apache.solr.handler.dataimport.AbstractDataImportHandlerTestCase,0.05,5,3,6,0,5,6,0,2,497,1
"org.apache.solr.handler.dataimport.TestTemplateString",1,2.00,1.00,9,0.14,3027.97,3,2,5,11,3,59.89,8,16,0,4,107.99,0.00,0.75,0.00,0,1.00,1,433.98,0,0,3,org.apache.solr.handler.dataimport.AbstractDataImportHandlerTestCase,0.00,10,3,1,0,10,1,0,1,91,1
"org.apache.solr.handler.dataimport.TestTemplateTransformer",1,0.00,1.00,19,0.37,12331.75,1,0,5,10,4,41.09,9,33,0,4,91.08,0.00,0.75,0.00,0,1.00,1,1121.45,2,0,4,org.apache.solr.handler.dataimport.AbstractDataImportHandlerTestCase,0.00,9,3,1,0,9,1,0,2,194,1
"org.apache.solr.handler.dataimport.TestTikaEntityProcessor",3,0.25,1.00,17,0.33,5259.78,5,2,13,19,1,169.38,4,39,0,4,119.38,0.00,0.75,0.67,0,1.00,1,990.19,4,0,1,org.apache.solr.handler.dataimport.AbstractDataImportHandlerTestCase,0.00,16,3,3,0,16,3,0,1,194,1
"org.apache.solr.handler.dataimport.TestURLDataSource",1,1.00,1.00,12,0.21,5500.95,6,5,6,11,4,101.29,0,16,0,4,101.29,0.00,0.75,0.80,0,0.00,1,642.92,0,0,4,org.apache.solr.handler.dataimport.AbstractDataImportHandlerTestCase,0.00,10,3,1,0,10,1,0,0,129,1
"org.apache.solr.handler.dataimport.TestVariableResolver",10,0.00,1.00,81,1.31,34802.10,10,0,4,34,7,159.42,11,109,1,4,109.42,0.00,0.75,0.00,1,10.00,1,3944.87,0,0,6,org.apache.solr.handler.dataimport.AbstractDataImportHandlerTestCase,0.00,24,3,10,0,24,10,0,4,761,1
"org.apache.solr.handler.dataimport.TestVariableResolver$DateMathParser",1,0.00,1.00,3,0.03,341.91,1,0,4,2,0,133.25,0,6,0,1,133.25,0.00,0.00,0.00,0,1.00,1,79.19,0,1,0,java.lang.Object,0.00,1,0,1,0,1,0,0,0,25,0
"org.apache.solr.handler.dataimport.TestVariableResolver$E",1,0.00,1.00,3,0.03,263.23,1,0,4,1,2,134.14,0,6,0,2,134.14,0.00,0.50,0.00,0,1.00,1,75.16,0,1,2,org.apache.solr.handler.dataimport.Evaluator,0.00,0,1,1,0,0,0,0,0,22,2
"org.apache.solr.handler.dataimport.TestXPathEntityProcessor",9,0.07,2.78,124,2.55,112490.71,16,7,9,41,6,146.95,9,214,0,4,96.95,0.00,0.75,0.21,1,41.00,9,7657.90,3,1,6,org.apache.solr.handler.dataimport.AbstractDataImportHandlerTestCase,0.00,32,3,25,0,32,8,0,2,1244,1
"org.apache.solr.handler.dataimport.TestXPathEntityProcessor$DataSource<Reader>",3,0.00,1.00,5,0.05,447.58,3,0,9,4,1,153.88,0,11,0,1,153.88,0.00,0.00,0.00,0,3.00,1,144.54,0,1,1,java.lang.Object,0.00,1,0,3,0,1,2,0,0,43,0
"org.apache.solr.handler.dataimport.TestXPathEntityProcessor$XPathEntityProcessor",1,1.00,3.00,9,0.11,4466.61,2,1,9,3,0,106.41,0,16,0,1,106.41,0.00,0.00,0.00,0,0.00,3,334.76,1,1,0,java.lang.Object,0.00,2,0,3,0,2,0,0,0,69,0
"org.apache.solr.handler.dataimport.TestXPathRecordReader",22,0.00,1.14,270,6.44,229792.20,22,0,5,43,2,99.07,13,523,0,4,99.07,0.00,0.75,0.00,0,22.00,3,19334.04,0,0,2,org.apache.solr.handler.dataimport.AbstractDataImportHandlerTestCase,0.00,21,3,25,0,21,22,0,8,3378,1
"org.apache.solr.handler.dataimport.TestXPathRecordReader$XPathRecordReader.Handler",1,0.00,4.00,5,0.08,1688.16,1,0,5,4,0,119.19,0,6,0,1,119.19,0.00,0.00,0.00,0,1.00,4,226.42,0,0,0,java.lang.Object,0.00,3,0,4,0,3,1,0,0,52,0
"org.apache.solr.handler.dataimport.TikaEntityProcessor",5,0.21,4.60,76,1.25,60333.90,11,6,31,40,4,144.64,7,101,0,3,94.64,0.00,0.67,0.33,0,7.00,13,3743.85,0,4,4,org.apache.solr.handler.dataimport.EntityProcessorBase,0.27,35,2,23,0,35,1,0,1,645,1
"org.apache.solr.handler.dataimport.TikaEntityProcessor$ContentHandlerDecorator",4,0.00,2.00,13,0.18,4180.28,4,0,31,6,0,129.27,2,26,0,1,129.27,0.00,0.00,0.00,0,4.00,3,533.69,2,0,0,java.lang.Object,0.00,2,0,8,0,2,4,0,2,124,0
"org.apache.solr.handler.dataimport.Transformer",1,0.00,1.00,2,0.02,200.84,1,0,1,1,23,183.12,29,3,22,1,141.64,0.00,0.00,0.00,0,1.00,1,63.42,0,1,1,java.lang.Object,0.00,0,0,1,18,0,0,0,2,19,2
"org.apache.solr.handler.dataimport.URLDataSource",6,0.18,3.00,62,0.91,32459.87,22,16,10,29,6,154.05,10,88,3,2,104.05,1.00,0.33,0.21,1,10.00,7,2740.68,0,3,3,org.apache.solr.handler.dataimport.DataSource,0.22,23,1,18,1,23,3,0,1,497,1
"org.apache.solr.handler.dataimport.VariableResolver",2,0.00,1.00,3,0.02,131.11,2,0,0,2,10,136.55,29,4,10,1,156.69,0.00,0.00,0.00,0,2.00,1,58.07,0,2,0,java.lang.Object,0.00,0,0,2,1,0,0,0,3,21,2
"org.apache.solr.handler.dataimport.VariableResolverImpl",8,0.03,3.25,75,1.01,74677.36,13,5,4,27,26,153.87,14,96,24,2,103.87,0.00,0.50,0.22,2,28.00,9,3043.27,0,5,2,org.apache.solr.handler.dataimport.VariableResolver,0.00,19,1,26,0,19,3,0,2,590,1
"org.apache.solr.handler.dataimport.XPathEntityProcessor",12,0.10,6.42,238,4.09,271093.51,37,25,23,88,13,138.59,21,324,1,3,88.59,0.00,0.67,0.13,6,20.00,19,12259.46,1,5,12,org.apache.solr.handler.dataimport.EntityProcessorBase,0.10,76,2,77,0,76,7,0,10,2044,1
"org.apache.solr.handler.dataimport.XPathEntityProcessor$Iterator<Map<String,Object>>",3,0.25,3.33,31,0.38,20183.46,5,2,23,10,1,103.28,1,40,0,1,103.28,0.00,0.00,0.33,0,4.00,8,1142.88,0,1,1,java.lang.Object,0.00,7,0,10,0,7,2,0,1,212,0
"org.apache.solr.handler.dataimport.XPathEntityProcessor$SimpleCharArrayReader",1,0.00,1.00,3,0.03,308.03,1,0,23,2,0,133.61,0,5,0,2,133.61,0.00,0.50,0.00,0,1.00,1,84.38,0,1,0,java.io.CharArrayWriter,0.00,1,1,1,0,1,0,0,0,24,2
"org.apache.solr.handler.dataimport.XPathEntityProcessor$Thread",2,0.00,4.00,16,0.17,3949.16,2,0,23,8,0,111.04,0,28,0,1,111.04,0.00,0.00,0.00,1,2.00,4,522.90,0,0,0,java.lang.Object,0.00,6,0,8,0,6,2,0,0,109,0
"org.apache.solr.handler.dataimport.XPathEntityProcessor$Thread$XPathRecordReader.Handler_0",1,0.00,3.00,11,0.12,3952.32,1,0,23,6,0,143.46,2,16,0,1,103.58,0.00,0.00,0.00,0,1.00,3,374.96,0,0,0,java.lang.Object,0.00,5,0,3,0,5,1,0,2,75,0
"org.apache.solr.handler.dataimport.XPathEntityProcessor$XPathRecordReader.Handler",1,0.00,1.00,3,0.04,592.87,1,0,23,3,0,131.37,0,5,0,1,131.37,0.00,0.00,0.00,0,1.00,1,127.88,0,0,0,java.lang.Object,0.00,2,0,1,0,2,1,0,0,32,0
"org.apache.solr.handler.dataimport.XPathRecordReader",7,0.11,2.57,59,0.89,34257.66,13,6,12,37,4,117.17,125,77,3,1,108.04,0.00,0.00,0.07,3,13.00,6,2668.41,0,4,1,java.lang.Object,0.00,30,0,18,0,30,3,0,17,537,1
"org.apache.solr.handler.dataimport.XPathRecordReader$Handler",1,0.00,1.00,3,0.03,337.11,1,0,12,2,0,133.30,0,4,0,1,133.30,0.00,0.00,0.00,0,1.00,1,84.00,0,0,0,java.lang.Object,0.00,1,0,1,0,1,1,0,0,23,0
"org.apache.solr.handler.dataimport.XPathRecordReader$Handler_0",1,0.00,1.00,2,0.02,156.38,1,0,12,1,0,94.39,8,3,0,1,142.49,0.00,0.00,0.00,0,1.00,1,58.21,0,0,0,,0.00,0,0,1,0,0,1,0,1,18,2
"org.apache.solr.handler.dataimport.XPathRecordReader$Node",12,0.06,6.33,195,2.95,199095.62,26,14,12,60,0,48.30,139,271,0,1,92.43,0.00,0.00,0.12,5,54.00,21,8849.62,0,3,0,java.lang.Object,0.00,48,0,76,0,48,9,0,92,1576,2
"org.apache.solr.handler.dataimport.ZKPropertiesWriter",4,0.44,2.75,38,0.57,18711.43,7,3,7,28,4,106.27,0,62,1,1,106.27,0.00,0.00,0.67,1,0.00,5,1707.81,0,1,4,java.lang.Object,0.00,24,0,11,0,24,3,1,0,330,1
"org.apache.lucene.codecs.pulsing.Nightly",2,0.00,6.50,90,1.47,70432.22,2,0,22,37,15,40.88,13,81,0,2,73.10,0.00,0.50,0.00,0,2.00,7,4399.47,0,0,15,org.apache.lucene.util.LuceneTestCase,0.00,35,1,13,0,35,2,0,7,664,1
"org.apache.lucene.codecs.pulsing.Pulsing40PostingsFormat",3,0.00,1.00,7,0.06,560.97,3,0,2,4,7,181.77,6,11,4,3,141.88,0.00,0.67,0.00,0,3.00,1,169.34,0,0,3,org.apache.lucene.codecs.pulsing.PulsingPostingsFormat,0.00,1,2,3,0,1,3,0,4,50,1
"org.apache.lucene.codecs.pulsing.PulsingPostingsFormat",7,0.12,1.29,41,0.50,13215.42,11,4,13,17,14,169.07,10,64,1,2,119.07,1.00,0.33,0.36,0,8.00,2,1486.92,1,3,13,org.apache.lucene.codecs.PostingsFormat,0.13,10,1,9,1,10,4,0,5,319,2
"org.apache.lucene.codecs.pulsing.PulsingPostingsReader",10,0.06,2.90,105,1.50,88441.08,12,2,19,37,20,102.61,48,142,4,2,102.37,0.00,0.50,0.45,2,0.00,8,4507.29,0,5,16,org.apache.lucene.codecs.PostingsReaderBase,0.24,27,1,29,0,27,5,0,31,856,1
"org.apache.lucene.codecs.pulsing.PulsingPostingsReader$PulsingDocsAndPositionsEnum",13,0.15,2.23,96,0.96,39408.54,25,12,19,25,6,161.87,16,135,0,4,111.87,0.00,0.75,0.22,2,26.00,5,2871.52,0,2,6,org.apache.lucene.index.DocsAndPositionsEnum,1.57,12,3,29,0,12,11,0,16,595,2
"org.apache.lucene.codecs.pulsing.PulsingPostingsReader$PulsingDocsEnum",7,0.26,3.14,70,0.75,44025.27,16,9,19,15,5,153.52,12,90,0,3,103.52,0.00,0.67,0.33,0,0.00,12,2254.87,0,1,5,org.apache.lucene.index.DocsEnum,1.00,8,2,22,0,8,6,0,12,448,2
"org.apache.lucene.codecs.pulsing.PulsingPostingsReader$PulsingEnumAttribute",1,0.00,1.00,2,0.02,120.45,1,0,19,1,0,143.38,0,3,0,2,143.38,0.00,0.50,0.00,0,1.00,1,48.18,0,1,0,,0.00,0,1,1,0,0,0,0,0,16,2
"org.apache.lucene.codecs.pulsing.PulsingPostingsReader$PulsingEnumAttributeImpl",3,1.00,1.00,6,0.07,1410.15,4,1,19,4,3,159.34,11,13,0,2,138.73,0.00,0.50,0.33,0,4.00,1,220.54,0,1,3,org.apache.lucene.util.AttributeImpl,0.25,1,1,3,0,1,2,1,11,58,3
"org.apache.lucene.codecs.pulsing.PulsingPostingsReader$PulsingTermState",3,0.50,2.33,31,0.36,15541.65,8,5,19,7,4,154.25,5,43,0,4,104.25,0.00,0.75,0.53,0,0.00,3,1090.38,3,2,4,org.apache.lucene.codecs.BlockTermState,0.80,4,3,7,0,4,1,0,5,226,2
"org.apache.lucene.codecs.pulsing.PulsingPostingsWriter",11,0.25,5.82,210,3.18,331954.53,24,13,11,42,11,69.75,61,240,4,3,87.62,0.00,0.67,0.31,1,0.00,18,9528.40,0,0,7,org.apache.lucene.codecs.PostingsWriterBase,0.71,31,2,64,0,31,11,0,51,1646,2
"org.apache.lucene.codecs.pulsing.PulsingPostingsWriter$PendingTerm",1,1.00,1.00,4,0.03,375.63,2,1,11,1,0,128.27,0,6,0,1,128.27,0.00,0.00,0.00,0,1.00,1,84.84,0,0,0,java.lang.Object,0.00,0,0,1,0,0,1,0,0,25,2
"org.apache.lucene.codecs.pulsing.PulsingPostingsWriter$Position",0,0.00,0.00,5,0.03,328.28,4,4,11,0,1,171.00,1,6,0,1,171.00,0.00,0.00,0.00,0,0.00,0,85.11,0,0,1,java.lang.Object,0.00,0,0,0,0,0,0,0,1,23,3
"org.apache.lucene.codecs.pulsing.TestPulsingReuse",2,0.00,3.00,56,0.96,33839.99,2,0,20,31,18,65.59,11,65,0,2,83.47,0.00,0.50,0.00,0,2.00,3,2892.60,0,0,18,org.apache.lucene.util.LuceneTestCase,0.00,29,1,6,0,29,2,0,9,473,1
"org.apache.lucene.benchmark.quality.utils.DocNameExtractor",2,1.00,1.50,11,0.12,3268.89,3,1,8,8,6,77.24,14,15,2,1,119.53,0.00,0.00,0.00,0,2.00,2,349.15,0,1,4,java.lang.Object,0.00,6,0,3,0,6,1,0,3,78,1
"org.apache.lucene.benchmark.quality.utils.DocNameExtractor$StoredFieldVisitor",2,0.00,2.00,10,0.10,2124.44,2,0,8,5,1,120.94,0,15,0,1,120.94,0.00,0.00,0.00,0,2.00,3,309.83,0,1,1,java.lang.Object,0.00,3,0,4,0,3,1,0,0,72,0
"org.apache.lucene.benchmark.quality.utils.QualityQueriesFinder",5,0.25,3.00,52,0.91,46045.21,7,2,9,26,8,142.11,14,69,1,1,102.23,0.00,0.00,0.30,1,10.00,5,2738.87,0,3,7,java.lang.Object,0.00,21,0,15,0,21,2,0,5,510,1
"org.apache.lucene.benchmark.quality.utils.QualityQueriesFinder$TermDf",1,2.00,1.00,6,0.04,383.86,3,2,9,1,0,121.62,0,8,0,1,121.62,0.00,0.00,0.00,0,1.00,1,114.62,0,0,0,java.lang.Object,0.00,0,0,1,0,0,1,0,0,33,2
"org.apache.lucene.benchmark.quality.utils.QualityQueriesFinder$TermsDfQueue",2,0.00,1.00,5,0.05,737.86,2,0,9,2,1,139.56,0,9,0,2,139.56,0.00,0.50,0.00,0,2.00,1,143.85,0,0,1,org.apache.lucene.util.PriorityQueue,0.00,0,1,2,0,0,2,0,0,41,2
"org.apache.lucene.benchmark.quality.utils.SimpleQQParser",3,0.17,1.67,22,0.26,8172.70,6,3,10,9,11,94.43,17,23,2,1,112.31,0.00,0.00,0.22,0,4.00,3,786.72,0,1,9,java.lang.Object,0.00,6,0,5,0,6,2,1,4,164,1
"org.apache.lucene.benchmark.quality.utils.SubmissionReport",4,0.17,2.00,30,0.40,12716.18,8,4,7,16,8,111.97,19,42,3,1,111.74,0.00,0.00,0.38,0,4.00,3,1208.66,0,1,5,java.lang.Object,0.00,12,0,8,0,12,3,0,3,245,1
"org.apache.zookeeper.SolrZooKeeper",3,0.00,1.00,7,0.05,444.00,3,0,2,5,5,182.57,6,12,5,2,142.68,0.00,0.50,0.00,0,3.00,1,149.56,0,0,0,ZooKeeper,0.00,2,1,3,0,2,3,0,2,44,1
"org.apache.zookeeper.SolrZooKeeper$Thread",1,0.00,3.00,7,0.07,975.82,1,0,2,5,0,115.68,0,13,0,1,115.68,0.00,0.00,0.00,0,1.00,3,220.61,0,0,0,java.lang.Object,0.00,4,0,3,0,4,1,0,0,51,0
"org.apache.solr.analysis.ASCIIFoldingFilterFactory",2,0.00,1.00,5,0.03,391.36,2,0,2,3,5,123.85,11,9,1,3,141.73,0.00,0.67,0.00,0,2.00,1,103.73,0,2,4,org.apache.solr.analysis.BaseTokenFilterFactory,0.00,1,2,2,0,1,0,1,1,32,1
"org.apache.solr.analysis.ArabicNormalizationFilterFactory",2,0.00,1.00,5,0.03,391.36,2,0,2,3,5,123.85,11,9,1,3,141.73,0.00,0.67,0.00,0,2.00,1,103.73,0,2,4,org.apache.solr.analysis.BaseTokenFilterFactory,0.00,1,2,2,0,1,0,1,1,32,1
"org.apache.solr.analysis.ArabicStemFilterFactory",1,0.00,1.00,3,0.02,225.35,1,0,2,2,4,97.11,12,5,1,3,134.67,0.00,0.67,0.00,0,1.00,1,58.69,0,1,3,org.apache.solr.analysis.BaseTokenFilterFactory,0.00,1,2,1,0,1,0,0,1,19,1
"org.apache.solr.analysis.BaseCharFilterFactory",5,0.38,1.40,17,0.20,4335.49,7,2,3,9,5,179.99,6,24,4,1,129.99,0.00,0.00,0.20,1,7.00,3,591.15,0,1,1,java.lang.Object,0.00,4,0,7,4,4,4,1,2,140,2
"org.apache.solr.analysis.BaseTokenFilterFactory",0,0.00,0.00,2,0.03,699.09,1,1,2,1,89,171.00,5,3,87,2,171.00,88.00,0.01,0.00,0,0.00,0,101.95,0,0,2,org.apache.solr.analysis.BaseTokenStreamFactory,0.00,1,1,0,88,1,0,1,1,24,2
"org.apache.solr.analysis.BaseTokenStreamFactory",11,0.07,2.00,64,0.90,28412.04,14,3,19,36,10,167.90,20,94,2,1,117.90,0.00,0.00,0.27,3,43.00,3,2691.06,0,3,8,java.lang.Object,0.00,25,0,22,109,25,8,0,11,542,1
"org.apache.solr.analysis.BaseTokenTestCase",0,0.00,0.00,3,0.08,1917.57,2,2,5,4,84,171.00,5,6,82,3,171.00,41.00,0.02,0.00,0,0.00,0,232.85,0,0,2,org.apache.lucene.analysis.BaseTokenStreamTestCase,0.00,4,2,0,82,4,0,0,3,47,2
"org.apache.solr.analysis.BaseTokenizerFactory",0,0.00,0.00,2,0.03,699.09,1,1,2,1,20,171.00,5,3,18,2,171.00,19.00,0.05,0.00,0,0.00,0,101.95,0,0,2,org.apache.solr.analysis.BaseTokenStreamFactory,0.00,1,1,0,19,1,0,1,1,24,2
"org.apache.solr.analysis.BeiderMorseFilterFactory",2,1.00,2.50,18,0.30,11201.46,4,2,9,12,4,57.57,17,23,1,3,105.68,0.00,0.67,1.00,0,0.00,4,910.62,2,1,3,org.apache.solr.analysis.BaseTokenFilterFactory,0.00,10,2,5,0,10,1,0,4,171,1
"org.apache.solr.analysis.BrazilianStemFilterFactory",1,0.00,1.00,3,0.02,225.35,1,0,2,2,4,97.11,12,5,1,3,134.67,0.00,0.67,0.00,0,1.00,1,58.69,0,1,3,org.apache.solr.analysis.BaseTokenFilterFactory,0.00,1,2,1,0,1,0,0,1,19,1
"org.apache.solr.analysis.BulgarianStemFilterFactory",1,0.00,1.00,3,0.02,225.35,1,0,2,2,4,97.11,12,5,1,3,134.67,0.00,0.67,0.00,0,1.00,1,58.69,0,1,3,org.apache.solr.analysis.BaseTokenFilterFactory,0.00,1,2,1,0,1,0,0,1,19,1
"org.apache.solr.analysis.CJKBigramFilterFactory",2,0.00,3.00,15,0.16,4248.52,3,1,3,3,4,70.73,14,24,1,3,113.02,0.00,0.67,1.00,0,0.00,5,474.30,2,1,3,org.apache.solr.analysis.BaseTokenFilterFactory,0.00,1,2,6,0,1,1,0,1,104,1
"org.apache.solr.analysis.CJKWidthFilterFactory",2,0.00,1.00,5,0.04,518.24,2,0,2,3,5,108.54,12,10,1,3,140.77,0.00,0.67,0.00,0,2.00,1,117.90,0,2,4,org.apache.solr.analysis.BaseTokenFilterFactory,0.00,1,2,2,0,1,0,1,1,35,1
"org.apache.solr.analysis.CapitalizationFilterFactory",2,1.33,6.00,53,0.81,35256.57,17,15,8,16,5,83.90,33,68,1,3,84.37,0.00,0.67,0.73,0,0.00,11,2427.08,2,1,4,org.apache.solr.analysis.BaseTokenFilterFactory,0.00,14,2,12,0,14,1,0,5,420,1
"org.apache.solr.analysis.CharFilterFactory",3,0.00,1.00,4,0.03,247.81,3,0,2,3,9,205.90,5,5,8,1,155.90,0.00,0.00,0.00,0,3.00,1,89.64,0,2,1,,0.00,0,0,3,0,0,1,0,1,31,1
"org.apache.solr.analysis.ClassicFilterFactory",1,0.00,1.00,3,0.02,192.92,1,0,3,2,5,97.64,12,5,1,3,135.21,0.00,0.67,0.00,0,1.00,1,60.48,0,1,4,org.apache.solr.analysis.BaseTokenFilterFactory,0.00,1,2,1,0,1,0,0,1,19,1
"org.apache.solr.analysis.ClassicTokenizerFactory",2,0.00,1.00,10,0.09,1539.78,3,1,5,4,5,104.32,11,15,1,3,122.20,0.00,0.67,1.00,0,0.00,1,281.43,2,1,4,org.apache.solr.analysis.BaseTokenizerFactory,0.00,2,2,2,0,2,1,0,1,68,1
"org.apache.solr.analysis.CommonGramsFilterFactory",4,0.17,1.75,22,0.21,4896.00,6,2,7,8,8,141.10,15,32,1,3,120.48,0.00,0.67,0.62,0,0.00,4,626.08,0,2,7,org.apache.solr.analysis.BaseTokenFilterFactory,0.00,4,2,7,0,4,2,1,3,136,1
"org.apache.solr.analysis.CommonGramsFilterFactoryTest",2,0.00,1.00,50,0.84,43151.97,2,0,9,17,8,84.96,8,58,0,4,84.72,0.00,0.75,0.00,0,0.00,1,2531.84,1,0,8,org.apache.solr.analysis.BaseTokenTestCase,0.00,15,3,2,0,15,2,0,2,433,1
"org.apache.solr.analysis.CommonGramsQueryFilterFactory",5,0.00,1.60,26,0.25,5682.53,7,2,9,10,9,141.37,19,39,1,3,120.76,0.00,0.67,0.50,0,1.00,4,753.94,2,2,8,org.apache.solr.analysis.BaseTokenFilterFactory,0.00,5,2,8,0,5,3,1,4,167,1
"org.apache.solr.analysis.CommonGramsQueryFilterFactoryTest",2,0.00,1.00,50,0.84,42945.14,2,0,9,17,8,84.98,8,58,0,4,84.74,0.00,0.75,0.00,0,0.00,1,2508.18,1,0,8,org.apache.solr.analysis.BaseTokenTestCase,0.00,15,3,2,0,15,2,0,2,430,1
"org.apache.solr.analysis.CzechStemFilterFactory",1,0.00,1.00,3,0.02,225.35,1,0,2,2,4,90.55,11,5,1,3,134.67,0.00,0.67,0.00,0,1.00,1,58.69,0,1,3,org.apache.solr.analysis.BaseTokenFilterFactory,0.00,1,2,1,0,1,0,0,1,19,1
"org.apache.solr.analysis.DelimitedPayloadTokenFilterFactory",3,0.38,2.67,25,0.31,7530.01,7,4,10,13,11,110.55,13,33,1,3,110.32,0.00,0.67,0.50,0,1.00,6,938.68,1,1,10,org.apache.solr.analysis.BaseTokenFilterFactory,0.00,10,2,8,0,10,2,1,1,190,1
"org.apache.solr.analysis.Deprecated",13,0.00,1.38,203,3.58,190034.61,13,0,12,27,5,134.14,34,257,0,3,94.26,0.00,0.67,0.00,2,13.00,6,10748.38,1,2,5,org.apache.lucene.analysis.BaseTokenStreamTestCase,0.00,14,2,18,0,14,11,0,23,1972,1
"org.apache.solr.analysis.Deprecated$Analyzer",1,0.00,3.00,5,0.09,2593.40,1,0,24,5,4,117.79,0,7,0,1,117.79,0.00,0.00,0.00,0,1.00,3,280.48,0,1,4,java.lang.Object,0.00,4,0,3,0,4,0,0,0,59,0
"org.apache.solr.analysis.Deprecated$Deprecated",3,0.31,1.33,25,0.36,9551.86,11,8,12,19,8,109.66,0,33,0,3,109.66,0.00,0.67,0.33,0,4.00,2,1079.23,0,0,8,org.apache.lucene.analysis.TokenStream,0.27,16,2,4,0,16,3,0,0,215,2
"org.apache.solr.analysis.Deprecated$ResourceLoader",3,0.00,1.33,11,0.14,3693.25,3,0,9,7,0,128.80,0,18,0,1,128.80,0.00,0.00,0.00,0,3.00,2,408.62,0,3,0,java.lang.Object,0.00,4,0,4,0,4,0,0,0,93,0
"org.apache.solr.analysis.DictionaryCompoundWordTokenFilterFactory",3,0.75,1.67,23,0.27,5659.66,9,6,8,7,9,113.80,12,32,1,3,113.56,0.00,0.67,0.67,0,0.00,2,821.69,3,0,8,org.apache.solr.analysis.BaseTokenFilterFactory,0.00,4,2,5,0,4,3,1,1,169,1
"org.apache.solr.analysis.DoubleMetaphoneFilterFactory",2,0.80,1.50,13,0.17,3282.11,7,5,3,5,4,98.69,11,19,1,3,116.56,0.00,0.67,0.60,0,0.00,2,501.94,1,1,3,org.apache.solr.analysis.BaseTokenFilterFactory,0.00,3,2,3,0,3,1,0,1,111,1
"org.apache.solr.analysis.DoubleMetaphoneFilterFactoryTest",3,0.00,1.00,31,0.49,13385.48,3,0,7,19,6,154.96,4,35,0,4,104.96,0.00,0.75,0.00,0,3.00,1,1459.22,1,0,6,org.apache.solr.analysis.BaseTokenTestCase,0.00,16,3,3,0,16,3,0,2,279,1
"org.apache.solr.analysis.EdgeNGramFilterFactory",2,1.33,2.50,15,0.22,7546.16,5,3,3,6,4,93.23,11,22,1,3,111.10,0.00,0.67,1.00,0,0.00,4,669.56,1,1,3,org.apache.solr.analysis.BaseTokenFilterFactory,0.00,4,2,5,0,4,1,0,1,138,1
"org.apache.solr.analysis.EdgeNGramTokenizerFactory",2,1.33,2.50,15,0.22,7546.16,5,3,3,6,3,93.23,10,20,1,3,111.10,0.00,0.67,1.00,0,0.00,4,669.56,1,1,2,org.apache.solr.analysis.BaseTokenizerFactory,0.00,4,2,5,0,4,1,0,1,138,1
"org.apache.solr.analysis.ElisionFilterFactory",2,0.00,2.50,12,0.14,2976.90,3,1,6,5,7,84.56,13,19,1,3,116.78,0.00,0.67,1.00,0,0.00,3,416.05,2,0,6,org.apache.solr.analysis.BaseTokenFilterFactory,0.00,3,2,5,0,3,2,1,1,92,1
"org.apache.solr.analysis.EnglishMinimalStemFilterFactory",1,0.00,1.00,3,0.02,225.35,1,0,2,2,4,97.11,12,5,1,3,134.67,0.00,0.67,0.00,0,1.00,1,58.69,0,1,3,org.apache.solr.analysis.BaseTokenFilterFactory,0.00,1,2,1,0,1,0,0,1,19,1
"org.apache.solr.analysis.EnglishPossessiveFilterFactory",2,0.00,1.00,6,0.05,786.43,2,0,3,3,3,100.55,12,10,0,3,132.77,0.00,0.67,0.00,0,2.00,1,155.94,2,1,3,org.apache.solr.analysis.BaseTokenFilterFactory,0.00,1,2,2,0,1,1,0,1,43,1
"org.apache.solr.analysis.FinnishLightStemFilterFactory",1,0.00,1.00,3,0.02,225.35,1,0,2,2,4,97.11,12,5,1,3,134.67,0.00,0.67,0.00,0,1.00,1,58.69,0,1,3,org.apache.solr.analysis.BaseTokenFilterFactory,0.00,1,2,1,0,1,0,0,1,19,1
"org.apache.solr.analysis.FrenchLightStemFilterFactory",1,0.00,1.00,3,0.02,225.35,1,0,2,2,4,105.29,13,5,1,3,134.67,0.00,0.67,0.00,0,1.00,1,58.69,0,1,3,org.apache.solr.analysis.BaseTokenFilterFactory,0.00,1,2,1,0,1,0,0,1,19,1
"org.apache.solr.analysis.FrenchMinimalStemFilterFactory",1,0.00,1.00,3,0.02,225.35,1,0,2,2,4,105.29,13,5,1,3,134.67,0.00,0.67,0.00,0,1.00,1,58.69,0,1,3,org.apache.solr.analysis.BaseTokenFilterFactory,0.00,1,2,1,0,1,0,0,1,19,1
"org.apache.solr.analysis.GalicianMinimalStemFilterFactory",1,0.00,1.00,3,0.02,225.35,1,0,2,2,4,97.11,12,5,1,3,134.67,0.00,0.67,0.00,0,1.00,1,58.69,0,1,3,org.apache.solr.analysis.BaseTokenFilterFactory,0.00,1,2,1,0,1,0,0,1,19,1
"org.apache.solr.analysis.GalicianStemFilterFactory",1,0.00,1.00,3,0.02,225.35,1,0,2,2,4,97.11,12,5,1,3,134.67,0.00,0.67,0.00,0,1.00,1,58.69,0,1,3,org.apache.solr.analysis.BaseTokenFilterFactory,0.00,1,2,1,0,1,0,0,1,19,1
"org.apache.solr.analysis.GermanLightStemFilterFactory",1,0.00,1.00,3,0.02,225.35,1,0,2,2,4,97.11,12,5,1,3,134.67,0.00,0.67,0.00,0,1.00,1,58.69,0,1,3,org.apache.solr.analysis.BaseTokenFilterFactory,0.00,1,2,1,0,1,0,0,1,19,1
"org.apache.solr.analysis.GermanMinimalStemFilterFactory",1,0.00,1.00,3,0.02,225.35,1,0,2,2,4,97.11,12,5,1,3,134.67,0.00,0.67,0.00,0,1.00,1,58.69,0,1,3,org.apache.solr.analysis.BaseTokenFilterFactory,0.00,1,2,1,0,1,0,0,1,19,1
"org.apache.solr.analysis.GermanNormalizationFilterFactory",2,0.00,1.00,5,0.03,391.36,2,0,2,3,5,123.85,11,9,1,3,141.73,0.00,0.67,0.00,0,2.00,1,103.73,0,2,4,org.apache.solr.analysis.BaseTokenFilterFactory,0.00,1,2,2,0,1,0,1,1,32,1
"org.apache.solr.analysis.GermanStemFilterFactory",1,0.00,1.00,3,0.02,225.35,1,0,2,2,4,97.11,12,5,1,3,134.67,0.00,0.67,0.00,0,1.00,1,58.69,0,1,3,org.apache.solr.analysis.BaseTokenFilterFactory,0.00,1,2,1,0,1,0,0,1,19,1
"org.apache.solr.analysis.GreekLowerCaseFilterFactory",3,0.00,1.33,9,0.10,1883.02,3,0,5,6,6,151.72,11,18,1,3,131.10,0.00,0.67,0.00,0,4.00,2,291.38,2,2,5,org.apache.solr.analysis.BaseTokenFilterFactory,0.00,3,2,4,0,3,1,1,1,71,1
"org.apache.solr.analysis.GreekStemFilterFactory",1,0.00,1.00,3,0.02,225.35,1,0,2,2,4,97.11,12,5,1,3,134.67,0.00,0.67,0.00,0,1.00,1,58.69,0,1,3,org.apache.solr.analysis.BaseTokenFilterFactory,0.00,1,2,1,0,1,0,0,1,19,1
"org.apache.solr.analysis.HTMLStripCharFilterFactory",2,0.50,3.00,19,0.22,7036.16,4,2,7,9,3,89.35,11,27,1,2,107.23,0.00,0.50,0.75,0,0.00,4,646.17,1,1,2,org.apache.solr.analysis.BaseCharFilterFactory,0.00,7,1,6,0,7,1,0,1,138,1
"org.apache.solr.analysis.HindiNormalizationFilterFactory",2,0.00,1.00,5,0.03,391.36,2,0,2,3,5,123.85,11,9,1,3,141.73,0.00,0.67,0.00,0,2.00,1,103.73,0,2,4,org.apache.solr.analysis.BaseTokenFilterFactory,0.00,1,2,2,0,1,0,1,1,32,1
"org.apache.solr.analysis.HindiStemFilterFactory",1,0.00,1.00,3,0.02,225.35,1,0,2,2,4,90.55,11,5,1,3,134.67,0.00,0.67,0.00,0,1.00,1,58.69,0,1,3,org.apache.solr.analysis.BaseTokenFilterFactory,0.00,1,2,1,0,1,0,0,1,19,1
"org.apache.solr.analysis.HungarianLightStemFilterFactory",1,0.00,1.00,3,0.02,225.35,1,0,2,2,4,97.11,12,5,1,3,134.67,0.00,0.67,0.00,0,1.00,1,58.69,0,1,3,org.apache.solr.analysis.BaseTokenFilterFactory,0.00,1,2,1,0,1,0,0,1,19,1
"org.apache.solr.analysis.HunspellStemFilterFactory",2,0.71,3.50,24,0.45,16867.15,9,7,10,12,8,79.40,28,32,1,3,99.54,0.00,0.67,0.50,0,2.00,6,1337.35,1,1,7,org.apache.solr.analysis.BaseTokenFilterFactory,0.00,10,2,7,0,10,1,1,3,240,1
"org.apache.solr.analysis.HyphenatedWordsFilterFactory",1,0.00,1.00,3,0.02,225.35,1,0,3,2,3,90.55,11,5,0,3,134.67,0.00,0.67,0.00,0,1.00,1,58.69,0,1,3,org.apache.solr.analysis.BaseTokenFilterFactory,0.00,1,2,1,0,1,0,0,1,19,1
"org.apache.solr.analysis.HyphenationCompoundWordTokenFilterFactory",3,0.83,2.33,35,0.45,11620.14,12,9,13,14,10,55.23,32,47,1,3,103.70,0.00,0.67,0.67,0,0.00,3,1356.02,2,1,9,org.apache.solr.analysis.BaseTokenFilterFactory,0.00,11,2,7,0,11,2,1,6,261,1
"org.apache.solr.analysis.ICUFoldingFilterFactory",2,0.00,1.00,5,0.04,441.21,2,0,2,3,5,93.21,17,9,1,3,141.32,0.00,0.67,0.00,0,2.00,1,105.36,0,2,4,org.apache.solr.analysis.BaseTokenFilterFactory,0.00,1,2,2,0,1,0,1,2,32,1
"org.apache.solr.analysis.ICUNormalizer2FilterFactory",3,0.50,3.00,19,0.33,16912.02,4,1,8,12,6,94.31,17,33,1,3,112.18,0.00,0.67,0.67,0,1.00,7,998.26,1,2,5,org.apache.solr.analysis.BaseTokenFilterFactory,0.00,9,2,9,0,9,1,1,2,190,1
"org.apache.solr.analysis.ICUTokenizerFactory",1,0.00,1.00,3,0.02,307.32,1,0,3,2,4,173.50,2,6,1,3,133.61,0.00,0.67,0.00,0,1.00,1,74.72,0,1,3,org.apache.solr.analysis.BaseTokenizerFactory,0.00,1,2,1,0,1,0,0,2,22,1
"org.apache.solr.analysis.ICUTransformFilterFactory",3,0.50,2.00,15,0.24,9432.07,4,1,7,8,6,137.84,11,27,1,3,117.23,0.00,0.67,0.67,0,1.00,4,721.20,1,2,5,org.apache.solr.analysis.BaseTokenFilterFactory,0.00,5,2,6,0,5,1,1,2,146,1
"org.apache.solr.analysis.IndicNormalizationFilterFactory",2,0.00,1.00,5,0.03,391.36,2,0,2,3,5,123.85,11,9,1,3,141.73,0.00,0.67,0.00,0,2.00,1,103.73,0,2,4,org.apache.solr.analysis.BaseTokenFilterFactory,0.00,1,2,2,0,1,0,1,1,32,1
"org.apache.solr.analysis.IndonesianStemFilterFactory",2,0.00,1.00,7,0.07,1082.60,3,1,3,3,4,99.46,12,11,1,3,131.68,0.00,0.67,1.00,0,0.00,1,211.73,1,1,3,org.apache.solr.analysis.BaseTokenFilterFactory,0.00,1,2,2,0,1,1,0,1,54,1
"org.apache.solr.analysis.IrishLowerCaseFilterFactory",2,0.00,1.00,5,0.04,518.24,2,0,2,3,5,108.54,12,10,1,3,140.77,0.00,0.67,0.00,0,2.00,1,117.90,0,2,4,org.apache.solr.analysis.BaseTokenFilterFactory,0.00,1,2,2,0,1,0,1,2,35,1
"org.apache.solr.analysis.ItalianLightStemFilterFactory",1,0.00,1.00,3,0.02,225.35,1,0,2,2,4,97.11,12,5,1,3,134.67,0.00,0.67,0.00,0,1.00,1,58.69,0,1,3,org.apache.solr.analysis.BaseTokenFilterFactory,0.00,1,2,1,0,1,0,0,1,19,1
"org.apache.solr.analysis.JapaneseBaseFormFilterFactory",1,0.00,1.00,3,0.02,352.23,1,0,2,2,4,89.02,11,6,1,3,133.15,0.00,0.67,0.00,0,1.00,1,72.87,0,1,3,org.apache.solr.analysis.BaseTokenFilterFactory,0.00,1,2,1,0,1,0,0,1,22,1
"org.apache.solr.analysis.JapaneseKatakanaStemFilterFactory",2,0.50,1.50,10,0.13,3057.36,4,2,4,4,4,87.54,12,16,0,3,119.76,0.00,0.67,0.75,0,0.00,2,398.43,1,1,4,org.apache.solr.analysis.BaseTokenFilterFactory,0.00,2,2,3,0,2,1,0,1,88,1
"org.apache.solr.analysis.JapanesePartOfSpeechStopFilterFactory",2,1.00,2.00,16,0.19,5118.71,4,2,8,8,7,78.09,13,21,1,3,110.32,0.00,0.67,1.00,0,0.00,3,562.86,1,1,6,org.apache.solr.analysis.BaseTokenFilterFactory,0.00,6,2,4,0,6,1,1,1,115,1
"org.apache.solr.analysis.JapaneseReadingFormFilterFactory",2,0.50,1.00,8,0.08,1279.48,4,2,3,3,3,94.22,12,12,0,3,126.45,0.00,0.67,0.75,0,0.00,1,245.12,1,1,3,org.apache.solr.analysis.BaseTokenFilterFactory,0.00,1,2,2,0,1,1,0,1,61,1
"org.apache.solr.analysis.JapaneseTokenizerFactory",3,0.40,2.33,29,0.41,11641.71,8,5,16,15,11,89.08,15,42,3,3,106.95,0.00,0.67,0.47,0,2.00,4,1220.41,0,2,8,org.apache.solr.analysis.BaseTokenizerFactory,0.00,12,2,7,0,12,1,1,1,235,1
"org.apache.solr.analysis.KStemFilterFactory",1,0.00,1.00,3,0.02,192.92,1,0,3,2,5,155.82,3,5,1,3,135.21,0.00,0.67,0.00,0,1.00,1,60.48,0,1,4,org.apache.solr.analysis.BaseTokenFilterFactory,0.00,1,2,1,0,1,0,0,1,19,1
"org.apache.solr.analysis.KeepWordFilterFactory",8,0.10,1.38,29,0.28,5446.84,11,3,8,12,7,180.82,15,43,1,3,130.82,0.00,0.67,0.42,0,2.00,3,827.16,2,2,6,org.apache.solr.analysis.BaseTokenFilterFactory,0.00,4,2,11,0,4,6,1,2,197,1
"org.apache.solr.analysis.KeywordMarkerFilterFactory",3,0.33,2.00,15,0.16,3106.87,6,3,6,6,7,71.02,27,22,1,3,121.02,0.00,0.67,0.56,0,0.00,3,466.54,0,1,6,org.apache.solr.analysis.BaseTokenFilterFactory,0.00,3,2,6,0,3,2,1,2,105,1
"org.apache.solr.analysis.KeywordTokenizerFactory",1,0.00,1.00,3,0.02,225.35,1,0,2,2,5,86.20,10,5,3,3,134.67,0.00,0.67,0.00,0,1.00,1,58.69,0,1,2,org.apache.solr.analysis.BaseTokenizerFactory,0.00,1,2,1,0,1,0,0,1,19,1
"org.apache.solr.analysis.LatvianStemFilterFactory",1,0.00,1.00,3,0.02,225.35,1,0,2,2,4,90.55,11,5,1,3,134.67,0.00,0.67,0.00,0,1.00,1,58.69,0,1,3,org.apache.solr.analysis.BaseTokenFilterFactory,0.00,1,2,1,0,1,0,0,1,19,1
"org.apache.solr.analysis.LegacyHTMLStripCharFilterTest",16,0.00,2.19,190,2.91,112994.49,16,0,15,46,6,151.66,26,227,0,3,101.66,0.00,0.67,0.00,3,16.00,7,8726.01,1,0,6,org.apache.lucene.analysis.BaseTokenStreamTestCase,0.00,30,2,35,0,30,16,0,26,1597,1
"org.apache.solr.analysis.LegacyHTMLStripCharFilterTest$Analyzer",2,0.00,1.00,6,0.08,1437.09,2,0,15,7,3,130.71,0,10,0,1,130.71,0.00,0.00,0.00,0,2.00,1,236.16,0,2,3,java.lang.Object,0.00,5,0,2,0,5,0,0,0,58,0
"org.apache.solr.analysis.LengthFilterFactory",2,1.20,1.00,12,0.15,2502.00,7,5,3,5,4,99.71,11,16,1,3,117.58,0.00,0.67,0.80,0,0.00,1,448.65,1,1,3,org.apache.solr.analysis.BaseTokenFilterFactory,0.00,3,2,2,0,3,1,0,1,101,1
"org.apache.solr.analysis.LengthFilterTest",1,0.00,1.00,20,0.34,16224.15,1,0,6,9,4,139.31,1,20,0,4,89.31,0.00,0.75,0.00,0,1.00,1,1018.48,1,0,4,org.apache.solr.analysis.BaseTokenTestCase,0.00,8,3,1,0,8,1,0,1,192,1
"org.apache.solr.analysis.LetterTokenizerFactory",2,0.00,1.00,6,0.05,786.43,2,0,3,3,3,114.90,10,10,1,3,132.77,0.00,0.67,0.00,0,2.00,1,155.94,2,1,2,org.apache.solr.analysis.BaseTokenizerFactory,0.00,1,2,2,0,1,1,0,1,43,1
"org.apache.solr.analysis.LimitTokenCountFilterFactory",2,0.00,1.00,7,0.08,1313.47,3,1,3,5,3,113.14,11,12,0,3,131.02,0.00,0.67,1.00,0,0.00,1,238.33,1,1,3,org.apache.solr.analysis.BaseTokenFilterFactory,0.00,3,2,2,0,3,1,0,1,60,1
"org.apache.solr.analysis.LowerCaseFilterFactory",3,0.00,1.00,8,0.07,952.44,3,0,3,4,5,160.69,11,14,1,3,140.07,0.00,0.67,0.00,0,4.00,1,200.97,2,2,4,org.apache.solr.analysis.BaseTokenFilterFactory,0.00,1,2,3,0,1,1,1,1,56,1
"org.apache.solr.analysis.LowerCaseTokenizerFactory",3,0.00,1.00,10,0.09,1494.27,3,0,4,6,6,152.58,10,16,1,3,131.96,0.00,0.67,0.00,0,5.00,1,260.43,2,2,5,org.apache.solr.analysis.BaseTokenizerFactory,0.00,3,2,3,0,3,1,1,1,69,1
"org.apache.solr.analysis.MappingCharFilterFactory",5,0.06,4.80,63,0.83,46239.26,9,4,12,26,9,119.77,15,77,1,2,99.15,0.00,0.50,0.30,2,9.00,14,2477.63,0,3,8,org.apache.solr.analysis.BaseCharFilterFactory,0.00,21,1,24,0,21,2,2,2,455,1
"org.apache.solr.analysis.MockTokenizerFactory",2,1.00,3.00,21,0.23,7128.46,4,2,5,7,4,155.47,3,28,0,3,105.47,0.00,0.67,1.00,0,0.00,5,698.78,1,1,4,org.apache.solr.analysis.BaseTokenizerFactory,0.00,5,2,6,0,5,1,0,1,142,1
"org.apache.solr.analysis.MultiTermAwareComponent",1,0.00,1.00,2,0.01,29.41,1,0,0,1,18,198.20,25,3,18,1,148.21,0.00,0.00,0.00,0,1.00,1,19.61,0,1,0,,0.00,0,0,1,0,0,0,0,3,9,1
"org.apache.solr.analysis.NGramFilterFactory",2,1.00,2.00,11,0.16,4556.47,4,2,3,5,5,86.11,12,17,2,3,118.33,0.00,0.67,1.00,0,0.00,3,487.78,1,1,3,org.apache.solr.analysis.BaseTokenFilterFactory,0.00,3,2,4,0,3,1,0,2,107,1
"org.apache.solr.analysis.NGramTokenizerFactory",2,1.00,2.00,11,0.16,4556.47,4,2,4,5,4,86.11,12,15,1,3,118.33,0.00,0.67,1.00,0,0.00,3,487.78,1,1,3,org.apache.solr.analysis.BaseTokenizerFactory,0.00,3,2,4,0,3,1,0,3,107,1
"org.apache.solr.analysis.NorwegianLightStemFilterFactory",1,0.00,1.00,3,0.02,225.35,1,0,2,2,4,97.11,12,5,1,3,134.67,0.00,0.67,0.00,0,1.00,1,58.69,0,1,3,org.apache.solr.analysis.BaseTokenFilterFactory,0.00,1,2,1,0,1,0,0,1,19,1
"org.apache.solr.analysis.NorwegianMinimalStemFilterFactory",1,0.00,1.00,3,0.02,225.35,1,0,2,2,4,97.11,12,5,1,3,134.67,0.00,0.67,0.00,0,1.00,1,58.69,0,1,3,org.apache.solr.analysis.BaseTokenFilterFactory,0.00,1,2,1,0,1,0,0,1,19,1
"org.apache.solr.analysis.NumericPayloadTokenFilterFactory",2,1.00,1.00,9,0.10,1608.54,4,2,3,5,3,107.79,11,13,0,3,125.66,0.00,0.67,1.00,0,0.00,1,292.08,1,1,3,org.apache.solr.analysis.BaseTokenFilterFactory,0.00,3,2,2,0,3,1,0,1,71,1
"org.apache.solr.analysis.PathHierarchyTokenizerFactory",2,1.50,4.50,33,0.39,16472.88,6,4,5,10,4,62.68,13,48,0,3,94.90,0.00,0.67,1.00,0,0.00,7,1173.35,1,1,4,org.apache.solr.analysis.BaseTokenizerFactory,0.00,8,2,9,0,8,1,0,2,226,1
"org.apache.solr.analysis.PatternReplaceCharFilterFactory",2,1.50,2.00,16,0.22,6025.34,6,4,5,8,4,67.47,14,25,1,2,109.76,0.00,0.50,1.00,0,0.00,3,652.38,1,1,3,org.apache.solr.analysis.BaseCharFilterFactory,0.00,6,1,4,0,6,1,0,1,131,1
"org.apache.solr.analysis.PatternReplaceFilterFactory",2,1.33,3.00,21,0.27,9768.33,5,3,5,9,4,72.18,13,34,1,3,104.40,0.00,0.67,1.00,0,0.00,5,805.86,1,1,3,org.apache.solr.analysis.BaseTokenFilterFactory,0.00,7,2,6,0,7,1,0,1,156,1
"org.apache.solr.analysis.PatternTokenizerFactory",2,1.00,3.00,22,0.31,11546.85,6,4,7,7,5,146.22,45,35,1,3,102.28,0.00,0.67,0.75,0,0.00,4,915.09,0,1,4,org.apache.solr.analysis.BaseTokenizerFactory,0.00,5,2,6,0,5,1,0,5,178,1
"org.apache.solr.analysis.PersianCharFilterFactory",2,0.00,1.00,5,0.04,518.24,2,0,2,3,5,122.89,11,10,1,2,140.77,0.00,0.50,0.00,0,2.00,1,117.90,0,2,4,org.apache.solr.analysis.BaseCharFilterFactory,0.00,1,1,2,0,1,0,1,1,35,1
"org.apache.solr.analysis.PersianNormalizationFilterFactory",2,0.00,1.00,5,0.03,391.36,2,0,2,3,5,109.50,12,9,1,3,141.73,0.00,0.67,0.00,0,2.00,1,103.73,0,2,4,org.apache.solr.analysis.BaseTokenFilterFactory,0.00,1,2,2,0,1,0,1,1,32,1
"org.apache.solr.analysis.PhoneticFilterFactory",4,0.19,3.50,44,0.82,36405.61,11,7,16,22,5,68.47,25,68,1,3,100.69,0.00,0.67,0.29,0,6.00,6,2447.02,1,3,4,org.apache.solr.analysis.BaseTokenFilterFactory,0.00,18,2,14,0,18,1,0,3,445,1
"org.apache.solr.analysis.PhoneticFilterFactory$HashMap<String,Class<?extendsEncoder>>",0,0.00,0.00,7,0.15,4514.34,0,0,16,1,0,171.00,0,7,0,1,171.00,0.00,0.00,0.00,0,0.00,0,451.43,0,0,0,java.lang.Object,0.00,1,0,0,0,1,0,0,0,92,0
"org.apache.solr.analysis.PorterStemFilterFactory",1,0.00,1.00,3,0.02,225.35,1,0,2,2,4,97.11,12,5,1,3,134.67,0.00,0.67,0.00,0,1.00,1,58.69,0,1,3,org.apache.solr.analysis.BaseTokenFilterFactory,0.00,1,2,1,0,1,0,0,1,19,1
"org.apache.solr.analysis.PortugueseLightStemFilterFactory",1,0.00,1.00,3,0.02,225.35,1,0,2,2,4,97.11,12,5,1,3,134.67,0.00,0.67,0.00,0,1.00,1,58.69,0,1,3,org.apache.solr.analysis.BaseTokenFilterFactory,0.00,1,2,1,0,1,0,0,1,19,1
"org.apache.solr.analysis.PortugueseMinimalStemFilterFactory",1,0.00,1.00,3,0.02,225.35,1,0,2,2,4,97.11,12,5,1,3,134.67,0.00,0.67,0.00,0,1.00,1,58.69,0,1,3,org.apache.solr.analysis.BaseTokenFilterFactory,0.00,1,2,1,0,1,0,0,1,19,1
"org.apache.solr.analysis.PortugueseStemFilterFactory",1,0.00,1.00,3,0.02,225.35,1,0,2,2,4,97.11,12,5,1,3,134.67,0.00,0.67,0.00,0,1.00,1,58.69,0,1,3,org.apache.solr.analysis.BaseTokenFilterFactory,0.00,1,2,1,0,1,0,0,1,19,1
"org.apache.solr.analysis.PositionFilterFactory",2,0.00,1.00,7,0.07,1029.10,3,1,3,3,3,83.75,16,11,0,3,131.85,0.00,0.67,1.00,0,0.00,1,201.67,1,1,3,org.apache.solr.analysis.BaseTokenFilterFactory,0.00,1,2,2,0,1,1,0,1,52,1
"org.apache.solr.analysis.RemoveDuplicatesTokenFilterFactory",1,0.00,1.00,3,0.02,225.35,1,0,2,2,4,90.55,11,5,1,3,134.67,0.00,0.67,0.00,0,1.00,1,58.69,0,1,3,org.apache.solr.analysis.BaseTokenFilterFactory,0.00,1,2,1,0,1,0,0,1,19,1
"org.apache.solr.analysis.ReverseStringFilterFactory",1,0.00,1.00,4,0.03,274.80,1,0,2,2,4,99.95,13,6,1,3,129.34,0.00,0.67,0.00,0,0.00,1,76.45,1,1,3,org.apache.solr.analysis.BaseTokenFilterFactory,0.00,1,2,1,0,1,0,0,1,23,1
"org.apache.solr.analysis.ReversedWildcardFilter",3,0.20,5.00,74,0.89,115443.82,8,5,5,11,5,33.04,29,87,1,4,83.04,0.00,0.75,0.33,1,4.00,9,2675.64,0,0,4,org.apache.lucene.analysis.TokenFilter,0.27,8,3,15,0,8,3,0,11,494,2
"org.apache.solr.analysis.ReversedWildcardFilterFactory",5,0.29,2.80,50,0.54,25577.26,11,6,3,12,6,55.78,52,65,2,3,104.25,0.00,0.67,0.40,0,8.00,9,1629.98,1,1,4,org.apache.solr.analysis.BaseTokenFilterFactory,0.00,7,2,14,0,7,4,0,7,328,1
"org.apache.solr.analysis.RussianLightStemFilterFactory",1,0.00,1.00,3,0.02,225.35,1,0,2,2,4,97.11,12,5,1,3,134.67,0.00,0.67,0.00,0,1.00,1,58.69,0,1,3,org.apache.solr.analysis.BaseTokenFilterFactory,0.00,1,2,1,0,1,0,0,1,19,1
"org.apache.solr.analysis.ShingleFilterFactory",2,1.60,3.00,25,0.34,11381.36,7,5,5,9,5,68.70,12,43,1,3,100.92,0.00,0.67,1.00,0,0.00,5,1034.00,1,1,4,org.apache.solr.analysis.BaseTokenFilterFactory,0.00,7,2,6,0,7,1,0,1,200,1
"org.apache.solr.analysis.SmartChineseSentenceTokenizerFactory",1,0.00,1.00,3,0.02,192.92,1,0,3,2,4,135.44,4,5,1,3,135.21,0.00,0.67,0.00,0,1.00,1,60.48,0,1,3,org.apache.solr.analysis.BaseTokenizerFactory,0.00,1,2,1,0,1,0,0,1,19,1
"org.apache.solr.analysis.SmartChineseWordTokenFilterFactory",1,0.00,1.00,3,0.02,192.92,1,0,3,2,5,85.21,9,5,1,3,135.21,0.00,0.67,0.00,0,1.00,1,60.48,0,1,4,org.apache.solr.analysis.BaseTokenFilterFactory,0.00,1,2,1,0,1,0,0,1,19,1
"org.apache.solr.analysis.SnowballPorterFilterFactory",3,0.50,3.00,25,0.35,10485.29,7,4,10,9,10,91.28,15,38,1,3,109.16,0.00,0.67,0.58,0,0.00,3,1036.64,1,1,9,org.apache.solr.analysis.BaseTokenFilterFactory,0.00,6,2,9,0,6,2,1,1,208,1
"org.apache.solr.analysis.SnowballPorterFilterFactoryTest",2,0.00,1.50,33,0.55,15496.77,2,0,16,19,9,145.36,3,35,0,4,95.36,0.00,0.75,0.00,0,0.00,2,1645.49,1,0,9,org.apache.solr.analysis.BaseTokenTestCase,0.00,17,3,3,0,17,2,0,1,285,1
"org.apache.solr.analysis.SnowballPorterFilterFactoryTest$LinesMockSolrResourceLoader",4,1.00,1.00,10,0.08,939.54,5,1,16,4,1,141.10,0,15,0,1,141.10,0.00,0.00,0.25,0,6.00,1,241.90,0,3,1,java.lang.Object,0.00,0,0,4,0,0,1,1,0,67,0
"org.apache.solr.analysis.SolrAnalyzer",4,0.67,1.00,10,0.08,924.20,5,1,3,4,3,191.16,4,18,2,2,141.16,2.00,0.25,0.50,1,4.00,1,228.41,0,2,1,org.apache.lucene.analysis.Analyzer,0.00,0,1,4,2,0,2,0,2,66,2
"org.apache.solr.analysis.SpanishLightStemFilterFactory",1,0.00,1.00,3,0.02,225.35,1,0,2,2,4,97.11,12,5,1,3,134.67,0.00,0.67,0.00,0,1.00,1,58.69,0,1,3,org.apache.solr.analysis.BaseTokenFilterFactory,0.00,1,2,1,0,1,0,0,1,19,1
"org.apache.solr.analysis.StandardFilterFactory",2,0.00,1.00,6,0.05,786.43,2,0,3,3,3,114.90,11,10,0,3,132.77,0.00,0.67,0.00,0,2.00,1,155.94,2,1,3,org.apache.solr.analysis.BaseTokenFilterFactory,0.00,1,2,2,0,1,1,0,1,43,1
"org.apache.solr.analysis.StandardTokenizerFactory",2,0.00,1.00,10,0.09,1599.37,3,1,4,4,6,104.19,10,16,3,3,122.07,0.00,0.67,1.00,0,0.00,1,279.24,2,1,3,org.apache.solr.analysis.BaseTokenizerFactory,0.00,2,2,2,0,2,1,0,1,68,1
"org.apache.solr.analysis.StemmerOverrideFilterFactory",3,0.25,3.00,24,0.33,12325.51,5,2,8,13,8,129.22,11,33,1,3,108.60,0.00,0.67,0.67,0,0.00,6,987.31,1,1,7,org.apache.solr.analysis.BaseTokenFilterFactory,0.00,10,2,9,0,10,2,1,1,186,1
"org.apache.solr.analysis.StempelPolishStemFilterFactory",2,0.50,1.50,9,0.11,1837.61,4,2,9,7,9,175.11,3,14,1,3,125.11,0.00,0.67,0.75,0,0.00,2,336.81,0,1,8,org.apache.solr.analysis.BaseTokenFilterFactory,0.00,5,2,3,0,5,1,1,1,78,1
"org.apache.solr.analysis.StopFilterFactory",6,0.13,1.50,30,0.30,7539.59,9,3,8,12,8,160.31,12,44,1,3,120.43,0.00,0.67,0.44,0,2.00,4,895.69,2,2,7,org.apache.solr.analysis.BaseTokenFilterFactory,0.00,6,2,9,0,6,4,1,1,194,1
"org.apache.solr.analysis.StringMockSolrResourceLoader",4,0.67,1.00,10,0.10,1148.15,5,1,6,8,6,140.42,0,15,5,1,140.42,0.00,0.00,0.50,0,4.00,1,286.84,0,3,1,java.lang.Object,0.00,4,0,4,0,4,1,1,0,76,0
"org.apache.solr.analysis.SwedishLightStemFilterFactory",1,0.00,1.00,3,0.02,225.35,1,0,2,2,4,97.11,12,5,1,3,134.67,0.00,0.67,0.00,0,1.00,1,58.69,0,1,3,org.apache.solr.analysis.BaseTokenFilterFactory,0.00,1,2,1,0,1,0,0,1,19,1
"org.apache.solr.analysis.SynonymFilterFactory",3,0.00,1.67,18,0.22,6313.62,4,1,6,13,7,115.92,14,27,2,3,115.69,0.00,0.67,1.00,0,0.00,3,657.83,2,1,5,org.apache.solr.analysis.BaseTokenFilterFactory,0.00,10,2,5,0,10,2,1,3,141,1
"org.apache.solr.analysis.TestArabicFilters",4,0.00,1.00,34,0.45,9208.44,4,0,5,19,8,111.07,16,40,0,4,110.84,0.00,0.75,0.00,0,0.00,1,1355.36,1,0,8,org.apache.solr.analysis.BaseTokenTestCase,0.00,15,3,4,0,15,4,0,5,274,1
"org.apache.solr.analysis.TestBeiderMorseFilterFactory",3,0.00,1.00,30,0.50,13496.77,3,0,5,10,4,104.93,1,37,0,4,104.93,0.00,0.75,0.00,0,4.00,1,1503.99,1,0,4,org.apache.solr.analysis.BaseTokenTestCase,0.00,7,3,3,0,7,3,0,1,286,1
"org.apache.solr.analysis.TestBrazilianStemFilterFactory",1,0.00,1.00,7,0.09,1508.82,1,0,5,5,5,82.22,6,9,0,4,114.44,0.00,0.75,0.00,0,1.00,1,268.12,1,0,5,org.apache.solr.analysis.BaseTokenTestCase,0.00,4,3,1,0,4,1,0,2,58,1
"org.apache.solr.analysis.TestBulgarianStemFilterFactory",1,0.00,1.00,7,0.09,1508.82,1,0,5,5,5,82.22,6,9,0,4,114.44,0.00,0.75,0.00,0,1.00,1,268.12,1,0,5,org.apache.solr.analysis.BaseTokenTestCase,0.00,4,3,1,0,4,1,0,2,58,1
"org.apache.solr.analysis.TestCJKBigramFilterFactory",2,0.00,1.00,15,0.26,4935.16,2,0,6,9,4,152.65,4,20,0,4,112.76,0.00,0.75,0.00,0,2.00,1,772.60,1,0,4,org.apache.solr.analysis.BaseTokenTestCase,0.00,7,3,2,0,7,2,0,1,147,1
"org.apache.solr.analysis.TestCJKWidthFilterFactory",1,0.00,1.00,6,0.08,1342.67,1,0,4,5,4,137.96,3,8,0,4,117.34,0.00,0.75,0.00,0,1.00,1,246.26,1,0,4,org.apache.solr.analysis.BaseTokenTestCase,0.00,4,3,1,0,4,1,0,1,54,1
"org.apache.solr.analysis.TestCapitalizationFilterFactory",7,0.00,1.00,86,1.88,84685.95,7,0,6,14,5,98.83,31,131,0,4,98.59,0.00,0.75,0.00,0,0.00,1,5630.00,1,0,5,org.apache.solr.analysis.BaseTokenTestCase,0.00,7,3,7,0,7,7,0,14,1003,1
"org.apache.solr.analysis.TestChineseFilterFactory",1,0.00,1.00,7,0.09,1563.22,1,0,5,5,4,82.10,6,9,0,4,114.32,0.00,0.75,0.00,0,1.00,1,283.04,1,0,4,org.apache.solr.analysis.BaseTokenTestCase,0.00,4,3,1,0,4,1,0,2,60,1
"org.apache.solr.analysis.TestChineseTokenizerFactory",1,0.00,1.00,6,0.08,1183.27,1,0,3,4,2,85.55,6,8,0,4,117.77,0.00,0.75,0.00,0,1.00,1,227.03,1,0,2,org.apache.solr.analysis.BaseTokenTestCase,0.00,3,3,1,0,3,1,0,2,50,1
"org.apache.solr.analysis.TestCollationKeyFilterFactory",6,0.00,1.00,83,1.31,37260.55,6,0,14,28,6,99.81,27,106,0,4,99.58,0.00,0.75,0.00,1,6.00,1,3936.79,0,0,6,org.apache.solr.analysis.BaseTokenTestCase,0.00,22,3,6,0,22,6,0,9,735,1
"org.apache.solr.analysis.TestCollationKeyFilterFactory$StringMockSolrResourceLoader",4,1.00,1.00,10,0.08,958.21,5,1,14,6,1,141.03,0,15,0,1,141.03,0.00,0.00,0.25,0,6.00,1,251.11,0,3,1,java.lang.Object,0.00,2,0,4,0,2,1,1,0,69,1
"org.apache.solr.analysis.TestCollationKeyRangeQueries",4,0.00,1.00,22,0.32,6089.07,4,0,2,4,1,120.10,17,41,0,3,119.87,0.00,0.67,0.00,0,4.00,1,954.29,5,0,1,org.apache.solr.SolrTestCaseJ4,0.00,0,2,4,0,0,4,0,5,193,1
"org.apache.solr.analysis.TestCzechStemFilterFactory",1,0.00,1.00,7,0.09,1508.82,1,0,5,5,5,82.22,6,9,0,4,114.44,0.00,0.75,0.00,0,1.00,1,268.12,1,0,5,org.apache.solr.analysis.BaseTokenTestCase,0.00,4,3,1,0,4,1,0,2,58,1
"org.apache.solr.analysis.TestDelimitedPayloadTokenFilterFactory",2,0.00,2.00,37,0.65,26258.79,2,0,11,18,10,91.59,0,42,0,4,91.59,0.00,0.75,0.00,0,2.00,2,1961.94,0,0,10,org.apache.solr.analysis.BaseTokenTestCase,0.00,16,3,4,0,16,2,0,0,331,1
"org.apache.solr.analysis.TestDictionaryCompoundWordTokenFilterFactory",1,0.00,1.00,12,0.20,4496.18,1,0,9,10,7,69.76,6,15,0,4,101.98,0.00,0.75,0.00,0,0.00,1,591.18,1,0,7,org.apache.solr.analysis.BaseTokenTestCase,0.00,9,3,1,0,9,1,0,2,108,1
"org.apache.solr.analysis.TestElisionFilterFactory",3,0.00,1.00,36,0.54,13580.18,3,0,9,12,7,102.19,12,40,0,4,101.96,0.00,0.75,0.00,0,0.00,1,1612.72,1,0,7,org.apache.solr.analysis.BaseTokenTestCase,0.00,9,3,3,0,9,3,0,4,300,1
"org.apache.solr.analysis.TestEnglishMinimalStemFilterFactory",1,0.00,1.00,6,0.08,1316.03,1,0,4,5,4,138.02,3,8,0,4,117.41,0.00,0.75,0.00,0,1.00,1,238.99,1,0,4,org.apache.solr.analysis.BaseTokenTestCase,0.00,4,3,1,0,4,1,0,1,53,1
"org.apache.solr.analysis.TestFinnishLightStemFilterFactory",1,0.00,1.00,6,0.08,1316.03,1,0,4,5,4,138.02,3,8,0,4,117.41,0.00,0.75,0.00,0,1.00,1,238.99,1,0,4,org.apache.solr.analysis.BaseTokenTestCase,0.00,4,3,1,0,4,1,0,1,53,1
"org.apache.solr.analysis.TestFoldingMultitermExtrasQuery",5,0.00,1.00,38,0.63,38636.71,5,0,3,6,1,108.86,3,47,0,3,108.86,0.00,0.67,0.00,0,5.00,1,1885.43,6,1,1,org.apache.solr.SolrTestCaseJ4,0.00,1,2,5,0,1,4,0,3,388,1
"org.apache.solr.analysis.TestFrenchLightStemFilterFactory",1,0.00,1.00,6,0.08,1316.03,1,0,4,5,4,138.02,3,8,0,4,117.41,0.00,0.75,0.00,0,1.00,1,238.99,1,0,4,org.apache.solr.analysis.BaseTokenTestCase,0.00,4,3,1,0,4,1,0,1,53,1
"org.apache.solr.analysis.TestFrenchMinimalStemFilterFactory",1,0.00,1.00,6,0.08,1316.03,1,0,4,5,4,138.02,3,8,0,4,117.41,0.00,0.75,0.00,0,1.00,1,238.99,1,0,4,org.apache.solr.analysis.BaseTokenTestCase,0.00,4,3,1,0,4,1,0,1,53,1
"org.apache.solr.analysis.TestGalicianMinimalStemFilterFactory",1,0.00,1.00,6,0.08,1316.03,1,0,4,5,4,138.02,3,8,0,4,117.41,0.00,0.75,0.00,0,1.00,1,238.99,1,0,4,org.apache.solr.analysis.BaseTokenTestCase,0.00,4,3,1,0,4,1,0,1,53,1
"org.apache.solr.analysis.TestGalicianStemFilterFactory",1,0.00,1.00,6,0.08,1316.03,1,0,4,5,4,138.02,3,8,0,4,117.41,0.00,0.75,0.00,0,1.00,1,238.99,1,0,4,org.apache.solr.analysis.BaseTokenTestCase,0.00,4,3,1,0,4,1,0,1,53,1
"org.apache.solr.analysis.TestGermanLightStemFilterFactory",1,0.00,1.00,6,0.08,1316.03,1,0,4,5,4,138.02,3,8,0,4,117.41,0.00,0.75,0.00,0,1.00,1,238.99,1,0,4,org.apache.solr.analysis.BaseTokenTestCase,0.00,4,3,1,0,4,1,0,1,53,1
"org.apache.solr.analysis.TestGermanMinimalStemFilterFactory",1,0.00,1.00,6,0.08,1316.03,1,0,4,5,4,138.02,3,8,0,4,117.41,0.00,0.75,0.00,0,1.00,1,238.99,1,0,4,org.apache.solr.analysis.BaseTokenTestCase,0.00,4,3,1,0,4,1,0,1,53,1
"org.apache.solr.analysis.TestGermanNormalizationFilterFactory",1,0.00,1.00,6,0.08,1316.03,1,0,4,5,4,138.02,3,8,0,4,117.41,0.00,0.75,0.00,0,1.00,1,238.99,1,0,4,org.apache.solr.analysis.BaseTokenTestCase,0.00,4,3,1,0,4,1,0,1,53,1
"org.apache.solr.analysis.TestGermanStemFilterFactory",1,0.00,1.00,7,0.09,1508.82,1,0,5,5,5,82.22,6,9,0,4,114.44,0.00,0.75,0.00,0,1.00,1,268.12,1,0,5,org.apache.solr.analysis.BaseTokenTestCase,0.00,4,3,1,0,4,1,0,2,58,1
"org.apache.solr.analysis.TestGreekLowerCaseFilterFactory",1,0.00,1.00,8,0.10,1824.66,1,0,5,6,5,79.41,6,10,0,4,111.63,0.00,0.75,0.00,0,0.00,1,307.81,1,0,5,org.apache.solr.analysis.BaseTokenTestCase,0.00,5,3,1,0,5,1,0,2,65,1
"org.apache.solr.analysis.TestGreekStemFilterFactory",1,0.00,1.00,8,0.11,1880.91,1,0,6,6,6,137.81,19,10,0,4,111.53,0.00,0.75,0.00,0,0.00,1,320.51,1,0,6,org.apache.solr.analysis.BaseTokenTestCase,0.00,5,3,1,0,5,1,0,2,67,1
"org.apache.solr.analysis.TestHTMLStripCharFilterFactory",6,0.00,1.00,66,1.23,29680.32,6,0,8,14,6,142.95,15,79,0,4,103.06,0.00,0.75,0.00,0,6.00,1,3678.58,1,0,6,org.apache.solr.analysis.BaseTokenTestCase,0.00,8,3,6,0,8,6,0,13,641,1
"org.apache.solr.analysis.TestHindiFilters",3,0.00,1.00,34,0.42,9874.10,3,0,4,16,7,104.69,12,38,0,4,104.46,0.00,0.75,0.00,0,0.00,1,1270.92,1,0,7,org.apache.solr.analysis.BaseTokenTestCase,0.00,13,3,3,0,13,3,0,4,256,1
"org.apache.solr.analysis.TestHungarianLightStemFilterFactory",1,0.00,1.00,6,0.08,1316.03,1,0,4,5,4,138.02,3,8,0,4,117.41,0.00,0.75,0.00,0,1.00,1,238.99,1,0,4,org.apache.solr.analysis.BaseTokenTestCase,0.00,4,3,1,0,4,1,0,1,53,1
"org.apache.solr.analysis.TestHunspellStemFilterFactory",1,0.00,1.00,12,0.19,4697.72,1,0,8,11,6,122.44,3,14,0,4,101.83,0.00,0.75,0.00,0,0.00,1,581.17,1,0,6,org.apache.solr.analysis.BaseTokenTestCase,0.00,10,3,1,0,10,1,0,1,109,1
"org.apache.solr.analysis.TestHyphenationCompoundWordTokenFilterFactory",2,0.00,1.00,27,0.47,11788.59,2,0,9,11,7,81.88,11,34,0,4,99.76,0.00,0.75,0.00,0,0.00,1,1409.17,1,0,7,org.apache.solr.analysis.BaseTokenTestCase,0.00,9,3,2,0,9,2,0,3,247,1
"org.apache.solr.analysis.TestICUCollationKeyRangeQueries",4,0.00,1.00,22,0.32,6080.92,4,0,2,4,1,120.11,17,41,0,3,119.87,0.00,0.67,0.00,0,4.00,1,964.03,5,0,1,org.apache.solr.SolrTestCaseJ4,0.00,0,2,4,0,0,4,0,5,194,1
"org.apache.solr.analysis.TestICUFoldingFilterFactory",1,0.00,1.00,8,0.10,1592.46,1,0,5,6,5,151.98,2,10,0,4,112.10,0.00,0.75,0.00,0,0.00,1,285.39,1,0,5,org.apache.solr.analysis.BaseTokenTestCase,0.00,5,3,1,0,5,1,0,2,61,1
"org.apache.solr.analysis.TestICUNormalizer2FilterFactory",1,0.00,1.00,8,0.10,1676.75,1,0,5,6,5,132.54,3,10,0,4,111.92,0.00,0.75,0.00,0,0.00,1,308.08,1,0,5,org.apache.solr.analysis.BaseTokenTestCase,0.00,5,3,1,0,5,1,0,3,64,1
"org.apache.solr.analysis.TestICUTokenizerFactory",1,0.00,1.00,6,0.10,1450.97,1,0,3,4,3,167.08,1,10,0,4,117.08,0.00,0.75,0.00,0,1.00,1,291.61,1,0,3,org.apache.solr.analysis.BaseTokenTestCase,0.00,3,3,1,0,3,1,0,1,59,1
"org.apache.solr.analysis.TestICUTransformFilterFactory",2,0.00,1.00,25,0.36,10425.60,2,0,7,9,5,141.36,5,28,0,4,101.47,0.00,0.75,0.00,0,0.00,1,1089.49,1,0,5,org.apache.solr.analysis.BaseTokenTestCase,0.00,7,3,2,0,7,2,0,5,207,1
"org.apache.solr.analysis.TestIndonesianStemFilterFactory",2,0.00,1.00,18,0.27,6541.00,2,0,7,9,5,107.96,9,21,0,4,107.73,0.00,0.75,0.00,0,2.00,1,809.78,1,0,5,org.apache.solr.analysis.BaseTokenTestCase,0.00,7,3,2,0,7,2,0,3,159,1
"org.apache.solr.analysis.TestIrishLowerCaseFilterFactory",1,0.00,1.00,6,0.08,1370.00,1,0,4,5,4,137.89,3,8,0,4,117.27,0.00,0.75,0.00,0,1.00,1,253.55,1,0,4,org.apache.solr.analysis.BaseTokenTestCase,0.00,4,3,1,0,4,1,0,1,55,1
"org.apache.solr.analysis.TestItalianLightStemFilterFactory",1,0.00,1.00,6,0.08,1400.43,1,0,4,5,4,137.81,3,8,0,4,117.20,0.00,0.75,0.00,0,1.00,1,243.74,1,0,4,org.apache.solr.analysis.BaseTokenTestCase,0.00,4,3,1,0,4,1,0,1,54,1
"org.apache.solr.analysis.TestJapaneseBaseFormFilterFactory",1,0.00,1.00,9,0.13,2421.25,1,0,4,9,5,129.37,3,13,0,4,108.76,0.00,0.75,0.00,0,0.00,1,392.91,1,0,5,org.apache.solr.analysis.BaseTokenTestCase,0.00,8,3,1,0,8,1,0,1,79,1
"org.apache.solr.analysis.TestJapanesePartOfSpeechStopFilterFactory",1,0.00,1.00,15,0.24,7030.89,1,0,6,15,6,123.12,19,21,0,4,96.83,0.00,0.75,0.00,0,0.00,1,711.73,1,0,6,org.apache.solr.analysis.BaseTokenTestCase,0.00,14,3,1,0,14,1,0,2,130,1
"org.apache.solr.analysis.TestJapaneseTokenizerFactory",4,0.00,1.00,32,0.51,11571.56,4,0,6,13,5,149.94,9,50,0,4,110.06,0.00,0.75,0.00,0,4.00,1,1542.04,1,0,5,org.apache.solr.analysis.BaseTokenTestCase,0.00,9,3,4,0,9,4,0,3,299,1
"org.apache.solr.analysis.TestKStemFilterFactory",1,0.00,1.00,6,0.08,1316.03,1,0,4,5,4,143.69,19,8,0,4,117.41,0.00,0.75,0.00,0,1.00,1,238.99,1,0,4,org.apache.solr.analysis.BaseTokenTestCase,0.00,4,3,1,0,4,1,0,2,53,1
"org.apache.solr.analysis.TestKeepFilterFactory",1,0.00,1.00,20,0.31,14662.10,1,0,5,10,5,89.90,4,22,0,4,89.66,0.00,0.75,0.00,0,0.00,1,921.37,0,0,5,org.apache.solr.analysis.BaseTokenTestCase,0.00,9,3,1,0,9,1,0,1,170,1
"org.apache.solr.analysis.TestKeywordMarkerFilterFactory",2,0.00,1.00,24,0.39,9372.70,2,0,11,12,8,151.84,3,27,0,4,101.84,0.00,0.75,0.00,0,0.00,1,1174.25,1,0,8,org.apache.solr.analysis.BaseTokenTestCase,0.00,10,3,2,0,10,2,0,1,214,1
"org.apache.solr.analysis.TestLatvianStemFilterFactory",1,0.00,1.00,6,0.08,1400.43,1,0,4,5,4,137.81,3,8,0,4,117.20,0.00,0.75,0.00,0,1.00,1,243.74,1,0,4,org.apache.solr.analysis.BaseTokenTestCase,0.00,4,3,1,0,4,1,0,1,54,1
"org.apache.solr.analysis.TestLuceneMatchVersion",2,1.00,1.00,25,0.45,16059.53,3,1,9,18,9,139.88,5,30,0,3,100.00,0.00,0.67,0.50,0,2.00,1,1344.60,1,0,9,org.apache.solr.SolrTestCaseJ4,0.00,16,2,2,0,16,2,0,3,246,1
"org.apache.solr.analysis.TestMappingCharFilterFactory",1,0.00,4.00,15,0.17,4562.04,1,0,1,5,1,98.00,0,26,0,2,98.00,0.00,0.50,0.00,0,1.00,4,498.82,0,0,1,org.apache.lucene.util.LuceneTestCase,0.00,4,1,4,0,4,1,0,0,101,1
"org.apache.solr.analysis.TestMultiWordSynonyms",2,0.00,1.00,18,0.30,7277.77,2,0,11,17,6,107.60,8,22,0,4,107.36,0.00,0.75,0.00,0,2.00,1,907.34,1,0,6,org.apache.solr.analysis.BaseTokenTestCase,0.00,15,3,2,0,15,2,0,4,175,1
"org.apache.solr.analysis.TestMultiWordSynonyms$StringMockSolrResourceLoader",4,1.00,1.00,10,0.08,958.21,5,1,11,6,1,141.03,0,15,0,1,141.03,0.00,0.00,0.25,0,6.00,1,251.11,0,3,1,java.lang.Object,0.00,2,0,4,0,2,1,1,0,69,1
"org.apache.solr.analysis.TestNGramFilters",10,0.00,1.00,81,1.28,31170.56,10,0,7,26,8,130.42,33,102,0,4,109.80,0.00,0.75,0.00,0,10.00,1,3833.51,1,0,8,org.apache.solr.analysis.BaseTokenTestCase,0.00,16,3,10,0,16,10,0,11,743,1
"org.apache.solr.analysis.TestNorwegianLightStemFilterFactory",1,0.00,1.00,6,0.08,1400.43,1,0,4,5,4,137.81,3,8,0,4,117.20,0.00,0.75,0.00,0,1.00,1,243.74,1,0,4,org.apache.solr.analysis.BaseTokenTestCase,0.00,4,3,1,0,4,1,0,1,54,1
"org.apache.solr.analysis.TestNorwegianMinimalStemFilterFactory",1,0.00,1.00,6,0.09,1761.80,1,0,4,5,4,137.03,3,8,0,4,116.41,0.00,0.75,0.00,0,1.00,1,262.76,1,0,4,org.apache.solr.analysis.BaseTokenTestCase,0.00,4,3,1,0,4,1,0,1,58,1
"org.apache.solr.analysis.TestPatternReplaceCharFilterFactory",3,0.00,1.00,37,0.57,14808.01,3,0,8,16,6,122.27,11,46,0,4,101.66,0.00,0.75,0.00,0,3.00,1,1716.75,1,0,6,org.apache.solr.analysis.BaseTokenTestCase,0.00,13,3,3,0,13,3,0,9,314,1
"org.apache.solr.analysis.TestPatternReplaceFilterFactory",1,0.00,1.00,10,0.15,3892.33,1,0,5,8,4,126.04,3,14,0,4,105.43,0.00,0.75,0.00,0,1.00,1,456.34,1,0,4,org.apache.solr.analysis.BaseTokenTestCase,0.00,7,3,1,0,7,1,0,1,90,1
"org.apache.solr.analysis.TestPatternTokenizerFactory",1,0.00,1.00,9,0.13,3694.67,1,0,4,7,3,147.20,2,13,0,4,107.31,0.00,0.75,0.00,0,1.00,1,395.08,1,0,3,org.apache.solr.analysis.BaseTokenTestCase,0.00,6,3,1,0,6,1,0,2,80,1
"org.apache.solr.analysis.TestPersianNormalizationFilterFactory",1,0.00,1.00,7,0.09,1508.82,1,0,5,5,5,82.22,6,9,0,4,114.44,0.00,0.75,0.00,0,1.00,1,268.12,1,0,5,org.apache.solr.analysis.BaseTokenTestCase,0.00,4,3,1,0,4,1,0,2,58,1
"org.apache.solr.analysis.TestPhoneticFilterFactory",7,1.00,1.71,71,1.12,34390.17,8,1,7,19,5,144.39,14,103,0,4,104.51,0.00,0.75,0.14,2,12.00,4,3348.06,1,0,5,org.apache.solr.analysis.BaseTokenTestCase,0.00,12,3,12,0,12,7,0,6,647,1
"org.apache.solr.analysis.TestPorterStemFilterFactory",1,0.00,1.00,7,0.09,1508.82,1,0,5,5,5,82.22,6,9,0,4,114.44,0.00,0.75,0.00,0,1.00,1,268.12,1,0,5,org.apache.solr.analysis.BaseTokenTestCase,0.00,4,3,1,0,4,1,0,2,58,1
"org.apache.solr.analysis.TestPortugueseLightStemFilterFactory",1,0.00,1.00,6,0.08,1316.03,1,0,4,5,4,138.02,3,8,0,4,117.41,0.00,0.75,0.00,0,1.00,1,238.99,1,0,4,org.apache.solr.analysis.BaseTokenTestCase,0.00,4,3,1,0,4,1,0,1,53,1
"org.apache.solr.analysis.TestPortugueseMinimalStemFilterFactory",1,0.00,1.00,6,0.08,1316.03,1,0,4,5,4,138.02,3,8,0,4,117.41,0.00,0.75,0.00,0,1.00,1,238.99,1,0,4,org.apache.solr.analysis.BaseTokenTestCase,0.00,4,3,1,0,4,1,0,1,53,1
"org.apache.solr.analysis.TestPortugueseStemFilterFactory",1,0.00,1.00,6,0.08,1316.03,1,0,4,5,4,138.02,3,8,0,4,117.41,0.00,0.75,0.00,0,1.00,1,238.99,1,0,4,org.apache.solr.analysis.BaseTokenTestCase,0.00,4,3,1,0,4,1,0,1,53,1
"org.apache.solr.analysis.TestRemoveDuplicatesTokenFilterFactory",4,0.00,1.00,14,0.24,4754.94,4,0,7,12,7,128.99,1,28,0,4,128.99,0.00,0.75,0.00,2,4.00,1,718.20,1,2,7,org.apache.solr.analysis.BaseTokenTestCase,0.00,8,3,4,0,8,2,0,1,159,1
"org.apache.solr.analysis.TestRemoveDuplicatesTokenFilterFactory$TokenStream",1,0.00,2.00,14,0.15,2847.86,4,3,7,11,4,100.88,0,17,0,1,100.88,0.00,0.00,1.00,0,0.00,2,458.76,0,0,4,java.lang.Object,0.00,10,0,2,0,10,1,0,0,100,0
"org.apache.solr.analysis.TestReverseStringFilterFactory",1,0.00,1.00,8,0.10,1762.54,1,0,5,6,5,79.53,6,10,0,4,111.75,0.00,0.75,0.00,0,0.00,1,310.51,1,0,5,org.apache.solr.analysis.BaseTokenTestCase,0.00,5,3,1,0,5,1,0,2,65,1
"org.apache.solr.analysis.TestReversedWildcardFilterFactory",7,0.17,1.14,81,1.29,43126.11,10,3,21,31,13,152.28,10,121,0,3,102.28,0.00,0.67,0.19,1,18.00,2,3870.91,7,0,13,org.apache.solr.SolrTestCaseJ4,0.04,24,2,8,0,24,7,0,10,722,1
"org.apache.solr.analysis.TestRussianFilters",1,0.00,1.00,7,0.09,1455.37,1,0,3,5,2,82.35,6,10,0,4,114.57,0.00,0.75,0.00,0,0.00,1,275.51,1,0,2,org.apache.solr.analysis.BaseTokenTestCase,0.00,4,3,1,0,4,1,0,2,58,1
"org.apache.solr.analysis.TestRussianLightStemFilterFactory",1,0.00,1.00,6,0.08,1316.03,1,0,4,5,4,138.02,3,8,0,4,117.41,0.00,0.75,0.00,0,1.00,1,238.99,1,0,4,org.apache.solr.analysis.BaseTokenTestCase,0.00,4,3,1,0,4,1,0,1,53,1
"org.apache.solr.analysis.TestShingleFilterFactory",13,0.00,1.00,117,1.99,48469.86,13,0,6,20,4,127.89,50,149,0,4,107.28,0.00,0.75,0.00,0,13.00,1,5984.54,1,0,4,org.apache.solr.analysis.BaseTokenTestCase,0.00,7,3,13,0,7,13,0,14,1117,1
"org.apache.solr.analysis.TestSmartChineseFactories",2,0.00,1.00,14,0.21,4255.62,2,0,4,8,6,95.40,10,21,0,4,113.27,0.00,0.75,0.00,0,2.00,1,638.57,1,0,6,org.apache.solr.analysis.BaseTokenTestCase,0.00,6,3,2,0,6,2,0,7,130,1
"org.apache.solr.analysis.TestSpanishLightStemFilterFactory",1,0.00,1.00,6,0.08,1316.03,1,0,4,5,4,138.02,3,8,0,4,117.41,0.00,0.75,0.00,0,1.00,1,238.99,1,0,4,org.apache.solr.analysis.BaseTokenTestCase,0.00,4,3,1,0,4,1,0,1,53,1
"org.apache.solr.analysis.TestStandardFactories",10,0.00,1.20,87,1.19,28706.83,10,0,7,42,12,149.93,29,103,0,4,110.04,0.00,0.75,0.00,0,0.00,2,3577.73,1,0,12,org.apache.solr.analysis.BaseTokenTestCase,0.00,32,3,12,0,32,10,0,11,686,1
"org.apache.solr.analysis.TestStemmerOverrideFilterFactory",2,0.00,1.00,24,0.39,9343.47,2,0,11,12,8,141.73,4,27,0,4,101.85,0.00,0.75,0.00,0,0.00,1,1165.46,1,0,8,org.apache.solr.analysis.BaseTokenTestCase,0.00,10,3,2,0,10,2,0,2,213,1
"org.apache.solr.analysis.TestStempelPolishStemFilterFactory",1,0.00,1.00,7,0.09,1721.82,1,0,4,7,5,140.28,19,10,0,4,113.99,0.00,0.75,0.00,0,0.00,1,279.91,1,0,5,org.apache.solr.analysis.BaseTokenTestCase,0.00,6,3,1,0,6,1,0,2,61,1
"org.apache.solr.analysis.TestStopFilterFactory",1,0.00,1.00,37,0.62,36767.44,1,0,5,13,5,76.79,4,39,0,4,76.55,0.00,0.75,0.00,0,0.00,1,1862.49,0,0,5,org.apache.solr.analysis.BaseTokenTestCase,0.00,12,3,1,0,12,1,0,1,315,1
"org.apache.solr.analysis.TestSwedishLightStemFilterFactory",1,0.00,1.00,6,0.08,1400.43,1,0,4,5,4,137.81,3,8,0,4,117.20,0.00,0.75,0.00,0,1.00,1,243.74,1,0,4,org.apache.solr.analysis.BaseTokenTestCase,0.00,4,3,1,0,4,1,0,1,54,1
"org.apache.solr.analysis.TestSynonymFilterFactory",4,0.00,1.00,45,0.79,22247.19,4,0,14,17,8,142.55,8,55,0,4,102.66,0.00,0.75,0.00,0,4.00,1,2376.28,1,0,8,org.apache.solr.analysis.BaseTokenTestCase,0.00,13,3,4,0,13,4,0,6,433,1
"org.apache.solr.analysis.TestSynonymFilterFactory$StringMockSolrResourceLoader",4,0.67,1.00,10,0.10,1175.32,5,1,14,8,1,140.34,0,15,0,1,140.34,0.00,0.00,0.50,0,4.00,1,291.71,0,3,1,java.lang.Object,0.00,4,0,4,0,4,1,1,0,77,1
"org.apache.solr.analysis.TestThaiWordFilterFactory",1,0.00,1.00,9,0.13,2148.73,1,0,6,7,6,76.94,6,12,0,4,109.16,0.00,0.75,0.00,0,0.00,1,403.76,1,0,6,org.apache.solr.analysis.BaseTokenTestCase,0.00,6,3,1,0,6,1,0,2,78,1
"org.apache.solr.analysis.TestTrimFilterFactory",1,0.00,1.00,8,0.12,2926.45,1,0,5,8,4,130.63,3,10,0,4,110.02,0.00,0.75,0.00,0,1.00,1,371.63,1,0,4,org.apache.solr.analysis.BaseTokenTestCase,0.00,7,3,1,0,7,1,0,1,76,1
"org.apache.solr.analysis.TestTurkishLowerCaseFilterFactory",1,0.00,1.00,7,0.09,1508.82,1,0,5,5,5,82.22,6,9,0,4,114.44,0.00,0.75,0.00,0,1.00,1,268.12,1,0,5,org.apache.solr.analysis.BaseTokenTestCase,0.00,4,3,1,0,4,1,0,2,58,1
"org.apache.solr.analysis.TestTypeTokenFilterFactory",4,0.00,1.25,50,0.75,31537.36,4,0,8,18,6,150.01,4,61,0,4,100.01,0.00,0.75,0.00,0,0.00,2,2238.80,0,0,6,org.apache.solr.analysis.BaseTokenTestCase,0.00,14,3,5,0,14,4,0,2,418,1
"org.apache.solr.analysis.TestUAX29URLEmailTokenizerFactory",9,0.00,1.11,73,1.22,26749.41,9,0,6,20,3,159.94,10,149,0,4,109.94,0.00,0.75,0.00,0,0.00,2,3673.11,1,0,3,org.apache.solr.analysis.BaseTokenTestCase,0.00,11,3,10,0,11,9,0,8,681,1
"org.apache.solr.analysis.TestWikipediaTokenizerFactory",1,0.00,1.00,10,0.14,2588.89,1,0,5,4,4,133.10,19,13,0,4,106.82,0.00,0.75,0.00,0,1.00,1,425.30,1,0,4,org.apache.solr.analysis.BaseTokenTestCase,0.00,3,3,1,0,3,1,0,2,83,1
"org.apache.solr.analysis.TestWordDelimiterFilterFactory",9,0.00,1.00,75,1.11,31179.63,9,0,11,19,7,149.32,26,151,0,3,109.44,0.00,0.67,0.00,1,9.00,1,3331.11,6,0,7,org.apache.solr.SolrTestCaseJ4,0.00,10,2,9,0,10,9,0,8,638,1
"org.apache.solr.analysis.ThaiWordFilterFactory",1,0.00,1.00,4,0.03,274.80,1,0,2,2,4,85.21,11,6,1,3,129.34,0.00,0.67,0.00,0,0.00,1,76.45,1,1,3,org.apache.solr.analysis.BaseTokenFilterFactory,0.00,1,2,1,0,1,0,0,1,23,1
"org.apache.solr.analysis.TokenFilterFactory",3,0.00,1.00,4,0.03,247.81,3,0,2,3,11,126.52,39,5,10,1,155.90,0.00,0.00,0.00,0,3.00,1,89.64,0,2,1,,0.00,0,0,3,0,0,1,0,4,31,1
"org.apache.solr.analysis.TokenOffsetPayloadTokenFilterFactory",1,0.00,1.00,3,0.02,225.35,1,0,2,2,3,90.55,11,5,0,3,134.67,0.00,0.67,0.00,0,1.00,1,58.69,0,1,3,org.apache.solr.analysis.BaseTokenFilterFactory,0.00,1,2,1,0,1,0,0,1,19,1
"org.apache.solr.analysis.TokenizerChain",8,0.10,1.62,45,0.41,11105.26,11,3,3,16,17,120.07,7,51,9,3,120.07,0.00,0.67,0.25,1,28.00,3,1224.28,0,6,8,org.apache.solr.analysis.SolrAnalyzer,0.00,8,2,13,0,8,2,0,5,278,2
"org.apache.solr.analysis.TokenizerChain$SolrTokenStreamComponents",2,0.00,1.00,6,0.06,826.21,2,0,3,3,2,182.60,2,11,0,2,132.60,0.00,0.50,0.00,0,2.00,1,165.69,1,0,2,org.apache.lucene.analysis.TokenStreamComponents,0.00,1,1,2,0,1,2,0,2,45,0
"org.apache.solr.analysis.TokenizerFactory",3,0.00,1.00,4,0.03,241.10,3,0,3,3,8,118.44,37,5,7,1,156.00,0.00,0.00,0.00,0,3.00,1,91.19,0,2,1,,0.00,0,0,3,0,0,1,0,4,31,1
"org.apache.solr.analysis.TrieTokenizer",7,0.12,2.29,55,0.73,25105.15,14,7,8,27,6,111.29,1,83,1,4,111.29,0.00,0.75,0.24,1,0.00,8,2177.01,2,1,5,org.apache.lucene.analysis.Tokenizer,0.76,20,3,16,0,20,6,0,1,418,1
"org.apache.solr.analysis.TrieTokenizerFactory",2,0.00,1.00,8,0.07,1046.28,4,2,8,4,8,94.91,12,11,1,3,127.13,0.00,0.67,0.50,0,2.00,1,214.45,0,0,7,org.apache.solr.analysis.BaseTokenizerFactory,0.00,2,2,2,0,2,2,0,1,58,1
"org.apache.solr.analysis.TrimFilterFactory",2,0.00,2.00,11,0.14,3944.21,3,1,4,6,5,86.60,12,19,1,3,118.82,0.00,0.67,1.00,0,0.00,3,413.05,1,1,4,org.apache.solr.analysis.BaseTokenFilterFactory,0.00,4,2,4,0,4,1,0,1,89,1
"org.apache.solr.analysis.TurkishLowerCaseFilterFactory",2,0.00,1.00,5,0.03,391.36,2,0,2,3,5,123.85,11,9,1,3,141.73,0.00,0.67,0.00,0,2.00,1,103.73,0,2,4,org.apache.solr.analysis.BaseTokenFilterFactory,0.00,1,2,2,0,1,0,1,1,32,1
"org.apache.solr.analysis.TypeAsPayloadTokenFilterFactory",1,0.00,1.00,3,0.02,225.35,1,0,2,2,3,90.55,11,5,0,3,134.67,0.00,0.67,0.00,0,1.00,1,58.69,0,1,3,org.apache.solr.analysis.BaseTokenFilterFactory,0.00,1,2,1,0,1,0,0,1,19,1
"org.apache.solr.analysis.TypeTokenFilterFactory",4,0.44,2.00,26,0.32,10605.98,7,3,10,14,8,154.74,11,37,1,3,114.85,0.00,0.67,0.67,0,0.00,5,955.81,0,2,7,org.apache.solr.analysis.BaseTokenFilterFactory,0.00,10,2,8,0,10,2,1,1,187,1
"org.apache.solr.analysis.UAX29URLEmailTokenizerFactory",2,0.00,1.00,10,0.09,1599.37,3,1,4,4,4,104.19,11,15,1,3,122.07,0.00,0.67,1.00,0,0.00,1,279.24,2,1,3,org.apache.solr.analysis.BaseTokenizerFactory,0.00,2,2,2,0,2,1,0,1,68,1
"org.apache.solr.analysis.WhitespaceTokenizerFactory",2,0.00,1.00,6,0.05,786.43,2,0,3,3,3,114.90,10,10,1,3,132.77,0.00,0.67,0.00,0,2.00,1,155.94,2,1,2,org.apache.solr.analysis.BaseTokenizerFactory,0.00,1,2,2,0,1,1,0,1,43,1
"org.apache.solr.analysis.WikipediaTokenizerFactory",1,0.00,1.00,3,0.02,192.92,1,0,3,2,4,91.08,11,5,1,3,135.21,0.00,0.67,0.00,0,1.00,1,60.48,0,1,3,org.apache.solr.analysis.BaseTokenizerFactory,0.00,1,2,1,0,1,0,0,2,19,1
"org.apache.solr.analysis.WordDelimiterFilterFactory",6,0.11,7.50,98,1.54,78294.86,13,7,16,29,9,113.83,18,134,1,3,93.21,0.00,0.67,0.24,2,18.00,13,4627.01,2,3,8,org.apache.solr.analysis.BaseTokenFilterFactory,0.00,23,2,45,0,23,3,1,4,831,1
"org.apache.lucene.queryparser.util.QueryParserTestBase",60,0.48,1.37,657,9.71,291413.62,62,2,29,156,35,144.48,155,794,2,2,104.60,2.00,0.25,0.02,11,230.00,5,29144.51,2,7,33,org.apache.lucene.util.LuceneTestCase,0.00,96,1,82,2,96,53,0,123,5417,2
"org.apache.lucene.queryparser.util.QueryParserTestBase$Analyzer",1,0.00,1.00,3,0.04,595.79,1,0,29,3,1,131.35,0,5,0,1,131.35,0.00,0.00,0.00,0,1.00,1,112.25,0,1,1,java.lang.Object,0.00,2,0,1,0,2,0,0,0,29,0
"org.apache.lucene.queryparser.util.QueryParserTestBase$Analyzer1",1,0.00,1.00,4,0.06,1028.22,1,0,29,4,2,124.82,0,7,0,2,124.82,0.00,0.50,0.00,0,1.00,1,167.13,0,1,2,org.apache.lucene.queryparser.util.Analyzer,0.00,3,1,1,0,3,0,0,0,40,1
"org.apache.lucene.queryparser.util.QueryParserTestBase$Analyzer2",1,0.00,1.00,3,0.04,614.81,1,0,29,3,1,131.24,0,6,0,2,131.24,0.00,0.50,0.00,0,1.00,1,119.76,0,1,1,org.apache.lucene.queryparser.util.Analyzer,0.00,2,1,1,0,2,0,0,0,31,1
"org.apache.lucene.queryparser.util.QueryParserTestBase$MockAnalyzer",3,0.00,1.00,10,0.15,2865.59,3,0,29,5,4,129.73,2,16,0,1,129.73,0.00,0.00,0.00,0,3.00,1,436.33,1,3,4,java.lang.Object,0.00,2,0,3,0,2,0,0,2,100,0
"org.apache.lucene.queryparser.util.QueryParserTestBase$MockCollationAnalyzer",1,0.00,1.00,4,0.06,1028.22,1,0,29,4,2,124.82,0,7,0,2,124.82,0.00,0.50,0.00,0,1.00,1,167.13,0,1,2,org.apache.lucene.queryparser.util.Analyzer,0.00,3,1,1,0,3,0,0,0,40,1
"org.apache.lucene.queryparser.util.QueryParserTestBase$MockCollationFilter",2,1.00,1.50,11,0.10,2039.58,3,1,29,6,1,121.14,0,16,0,2,121.14,0.00,0.50,0.50,0,2.00,2,312.15,0,0,1,org.apache.lucene.index.TokenFilter,0.00,4,1,3,0,4,2,0,0,74,1
"org.apache.lucene.queryparser.util.QueryParserTestBase$MockSynonymFilter",2,0.33,2.00,18,0.16,3475.21,5,3,29,9,2,109.73,1,24,0,2,109.73,0.00,0.50,0.50,0,2.00,3,494.58,0,0,2,org.apache.lucene.index.TokenFilter,0.00,7,1,4,0,7,2,0,1,109,1
"org.apache.lucene.queryparser.util.QueryParserTestBase$QPTestAnalyzer",1,0.00,1.00,4,0.06,1069.20,1,0,29,4,2,174.69,1,7,0,2,124.69,0.00,0.50,0.00,0,1.00,1,175.62,0,1,2,org.apache.lucene.index.Analyzer,0.00,3,1,1,0,3,0,0,1,42,3
"org.apache.lucene.queryparser.util.QueryParserTestBase$QPTestFilter",2,1.00,3.00,26,0.27,8254.38,7,5,29,11,2,140.61,4,33,0,2,100.72,0.00,0.50,0.70,0,0.00,5,822.80,0,0,2,org.apache.lucene.index.TokenFilter,0.00,9,1,6,0,9,2,0,1,169,3
"org.apache.lucene.queryparser.util.QueryParserTestBase$QPTestParser",3,0.00,1.00,7,0.08,1090.71,3,0,29,4,3,139.61,0,13,0,3,139.61,0.00,0.67,0.00,0,3.00,1,239.82,0,2,3,org.apache.lucene.queryparser.classic.QueryParser,0.00,1,2,3,0,1,1,0,0,63,2
"org.apache.lucene.queryparser.util.QueryParserTestBase$SimpleCJKAnalyzer",1,0.00,1.00,3,0.03,425.86,1,0,29,3,0,132.50,0,6,0,2,132.50,0.00,0.50,0.00,0,1.00,1,97.55,0,1,0,org.apache.lucene.index.Analyzer,0.00,2,1,1,0,2,0,0,0,27,1
"org.apache.lucene.queryparser.util.QueryParserTestBase$SimpleCJKTokenizer",2,1.00,1.50,10,0.10,1712.34,3,1,29,6,2,121.74,0,15,0,4,121.74,0.00,0.75,0.50,0,2.00,2,297.37,0,0,2,org.apache.lucene.analysis.Tokenizer,0.25,4,3,3,0,4,2,0,0,70,1
"org.apache.lucene.queryparser.util.QueryParserTestBase$SmartQueryParser",2,1.00,1.50,6,0.09,1834.17,3,1,29,4,3,129.78,0,14,0,3,129.78,0.00,0.67,0.50,0,2.00,2,260.37,1,1,3,org.apache.lucene.queryparser.classic.QueryParser,0.00,2,2,3,0,2,1,0,0,64,1
"org.apache.solr.client.solrj.util.ClientUtils",10,3.00,3.20,94,1.45,71346.95,13,3,22,49,26,105.03,49,128,16,1,104.79,0.00,0.00,0.00,1,10.00,9,4360.19,0,8,10,java.lang.Object,0.00,39,0,32,0,39,2,0,17,819,1
"org.apache.solr.client.solrj.util.ClientUtilsTest",1,0.00,1.00,7,0.07,1113.60,1,0,1,3,1,97.61,5,10,0,2,115.48,0.00,0.50,0.00,0,1.00,1,224.01,0,0,1,org.apache.lucene.util.LuceneTestCase,0.00,2,1,1,0,2,1,0,1,56,1
"org.apache.lucene.store.AlreadyClosedException",1,0.00,1.00,3,0.02,106.02,1,0,0,1,31,170.64,20,5,31,2,137.25,0.00,0.50,0.00,0,1.00,1,45.51,0,0,0,java.lang.IllegalStateException,0.00,0,1,1,0,0,1,0,2,16,1
"org.apache.lucene.store.BufferedIndexInput",24,0.15,2.62,187,2.64,216766.49,31,7,2,29,18,147.99,64,258,16,3,108.10,3.00,0.22,0.29,6,30.00,11,7931.51,6,1,3,org.apache.lucene.store.IndexInput,0.86,5,2,63,6,5,23,0,44,1565,2
"org.apache.lucene.store.BufferedIndexOutput",9,0.12,1.89,46,0.51,34493.44,13,4,1,10,2,116.80,41,68,1,3,116.56,0.50,0.50,0.36,2,8.00,8,1534.91,0,0,1,org.apache.lucene.store.IndexOutput,0.81,1,2,17,1,1,9,0,21,330,2
"org.apache.lucene.store.ByteArrayDataInput",19,0.17,1.74,108,1.43,117487.62,22,3,2,21,28,114.94,11,138,26,2,114.94,0.00,0.50,0.49,2,0.00,10,4276.06,0,0,2,org.apache.lucene.store.DataInput,0.47,2,1,33,0,2,19,0,6,900,2
"org.apache.lucene.store.ByteArrayDataOutput",8,0.05,1.00,25,0.22,3995.07,11,3,1,9,10,131.95,6,36,8,2,131.95,0.00,0.50,0.38,1,8.00,1,666.19,0,0,2,org.apache.lucene.store.DataOutput,0.21,1,1,8,0,1,8,0,1,170,1
"org.apache.lucene.store.ChecksumIndexInput",8,0.07,1.00,24,0.22,3771.61,10,2,3,17,5,132.15,5,40,4,3,132.15,0.00,0.67,0.56,0,0.00,1,658.17,0,0,1,org.apache.lucene.store.IndexInput,0.69,9,2,8,0,9,8,0,1,171,1
"org.apache.lucene.store.ChecksumIndexOutput",11,0.05,1.00,32,0.30,4775.52,13,2,3,23,4,189.00,17,51,3,3,139.00,0.00,0.67,0.55,1,0.00,1,899.78,0,0,1,org.apache.lucene.store.IndexOutput,0.75,12,2,11,0,12,11,0,8,232,1
"org.apache.lucene.store.CompoundFileDirectory",17,0.05,2.24,168,2.21,131854.89,25,8,9,54,21,144.48,34,222,11,2,104.59,0.00,0.50,0.17,0,66.00,8,6638.64,1,8,10,org.apache.lucene.store.Directory,0.18,37,1,38,0,37,9,0,23,1218,2
"org.apache.lucene.store.CompoundFileDirectory$FileEntry",0,0.00,0.00,3,0.02,186.86,2,2,9,0,0,171.00,0,4,0,1,171.00,0.00,0.00,0.00,0,0.00,0,49.83,0,0,0,java.lang.Object,0.00,0,0,0,0,0,0,0,0,15,3
"org.apache.lucene.store.CompoundFileDirectory$IndexInputSlicer",3,0.00,1.00,6,0.08,1379.15,3,0,9,3,1,138.80,0,12,0,1,138.80,0.00,0.00,0.00,1,4.00,1,242.70,0,0,1,java.lang.Object,0.00,0,0,3,0,0,3,0,0,62,0
"org.apache.lucene.store.CompoundFileWriter",15,0.07,2.33,141,1.80,73395.52,29,14,14,58,8,126.77,57,196,1,1,106.16,0.00,0.00,0.14,6,64.00,6,5407.68,0,5,7,java.lang.Object,0.00,43,0,35,0,43,10,1,18,1020,1
"org.apache.lucene.store.CompoundFileWriter$DirectCFSIndexOutput",8,0.31,1.25,41,0.37,6947.48,14,6,14,17,1,121.73,3,60,0,3,121.73,0.00,0.67,0.44,0,0.00,3,1115.27,0,0,1,org.apache.lucene.store.IndexOutput,0.84,9,2,10,0,9,8,0,3,264,2
"org.apache.lucene.store.CompoundFileWriter$FileEntry",0,0.00,0.00,5,0.03,295.55,4,4,14,0,1,171.00,3,6,0,1,171.00,0.00,0.00,0.00,0,0.00,0,87.57,0,0,1,java.lang.Object,0.00,0,0,0,0,0,0,0,3,23,3
"org.apache.lucene.store.DataInput",11,0.00,2.45,78,1.03,69226.25,11,0,4,15,43,67.06,78,92,42,1,109.35,0.00,0.00,0.00,5,11.00,10,3086.19,1,3,1,java.lang.Object,0.00,4,0,27,22,4,8,1,15,660,2
"org.apache.lucene.store.DataOutput",11,0.45,1.64,53,0.65,21884.89,13,2,4,18,27,143.07,41,71,24,1,122.45,0.00,0.00,0.09,5,20.00,4,1964.63,0,0,3,java.lang.Object,0.00,7,0,18,16,7,11,0,11,436,2
"org.apache.lucene.store.Directory",17,0.44,1.18,43,0.46,8323.00,19,2,6,26,534,96.26,135,63,528,1,138.55,0.00,0.00,0.09,3,58.00,2,1367.23,1,4,7,java.lang.Object,0.00,9,0,20,19,9,13,1,20,336,2
"org.apache.lucene.store.Directory$IndexInputSlicer",3,0.00,1.00,8,0.11,1729.02,4,1,6,7,2,138.03,0,14,0,1,138.03,0.00,0.00,1.00,0,0.00,1,334.47,0,0,2,java.lang.Object,0.00,4,0,3,0,4,3,0,0,83,0
"org.apache.lucene.store.Directory$IndexInputSlicer_0",2,0.00,1.00,3,0.03,254.83,2,0,6,2,1,175.04,7,4,0,1,154.42,0.00,0.00,0.00,0,2.00,1,95.46,0,0,1,java.lang.Object,0.00,0,0,2,0,0,2,1,2,29,2
"org.apache.lucene.store.Directory$SlicedIndexInput",8,0.14,1.38,35,0.46,11468.06,11,3,6,14,3,173.61,14,51,0,4,123.61,0.00,0.75,0.46,0,2.00,3,1382.30,2,1,3,org.apache.lucene.store.BufferedIndexInput,0.48,6,3,11,0,6,7,0,6,309,3
"org.apache.lucene.store.FSDirectory",25,0.06,2.24,142,1.79,64337.99,30,5,12,68,41,75.59,193,206,31,2,117.88,5.00,0.14,0.14,4,195.00,7,5378.22,2,9,13,org.apache.lucene.store.Directory,0.24,43,1,56,5,43,16,0,36,1120,2
"org.apache.lucene.store.FSDirectory$FSIndexOutput",6,0.20,1.67,37,0.37,8428.18,11,5,12,15,3,117.07,5,56,0,4,117.07,0.00,0.75,0.37,0,0.00,4,1115.97,2,0,3,org.apache.lucene.store.BufferedIndexOutput,0.62,9,3,10,0,9,6,0,5,249,2
"org.apache.lucene.store.FSDirectory$FilenameFilter",1,0.00,1.00,3,0.03,458.50,1,0,12,3,0,132.24,0,4,0,1,132.24,0.00,0.00,0.00,0,1.00,1,86.14,0,0,0,java.lang.Object,0.00,2,0,1,0,2,1,0,0,24,0
"org.apache.lucene.store.FSLockFactory",2,1.00,1.50,7,0.06,1213.45,3,1,1,3,5,83.09,16,11,4,2,131.19,2.00,0.25,0.50,0,2.00,2,190.50,0,1,1,org.apache.lucene.store.LockFactory,0.00,1,1,3,2,1,1,0,4,49,2
"org.apache.lucene.store.FileSwitchDirectory",14,0.06,1.86,69,0.81,34760.22,18,4,6,34,6,171.66,25,110,1,2,121.66,0.00,0.50,0.20,2,38.00,8,2437.01,0,8,5,org.apache.lucene.store.Directory,0.13,20,1,26,0,20,6,0,14,538,1
"org.apache.lucene.store.FlushInfo",4,0.33,2.25,22,0.24,7242.66,6,2,0,5,8,86.86,27,37,8,1,119.09,0.00,0.00,0.75,0,0.00,6,728.92,0,1,0,java.lang.Object,0.00,1,0,9,0,1,3,0,3,171,1
"org.apache.lucene.store.IOContext",10,0.03,2.50,62,0.76,30182.32,17,7,0,17,167,134.98,34,86,165,1,114.36,0.00,0.00,0.17,0,22.00,12,2288.26,0,1,2,java.lang.Object,0.00,7,0,25,0,7,9,0,5,510,1
"org.apache.lucene.store.IOContext$Context",0,0.00,0.00,2,0.01,57.06,0,0,0,0,0,171.00,0,3,0,1,171.00,0.00,0.00,0.00,0,0.00,0,28.53,0,0,0,java.lang.Object,0.00,0,0,0,0,0,0,0,0,9,1
"org.apache.lucene.store.IndexInput",7,1.00,1.43,20,0.22,8593.04,8,1,2,9,180,155.98,27,27,178,2,135.36,16.00,0.06,0.14,0,12.00,3,667.96,1,1,3,org.apache.lucene.store.DataInput,0.00,2,1,10,16,2,6,2,7,155,2
"org.apache.lucene.store.IndexOutput",6,0.00,1.00,7,0.06,436.71,6,0,2,6,114,156.57,25,8,113,2,156.34,10.00,0.08,0.00,0,6.00,1,177.79,0,0,1,org.apache.lucene.store.DataOutput,0.00,0,1,6,10,0,6,1,7,58,2
"org.apache.lucene.store.InputStreamDataInput",4,0.33,1.75,17,0.19,6864.24,5,1,2,7,8,172.94,4,27,7,2,122.94,0.00,0.50,0.75,0,0.00,3,571.33,0,0,1,org.apache.lucene.store.DataInput,0.27,3,1,7,0,3,4,1,2,129,1
"org.apache.lucene.store.Lock",4,0.11,2.50,28,0.34,19599.75,7,3,2,10,28,61.73,41,37,26,1,110.21,0.00,0.00,0.25,1,6.00,7,1012.61,0,0,2,java.lang.Object,0.00,6,0,10,8,6,4,0,9,197,2
"org.apache.lucene.store.Lock$With",3,0.25,1.33,13,0.11,1805.78,5,2,2,5,2,147.20,10,19,0,1,126.59,0.00,0.00,0.33,1,4.00,2,320.43,0,2,2,java.lang.Object,0.00,2,0,4,0,2,1,0,3,81,3
"org.apache.lucene.store.LockFactory",4,1.00,1.00,8,0.06,564.89,5,1,1,4,17,92.84,36,11,16,1,142.84,0.00,0.00,0.00,0,4.00,1,176.92,0,2,1,java.lang.Object,0.00,0,0,4,8,0,2,0,5,53,2
"org.apache.lucene.store.LockObtainFailedException",1,0.00,1.00,3,0.02,106.02,1,0,1,1,32,94.96,7,5,32,2,137.25,0.00,0.50,0.00,0,1.00,1,45.51,0,0,0,java.io.IOException,0.00,0,1,1,0,0,1,0,1,16,1
"org.apache.lucene.store.LockReleaseFailedException",1,0.00,1.00,3,0.02,106.02,1,0,1,1,4,119.38,5,5,4,2,137.25,0.00,0.50,0.00,0,1.00,1,45.51,0,0,0,java.io.IOException,0.00,0,1,1,0,0,1,0,1,16,1
"org.apache.lucene.store.LockStressTest",1,0.00,11.00,36,0.74,45735.51,1,0,2,17,5,27.59,8,64,0,1,75.70,0.00,0.00,0.00,0,1.00,11,2208.03,0,0,5,java.lang.Object,0.00,16,0,11,0,16,1,0,1,331,1
"org.apache.lucene.store.LockVerifyServer",2,0.00,4.50,36,0.57,33684.68,2,0,5,18,0,72.67,10,47,0,1,90.55,0.00,0.00,0.00,1,2.00,8,1721.18,0,1,0,java.lang.Object,0.00,16,0,9,0,16,1,0,2,290,1
"org.apache.lucene.store.MMapDirectory",9,0.06,1.44,50,0.56,13002.70,13,4,17,22,10,75.83,103,72,6,3,119.96,0.00,0.67,0.19,1,46.00,3,1674.52,2,1,5,org.apache.lucene.store.FSDirectory,0.00,13,2,13,0,13,8,0,15,367,1
"org.apache.lucene.store.MMapDirectory$IndexInputSlicer",3,0.00,1.00,7,0.12,2029.63,3,0,17,6,1,137.48,0,13,0,1,137.48,0.00,0.00,0.00,1,4.00,1,357.49,0,0,1,java.lang.Object,0.00,3,0,3,0,3,3,0,0,84,0
"org.apache.lucene.store.MMapDirectory$MMapIndexInput",14,0.09,3.07,134,1.81,98431.14,23,9,17,37,2,104.85,11,192,0,3,104.85,0.00,0.67,0.20,3,6.00,6,5420.65,4,1,2,org.apache.lucene.store.IndexInput,0.94,23,2,43,0,23,13,0,11,1016,2
"org.apache.lucene.store.MMapDirectory$PrivilegedExceptionAction<Object>",1,0.00,2.00,8,0.10,2648.16,1,0,17,7,0,110.20,0,12,0,1,110.20,0.00,0.00,0.00,0,1.00,2,292.28,0,1,0,java.lang.Object,0.00,6,0,2,0,6,0,0,0,65,0
"org.apache.lucene.store.MergeInfo",4,0.67,3.00,30,0.37,12340.06,8,4,0,5,5,79.52,27,48,5,1,111.75,0.00,0.00,0.75,0,0.00,8,1109.09,0,1,0,java.lang.Object,0.00,1,0,12,0,1,3,0,3,248,1
"org.apache.lucene.store.MockDirectoryWrapper",56,0.02,2.25,373,5.24,280143.51,82,26,21,156,83,162.66,109,509,70,2,112.66,3.00,0.20,0.06,13,1382.00,12,15731.19,0,5,16,org.apache.lucene.store.Directory,0.16,100,1,126,3,100,51,0,60,2902,1
"org.apache.lucene.store.MockDirectoryWrapper$Failure",4,0.67,1.00,9,0.05,354.80,5,1,21,4,1,144.67,16,11,0,1,144.43,0.00,0.00,0.50,0,4.00,1,141.29,0,1,1,java.lang.Object,0.00,0,0,4,0,0,3,0,2,45,2
"org.apache.lucene.store.MockDirectoryWrapper$Handle",0,0.00,0.00,2,0.01,48.00,0,0,21,0,0,171.00,0,3,0,1,171.00,0.00,0.00,0.00,0,0.00,0,24.00,0,0,0,java.lang.Object,0.00,0,0,0,0,0,0,0,0,8,2
"org.apache.lucene.store.MockDirectoryWrapper$IndexInputSlicer",3,1.00,1.33,17,0.19,4112.57,4,1,21,10,3,120.16,0,24,0,1,120.16,0.00,0.00,0.33,0,4.00,2,583.94,0,0,3,java.lang.Object,0.00,7,0,4,0,7,3,0,0,129,0
"org.apache.lucene.store.MockDirectoryWrapper$Throttling",0,0.00,0.00,2,0.01,48.00,0,0,21,0,0,171.00,1,5,0,1,171.00,0.00,0.00,0.00,0,0.00,0,24.00,0,0,0,java.lang.Object,0.00,0,0,0,0,0,0,0,1,8,2
"org.apache.lucene.store.MockIndexInputWrapper",19,0.06,1.11,71,0.65,11150.62,24,5,2,38,5,171.26,41,113,3,3,131.38,0.00,0.67,0.25,1,0.00,2,1936.52,0,4,3,org.apache.lucene.store.IndexInput,1.38,19,2,21,0,19,15,0,13,477,1
"org.apache.lucene.store.MockIndexOutputWrapper",11,0.12,2.09,71,0.98,63571.78,16,5,2,32,3,162.18,17,106,1,3,112.18,0.00,0.67,0.31,1,0.00,11,2939.76,0,1,3,org.apache.lucene.store.IndexOutput,0.96,21,2,23,0,21,10,0,12,562,1
"org.apache.lucene.store.MockLockFactoryWrapper",6,0.00,1.00,18,0.17,2575.12,8,2,1,13,3,132.47,4,30,1,2,132.47,0.00,0.50,0.50,0,0.00,1,512.05,0,2,3,org.apache.lucene.store.LockFactory,0.20,7,1,6,0,7,4,0,1,136,1
"org.apache.lucene.store.MockLockFactoryWrapper$MockLock",4,0.17,1.25,17,0.14,2008.66,6,2,1,9,1,127.22,0,26,0,2,127.22,0.00,0.50,0.62,0,0.00,2,417.42,0,0,1,org.apache.lucene.store.Lock,0.75,5,1,5,0,5,4,0,0,107,1
"org.apache.lucene.store.NIOFSDirectory",4,0.00,1.00,14,0.16,2183.27,4,0,8,8,8,81.65,38,21,5,3,131.65,0.00,0.67,0.00,0,4.00,1,465.10,2,1,4,org.apache.lucene.store.FSDirectory,0.00,4,2,4,0,4,3,0,4,113,1
"org.apache.lucene.store.NIOFSDirectory$Directory.IndexInputSlicer",3,0.00,1.00,7,0.11,1698.52,3,0,8,7,2,138.09,0,14,0,1,138.09,0.00,0.00,0.00,1,3.00,1,320.86,0,0,2,java.lang.Object,0.00,4,0,3,0,4,3,0,0,77,0
"org.apache.lucene.store.NIOFSDirectory$NIOFSIndexInput",5,0.12,2.40,49,0.70,45143.59,7,2,8,19,1,154.05,8,71,0,2,104.05,0.00,0.50,0.60,0,0.00,7,2090.85,1,0,1,SimpleFSDirectory.SimpleFSIndexInput,0.00,14,1,12,0,14,5,0,8,385,2
"org.apache.lucene.store.NRTCachingDirectory",20,0.17,2.20,119,1.44,49771.22,26,6,7,55,14,138.62,68,181,3,2,118.00,0.00,0.50,0.32,2,0.00,6,4314.79,1,6,11,org.apache.lucene.store.Directory,0.32,35,1,44,0,35,14,0,31,912,1
"org.apache.lucene.store.NativeFSLock",6,0.30,4.17,82,0.86,49000.87,12,6,6,25,3,48.31,54,135,1,2,98.31,0.00,0.50,0.42,3,0.00,13,2569.58,0,1,2,org.apache.lucene.store.Lock,0.60,19,1,25,0,19,5,0,36,489,0
"org.apache.lucene.store.NativeFSLockFactory",5,0.00,1.60,16,0.17,3732.97,5,0,6,10,8,86.34,58,27,5,3,130.47,0.00,0.67,0.00,1,7.00,3,520.24,1,1,3,org.apache.lucene.store.FSLockFactory,0.00,5,2,8,0,5,4,0,14,125,1
"org.apache.lucene.store.NativePosixUtil",6,6.00,1.17,18,0.25,4279.56,12,6,3,7,2,130.70,0,22,2,1,130.70,0.00,0.00,0.00,1,6.00,2,742.94,0,1,0,java.lang.Object,0.00,1,0,7,0,1,5,0,0,179,2
"org.apache.lucene.store.NativeUnixDirectory",4,0.19,1.75,32,0.48,13732.85,11,7,10,11,5,98.98,61,42,0,3,109.34,0.00,0.67,0.29,0,8.00,2,1437.92,3,0,5,org.apache.lucene.store.FSDirectory,0.00,7,2,7,0,7,4,0,12,288,1
"org.apache.lucene.store.NativeUnixDirectory$NativeUnixIndexInput",10,0.36,2.10,89,0.96,31898.25,18,8,10,31,2,159.55,12,123,0,3,109.55,0.00,0.67,0.45,2,0.00,3,2890.02,0,1,2,org.apache.lucene.store.IndexInput,0.75,21,2,21,0,21,9,0,12,590,3
"org.apache.lucene.store.NativeUnixDirectory$NativeUnixIndexOutput",9,0.30,1.78,74,0.84,33390.57,17,8,10,25,2,148.96,25,104,0,3,109.07,0.00,0.67,0.39,1,0.00,3,2520.68,0,0,2,org.apache.lucene.store.IndexOutput,0.81,16,2,16,0,16,9,0,25,517,3
"org.apache.lucene.store.NoLock",4,0.00,1.00,8,0.05,547.10,4,0,1,4,2,142.95,0,17,1,2,142.95,0.00,0.50,0.00,0,4.00,1,153.76,0,1,1,org.apache.lucene.store.Lock,0.75,0,1,4,0,0,3,0,0,48,0
"org.apache.lucene.store.NoLockFactory",4,0.33,1.00,9,0.07,1149.42,6,2,1,6,8,180.30,8,14,5,2,140.41,0.00,0.50,0.25,0,8.00,1,216.41,0,2,3,org.apache.lucene.store.LockFactory,0.00,2,1,4,0,2,2,0,2,62,1
"org.apache.lucene.store.NoSuchDirectoryException",1,0.00,1.00,3,0.02,106.02,1,0,1,1,9,137.49,4,5,9,2,137.25,0.00,0.50,0.00,0,1.00,1,45.51,0,0,0,java.io.FileNotFoundException,0.00,0,1,1,0,0,1,0,1,16,1
"org.apache.lucene.store.OutputStreamDataOutput",4,0.33,1.00,10,0.11,1575.65,5,1,1,6,7,139.33,3,18,6,2,139.33,0.00,0.50,0.75,0,0.00,1,321.97,0,0,1,org.apache.lucene.store.DataOutput,0.27,2,1,4,0,2,4,1,1,84,1
"org.apache.lucene.store.RAMDirectory",13,0.12,1.62,64,0.70,18854.32,15,2,9,35,60,144.15,47,91,53,2,123.54,2.00,0.25,0.38,1,9.00,3,2101.62,2,3,8,org.apache.lucene.store.Directory,0.13,22,1,21,2,22,10,0,17,462,1
"org.apache.lucene.store.RAMFile",9,0.06,1.11,28,0.23,4795.86,13,4,1,13,6,181.71,9,38,6,1,131.71,0.00,0.00,0.19,1,28.00,2,684.14,0,0,1,java.lang.Object,0.00,4,0,10,1,4,9,0,4,173,1
"org.apache.lucene.store.RAMInputStream",9,0.39,2.44,69,0.83,39204.61,17,8,2,15,8,110.61,8,95,4,3,110.61,0.00,0.67,0.47,1,0.00,4,2482.90,0,0,4,org.apache.lucene.store.IndexInput,0.78,6,2,22,0,6,9,1,6,491,1
"org.apache.lucene.store.RAMOutputStream",16,0.29,1.94,104,1.07,44872.60,23,7,1,24,18,164.67,17,142,15,3,114.67,0.00,0.67,0.41,3,0.00,4,3205.61,0,0,3,org.apache.lucene.store.IndexOutput,0.73,8,2,31,0,8,16,0,12,671,1
"org.apache.lucene.store.RateLimiter",4,0.11,2.00,25,0.26,13186.38,7,3,1,7,3,81.89,26,35,2,1,114.11,0.00,0.00,0.25,1,4.00,5,777.32,0,0,1,java.lang.Object,0.00,3,0,8,0,3,4,0,12,166,1
"org.apache.lucene.store.SimpleFSDirectory",4,0.00,1.00,15,0.18,3189.44,4,0,5,9,11,130.59,19,21,8,3,130.35,0.00,0.67,0.00,0,6.00,1,532.10,2,2,4,org.apache.lucene.store.FSDirectory,0.00,5,2,4,0,5,2,0,4,124,1
"org.apache.lucene.store.SimpleFSDirectory$IndexInputSlicer",3,0.00,1.00,7,0.14,2461.57,3,0,5,7,2,136.82,0,14,0,1,136.82,0.00,0.00,0.00,1,3.00,1,409.44,0,2,2,java.lang.Object,0.00,4,0,3,0,4,1,0,0,92,0
"org.apache.lucene.store.SimpleFSDirectory$SimpleFSIndexInput",9,0.02,1.67,58,0.72,36231.98,14,5,5,21,3,163.47,11,86,0,4,113.47,0.00,0.75,0.22,0,16.00,6,2151.04,1,1,3,org.apache.lucene.store.BufferedIndexInput,0.39,12,3,15,0,12,8,0,9,436,2
"org.apache.lucene.store.SimpleFSDirectory$SimpleFSIndexInput$Descriptor",2,0.33,1.50,12,0.09,1358.75,5,3,5,2,0,169.58,2,17,0,2,119.58,0.00,0.50,0.50,0,0.00,2,273.95,1,0,0,java.io.RandomAccessFile,0.00,0,1,3,0,0,2,0,2,69,2
"org.apache.lucene.store.SimpleFSLock",5,0.12,1.80,18,0.22,5633.91,7,2,2,14,3,129.03,2,33,1,2,129.03,0.00,0.50,0.60,0,0.00,4,651.51,0,1,2,org.apache.lucene.store.Lock,0.67,9,1,9,0,9,4,0,2,155,0
"org.apache.lucene.store.SimpleFSLockFactory",5,0.00,1.80,18,0.20,5735.12,5,0,2,10,8,78.97,45,30,5,3,128.97,0.00,0.67,0.00,0,7.00,4,594.31,1,1,3,org.apache.lucene.store.FSLockFactory,0.00,5,2,9,0,5,4,0,4,139,1
"org.apache.lucene.store.SingleInstanceLock",5,0.25,1.00,17,0.15,2520.69,7,2,2,8,2,131.92,0,30,1,2,131.92,0.00,0.50,0.70,0,0.00,1,445.66,1,1,1,org.apache.lucene.store.Lock,0.67,3,1,5,0,3,4,0,0,117,0
"org.apache.lucene.store.SingleInstanceLockFactory",2,0.00,1.50,8,0.09,1813.75,3,1,2,6,6,92.94,13,15,3,2,125.16,0.00,0.50,1.00,0,0.00,2,273.82,0,0,3,org.apache.lucene.store.LockFactory,0.00,4,1,3,0,4,2,0,4,68,1
"org.apache.lucene.store.TestBufferedIndexInput",9,0.31,2.78,146,1.91,103857.03,11,2,24,52,14,114.47,35,168,0,2,93.86,0.00,0.50,0.22,5,18.00,7,5730.88,0,0,14,org.apache.lucene.util.LuceneTestCase,0.00,43,1,25,0,43,9,0,35,1034,1
"org.apache.lucene.store.TestBufferedIndexInput$MockFSDirectory",10,0.04,1.10,32,0.38,6889.65,13,3,24,25,7,130.83,5,57,0,2,130.83,0.00,0.50,0.37,0,0.00,2,1126.05,0,3,7,org.apache.lucene.store.Directory,0.15,15,1,11,0,15,7,0,5,268,2
"org.apache.lucene.store.TestBufferedIndexInput$MyBufferedIndexInput",6,0.50,1.17,20,0.18,3573.88,8,2,24,6,1,131.31,1,28,0,4,131.31,0.00,0.75,0.08,0,10.00,2,537.99,0,0,1,org.apache.lucene.store.BufferedIndexInput,0.33,0,3,7,0,0,6,0,1,136,2
"org.apache.lucene.store.TestByteArrayDataInput",1,0.00,1.00,8,0.10,2648.22,1,0,1,5,1,110.36,0,10,0,2,110.36,0.00,0.50,0.00,0,1.00,1,286.92,0,0,1,org.apache.lucene.util.LuceneTestCase,0.00,4,1,1,0,4,1,0,0,66,1
"org.apache.lucene.store.TestCopyBytes",3,0.00,5.33,102,1.43,125258.77,3,0,4,31,5,116.99,7,104,0,2,77.10,0.00,0.50,0.00,1,3.00,10,4297.25,0,0,5,org.apache.lucene.util.LuceneTestCase,0.00,28,1,16,0,28,3,0,7,713,1
"org.apache.lucene.store.TestCopyBytes$CopyThread",2,0.00,1.50,11,0.10,1733.90,4,2,4,6,2,121.70,0,17,0,2,121.70,0.00,0.50,0.50,0,2.00,2,294.98,0,0,2,org.apache.lucene.store.Thread,0.00,4,1,3,0,4,2,0,0,73,1
"org.apache.lucene.store.TestDirectory",8,0.00,2.25,108,1.38,84083.64,8,0,5,44,12,147.59,14,121,0,2,97.59,0.00,0.50,0.00,1,8.00,8,4136.30,0,0,12,org.apache.lucene.util.LuceneTestCase,0.00,36,1,18,0,36,8,0,14,742,1
"org.apache.lucene.store.TestFileSwitchDirectory",6,0.00,2.00,86,1.24,46881.56,6,0,14,53,16,118.05,18,95,0,2,97.43,0.00,0.50,0.00,2,6.00,4,3706.18,0,1,16,org.apache.lucene.util.LuceneTestCase,0.00,47,1,12,0,47,5,0,12,667,1
"org.apache.lucene.store.TestHugeRamFile",1,1.00,8.00,57,0.72,79886.22,2,1,3,12,2,18.31,8,48,0,2,66.42,0.00,0.50,0.00,0,1.00,8,2148.13,0,0,2,org.apache.lucene.util.LuceneTestCase,0.00,11,1,8,0,11,1,0,7,369,1
"org.apache.lucene.store.TestHugeRamFile$DenseRAMFile",1,0.00,3.00,12,0.16,6226.52,3,2,3,4,1,121.23,3,17,0,2,100.61,0.00,0.50,1.00,0,0.00,3,471.85,0,0,1,org.apache.lucene.store.RAMFile,0.20,3,1,3,0,3,1,0,3,101,2
"org.apache.lucene.store.TestLock",1,0.00,2.00,9,0.08,1329.35,1,0,2,5,1,110.65,0,13,0,2,110.65,0.00,0.50,0.00,0,1.00,2,247.01,0,0,1,org.apache.lucene.util.LuceneTestCase,0.00,4,1,2,0,4,1,0,0,57,1
"org.apache.lucene.store.TestLock$LockMock",3,1.00,1.00,8,0.05,517.34,4,1,2,3,1,142.16,1,15,0,2,142.16,0.00,0.50,0.33,0,4.00,1,145.73,0,0,1,org.apache.lucene.store.Lock,0.86,0,1,3,0,0,3,0,1,44,1
"org.apache.lucene.store.TestLockFactory",12,0.00,1.75,130,1.75,50963.57,12,0,18,60,24,144.88,33,158,0,2,105.00,0.00,0.50,0.00,1,12.00,3,5247.36,0,0,24,org.apache.lucene.util.LuceneTestCase,0.00,48,1,21,0,48,12,0,33,1017,1
"org.apache.lucene.store.TestLockFactory$MockLockFactory",4,0.11,1.00,18,0.20,3751.25,7,3,18,12,5,125.14,0,26,0,2,125.14,0.00,0.50,0.25,0,8.00,1,609.14,1,1,5,org.apache.lucene.store.LockFactory,0.00,8,1,4,0,8,3,0,0,140,1
"org.apache.lucene.store.TestLockFactory$MockLockFactory$MockLock",3,1.00,1.00,8,0.05,494.89,4,1,18,3,1,142.31,1,15,0,2,142.31,0.00,0.50,0.33,0,4.00,1,144.06,0,0,1,org.apache.lucene.store.Lock,0.86,0,1,3,0,0,3,0,1,44,1
"org.apache.lucene.store.TestLockFactory$SearcherThread",2,0.00,3.00,34,0.39,16782.34,5,3,18,11,6,93.95,1,42,0,2,93.95,0.00,0.50,0.33,0,2.00,5,1166.98,0,0,6,org.apache.lucene.analysis.Thread,0.00,9,1,6,0,9,2,0,1,219,1
"org.apache.lucene.store.TestLockFactory$WriterThread",2,0.00,4.50,38,0.48,31826.85,5,3,18,12,4,110.48,6,49,0,2,89.87,0.00,0.50,0.33,0,2.00,8,1434.88,0,0,4,org.apache.lucene.analysis.Thread,0.00,10,1,9,0,10,2,0,6,260,1
"org.apache.lucene.store.TestMultiMMap",7,0.83,2.71,127,1.68,69645.45,8,1,12,49,14,132.35,14,126,0,2,92.46,0.00,0.50,0.29,0,13.00,4,5042.56,1,0,14,org.apache.lucene.util.LuceneTestCase,0.00,42,1,19,0,42,7,0,8,900,1
"org.apache.lucene.store.TestNRTCachingDirectory",7,0.00,2.57,97,1.45,59623.31,7,0,22,59,22,138.17,15,113,0,2,98.28,0.00,0.50,0.00,1,7.00,9,4340.65,0,0,22,org.apache.lucene.util.LuceneTestCase,0.00,52,1,18,0,52,7,0,12,755,1
"org.apache.lucene.store.TestRAMDirectory",7,0.00,2.00,98,1.24,39592.20,11,4,13,47,15,138.42,16,97,0,2,98.54,0.00,0.50,0.25,1,3.00,4,3710.20,2,0,15,org.apache.lucene.util.LuceneTestCase,0.00,40,1,14,0,40,7,0,13,704,1
"org.apache.lucene.store.TestRAMDirectory$Thread",1,0.00,3.00,11,0.13,4188.85,1,0,13,8,3,103.38,0,13,0,1,103.38,0.00,0.00,0.00,0,0.00,3,383.26,0,0,3,java.lang.Object,0.00,7,0,3,0,7,1,0,0,75,0
"org.apache.lucene.store.TestWindowsMMap",5,0.38,2.00,53,0.59,15594.21,7,2,11,31,9,156.02,6,58,0,2,106.02,0.00,0.50,0.20,3,11.00,3,1759.12,1,2,9,org.apache.lucene.util.LuceneTestCase,0.00,26,1,10,0,26,3,0,6,347,1
"org.apache.lucene.store.VerifyingLockFactory",3,0.12,1.00,15,0.15,2461.31,7,4,4,6,3,79.69,21,22,1,2,121.98,0.00,0.50,0.17,0,1.00,1,435.22,0,1,2,org.apache.lucene.store.LockFactory,0.00,3,1,3,0,3,2,0,2,107,1
"org.apache.lucene.store.VerifyingLockFactory$CheckedLock",6,0.40,1.67,29,0.32,7709.26,7,1,4,18,2,123.94,0,47,0,2,123.94,0.00,0.50,0.67,2,2.00,3,952.89,0,0,2,org.apache.lucene.store.Lock,0.80,12,1,10,0,12,6,0,0,211,1
"org.apache.lucene.store.WindowsDirectory",7,1.00,1.00,16,0.20,2496.57,8,1,5,11,8,121.80,35,22,1,3,139.67,0.00,0.67,0.14,0,12.00,1,585.69,2,0,7,org.apache.lucene.store.FSDirectory,0.00,4,2,7,0,4,7,0,9,149,1
"org.apache.lucene.store.WindowsDirectory$WindowsIndexInput",6,0.10,1.50,28,0.32,8570.42,10,4,5,14,2,123.60,1,44,0,4,123.60,0.00,0.75,0.33,0,6.00,3,970.73,1,1,2,org.apache.lucene.store.BufferedIndexInput,0.42,8,3,9,0,8,5,0,1,218,2
"org.apache.lucene.store._TestHelper",3,0.00,1.67,14,0.10,1978.43,3,0,2,4,2,108.35,16,22,1,1,126.22,0.00,0.00,0.00,1,3.00,2,314.30,0,0,1,java.lang.Object,0.00,1,0,5,0,1,3,0,4,78,1
"org.apache.solr.handler.admin.AdminHandlers",11,1.00,1.73,45,0.61,29847.50,12,1,9,31,15,171.38,11,77,0,1,121.38,0.00,0.00,0.09,0,20.00,9,1834.28,0,7,15,java.lang.Object,0.00,20,0,19,0,20,4,2,4,355,1
"org.apache.solr.handler.admin.AdminHandlers$StandardHandler",1,2.00,1.00,6,0.04,469.78,3,2,9,1,1,120.93,0,9,0,1,120.93,0.00,0.00,0.00,0,1.00,1,128.04,0,0,1,java.lang.Object,0.00,0,0,1,0,0,1,0,0,35,2
"org.apache.solr.handler.admin.CoreAdminHandler",26,0.08,4.38,407,6.53,407220.50,30,4,49,147,38,75.88,151,549,2,2,93.76,0.00,0.50,0.17,14,102.00,19,19577.70,0,8,37,org.apache.solr.handler.RequestHandlerBase,0.21,121,1,114,0,121,18,0,64,3231,1
"org.apache.solr.handler.admin.CoreAdminHandler$CloseHook",2,0.00,3.00,13,0.17,8697.97,2,0,49,9,1,113.07,0,21,0,1,113.07,0.00,0.00,0.00,0,2.00,5,508.83,0,0,1,java.lang.Object,0.00,7,0,6,0,7,2,0,0,107,0
"org.apache.solr.handler.admin.CoreAdminHandlerTest",3,0.00,2.33,35,0.65,23544.17,3,0,13,30,6,151.29,3,62,0,3,101.29,0.00,0.67,0.00,1,1.00,3,1938.07,2,0,6,org.apache.solr.SolrTestCaseJ4,0.00,27,2,7,0,27,3,0,3,327,1
"org.apache.solr.handler.admin.LogLevelHandler",7,0.42,2.43,51,0.71,28180.19,9,2,21,29,9,110.41,114,79,2,2,110.88,0.00,0.50,0.14,0,13.00,7,2121.45,0,5,7,org.apache.solr.handler.RequestHandlerBase,0.53,22,1,17,0,22,2,0,19,400,1
"org.apache.solr.handler.admin.LogLevelHandler$LoggerFactoryWrapper",4,0.00,1.00,5,0.03,209.23,4,0,21,4,0,157.47,0,6,0,1,157.47,0.00,0.00,0.00,0,4.00,1,98.22,0,3,0,,0.00,0,0,4,0,0,1,0,0,35,2
"org.apache.solr.handler.admin.LogLevelHandler$LoggerFactoryWrapperJUL",4,0.00,3.25,35,0.57,25316.66,4,0,21,28,0,107.11,1,61,0,1,107.11,0.00,0.00,0.00,0,4.00,6,1715.88,0,3,0,java.lang.Object,0.00,24,0,13,0,24,1,1,1,332,2
"org.apache.solr.handler.admin.LogLevelHandler$LoggerWrapper",6,0.40,1.50,23,0.22,5873.50,8,2,21,11,1,129.56,0,33,0,1,129.56,0.00,0.00,0.17,1,18.00,4,669.29,0,3,1,java.lang.Object,0.00,5,0,9,0,5,3,1,0,162,3
"org.apache.solr.handler.admin.LogLevelHandler$LoggerWrapperJUL",3,0.25,2.67,21,0.23,8206.25,5,2,21,8,0,162.18,4,40,0,2,112.18,0.00,0.50,0.33,0,1.00,6,700.81,0,1,0,org.apache.solr.handler.admin.LoggerWrapper,0.00,5,1,8,0,5,2,0,4,157,2
"org.apache.solr.handler.admin.LogLevelHandlerTest",2,0.00,1.00,8,0.16,3337.23,2,0,5,7,2,123.17,0,22,0,3,123.17,0.00,0.67,0.00,0,2.00,1,475.27,2,0,2,org.apache.solr.SolrTestCaseJ4,0.00,5,2,2,0,5,2,0,0,98,1
"org.apache.solr.handler.admin.LukeRequestHandler",0,0.00,0.00,8,0.11,2482.83,6,6,39,1,32,171.00,16,9,4,2,171.00,0.00,0.50,0.00,0,0.00,0,341.84,0,0,28,org.apache.solr.handler.RequestHandlerBase,0.00,1,1,0,0,1,0,0,1,69,1
"org.apache.solr.handler.admin.LukeRequestHandler$ShowStyle",1,0.00,96.00,340,10.47,2419997.74,1,0,39,165,29,24.31,64,431,0,1,25.25,0.00,0.00,0.00,0,0.00,96,31400.17,0,1,29,java.lang.Object,0.00,164,0,96,0,164,0,0,51,3621,2
"org.apache.solr.handler.admin.LukeRequestHandler$ShowStyle$TermHistogram",2,0.50,3.00,22,0.20,8886.22,4,2,39,4,1,103.18,1,21,0,1,103.18,0.00,0.00,0.75,0,0.00,4,587.93,0,1,1,java.lang.Object,0.00,2,0,6,0,2,1,0,1,131,1
"org.apache.solr.handler.admin.LukeRequestHandler$ShowStyle$TopTermQueue",4,0.33,1.75,27,0.32,10879.68,7,3,39,14,4,164.80,4,38,0,2,114.80,0.00,0.50,0.08,0,6.00,4,972.44,2,2,4,org.apache.lucene.util.PriorityQueue,0.00,10,1,7,0,10,2,0,2,205,2
"org.apache.solr.handler.admin.LukeRequestHandler$ShowStyle$TopTermQueue$TermInfo",1,0.00,1.00,6,0.03,215.85,3,2,39,1,1,123.59,0,8,0,1,123.59,0.00,0.00,1.00,0,0.00,1,93.10,0,0,1,java.lang.Object,0.00,0,0,1,0,0,1,0,0,28,1
"org.apache.solr.handler.admin.LukeRequestHandlerTest",9,0.00,1.56,56,0.97,32083.83,9,0,7,20,3,163.90,10,118,0,3,113.90,0.00,0.67,0.00,3,16.00,4,2900.93,5,4,3,org.apache.solr.util.AbstractSolrTestCase,0.14,11,2,14,0,11,5,0,8,554,1
"org.apache.solr.handler.admin.PluginInfoHandler",6,0.00,2.83,43,0.78,51651.85,6,0,10,28,8,158.25,11,61,1,2,108.25,0.00,0.50,0.00,0,6.00,12,2352.75,0,5,7,org.apache.solr.handler.RequestHandlerBase,0.44,22,1,17,0,22,1,0,2,417,1
"org.apache.solr.handler.admin.PropertiesRequestHandler",5,0.00,1.20,20,0.21,5939.34,5,0,6,13,6,174.29,5,35,1,2,124.29,0.00,0.50,0.00,0,5.00,2,624.68,0,4,5,org.apache.solr.handler.RequestHandlerBase,0.47,8,1,6,0,8,1,0,2,137,1
"org.apache.solr.handler.admin.ShowFileRequestHandler",11,0.05,3.55,135,2.41,156911.08,15,4,28,73,17,79.87,64,197,3,2,97.74,0.00,0.50,0.20,2,37.00,13,7233.87,1,6,15,org.apache.solr.handler.RequestHandlerBase,0.35,62,1,39,0,62,5,0,26,1159,1
"org.apache.solr.handler.admin.ShowFileRequestHandlerTest",3,0.00,1.00,18,0.22,3985.32,3,0,13,17,7,137.99,9,23,0,4,117.38,0.00,0.75,0.00,0,3.00,1,672.69,3,0,7,org.apache.solr.SolrJettyTestBase,0.00,14,3,3,0,14,3,0,6,144,1
"org.apache.solr.handler.admin.ShowFileRequestHandlerTest$ResponseParser",3,0.00,1.67,10,0.12,2527.49,3,0,13,7,1,130.05,2,19,0,1,130.05,0.00,0.00,0.00,0,3.00,3,347.20,0,3,1,java.lang.Object,0.00,4,0,5,0,4,0,0,2,79,0
"org.apache.solr.handler.admin.SolrInfoMBeanHandler",6,0.00,3.00,54,1.00,69348.15,6,0,13,39,8,153.16,10,69,1,2,103.16,0.00,0.50,0.00,1,6.00,10,3003.33,0,5,7,org.apache.solr.handler.RequestHandlerBase,0.44,33,1,18,0,33,1,0,4,498,1
"org.apache.solr.handler.admin.SystemInfoHandler",13,0.12,1.92,136,2.27,112456.46,18,5,23,74,10,102.78,55,183,2,2,102.54,0.00,0.50,0.09,1,53.00,4,6813.16,0,10,8,org.apache.solr.handler.RequestHandlerBase,0.32,61,1,25,0,61,3,0,28,1241,1
"org.apache.solr.handler.admin.SystemInfoHandlerTest",1,0.00,1.00,12,0.18,5608.05,1,0,4,10,2,121.84,3,14,0,2,101.22,0.00,0.50,0.00,0,1.00,1,525.83,0,0,2,org.apache.lucene.util.LuceneTestCase,0.00,9,1,1,0,9,1,0,3,110,1
"org.apache.solr.handler.admin.ThreadDumpHandler",7,0.00,2.57,65,1.03,62003.79,7,0,9,34,6,143.99,17,89,1,2,104.10,0.00,0.50,0.00,0,7.00,7,3099.04,0,6,5,org.apache.solr.handler.RequestHandlerBase,0.42,27,1,18,0,27,1,0,8,551,1
"org.apache.lucene.queryparser.flexible.core.QueryNodeError",4,1.00,1.00,12,0.09,1021.22,5,1,2,5,9,102.03,25,17,7,2,134.25,0.00,0.50,0.00,0,4.00,1,261.70,0,1,2,java.lang.Error,0.00,1,1,4,0,1,3,1,5,74,1
"org.apache.lucene.queryparser.flexible.core.QueryNodeException",8,1.00,1.00,20,0.18,2363.36,9,1,7,11,74,190.32,14,32,68,2,140.32,2.00,0.25,0.00,1,8.00,1,538.64,0,5,6,java.lang.Exception,0.00,3,1,8,2,3,3,1,1,146,1
"org.apache.lucene.queryparser.flexible.core.QueryNodeParseException",12,4.00,1.00,30,0.22,2622.83,16,4,5,13,13,181.23,34,44,8,3,141.35,0.50,0.50,0.00,0,12.00,1,666.66,0,2,6,org.apache.lucene.queryparser.flexible.core.QueryNodeException,0.00,1,2,12,1,1,10,0,6,185,1
"org.apache.lucene.queryparser.flexible.core.QueryParserHelper",10,0.22,1.50,42,0.36,6664.74,14,4,5,15,7,125.74,162,60,1,1,126.21,0.00,0.00,0.05,5,26.00,2,1070.24,0,5,6,java.lang.Object,0.00,5,0,15,3,5,5,0,12,261,1
"org.apache.solr.search.grouping.endresulttransformer.EndResultTransformer",1,0.00,1.00,3,0.03,191.35,1,0,5,1,8,144.36,17,4,4,1,135.23,0.00,0.00,0.00,0,1.00,1,84.90,0,0,4,,0.00,0,0,1,0,0,1,0,3,25,1
"org.apache.solr.search.grouping.endresulttransformer.EndResultTransformer$SolrDocumentSource",1,0.00,1.00,2,0.01,30.51,1,0,5,1,2,148.08,0,3,0,1,148.08,0.00,0.00,0.00,0,1.00,1,25.51,0,1,2,,0.00,0,0,1,0,0,0,0,0,11,1
"org.apache.solr.search.grouping.endresulttransformer.GroupedEndResultTransformer",2,1.00,7.00,52,1.01,72247.49,3,1,16,29,15,131.88,3,63,1,1,81.88,0.00,0.00,0.50,0,2.00,13,3044.05,0,0,14,java.lang.Object,0.00,27,0,14,0,27,2,1,1,476,1
"org.apache.solr.search.grouping.endresulttransformer.MainEndResultTransformer",1,0.00,7.00,19,0.31,13686.45,1,0,8,12,8,110.89,3,25,0,1,90.28,0.00,0.00,0.00,0,1.00,7,927.32,0,0,8,java.lang.Object,0.00,11,0,7,0,11,1,1,1,161,1
"org.apache.solr.search.grouping.endresulttransformer.SimpleEndResultTransformer",1,0.00,10.00,28,0.49,23918.88,1,0,10,14,10,102.62,3,36,0,1,82.01,0.00,0.00,0.00,0,1.00,10,1468.15,0,0,10,java.lang.Object,0.00,13,0,10,0,13,1,1,1,243,1
"org.apache.solr.common.cloud.CloudState",19,0.03,2.05,129,2.02,96576.35,24,5,14,75,30,112.62,2,163,25,1,112.62,0.00,0.00,0.17,6,108.00,6,6062.29,0,11,6,java.lang.Object,0.00,56,0,39,0,56,8,1,2,1213,1
"org.apache.solr.common.cloud.CloudState$RangeInfo",0,0.00,0.00,3,0.02,210.93,2,2,14,0,0,171.00,0,4,0,1,171.00,0.00,0.00,0.00,0,0.00,0,70.31,0,0,0,java.lang.Object,0.00,0,0,0,0,0,0,0,0,19,0
"org.apache.solr.common.cloud.ConnectionManager",7,0.15,2.29,62,0.72,21843.65,17,10,10,22,6,109.61,0,83,2,1,109.61,0.00,0.00,0.23,1,0.00,6,2165.86,0,1,5,java.lang.Object,0.00,15,0,16,0,15,6,1,0,429,0
"org.apache.solr.common.cloud.ConnectionManager$ZkClientConnectionStrategy.ZkUpdate",1,0.00,2.00,9,0.10,1903.64,1,0,10,2,3,109.42,0,15,0,1,109.42,0.00,0.00,0.00,0,0.00,2,290.51,0,0,3,java.lang.Object,0.00,1,0,2,0,1,1,0,0,61,0
"org.apache.solr.common.cloud.CoreState",12,0.36,1.33,44,0.55,15488.39,13,1,5,26,11,128.64,0,64,10,1,128.64,0.00,0.00,0.67,1,0.00,2,1646.09,0,7,1,java.lang.Object,0.00,14,0,16,0,14,5,1,0,377,1
"org.apache.solr.common.cloud.DefaultConnectionStrategy",2,1.00,1.50,11,0.19,4126.01,3,1,7,7,4,168.73,3,20,1,2,118.73,0.00,0.50,0.50,0,2.00,2,555.06,0,0,3,org.apache.solr.common.cloud.ZkClientConnectionStrategy,0.00,5,1,3,0,5,2,0,1,117,1
"org.apache.solr.common.cloud.HashPartitioner",1,0.00,2.00,13,0.17,7135.42,1,0,2,5,2,54.82,11,16,2,1,98.94,0.00,0.00,0.00,0,1.00,2,497.44,0,1,0,java.lang.Object,0.00,4,0,2,0,4,0,0,3,103,1
"org.apache.solr.common.cloud.HashPartitioner$Range",1,2.00,1.00,6,0.04,605.24,3,2,2,1,0,120.07,0,8,0,1,120.07,0.00,0.00,0.00,0,1.00,1,116.74,0,0,0,java.lang.Object,0.00,0,0,1,0,0,1,0,0,35,2
"org.apache.solr.common.cloud.OnReconnect",1,0.00,1.00,2,0.01,29.41,1,0,0,1,4,147.73,16,3,4,1,148.21,0.00,0.00,0.00,0,1.00,1,19.61,0,0,0,,0.00,0,0,1,0,0,1,0,1,9,1
"org.apache.solr.common.cloud.SafeStopThread",2,0.00,1.00,3,0.01,46.83,2,0,0,2,2,112.11,16,4,2,1,160.22,0.00,0.00,0.00,0,2.00,1,31.22,0,0,0,,0.00,0,0,2,0,0,2,0,1,14,1
"org.apache.solr.common.cloud.Slice",6,0.10,1.17,21,0.24,6108.58,8,2,4,13,25,129.48,1,30,24,1,129.48,0.00,0.00,0.42,0,6.00,2,722.17,0,4,1,java.lang.Object,0.00,7,0,7,0,7,2,1,1,173,1
"org.apache.solr.common.cloud.SolrZkClient",33,0.01,2.00,186,2.78,134020.79,42,9,29,85,41,74.06,239,279,35,1,116.35,0.00,0.00,0.10,7,288.00,13,8346.08,0,9,9,java.lang.Object,0.00,52,0,66,0,52,24,0,36,1618,1
"org.apache.solr.common.cloud.SolrZkClient$ZkOperation",1,0.00,1.00,4,0.03,397.30,1,0,29,1,0,128.07,0,6,0,1,128.07,0.00,0.00,0.00,0,0.00,1,95.57,0,1,0,java.lang.Object,0.00,0,0,1,0,0,0,0,0,25,0
"org.apache.solr.common.cloud.SolrZkClient$ZkOperation_0",1,0.00,1.00,3,0.03,357.16,1,0,29,1,0,133.10,0,5,0,1,133.10,0.00,0.00,0.00,0,0.00,1,85.66,0,1,0,java.lang.Object,0.00,0,0,1,0,0,0,0,0,23,0
"org.apache.solr.common.cloud.SolrZkClient$ZkOperation_1",1,0.00,1.00,3,0.03,493.63,1,0,29,1,0,131.99,0,5,0,1,131.99,0.00,0.00,0.00,0,0.00,1,95.57,0,1,0,java.lang.Object,0.00,0,0,1,0,0,0,0,0,25,0
"org.apache.solr.common.cloud.SolrZkClient$ZkOperation_2",1,0.00,1.00,3,0.03,401.26,1,0,29,1,0,132.70,0,5,0,1,132.70,0.00,0.00,0.00,0,0.00,1,97.21,0,1,0,java.lang.Object,0.00,0,0,1,0,0,0,0,0,25,0
"org.apache.solr.common.cloud.SolrZkClient$ZkOperation_3",1,0.00,1.00,3,0.03,534.95,1,0,29,1,0,131.72,0,5,0,1,131.72,0.00,0.00,0.00,0,0.00,1,103.08,0,1,0,java.lang.Object,0.00,0,0,1,0,0,0,0,0,26,0
"org.apache.solr.common.cloud.SolrZkClient$ZkOperation_4",1,0.00,1.00,3,0.03,453.57,1,0,29,1,0,132.28,0,5,0,1,132.28,0.00,0.00,0.00,0,0.00,1,97.21,0,0,0,java.lang.Object,0.00,0,0,1,0,0,1,0,0,25,0
"org.apache.solr.common.cloud.SolrZkClient$ZkOperation_5",1,0.00,1.00,3,0.03,378.95,1,0,29,1,0,132.90,0,5,0,1,132.90,0.00,0.00,0.00,0,0.00,1,91.40,0,1,0,java.lang.Object,0.00,0,0,1,0,0,0,0,0,24,0
"org.apache.solr.common.cloud.SolrZkClient$ZkOperation_6",1,0.00,1.00,3,0.04,485.02,1,0,29,1,0,132.05,0,6,0,1,132.05,0.00,0.00,0.00,0,0.00,1,117.81,0,1,0,java.lang.Object,0.00,0,0,1,0,0,0,0,0,29,0
"org.apache.solr.common.cloud.SolrZkClient$ZkOperation_7",1,0.00,1.00,4,0.04,528.02,1,0,29,1,0,127.10,0,6,0,1,127.10,0.00,0.00,0.00,0,0.00,1,128.40,0,1,0,java.lang.Object,0.00,0,0,1,0,0,0,0,0,31,0
"org.apache.solr.common.cloud.SolrZkClient$ZkUpdate",1,0.00,3.00,10,0.11,3035.41,1,0,29,5,2,156.02,1,16,0,1,106.02,0.00,0.00,0.00,0,0.00,3,333.60,0,0,2,java.lang.Object,0.00,4,0,3,0,4,1,0,1,68,0
"org.apache.solr.common.cloud.ZkClientConnectionStrategy",2,0.00,1.00,4,0.06,452.50,2,0,4,2,8,191.23,3,5,7,1,141.23,0.00,0.00,0.00,0,2.00,1,181.00,0,0,1,java.lang.Object,0.00,0,0,2,1,0,2,0,1,47,2
"org.apache.solr.common.cloud.ZkClientConnectionStrategy$ZkUpdate",1,0.00,1.00,2,0.02,146.32,1,0,4,1,1,142.72,0,3,0,1,142.72,0.00,0.00,0.00,0,1.00,1,58.53,0,0,1,java.lang.Object,0.00,0,0,1,0,0,1,0,0,18,3
"org.apache.solr.common.cloud.ZkCmdExecutor",9,0.25,2.00,41,0.47,16247.23,12,3,7,19,7,172.74,13,62,5,1,122.74,0.00,0.00,0.11,2,26.00,7,1396.21,0,1,3,java.lang.Object,0.00,10,0,18,0,10,8,0,3,296,1
"org.apache.solr.common.cloud.ZkCoreNodeProps",10,0.33,1.50,29,0.31,10975.85,11,1,0,19,24,185.73,17,41,23,1,135.73,0.00,0.00,0.70,2,0.00,6,944.24,0,8,2,java.lang.Object,0.00,9,0,15,0,9,2,0,2,231,1
"org.apache.solr.common.cloud.ZkNodeProps",11,0.30,1.27,39,0.47,15306.34,12,1,6,29,36,128.39,1,52,36,1,128.39,0.00,0.00,0.73,0,0.00,3,1419.22,0,5,1,java.lang.Object,0.00,18,0,14,0,18,6,1,1,330,1
"org.apache.solr.common.cloud.ZkOperation",1,0.00,1.00,2,0.01,94.54,1,0,2,1,3,114.83,13,3,3,1,144.21,0.00,0.00,0.00,0,1.00,1,40.14,0,1,0,java.lang.Object,0.00,0,0,1,0,0,0,0,2,14,2
"org.apache.solr.common.cloud.ZkStateReader",21,0.00,1.86,150,2.28,83875.76,48,27,25,80,57,110.97,19,206,51,1,110.97,0.00,0.00,0.04,6,129.00,9,6844.86,0,8,10,java.lang.Object,0.00,59,0,39,0,59,13,0,17,1271,1
"org.apache.solr.common.cloud.ZkStateReader$OnReconnect",1,0.00,3.00,9,0.11,2674.74,1,0,25,5,2,148.05,2,15,0,1,108.16,0.00,0.00,0.00,0,0.00,3,340.84,0,0,2,java.lang.Object,0.00,4,0,3,0,4,1,0,2,74,0
"org.apache.solr.common.cloud.ZkStateReader$Runnable",1,0.00,5.00,26,0.42,22901.06,1,0,25,11,3,123.40,2,37,0,1,83.52,0.00,0.00,0.00,0,0.00,5,1251.55,0,0,3,java.lang.Object,0.00,10,0,5,0,10,1,0,2,209,0
"org.apache.solr.common.cloud.ZkStateReader$RunnableWatcher",1,1.00,1.00,4,0.02,266.56,2,1,25,1,0,129.44,0,6,0,1,129.44,0.00,0.00,0.00,0,1.00,1,74.73,0,0,0,java.lang.Object,0.00,0,0,1,0,0,1,1,0,23,1
"org.apache.solr.common.cloud.ZkStateReader$Watcher",1,0.00,4.00,17,0.29,12251.39,1,0,25,8,3,74.72,5,28,0,1,92.59,0.00,0.00,0.00,0,0.00,4,867.96,0,0,3,java.lang.Object,0.00,7,0,4,0,7,1,0,5,149,0
"org.apache.solr.common.cloud.ZkStateReader$Watcher_0",1,0.00,4.00,18,0.32,14612.23,1,0,25,10,3,111.68,3,29,0,1,91.06,0.00,0.00,0.00,0,0.00,4,972.58,0,0,3,java.lang.Object,0.00,9,0,4,0,9,1,0,3,166,0
"org.apache.solr.common.cloud.ZkStateReader$ZKTF",1,0.00,1.00,6,0.06,1245.76,2,1,25,4,0,117.60,0,9,0,1,117.60,0.00,0.00,1.00,0,0.00,1,185.29,0,1,0,java.lang.Object,0.00,3,0,1,0,3,0,1,0,46,2
"org.apache.solr.common.cloud.ZooKeeperException",2,0.00,1.00,5,0.04,303.92,2,0,1,2,18,142.59,0,8,17,3,142.59,0.00,0.67,0.00,0,2.00,1,116.05,0,0,1,org.apache.solr.common.SolrException,0.00,0,2,2,0,0,2,0,0,35,1
"org.apache.solr.servlet.cache.HttpCacheHeaderUtil",10,1.00,3.00,91,1.39,53339.39,11,1,19,48,10,55.80,97,148,2,1,105.80,0.00,0.00,0.10,4,18.00,4,4177.92,0,1,8,java.lang.Object,0.00,38,0,30,0,38,9,0,35,798,2
"org.apache.solr.servlet.cache.HttpCacheHeaderUtil$EtagCacheVal",2,0.33,2.00,13,0.16,4336.07,5,3,19,8,0,115.54,1,23,0,1,115.54,0.00,0.00,0.50,0,2.00,3,471.81,0,1,0,java.lang.Object,0.00,6,0,4,0,6,1,0,1,103,2
"org.apache.solr.servlet.cache.Method",1,0.00,2.00,6,0.05,769.59,1,0,1,3,2,119.09,0,10,2,1,119.09,0.00,0.00,0.00,0,1.00,2,162.51,0,1,0,java.lang.Object,0.00,2,0,2,0,2,0,0,0,40,1
