Name, No. Methods, LCOM, AVCC, NOS, HBUG, HEFF, UWCS, INST, PACK, RFC, CBO, MI, CCML, NLOC, F-IN, DIT, MINC, S-R, R-R, COH, LMC, LCOM2, MAXCC, HVOL, HIER, NQU, FOUT, Superclass, SIX, EXT, NSUP, TCC, NSUB, MPC, NCO, INTR, CCOM, HLTH, MOD
"org.apache.http.entity.mime.content.ContentBody",1,0.00,1.00,2,0.01,52.92,1,0,2,1,2,146.43,4,3,2,3,146.20,0.00,0.67,0.00,0,1.00,1,30.46,0,1,0,,0.00,0,2,1,0,0,0,0,1,12,1
"org.apache.http.entity.mime.content.NotThreadSafe",9,2.00,1.33,33,0.32,8976.75,11,2,5,13,0,129.52,8,50,0,2,129.52,0.00,0.50,0.00,1,9.00,3,961.19,0,4,0,AbstractContentBody,0.00,4,1,12,0,4,5,0,3,221,1
"org.apache.http.cookie.ClientCookie",2,10.00,1.00,13,0.17,2680.92,12,10,0,2,5,75.06,14,14,5,2,117.35,0.00,0.50,0.00,0,2.00,1,505.04,0,1,0,,0.00,0,1,2,0,0,1,0,3,108,1
"org.apache.http.cookie.Cookie",12,0.00,1.00,13,0.04,141.89,12,0,1,12,20,130.33,78,14,20,1,162.55,0.00,0.00,0.00,0,12.00,1,121.26,0,7,0,,0.00,0,0,12,0,0,5,0,13,57,1
"org.apache.http.cookie.CookieAttributeHandler",3,0.00,1.00,4,0.03,138.66,3,0,0,3,9,113.76,34,7,7,1,157.89,0.00,0.00,0.00,0,3.00,1,100.44,0,0,2,,0.00,0,0,3,0,0,3,0,4,33,1
"org.apache.http.cookie.CookieSpec",6,0.00,1.00,7,0.06,316.39,6,0,2,6,10,108.96,61,8,9,1,157.44,0.00,0.00,0.00,0,6.00,1,169.36,0,3,1,,0.00,0,0,6,0,0,3,0,7,56,1
"org.apache.http.cookie.CookieSpecFactory",1,0.00,1.00,2,0.01,30.51,1,0,1,1,2,110.52,12,3,1,1,148.08,0.00,0.00,0.00,0,1.00,1,25.51,0,1,1,,0.00,0,0,1,0,0,0,0,2,11,1
"org.apache.http.cookie.Immutable",2,1.00,3.50,20,0.20,6335.37,3,1,3,6,1,57.74,16,26,0,1,105.84,0.00,0.00,0.00,1,2.00,4,593.90,0,1,1,java.lang.Object,0.00,4,0,7,0,4,1,2,2,132,1
"org.apache.http.cookie.SM",0,0.00,0.00,5,0.05,743.92,4,4,0,0,3,171.00,6,6,3,1,171.00,0.00,0.00,0.00,0,0.00,0,163.50,0,0,0,,0.00,0,0,0,0,0,0,0,1,40,1
"org.apache.http.cookie.SetCookie",7,0.00,1.00,8,0.04,144.76,7,0,1,7,5,112.54,60,9,5,2,160.64,0.00,0.50,0.00,0,7.00,1,126.66,0,0,0,,0.00,0,1,7,0,0,7,0,7,49,1
"org.apache.http.cookie.SetCookie2",3,0.00,1.00,4,0.02,96.69,3,0,0,3,5,116.83,21,5,5,2,159.12,0.00,0.50,0.00,0,3.00,1,68.77,0,0,0,,0.00,0,1,3,0,0,3,0,4,26,1
"org.apache.http.cookie.TestCookieOrigin",8,0.00,1.50,29,0.28,3934.85,8,0,3,16,1,181.91,9,46,1,2,131.91,0.00,0.50,0.00,0,8.00,2,839.18,0,1,0,junit.framework.TestCase,0.00,8,1,12,0,8,7,0,7,205,1
"org.apache.http.cookie.TestCookiePathComparator",8,0.00,1.00,53,0.67,18911.33,8,0,5,14,2,115.41,5,62,1,2,115.41,0.00,0.50,0.00,0,8.00,1,1997.84,0,1,1,junit.framework.TestCase,0.00,6,1,8,0,6,7,0,3,432,1
"org.apache.http.cookie.TestCookiePolicy",5,0.08,2.20,64,0.75,29094.66,8,3,10,21,1,140.80,11,90,1,2,100.92,0.00,0.50,0.40,0,7.00,5,2252.53,0,1,0,junit.framework.TestCase,0.00,16,1,11,0,16,4,0,9,466,1
"org.apache.http.cookie.ThreadSafe",7,0.33,1.86,32,0.39,9534.27,8,1,8,19,2,75.61,59,49,0,1,123.72,0.00,0.00,0.71,1,0.00,3,1169.64,0,3,2,java.lang.Object,0.00,12,0,13,0,12,4,0,7,257,2
"org.apache.http.impl.cookie.Immutable",4,0.00,1.25,10,0.09,1504.53,4,0,7,5,4,189.44,5,18,0,1,139.44,0.00,0.00,0.00,0,4.00,2,281.81,0,0,4,java.lang.Object,0.00,1,0,5,0,1,4,1,1,75,1
"org.apache.http.impl.cookie.Immutable$DateFormatHolder",1,0.00,3.00,15,0.24,10625.71,1,0,10,12,0,57.61,12,23,0,1,95.17,0.00,0.00,0.00,0,1.00,3,724.08,0,1,0,java.lang.Object,0.00,11,0,3,0,11,0,0,1,149,2
"org.apache.http.impl.cookie.Immutable$DateFormatHolder$ThreadLocal<SoftReference<Map<String,SimpleDateFormat>>>",1,0.00,1.00,3,0.06,1340.27,1,0,10,3,0,128.58,0,6,0,1,128.58,0.00,0.00,0.00,0,1.00,1,182.51,0,1,0,java.lang.Object,0.00,2,0,1,0,2,0,0,0,48,0
"org.apache.http.impl.cookie.NotThreadSafe",13,0.12,3.08,100,1.07,45895.47,19,6,10,31,4,161.28,16,142,0,1,111.28,0.00,0.00,0.05,4,57.00,9,3221.99,0,4,4,java.lang.Object,0.00,18,0,40,0,18,9,1,11,662,1
"org.apache.http.impl.cookie.PublicSuffixFilter",7,0.22,2.14,32,0.44,15258.07,10,3,9,18,5,142.69,26,41,2,1,122.08,0.00,0.00,0.14,1,10.00,8,1311.82,0,0,3,java.lang.Object,0.00,11,0,15,0,11,7,1,6,281,1
"org.apache.http.impl.cookie.TestAbstractCookieSpec",6,0.00,1.50,46,0.52,15689.13,6,0,11,23,4,112.47,4,59,1,2,112.47,0.00,0.50,0.00,0,6.00,3,1556.95,0,1,3,junit.framework.TestCase,0.00,17,1,9,0,17,5,0,4,333,1
"org.apache.http.impl.cookie.TestAbstractCookieSpec$DummyCookieAttribHandler",3,0.00,1.00,5,0.05,308.89,3,0,11,3,3,155.15,0,9,0,1,155.15,0.00,0.00,0.00,0,3.00,1,138.78,0,0,3,java.lang.Object,0.00,0,0,3,0,0,3,1,0,41,2
"org.apache.http.impl.cookie.TestAbstractCookieSpec$DummyCookieSpec",6,0.00,1.00,12,0.09,872.49,6,0,11,6,1,142.74,0,19,0,2,142.74,0.00,0.50,0.00,0,6.00,1,277.42,0,3,1,AbstractCookieSpec,0.00,0,1,6,0,0,3,0,0,79,2
"org.apache.http.impl.cookie.TestBasicCookieAttribHandlers",34,0.00,1.76,267,3.23,78160.60,34,0,21,71,3,112.87,27,354,1,2,112.87,0.00,0.50,0.00,0,34.00,6,9693.93,0,1,2,junit.framework.TestCase,0.00,37,1,60,0,37,33,0,27,2016,1
"org.apache.http.impl.cookie.TestBrowserCompatSpec",57,0.00,1.77,690,10.99,365164.25,57,0,13,94,4,150.64,69,740,1,2,100.64,0.00,0.50,0.00,1,57.00,9,32960.53,0,1,3,junit.framework.TestCase,0.00,37,1,101,0,37,56,0,39,5926,1
"org.apache.http.impl.cookie.TestCookieBestMatchSpec",12,0.00,1.92,153,2.15,69063.12,12,0,13,46,5,140.87,27,172,1,2,100.98,0.00,0.50,0.00,0,12.00,5,6449.30,0,1,4,junit.framework.TestCase,0.00,34,1,23,0,34,11,0,23,1191,1
"org.apache.http.impl.cookie.TestCookieNetscapeDraft",13,0.00,2.00,141,2.13,60990.97,13,0,12,39,4,144.51,27,165,1,2,104.63,0.00,0.50,0.00,0,13.00,5,6384.02,0,1,3,junit.framework.TestCase,0.00,26,1,26,0,26,12,0,15,1174,1
"org.apache.http.impl.cookie.TestCookieRFC2109Spec",21,0.00,2.14,277,4.00,126935.43,21,0,12,50,4,139.38,55,334,1,2,99.49,0.00,0.50,0.00,0,21.00,6,11985.41,0,1,3,junit.framework.TestCase,0.00,29,1,45,0,29,20,0,26,2197,1
"org.apache.http.impl.cookie.TestCookieRFC2965Spec",48,0.00,1.77,648,9.45,331884.69,48,0,13,96,4,119.69,166,699,1,2,99.08,0.00,0.50,0.00,0,48.00,6,28351.43,0,1,3,junit.framework.TestCase,0.00,48,1,85,0,48,47,0,95,5144,1
"org.apache.http.impl.cookie.TestDateUtils",9,0.00,1.44,72,0.94,27708.75,9,0,5,22,1,109.76,8,95,1,2,109.76,0.00,0.50,0.00,0,9.00,5,2812.61,0,1,0,junit.framework.TestCase,0.00,13,1,13,0,13,8,0,5,577,1
"org.apache.http.impl.cookie.TestNetscapeCookieAttribHandlers",10,0.00,1.70,74,0.87,19083.44,10,0,6,22,2,113.52,8,99,1,2,113.52,0.00,0.50,0.00,0,10.00,3,2597.22,0,1,1,junit.framework.TestCase,0.00,12,1,17,0,12,9,0,8,536,1
"org.apache.http.impl.cookie.TestNetscapeDraftHeaderParser",4,0.00,1.00,35,0.52,16671.55,4,0,7,21,1,158.81,4,41,1,2,108.81,0.00,0.50,0.00,0,4.00,1,1552.15,0,1,0,junit.framework.TestCase,0.00,17,1,4,0,17,3,0,1,292,1
"org.apache.http.impl.cookie.TestPublicSuffixListParser",6,0.10,1.17,44,0.65,16850.86,8,2,7,24,2,112.28,4,53,1,2,112.28,0.00,0.50,0.42,0,0.00,2,1943.69,0,1,1,junit.framework.TestCase,0.00,18,1,7,0,18,5,0,4,408,1
"org.apache.http.impl.cookie.TestRFC2109CookieAttribHandlers",17,0.00,2.18,149,1.70,43924.09,17,0,6,35,2,160.26,21,207,1,2,110.26,0.00,0.50,0.00,0,17.00,6,5096.43,0,1,1,junit.framework.TestCase,0.00,18,1,37,0,18,16,0,21,1051,1
"org.apache.http.examples.conn.ManagerConnectDirect",6,0.10,1.50,59,0.84,43129.88,8,2,20,36,4,56.84,53,72,0,1,104.94,0.00,0.00,0.42,4,6.00,4,2526.92,0,4,4,java.lang.Object,0.00,30,0,9,0,30,2,0,16,440,1
"org.apache.http.examples.conn.ManagerConnectProxy",8,0.21,1.50,87,1.32,72939.05,10,2,21,45,4,54.32,66,107,0,1,102.42,0.00,0.00,0.31,6,16.00,4,3959.67,0,5,4,java.lang.Object,0.00,37,0,12,0,37,3,0,21,675,1
"org.apache.http.examples.conn.OperatorConnectDirect",1,0.00,2.00,33,0.53,23044.65,1,0,18,23,3,88.97,17,35,0,1,79.84,0.00,0.00,0.00,0,1.00,2,1599.69,0,0,3,java.lang.Object,0.00,22,0,2,0,22,1,0,9,253,1
"org.apache.http.examples.conn.OperatorConnectProxy",2,0.00,2.00,56,0.97,54474.73,2,0,18,31,2,71.58,31,63,0,1,81.93,0.00,0.00,0.00,1,2.00,2,2922.89,0,0,2,java.lang.Object,0.00,29,0,4,0,29,2,0,23,455,1
"org.apache.http.client.params.AllClientPNames",0,0.00,0.00,1,0.02,96.21,0,0,7,0,5,171.00,14,5,0,9,171.00,0.00,0.89,0.00,0,0.00,0,48.11,0,0,5,,0.00,0,8,0,0,0,0,0,2,13,1
"org.apache.http.client.params.ClientPNames",0,0.00,0.00,12,0.18,3079.91,11,11,0,0,5,171.00,75,14,5,1,171.00,0.00,0.00,0.00,0,0.00,0,534.71,0,0,0,,0.00,0,0,0,0,0,0,0,12,106,1
"org.apache.http.client.params.Immutable",7,0.00,2.00,30,0.33,7352.06,7,0,2,12,1,124.59,5,50,0,1,124.59,0.00,0.00,0.00,0,7.00,3,981.06,0,1,1,java.lang.Object,0.00,5,0,14,0,5,6,0,1,221,1
"org.apache.http.client.params.NotThreadSafe",12,0.00,1.00,25,0.27,2800.50,12,0,7,15,2,141.12,7,39,0,2,141.12,0.00,0.50,0.00,0,12.00,1,800.37,0,0,2,org.apache.http.params.HttpAbstractParamBean,0.00,3,1,12,0,3,12,0,1,212,1
"org.apache.http.impl.conn.AbstractClientConnAdapter",29,0.05,1.41,136,1.00,16014.57,35,6,15,54,7,166.75,69,187,4,1,126.87,0.00,0.00,0.11,5,246.00,4,3007.53,0,7,3,java.lang.Object,0.00,25,0,41,4,25,22,1,26,741,2
"org.apache.http.impl.conn.AbstractPoolEntry",8,0.00,3.12,68,0.91,33968.04,13,5,8,27,6,79.10,106,114,4,1,108.48,0.00,0.00,0.20,3,10.00,7,2734.85,0,1,2,java.lang.Object,0.00,19,0,25,2,19,7,0,33,543,2
"org.apache.http.impl.conn.AbstractPooledConnAdapter",12,0.09,1.50,42,0.37,5629.53,13,1,7,23,6,171.96,29,68,2,2,132.07,2.00,0.25,0.92,1,0.00,3,1113.17,2,2,4,org.apache.http.impl.conn.AbstractClientConnAdapter,0.05,11,1,18,2,11,10,0,5,283,2
"org.apache.http.impl.conn.ClientConnAdapterMockup",10,0.00,1.00,19,0.15,1332.56,10,0,6,11,6,154.27,3,30,4,2,154.27,0.00,0.50,0.00,0,10.00,1,454.73,0,2,2,org.apache.http.impl.conn.AbstractClientConnAdapter,0.00,1,1,10,0,1,8,0,1,128,1
"org.apache.http.impl.conn.ExecReqThread",6,0.15,1.67,32,0.41,12919.32,10,4,10,16,3,100.69,32,54,1,3,118.56,0.00,0.67,0.38,2,2.00,4,1226.25,1,1,2,org.apache.http.impl.conn.GetConnThread,0.27,10,2,10,0,10,5,0,8,255,1
"org.apache.http.impl.conn.ExecReqThread$RequestSpec",0,0.00,0.00,5,0.03,237.96,4,4,10,0,0,171.00,0,6,0,1,171.00,0.00,0.00,0.00,0,0.00,0,95.18,0,0,0,java.lang.Object,0.00,0,0,0,0,0,0,0,0,25,2
"org.apache.http.impl.conn.GetConnThread",5,0.20,1.20,20,0.17,2000.65,10,5,5,7,6,128.24,21,32,3,2,128.01,1.00,0.33,0.36,0,5.00,2,503.36,0,2,3,java.lang.Thread,0.00,2,1,6,1,2,3,0,5,125,1
"org.apache.http.impl.conn.Helper",2,0.00,1.00,12,0.19,6135.94,2,0,10,11,2,114.75,8,22,2,1,114.52,0.00,0.00,0.00,0,2.00,1,570.64,0,1,0,java.lang.Object,0.00,9,0,2,0,9,1,0,4,114,2
"org.apache.http.impl.conn.Immutable",8,2.00,1.62,32,0.38,7836.61,10,2,5,13,0,174.88,13,46,0,1,124.88,0.00,0.00,0.00,4,8.00,2,1149.58,0,1,0,java.lang.Object,0.00,5,0,13,0,5,7,1,4,275,1
"org.apache.http.impl.conn.NotThreadSafe",6,0.30,3.00,50,0.64,19689.09,8,2,9,21,0,77.15,36,72,0,1,109.37,0.00,0.00,0.75,0,0.00,6,1921.61,0,0,0,java.lang.Object,0.00,15,0,18,0,15,6,0,8,380,1
"org.apache.http.impl.conn.NotThreadSafe$TimeValues",1,2.00,2.00,9,0.08,1672.07,3,2,9,2,0,91.99,5,12,0,1,109.86,0.00,0.00,0.00,0,1.00,2,248.23,0,0,0,java.lang.Object,0.00,1,0,2,0,1,1,0,1,60,2
"org.apache.http.impl.conn.TestDefaultResponseParser",7,0.00,1.43,46,0.68,13563.99,7,0,16,24,3,116.00,3,94,1,2,116.00,0.00,0.50,0.00,0,7.00,2,2047.40,0,1,2,junit.framework.TestCase,0.00,17,1,10,0,17,6,0,1,394,1
"org.apache.http.impl.conn.TestLocalServer",5,0.00,1.60,51,0.88,35032.05,5,0,14,32,3,103.31,4,79,1,4,103.31,0.00,0.75,0.00,0,7.00,4,2648.38,2,1,2,org.apache.http.localserver.ServerTestBase,0.00,27,3,8,0,27,4,0,1,460,1
"org.apache.http.impl.conn.TestProxySelRoutePlanner",6,0.00,1.00,34,0.59,13452.73,6,0,19,29,4,168.54,8,51,1,2,118.54,0.00,0.50,0.00,1,6.00,1,1762.17,0,2,3,junit.framework.TestCase,0.00,23,1,6,0,23,4,0,2,336,1
"org.apache.http.impl.conn.TestSCMWithServer",8,0.00,1.25,96,1.54,68751.85,8,0,15,35,5,120.33,29,123,1,4,99.71,0.00,0.75,0.00,1,20.00,2,4619.59,1,1,4,org.apache.http.localserver.ServerTestBase,0.00,27,3,10,0,27,7,0,15,808,1
"org.apache.http.impl.conn.TestTSCCMNoServer",19,0.00,2.05,260,3.72,140460.22,19,0,19,61,7,99.05,94,356,1,2,98.82,0.00,0.50,0.00,3,19.00,6,11153.24,0,6,6,junit.framework.TestCase,0.00,42,1,39,0,42,13,0,74,2006,1
"org.apache.http.impl.conn.TestTSCCMWithServer",16,0.00,2.44,340,5.81,284585.55,16,0,36,83,11,45.71,119,422,1,4,88.01,0.00,0.75,0.00,2,0.00,6,17418.22,1,4,10,org.apache.http.localserver.ServerTestBase,0.00,67,3,39,0,67,12,0,96,2790,1
"org.apache.http.impl.conn.TestTSCCMWithServer$LatchSupport",3,0.00,2.00,14,0.15,2494.46,6,3,36,7,0,125.39,0,22,0,1,125.39,0.00,0.00,0.33,0,1.00,3,454.30,0,0,0,java.lang.Object,0.00,4,0,6,0,4,3,0,0,109,2
"org.apache.http.impl.conn.TestTSCCMWithServer$Runnable",1,0.00,2.00,7,0.05,543.52,1,0,36,5,0,117.78,0,10,0,1,117.78,0.00,0.00,0.00,0,1.00,2,148.18,0,0,0,java.lang.Object,0.00,4,0,2,0,4,1,0,0,37,0
"org.apache.http.impl.conn.TestTSCCMWithServer$Runnable_0",1,0.00,2.00,7,0.05,543.52,1,0,36,5,0,117.78,0,10,0,1,117.78,0.00,0.00,0.00,0,1.00,2,148.18,0,0,0,java.lang.Object,0.00,4,0,2,0,4,1,0,0,37,0
"org.apache.http.impl.conn.TestTSCCMWithServer$Runnable_1",1,0.00,2.00,7,0.05,543.52,1,0,36,5,0,117.78,0,10,0,1,117.78,0.00,0.00,0.00,0,1.00,2,148.18,0,0,0,java.lang.Object,0.00,4,0,2,0,4,1,0,0,37,0
"org.apache.http.impl.conn.TestTSCCMWithServer$Runnable_2",1,0.00,2.00,7,0.05,598.45,1,0,36,6,0,117.45,0,10,0,1,117.45,0.00,0.00,0.00,0,1.00,2,163.59,0,0,0,java.lang.Object,0.00,5,0,2,0,5,1,0,0,40,0
"org.apache.http.impl.conn.TestTSCCMWithServer$StallingOperator",4,0.33,1.25,12,0.15,2116.76,5,1,36,8,2,131.70,0,23,0,2,131.70,0.00,0.50,0.75,0,0.00,2,444.68,0,1,2,org.apache.http.impl.conn.LatchSupport,0.00,4,1,5,0,4,3,1,0,108,2
"org.apache.http.impl.conn.TestTSCCMWithServer$StallingSocketFactory",4,0.33,1.75,15,0.19,3749.36,5,1,36,8,1,129.67,0,28,0,2,129.67,0.00,0.50,0.75,0,0.00,3,579.04,0,2,1,org.apache.http.impl.conn.LatchSupport,0.00,4,1,7,0,4,2,1,0,133,2
"org.apache.http.impl.conn.TestTSCCMWithServer$ThreadSafeClientConnManager",1,0.00,1.00,4,0.05,775.60,1,0,36,4,1,125.79,0,7,0,1,125.79,0.00,0.00,0.00,0,1.00,1,156.56,1,1,1,java.lang.Object,0.00,3,0,1,0,3,0,0,0,38,0
"org.apache.http.impl.conn.TestTSCCMWithServer$WaitPolicy",0,0.00,0.00,2,0.01,36.00,0,0,36,0,1,171.00,0,1,0,1,171.00,0.00,0.00,0.00,0,0.00,0,24.00,0,0,1,java.lang.Object,0.00,0,0,0,0,0,0,1,0,8,1
"org.apache.http.impl.conn.ThreadSafe",5,0.50,3.80,54,0.83,33048.99,6,1,16,31,4,61.02,35,101,0,1,103.31,0.00,0.00,0.60,1,2.00,7,2481.62,0,1,4,java.lang.Object,0.00,26,0,19,0,26,4,1,7,449,1
"org.apache.http.impl.conn.ThreadSafe$ClientConnectionRequest",2,0.00,1.00,4,0.03,280.21,2,0,14,3,1,142.87,1,8,0,1,142.87,0.00,0.00,0.00,0,2.00,1,95.61,0,1,1,java.lang.Object,0.00,1,0,2,0,1,1,0,1,28,0
"org.apache.http.impl.conn.ThreadSafe$ConnAdapter",1,0.00,1.00,5,0.04,437.34,1,0,14,1,1,91.91,6,7,0,3,124.13,0.00,0.67,0.00,0,1.00,1,109.28,1,0,1,org.apache.http.impl.conn.AbstractPooledConnAdapter,0.00,0,2,1,0,0,1,0,1,30,1
"org.apache.http.impl.conn.ThreadSafe$PoolEntry",3,0.00,1.67,9,0.07,868.74,3,0,14,6,1,154.31,10,15,0,2,133.70,0.00,0.50,0.00,0,1.00,2,215.90,1,0,1,org.apache.http.impl.conn.AbstractPoolEntry,0.00,3,1,5,0,3,3,0,3,61,1
"org.apache.http.conn.ssl.CertificatesToPlayWith",0,0.00,0.00,21,2.45,58544.74,20,20,0,1,2,171.00,55,369,2,1,171.00,0.00,0.00,0.00,0,0.00,0,7352.93,0,0,0,java.lang.Object,0.00,1,0,0,0,1,0,0,14,900,1
"org.apache.http.conn.ssl.Immutable",2,0.00,1.00,4,0.04,467.65,2,0,1,2,0,141.35,8,11,0,2,141.12,0.00,0.50,0.00,0,2.00,1,127.32,0,1,0,AbstractVerifier,0.00,0,1,2,0,0,1,0,2,38,1
"org.apache.http.conn.ssl.NotThreadSafe",16,0.05,2.19,104,1.46,59223.40,27,11,25,42,3,65.59,132,189,0,1,113.69,0.00,0.00,0.05,2,92.00,10,4369.04,0,5,3,java.lang.Object,0.00,26,0,35,0,26,11,1,20,857,1
"org.apache.http.conn.ssl.TestHostnameVerifier",6,0.00,1.50,135,1.78,171962.41,6,0,8,19,3,85.97,29,151,1,2,85.73,0.00,0.50,0.00,1,6.00,3,5353.62,0,1,2,junit.framework.TestCase,0.00,13,1,9,0,13,5,0,21,965,1
"org.apache.http.conn.ssl.TestSSLSocketFactory",4,0.00,1.00,52,1.06,33977.53,4,0,27,51,3,148.51,4,71,1,2,98.51,0.00,0.50,0.00,0,4.00,1,3191.74,0,1,2,junit.framework.TestCase,0.00,47,1,4,0,47,3,0,2,494,1
"org.apache.http.conn.ssl.TestSSLSocketFactory$TestX509HostnameVerifier",5,1.00,1.00,10,0.09,862.48,6,1,27,5,1,142.16,0,16,0,1,142.16,0.00,0.00,0.00,0,5.00,1,284.16,0,0,1,java.lang.Object,0.00,0,0,5,0,0,5,1,0,78,1
"org.apache.http.conn.ssl.X509HostnameVerifier",3,0.00,1.00,4,0.04,260.39,3,0,5,3,3,126.35,39,6,3,2,155.73,0.00,0.50,0.00,0,3.00,1,132.97,0,0,0,,0.00,0,1,3,0,0,3,0,4,41,1
"org.apache.http.examples.client.ClientAbortMethod",1,0.00,2.00,14,0.21,7843.74,1,0,5,12,1,49.31,8,17,0,1,97.42,0.00,0.00,0.00,0,1.00,2,641.29,0,0,1,java.lang.Object,0.00,11,0,2,0,11,1,0,6,120,1
"org.apache.http.examples.client.ClientAuthentication",1,0.00,3.00,15,0.25,7805.10,1,0,6,16,0,53.93,7,21,0,1,96.23,0.00,0.00,0.00,0,1.00,3,747.35,0,0,0,java.lang.Object,0.00,15,0,3,0,15,1,0,4,135,1
"org.apache.http.examples.client.ClientChunkEncodedPost",1,0.00,4.00,23,0.38,14606.73,1,0,8,20,1,42.96,11,30,0,1,87.09,0.00,0.00,0.00,0,1.00,4,1145.25,0,0,1,java.lang.Object,0.00,19,0,4,0,19,1,0,9,195,1
"org.apache.http.examples.client.ClientConnectionRelease",1,0.00,4.00,19,0.30,14212.58,1,0,8,16,1,108.41,18,27,0,1,90.28,0.00,0.00,0.00,0,1.00,4,892.55,0,0,1,java.lang.Object,0.00,15,0,4,0,15,1,0,15,157,1
"org.apache.http.examples.client.ClientCustomContext",1,0.00,4.00,24,0.38,18026.06,1,0,12,17,4,48.12,12,26,0,1,85.68,0.00,0.00,0.00,0,1.00,4,1148.42,0,0,4,java.lang.Object,0.00,16,0,4,0,16,1,0,9,192,1
"org.apache.http.examples.client.ClientCustomSSL",1,0.00,3.00,22,0.38,15374.20,1,0,9,23,0,45.41,7,28,0,1,87.70,0.00,0.00,0.00,0,1.00,3,1128.16,0,0,0,java.lang.Object,0.00,22,0,3,0,22,1,0,4,190,1
"org.apache.http.examples.client.ClientEvictExpiredConnections",1,0.00,4.00,31,0.46,19222.74,1,0,11,22,2,37.19,11,39,0,1,81.32,0.00,0.00,0.00,0,1.00,4,1370.00,0,0,2,java.lang.Object,0.00,21,0,4,0,21,1,0,8,227,1
"org.apache.http.examples.client.ClientEvictExpiredConnections$IdleConnectionEvictor",3,0.25,1.67,17,0.13,1981.82,5,2,11,7,1,172.60,4,27,0,2,122.60,0.00,0.50,0.33,0,5.00,3,378.89,0,0,1,java.lang.Thread,0.00,4,1,5,0,4,3,0,4,92,2
"org.apache.http.examples.client.ClientExecuteDirect",1,0.00,3.00,20,0.30,13170.97,1,0,8,12,1,41.67,8,21,0,1,89.78,0.00,0.00,0.00,0,1.00,3,886.77,0,0,1,java.lang.Object,0.00,11,0,3,0,11,1,0,4,156,1
"org.apache.http.examples.client.ClientExecuteProxy",1,0.00,3.00,22,0.36,15498.00,1,0,9,14,2,39.57,8,23,0,1,87.67,0.00,0.00,0.00,0,1.00,3,1076.00,0,0,2,java.lang.Object,0.00,13,0,3,0,13,1,0,4,182,1
"org.apache.http.examples.client.ClientFormLogin",1,0.00,7.00,40,0.66,41292.95,1,0,12,21,1,32.15,7,45,0,1,74.44,0.00,0.00,0.00,0,1.00,7,1987.90,0,0,1,java.lang.Object,0.00,20,0,7,0,20,1,0,4,319,1
"org.apache.http.examples.client.ClientGZipContentCompression",1,0.00,2.00,21,0.33,14999.86,1,0,16,17,0,97.76,17,24,0,1,88.63,0.00,0.00,0.00,0,1.00,2,989.46,0,0,0,java.lang.Object,0.00,16,0,2,0,16,1,0,5,180,1
"org.apache.http.examples.client.ClientGZipContentCompression$GzipDecompressingEntity",3,0.00,1.00,8,0.07,1103.47,3,0,16,5,0,139.57,2,15,0,2,139.57,0.00,0.50,0.00,0,3.00,1,196.14,0,1,0,org.apache.http.entity.HttpEntityWrapper,0.00,2,1,3,0,2,2,0,2,54,1
"org.apache.http.examples.client.ClientGZipContentCompression$HttpRequestInterceptor",1,0.00,2.00,4,0.05,753.20,1,0,16,3,0,125.73,0,8,0,1,125.73,0.00,0.00,0.00,0,1.00,2,139.77,0,0,0,java.lang.Object,0.00,2,0,2,0,2,1,0,0,34,0
"org.apache.http.examples.client.ClientGZipContentCompression$HttpResponseInterceptor",1,0.00,4.00,13,0.16,5529.91,1,0,16,8,0,99.66,0,17,0,1,99.66,0.00,0.00,0.00,0,1.00,4,485.51,0,0,0,java.lang.Object,0.00,7,0,4,0,7,1,0,0,92,0
"org.apache.http.examples.client.ClientInteractiveAuthentication",1,0.00,7.00,40,0.70,38625.78,1,0,14,26,2,30.54,11,48,0,1,74.67,0.00,0.00,0.00,0,1.00,7,2110.02,0,0,2,java.lang.Object,0.00,25,0,7,0,25,1,0,8,327,1
"org.apache.http.examples.client.ClientKerberosAuthentication",1,0.00,3.00,23,0.36,12662.12,1,0,11,19,3,96.66,98,29,0,1,87.65,0.00,0.00,0.00,0,1.00,3,1091.66,0,0,3,java.lang.Object,0.00,18,0,3,0,18,1,0,9,186,1
"org.apache.http.examples.client.ClientKerberosAuthentication$Credentials",2,0.00,1.00,5,0.02,132.00,2,0,11,2,0,145.44,0,7,0,1,145.44,0.00,0.00,0.00,0,2.00,1,56.00,0,2,0,java.lang.Object,0.00,0,0,2,0,0,0,0,0,20,0
"org.apache.http.examples.client.ClientMultiThreadedExecution",1,0.00,4.00,27,0.33,13719.79,1,0,12,14,1,102.84,18,29,0,1,84.71,0.00,0.00,0.00,0,1.00,4,992.29,0,0,1,java.lang.Object,0.00,13,0,4,0,13,1,0,13,178,1
"org.apache.http.examples.client.ClientMultiThreadedExecution$GetThread",2,0.50,2.00,21,0.28,7654.46,6,4,12,9,1,145.21,5,28,0,2,105.32,0.00,0.50,0.50,0,2.00,3,853.93,0,0,1,java.lang.Thread,0.00,7,1,4,0,7,2,0,3,173,1
"org.apache.http.examples.client.ClientPreemptiveBasicAuthentication",1,0.00,3.00,25,0.40,16101.00,1,0,20,22,4,85.00,16,28,0,1,85.47,0.00,0.00,0.00,0,1.00,3,1196.73,0,0,4,java.lang.Object,0.00,21,0,3,0,21,1,0,7,201,1
"org.apache.http.examples.client.ClientPreemptiveBasicAuthentication$PreemptiveAuth",1,0.00,4.00,13,0.23,7674.62,1,0,20,10,4,148.53,1,27,0,1,98.53,0.00,0.00,0.00,0,1.00,4,693.17,0,0,4,java.lang.Object,0.00,9,0,4,0,9,1,1,1,128,1
"org.apache.http.examples.client.ClientPreemptiveDigestAuthentication",1,0.00,3.00,29,0.46,18231.87,1,0,21,25,4,108.93,19,32,0,1,82.64,0.00,0.00,0.00,0,1.00,3,1383.96,0,0,4,java.lang.Object,0.00,24,0,3,0,24,1,0,10,229,1
"org.apache.http.examples.client.ClientPreemptiveDigestAuthentication$PersistentDigest",1,0.00,3.00,7,0.09,2017.40,1,0,21,4,2,133.81,3,14,0,1,113.20,0.00,0.00,0.00,0,1.00,3,283.04,0,0,2,java.lang.Object,0.00,3,0,3,0,3,1,1,3,60,1
"org.apache.http.examples.client.ClientPreemptiveDigestAuthentication$PreemptiveAuth",1,0.00,4.00,13,0.23,7674.62,1,0,21,10,4,148.53,1,27,0,1,98.53,0.00,0.00,0.00,0,1.00,4,693.17,0,0,4,java.lang.Object,0.00,9,0,4,0,9,1,1,1,128,1
"org.apache.http.examples.client.ClientProxyAuthentication",1,0.00,3.00,20,0.37,12731.62,1,0,8,19,1,47.60,7,26,0,1,89.89,0.00,0.00,0.00,0,1.00,3,1097.62,0,0,1,java.lang.Object,0.00,18,0,3,0,18,1,0,4,187,1
"org.apache.http.examples.client.ClientWithResponseHandler",1,0.00,1.00,11,0.16,6067.23,1,0,5,9,2,54.26,8,13,0,1,102.36,0.00,0.00,0.00,0,1.00,1,490.81,0,0,2,java.lang.Object,0.00,8,0,1,0,8,1,0,5,96,1
"org.apache.http.entity.mime.Deprecated",1,1.00,1.00,4,0.04,582.77,2,1,1,2,0,108.89,5,6,0,2,126.76,0.00,0.50,0.00,0,1.00,1,118.51,0,0,0,java.lang.RuntimeException,0.00,1,1,1,0,1,1,0,1,32,1
"org.apache.http.entity.mime.HttpMultipartMode",0,0.00,0.00,2,0.01,23.26,0,0,0,0,3,171.00,4,4,3,1,171.00,0.00,0.00,0.00,0,0.00,0,15.51,0,0,0,java.lang.Object,0.00,0,0,0,0,0,0,0,1,6,1
"org.apache.http.entity.mime.Immutable",5,3.00,1.20,23,0.20,3805.88,8,3,4,9,0,175.81,6,31,0,1,125.81,0.00,0.00,0.00,1,5.00,2,585.86,0,4,0,java.lang.Object,0.00,4,0,6,0,4,1,1,2,148,1
"org.apache.http.entity.mime.NotThreadSafe",6,1.00,2.00,40,0.43,11058.87,7,1,5,20,1,166.10,9,53,0,2,116.10,0.00,0.50,0.00,5,6.00,3,1285.91,0,1,1,org.apache.james.mime4j.message.BodyPart,0.00,14,1,12,0,14,5,0,2,285,1
"org.apache.http.entity.mime.TestMultipartContentBody",5,0.00,1.00,46,0.70,23226.34,5,0,7,33,1,106.53,3,53,1,2,106.53,0.00,0.50,0.00,0,5.00,1,2087.31,0,1,0,junit.framework.TestCase,0.00,28,1,5,0,28,4,0,3,409,1
"org.apache.http.entity.mime.TestMultipartForm",10,0.33,1.30,184,3.22,104846.76,12,2,19,53,2,92.45,3,320,1,2,92.45,0.00,0.50,0.20,1,22.00,3,9650.37,0,2,1,junit.framework.TestCase,0.00,43,1,13,0,43,8,0,3,1609,1
"org.apache.http.entity.mime.TestMultipartFormHttpEntity",7,0.00,1.00,72,0.93,27381.56,7,0,13,37,2,105.41,3,85,1,2,105.41,0.00,0.50,0.00,0,7.00,1,2799.28,0,1,1,junit.framework.TestCase,0.00,30,1,7,0,30,6,0,3,546,1
"org.apache.http.entity.mime.ThreadSafe",15,0.15,1.67,77,0.88,25170.04,21,6,16,41,2,169.41,15,108,0,1,119.41,0.00,0.00,0.02,3,41.00,5,2646.79,0,4,2,java.lang.Object,0.00,26,0,25,0,26,11,1,5,558,1
"org.apache.http.conn.params.ConnConnectionPNames",0,0.00,0.00,2,0.01,157.40,1,1,0,0,1,171.00,22,3,1,1,171.00,0.00,0.00,0.00,0,0.00,0,44.97,0,0,0,,0.00,0,0,0,0,0,0,0,2,13,1
"org.apache.http.conn.params.ConnManagerPNames",0,0.00,0.00,4,0.05,941.02,3,3,0,0,1,171.00,29,7,1,1,171.00,0.00,0.00,0.00,0,0.00,0,151.24,0,0,0,,0.00,0,0,0,0,0,0,0,4,37,1
"org.apache.http.conn.params.ConnPerRoute",1,0.00,1.00,2,0.01,30.51,1,0,1,1,4,99.98,8,3,4,1,148.08,0.00,0.00,0.00,0,1.00,1,25.51,0,0,0,,0.00,0,0,1,0,0,1,0,1,11,1
"org.apache.http.conn.params.ConnRoutePNames",0,0.00,0.00,4,0.04,529.87,3,3,0,0,3,171.00,38,5,3,1,171.00,0.00,0.00,0.00,0,0.00,0,121.11,0,0,0,,0.00,0,0,0,0,0,0,0,4,31,1
"org.apache.http.conn.params.Immutable",6,1.00,2.17,31,0.36,9497.48,7,1,3,14,2,75.43,67,58,0,1,119.55,0.00,0.00,0.17,0,18.00,3,1091.98,0,1,2,java.lang.Object,0.00,8,0,13,0,8,5,1,9,240,2
"org.apache.http.conn.params.Immutable$ConnPerRoute",1,0.00,1.00,3,0.02,141.06,1,0,3,1,0,136.28,0,4,0,1,136.28,0.00,0.00,0.00,0,1.00,1,51.02,0,0,0,java.lang.Object,0.00,0,0,1,0,0,1,0,0,16,0
"org.apache.http.conn.params.NotThreadSafe",4,0.00,1.00,9,0.09,854.31,4,0,6,5,1,181.31,10,14,0,2,141.43,0.00,0.50,0.00,0,4.00,1,256.04,0,0,1,org.apache.http.params.HttpAbstractParamBean,0.00,1,1,4,0,1,4,0,4,71,1
"org.apache.http.conn.params.TestRouteParams",7,0.17,1.86,69,0.87,25568.70,10,3,10,23,1,157.21,12,113,1,2,107.21,0.00,0.50,0.19,0,13.00,7,2600.15,0,1,0,junit.framework.TestCase,0.00,16,1,13,0,16,6,0,9,563,1
"org.apache.http.conn.params.ThreadSafe",9,0.33,1.67,39,0.41,9542.29,12,3,5,17,1,174.60,13,63,0,1,124.60,0.00,0.00,0.04,2,16.00,3,1232.57,0,1,1,java.lang.Object,0.00,8,0,15,0,8,8,1,4,278,2
"org.apache.http.client.AuthenticationHandler",3,0.00,1.00,4,0.05,332.26,3,0,7,3,1,134.76,44,12,0,1,154.90,0.00,0.00,0.00,0,3.00,1,151.30,0,2,1,,0.00,0,0,3,0,0,1,0,4,43,1
"org.apache.http.client.CookieStore",4,0.00,1.00,5,0.02,93.32,4,0,3,4,6,128.01,27,6,5,1,160.23,0.00,0.00,0.00,0,4.00,1,68.67,0,1,1,,0.00,0,0,4,0,0,3,0,5,28,1
"org.apache.http.client.CredentialsProvider",3,0.00,1.00,4,0.02,62.51,3,0,2,3,7,112.14,31,5,6,1,160.61,0.00,0.00,0.00,0,3.00,1,57.51,0,1,1,,0.00,0,0,3,0,0,2,0,4,23,1
"org.apache.http.client.HttpClient",10,0.00,1.00,11,0.17,1704.85,10,0,8,10,18,179.71,197,33,15,1,153.43,0.00,0.00,0.00,0,10.00,1,522.35,0,6,3,,0.00,0,0,10,0,0,4,0,11,141,1
"org.apache.http.client.HttpRequestRetryHandler",1,0.00,1.00,2,0.01,48.22,1,0,2,1,2,190.46,22,3,2,1,146.52,0.00,0.00,0.00,0,1.00,1,43.22,0,0,0,,0.00,0,0,1,0,0,1,0,2,15,1
"org.apache.http.client.Immutable",3,1.00,1.00,8,0.05,646.35,4,1,1,3,0,99.11,21,12,0,2,141.40,0.00,0.50,0.00,0,3.00,1,163.28,0,0,0,RedirectException,0.00,0,1,3,0,0,3,0,4,48,1
"org.apache.http.client.RedirectHandler",2,0.00,1.00,3,0.02,88.83,2,0,4,2,0,147.67,31,5,0,1,158.03,0.00,0.00,0.00,0,2.00,1,67.22,0,1,0,,0.00,0,0,2,0,0,1,0,3,23,1
"org.apache.http.client.RequestDirector",1,0.00,1.00,2,0.02,87.16,1,0,6,1,0,181.53,30,4,0,1,144.49,0.00,0.00,0.00,0,1.00,1,58.11,0,1,0,,0.00,0,0,1,0,0,0,0,2,18,1
"org.apache.http.client.ResponseHandler",1,0.00,1.00,2,0.02,98.94,1,0,2,1,2,153.19,17,3,2,1,144.06,0.00,0.00,0.00,0,1.00,1,50.99,0,0,0,,0.00,0,0,1,0,0,1,0,2,17,1
"org.apache.http.client.UserTokenHandler",1,0.00,1.00,2,0.01,30.51,1,0,1,1,1,192.02,22,3,1,1,148.08,0.00,0.00,0.00,0,1.00,1,25.51,0,1,0,,0.00,0,0,1,0,0,0,0,2,11,1
"org.apache.http.examples.entity.mime.ClientMultipartFormPost",1,0.00,4.00,23,0.38,13592.77,1,0,9,18,1,107.95,3,29,0,1,87.34,0.00,0.00,0.00,0,1.00,4,1134.84,0,0,1,java.lang.Object,0.00,17,0,4,0,17,1,0,1,194,1
"org.apache.http.contrib.auth.BouncySpnegoTokenGenerator",3,0.00,3.00,62,0.88,53090.62,6,3,14,26,1,128.65,7,63,0,1,88.76,0.00,0.00,0.33,2,4.00,4,2647.61,0,0,1,java.lang.Object,0.00,23,0,9,0,23,3,1,4,475,1
"org.apache.http.mockup.HttpConnectionMockup",8,1.00,1.00,17,0.10,845.18,9,1,3,8,0,143.83,4,26,0,1,143.83,0.00,0.00,0.00,0,8.00,1,285.78,0,1,0,java.lang.Object,0.00,0,0,8,0,0,7,1,1,87,1
"org.apache.http.mockup.ProxySelectorMockup",3,0.50,1.67,12,0.14,3005.33,4,1,7,7,1,82.50,22,20,1,2,124.79,0.00,0.50,0.67,0,1.00,3,405.84,0,1,0,java.net.ProxySelector,0.00,4,1,5,0,4,2,0,5,95,1
"org.apache.http.mockup.SecureSocketFactoryMockup",3,1.00,1.00,8,0.08,1140.90,4,1,2,5,3,189.45,5,16,1,2,139.45,0.00,0.50,0.00,0,4.00,1,234.27,0,2,2,org.apache.http.mockup.SocketFactoryMockup,0.25,2,1,3,0,2,1,1,3,62,1
"org.apache.http.mockup.SessionInputBufferMockup",11,0.90,1.00,25,0.31,4285.91,12,1,7,15,1,139.37,3,66,1,2,139.37,0.00,0.50,0.18,0,25.00,1,942.55,0,0,0,org.apache.http.impl.io.AbstractSessionInputBuffer,0.00,4,1,11,0,4,11,0,1,241,1
"org.apache.http.mockup.SocketFactoryMockup",5,0.38,1.20,13,0.14,2071.10,7,2,4,10,4,189.12,7,23,3,1,139.12,0.00,0.00,0.20,0,7.00,2,415.25,0,3,1,java.lang.Object,0.00,5,0,6,1,5,2,1,5,106,1
"org.apache.http.impl.auth.Immutable",1,0.00,1.00,3,0.02,253.12,1,0,4,2,2,102.06,6,5,0,1,134.28,0.00,0.00,0.00,0,1.00,1,73.60,0,1,2,java.lang.Object,0.00,1,0,1,0,1,0,1,1,22,1
"org.apache.http.impl.auth.NTLMEngine",2,0.00,1.00,3,0.03,212.92,2,0,0,2,0,134.89,28,11,0,1,155.04,0.00,0.00,0.00,0,2.00,1,95.35,0,2,0,,0.00,0,0,2,0,0,0,0,3,31,1
"org.apache.http.impl.auth.NegotiateScheme",14,0.08,2.50,104,1.52,63419.45,29,15,17,50,4,62.37,120,153,1,1,110.47,0.00,0.00,0.14,4,70.00,11,4552.46,0,4,3,java.lang.Object,0.00,36,0,35,0,36,10,1,29,837,1
"org.apache.http.impl.auth.NegotiateSchemeFactory",8,0.10,1.00,24,0.16,2252.88,11,3,3,12,5,183.91,8,33,1,1,133.91,0.00,0.00,0.25,0,20.00,1,491.14,0,2,4,java.lang.Object,0.00,4,0,8,0,4,6,1,3,133,1
"org.apache.http.impl.auth.NotThreadSafe",14,0.00,3.21,207,2.97,193779.64,22,8,17,58,1,47.26,120,266,0,2,95.37,0.00,0.50,0.12,6,50.00,11,8916.00,1,9,1,RFC2617Scheme,0.00,44,1,45,0,44,5,0,32,1540,1
"org.apache.http.impl.auth.NotThreadSafe$State",0,0.00,0.00,2,0.01,28.53,0,0,12,0,0,171.00,0,8,0,1,171.00,0.00,0.00,0.00,0,0.00,0,28.53,0,0,0,java.lang.Object,0.00,0,0,0,0,0,0,0,0,9,0
"org.apache.http.impl.auth.SpnegoTokenGenerator",1,0.00,1.00,2,0.01,90.00,1,0,1,1,3,165.00,3,3,3,1,144.38,0.00,0.00,0.00,0,1.00,1,40.00,0,0,0,,0.00,0,0,1,0,0,1,0,1,15,1
"org.apache.http.impl.auth.TestBasicScheme",7,0.00,1.29,53,0.75,15090.07,7,0,13,32,2,163.17,9,65,1,2,113.17,0.00,0.50,0.00,0,7.00,2,2246.39,0,1,1,junit.framework.TestCase,0.00,25,1,9,0,25,6,0,5,430,1
"org.apache.http.impl.auth.TestDigestScheme",15,0.00,1.33,178,2.83,87589.60,15,0,16,40,3,152.43,27,216,1,2,102.43,0.00,0.50,0.00,1,15.00,3,8490.24,0,2,2,junit.framework.TestCase,0.00,25,1,20,0,25,13,0,18,1504,1
"org.apache.http.impl.auth.TestRFC2617Scheme",7,0.00,1.43,42,0.46,8497.04,7,0,12,18,2,117.60,5,58,1,2,117.60,0.00,0.50,0.00,0,7.00,2,1393.78,0,1,1,junit.framework.TestCase,0.00,11,1,10,0,11,6,0,5,301,1
"org.apache.http.impl.auth.TestRFC2617Scheme$TestAuthScheme",4,0.00,1.00,9,0.05,429.81,4,0,12,4,1,143.78,0,16,0,2,143.78,0.00,0.50,0.00,0,4.00,1,150.02,0,2,1,RFC2617Scheme,0.00,0,1,4,0,0,2,0,0,46,1
"org.apache.http.impl.client.ContentEncodingHttpClient",4,0.00,1.00,12,0.09,1369.39,4,0,5,8,2,115.37,21,18,1,2,133.24,0.00,0.50,0.00,0,4.00,1,261.97,1,1,1,DefaultHttpClient,0.00,4,1,4,0,4,3,0,5,73,1
"org.apache.http.impl.client.Immutable",5,0.38,3.00,39,0.39,17219.95,7,2,12,8,1,69.08,35,60,0,1,111.37,0.00,0.00,0.20,0,11.00,11,1171.33,0,0,1,java.lang.Object,0.00,3,0,15,0,3,5,1,18,232,1
"org.apache.http.impl.client.NotThreadSafe",3,0.25,1.00,11,0.08,971.05,5,2,2,3,0,133.67,14,15,0,1,133.44,0.00,0.00,0.33,0,5.00,1,225.04,0,1,0,java.lang.Object,0.00,0,0,3,0,0,2,0,5,62,1
"org.apache.http.impl.client.TestBasicCredentialsProvider",13,0.01,1.00,97,1.51,63299.17,19,6,4,25,2,160.44,14,134,1,2,110.44,0.00,0.50,0.15,0,59.00,1,4542.46,0,1,1,junit.framework.TestCase,0.00,12,1,13,0,12,12,0,7,946,1
"org.apache.http.impl.client.TestClientAuthentication",9,0.00,1.11,95,1.30,25229.19,9,0,31,44,7,106.52,3,113,1,3,106.52,0.00,0.67,0.00,0,0.00,2,3899.71,1,1,6,org.apache.http.localserver.BasicServerTestBase,0.00,35,2,10,0,35,8,0,1,733,1
"org.apache.http.impl.client.TestClientAuthentication$AuthHandler",1,0.00,2.00,9,0.14,4042.44,1,0,31,6,0,106.84,0,15,0,1,106.84,0.00,0.00,0.00,0,1.00,2,422.68,0,0,0,java.lang.Object,0.00,5,0,2,0,5,1,1,0,82,1
"org.apache.http.impl.client.TestClientAuthentication$TestCredentialsProvider",5,2.00,1.00,13,0.08,947.68,7,2,31,5,2,141.83,0,19,0,1,141.83,0.00,0.00,0.00,0,5.00,1,254.77,0,2,2,java.lang.Object,0.00,0,0,5,0,0,3,1,0,74,1
"org.apache.http.impl.client.TestContentCodings",11,0.00,1.36,92,1.24,32027.02,11,0,34,51,5,67.67,83,110,1,4,109.96,0.00,0.75,0.00,1,11.00,5,3734.62,1,2,4,org.apache.http.localserver.ServerTestBase,0.00,40,3,15,0,40,9,0,16,697,1
"org.apache.http.impl.client.TestContentCodings$HttpRequestHandler",1,0.00,1.00,3,0.03,313.93,1,0,34,2,0,154.16,3,7,0,1,133.54,0.00,0.00,0.00,0,1.00,1,101.45,0,0,0,java.lang.Object,0.00,1,0,1,0,1,1,0,1,26,0
"org.apache.http.impl.client.TestContentCodings$HttpRequestHandler_0",1,0.00,1.00,6,0.09,1547.25,1,0,34,5,0,137.47,3,7,0,1,116.86,0.00,0.00,0.00,0,1.00,1,260.22,0,0,0,java.lang.Object,0.00,4,0,1,0,4,1,0,1,54,0
"org.apache.http.impl.client.TestContentCodings$HttpRequestHandler_1",1,0.00,4.00,21,0.32,10058.79,1,0,34,15,0,47.55,7,27,0,1,89.84,0.00,0.00,0.00,0,1.00,4,954.72,0,0,0,java.lang.Object,0.00,14,0,4,0,14,1,0,5,163,0
"org.apache.http.impl.client.TestContentCodings$HttpRequestHandler_2",1,0.00,5.00,22,0.34,12724.62,1,0,34,15,0,44.10,11,30,0,1,88.23,0.00,0.00,0.00,0,1.00,5,1021.04,0,0,0,java.lang.Object,0.00,14,0,5,0,14,1,0,2,171,0
"org.apache.http.impl.client.TestContentCodings$HttpRequestInterceptor",1,0.00,1.00,3,0.03,266.17,1,0,34,2,0,154.72,3,5,0,1,134.10,0.00,0.00,0.00,0,1.00,1,85.66,0,0,0,java.lang.Object,0.00,1,0,1,0,1,1,0,1,23,0
"org.apache.http.impl.client.TestContentCodings$HttpResponseInterceptor",1,0.00,5.00,14,0.16,4931.14,1,0,34,6,0,119.41,3,17,0,1,98.80,0.00,0.00,0.00,0,1.00,5,487.92,0,0,0,java.lang.Object,0.00,5,0,5,0,5,1,0,1,93,0
"org.apache.http.impl.client.TestContentCodings$WorkerTask",4,0.17,1.75,26,0.26,3714.77,10,6,34,12,2,76.18,31,37,0,1,118.47,0.00,0.00,0.29,0,4.00,3,765.35,0,1,2,java.lang.Object,0.00,8,0,7,0,8,3,1,9,170,0
"org.apache.http.impl.client.TestCookieIdentityComparator",9,0.00,1.00,84,1.02,30358.39,9,0,3,19,1,157.62,9,94,1,2,107.62,0.00,0.50,0.00,0,9.00,1,3061.21,0,1,0,junit.framework.TestCase,0.00,10,1,9,0,10,8,0,5,649,1
"org.apache.http.impl.client.TestDefaultClientRequestDirector",14,0.00,1.43,180,2.91,80987.77,14,0,50,78,12,151.03,26,208,1,3,101.04,0.00,0.67,0.00,0,26.00,2,8717.24,1,1,11,org.apache.http.localserver.BasicServerTestBase,0.00,64,2,20,0,64,13,0,7,1548,1
"org.apache.http.impl.client.TestDefaultClientRequestDirector$BasicRedirectService",2,2.00,1.00,10,0.15,2616.73,4,2,50,7,0,120.38,0,16,0,1,120.38,0.00,0.00,0.00,0,2.00,1,439.16,0,0,0,java.lang.Object,0.00,5,0,2,0,5,2,1,0,95,1
"org.apache.http.impl.client.TestDefaultClientRequestDirector$BasicService",1,0.00,1.00,4,0.05,705.35,1,0,50,4,0,126.11,0,8,0,1,126.11,0.00,0.00,0.00,0,1.00,1,164.41,0,0,0,java.lang.Object,0.00,3,0,1,0,3,1,1,0,39,2
"org.apache.http.impl.client.TestDefaultClientRequestDirector$ConMan",10,2.00,1.00,27,0.23,2900.56,12,2,50,17,4,140.38,0,41,0,1,140.38,0.00,0.00,0.00,0,10.00,1,689.59,0,5,4,java.lang.Object,0.00,7,0,10,0,7,5,1,0,184,1
"org.apache.http.impl.client.TestDefaultClientRequestDirector$ConMan$ClientConnectionRequest_4",2,0.00,2.00,8,0.10,2148.62,2,0,50,5,2,174.51,2,15,0,1,124.51,0.00,0.00,0.00,0,2.00,3,287.41,0,1,2,java.lang.Object,0.00,3,0,4,0,3,1,0,2,64,0
"org.apache.http.impl.client.TestDefaultClientRequestDirector$ConnMan2",10,2.00,1.00,24,0.19,2104.37,12,2,50,16,4,141.48,0,38,0,1,141.48,0.00,0.00,0.00,0,10.00,1,577.83,0,5,4,java.lang.Object,0.00,6,0,10,0,6,5,1,0,157,1
"org.apache.http.impl.client.TestDefaultClientRequestDirector$ConnMan2$ClientConnectionRequest_3",2,0.00,1.00,6,0.04,401.62,2,0,50,4,2,135.07,0,11,0,1,135.07,0.00,0.00,0.00,0,2.00,1,116.54,0,1,2,java.lang.Object,0.00,2,0,2,0,2,1,0,0,33,0
"org.apache.http.impl.client.TestDefaultClientRequestDirector$ConnMan2$ClientConnectionRequest_3$ClientConnAdapterMockup",1,0.00,1.00,3,0.04,428.57,1,0,50,2,0,132.48,0,6,0,1,132.48,0.00,0.00,0.00,0,1.00,1,108.86,0,0,0,java.lang.Object,0.00,1,0,1,0,1,1,0,0,28,0
"org.apache.http.impl.client.TestDefaultClientRequestDirector$ConnMan3",3,0.25,1.00,11,0.10,1483.55,5,2,50,3,1,131.99,0,17,0,2,131.99,0.00,0.50,0.33,0,5.00,1,295.33,2,1,1,org.apache.http.impl.conn.SingleClientConnManager,0.00,0,1,3,0,0,2,0,0,77,2
"org.apache.http.impl.client.TestDefaultClientRequestDirector$ConnMan4",2,2.00,1.50,13,0.13,2643.56,4,2,50,7,1,167.30,2,19,0,2,117.30,0.00,0.50,0.00,0,2.00,2,385.37,1,1,1,org.apache.http.impl.conn.tsccm.ThreadSafeClientConnManager,0.00,5,1,3,0,5,1,0,2,92,2
"org.apache.http.impl.client.TestDefaultClientRequestDirector$ConnMan4$ClientConnectionRequest",2,0.00,2.00,8,0.10,2148.62,2,0,50,5,2,174.51,2,15,0,1,124.51,0.00,0.00,0.00,0,2.00,3,287.41,0,1,2,java.lang.Object,0.00,3,0,4,0,3,1,0,2,64,0
"org.apache.http.impl.client.TestDefaultClientRequestDirector$CustomGet",2,1.00,2.00,10,0.11,2432.21,3,1,50,4,1,120.47,0,17,0,2,120.47,0.00,0.50,0.50,0,2.00,3,344.76,1,0,1,org.apache.http.client.methods.HttpGet,0.00,2,1,4,0,2,2,0,0,79,2
"org.apache.http.impl.client.TestDefaultClientRequestDirector$FaultyHttpClient",3,1.00,1.00,8,0.05,592.50,4,1,50,4,0,141.69,0,13,0,2,141.69,0.00,0.50,0.33,0,4.00,1,157.48,0,1,0,DefaultHttpClient,0.00,1,1,3,0,1,2,0,0,47,2
"org.apache.http.impl.client.TestDefaultClientRequestDirector$FaultyHttpRequestExecutor",2,0.00,1.50,11,0.14,3697.43,4,2,50,5,0,119.11,0,19,0,2,119.11,0.00,0.50,0.50,0,2.00,2,426.25,1,1,0,org.apache.http.protocol.HttpRequestExecutor,0.00,3,1,3,0,3,1,0,0,93,2
"org.apache.http.impl.client.TestDefaultClientRequestDirector$HttpRequestInterceptor",1,0.00,1.00,3,0.03,346.35,1,0,50,2,0,133.20,0,6,0,1,133.20,0.00,0.00,0.00,0,1.00,1,95.57,0,0,0,java.lang.Object,0.00,1,0,1,0,1,1,0,0,25,0
"org.apache.http.impl.client.TestDefaultClientRequestDirector$HttpRequestRetryHandler",1,0.00,1.00,3,0.02,199.53,1,0,50,1,0,135.09,0,7,0,1,135.09,0.00,0.00,0.00,0,1.00,1,70.51,0,0,0,java.lang.Object,0.00,0,0,1,0,0,1,0,0,20,0
"org.apache.http.impl.client.TestDefaultClientRequestDirector$Runnable",1,0.00,2.00,6,0.05,611.31,1,0,50,4,0,119.87,0,10,0,1,119.87,0.00,0.00,0.00,0,1.00,2,146.30,0,0,0,java.lang.Object,0.00,3,0,2,0,3,1,0,0,36,0
"org.apache.http.impl.client.TestDefaultClientRequestDirector$Runnable_0",1,0.00,2.00,6,0.05,655.31,1,0,50,5,0,119.64,0,10,0,1,119.64,0.00,0.00,0.00,0,1.00,2,157.34,0,0,0,java.lang.Object,0.00,4,0,2,0,4,1,0,0,38,0
"org.apache.http.impl.client.TestDefaultClientRequestDirector$Runnable_1",1,0.00,4.00,9,0.11,2273.34,1,0,50,7,0,108.65,0,16,0,1,108.65,0.00,0.00,0.00,0,1.00,4,341.40,0,0,0,java.lang.Object,0.00,6,0,4,0,6,1,0,0,69,0
"org.apache.http.impl.client.TestDefaultClientRequestDirector$Runnable_2",1,0.00,2.00,7,0.07,1184.17,1,0,50,5,0,115.11,0,11,0,1,115.11,0.00,0.00,0.00,0,1.00,2,205.42,0,0,0,java.lang.Object,0.00,4,0,2,0,4,1,0,0,46,0
"org.apache.http.impl.client.TestDefaultClientRequestDirector$SimpleService",2,0.00,1.00,7,0.07,1086.24,2,0,50,5,0,131.67,0,13,0,1,131.67,0.00,0.00,0.00,0,2.00,1,216.92,0,0,0,java.lang.Object,0.00,3,0,2,0,3,2,1,0,52,1
"org.apache.http.impl.client.TestDefaultClientRequestDirector$ThrowingService",1,0.00,1.00,3,0.04,452.78,1,0,50,2,0,132.29,0,8,0,1,132.29,0.00,0.00,0.00,0,1.00,1,111.39,0,0,0,java.lang.Object,0.00,1,0,1,0,1,1,1,0,29,2
"org.apache.http.impl.client.TestDefaultConnKeepAliveStrategy",8,0.00,1.12,41,0.55,8616.93,8,0,11,19,2,171.02,8,56,1,2,121.02,0.00,0.50,0.00,0,8.00,2,1651.02,0,1,1,junit.framework.TestCase,0.00,11,1,9,0,11,7,0,5,342,1
"org.apache.http.impl.client.TestRequestWrapper",6,0.00,1.33,43,0.64,15029.42,6,0,16,26,3,162.65,7,55,1,3,112.65,0.00,0.67,0.00,0,10.00,2,1914.87,1,1,2,org.apache.http.localserver.BasicServerTestBase,0.00,20,2,8,0,20,5,0,4,360,1
"org.apache.http.impl.client.TestRequestWrapper$SimpleService",2,0.00,1.00,7,0.07,1086.24,2,0,16,5,0,131.67,0,13,0,1,131.67,0.00,0.00,0.00,0,2.00,1,216.92,0,0,0,java.lang.Object,0.00,3,0,2,0,3,2,1,0,52,1
"org.apache.http.impl.client.TestStatefulConnManagement",4,0.00,2.75,64,0.77,45596.29,4,0,23,30,5,93.90,3,58,1,4,93.90,0.00,0.75,0.00,0,6.00,8,2315.46,0,1,4,org.apache.http.localserver.ServerTestBase,0.00,26,3,11,0,26,3,0,1,401,1
"org.apache.http.impl.client.TestStatefulConnManagement$HttpWorker",4,6.00,1.75,33,0.37,10789.69,10,6,23,11,2,110.17,0,48,0,2,110.17,0.00,0.50,0.00,0,4.00,4,1107.41,0,1,2,java.lang.Thread,0.00,7,1,7,0,7,3,0,0,225,1
"org.apache.http.impl.client.TestStatefulConnManagement$SimpleService",2,0.00,1.00,7,0.07,1086.24,2,0,23,5,0,131.67,0,13,0,1,131.67,0.00,0.00,0.00,0,2.00,1,216.92,0,0,0,java.lang.Object,0.00,3,0,2,0,3,2,1,0,52,1
"org.apache.http.impl.client.TestStatefulConnManagement$UserTokenHandler",1,0.00,1.00,4,0.03,496.00,1,0,23,2,0,127.32,0,5,0,1,127.32,0.00,0.00,0.00,0,1.00,1,96.00,0,1,0,java.lang.Object,0.00,1,0,1,0,1,0,0,0,26,0
"org.apache.http.impl.client.ThreadSafe",6,0.80,2.00,31,0.33,13327.51,7,1,6,12,2,139.03,19,49,0,1,118.41,0.00,0.00,0.33,2,10.00,5,1002.63,0,3,2,java.lang.Object,0.00,6,0,12,0,6,3,1,6,221,1
"org.apache.http.impl.conn.tsccm.AwaitThread",4,0.47,1.25,25,0.19,2676.09,9,5,2,7,1,159.56,11,36,1,2,119.67,0.00,0.50,0.55,0,0.00,2,558.28,0,1,0,java.lang.Thread,0.00,3,1,5,0,3,3,0,4,133,1
"org.apache.http.impl.conn.tsccm.BasicPoolEntry",6,0.00,1.33,18,0.14,2113.47,6,0,5,7,10,172.97,14,32,7,2,133.08,0.00,0.50,0.00,0,6.00,2,423.78,1,2,3,org.apache.http.impl.conn.AbstractPoolEntry,0.14,1,1,8,0,1,4,0,3,111,1
"org.apache.http.impl.conn.tsccm.BasicPooledConnAdapter",4,0.00,1.00,10,0.07,721.61,4,0,3,4,5,124.13,21,18,2,3,142.00,0.00,0.67,0.00,0,4.00,1,195.70,3,2,3,org.apache.http.impl.conn.AbstractPooledConnAdapter,0.13,0,2,4,0,0,2,0,6,59,1
"org.apache.http.impl.conn.tsccm.Deprecated",4,0.00,3.00,25,0.26,6545.54,7,3,2,9,0,67.93,40,38,0,1,116.41,0.00,0.00,0.33,0,4.00,5,776.30,0,1,0,java.lang.Object,0.00,5,0,12,0,5,3,1,10,174,1
"org.apache.http.impl.conn.tsccm.Immutable",2,1.00,1.50,9,0.09,1836.98,3,1,4,4,1,76.64,21,15,0,2,125.12,0.00,0.50,0.50,0,2.00,2,270.53,0,1,1,java.lang.ref.WeakReference,0.00,2,1,3,0,2,1,0,5,64,1
"org.apache.http.impl.conn.tsccm.NotThreadSafe",15,0.02,1.80,69,0.76,21564.33,21,6,10,34,2,81.25,113,104,0,1,123.54,0.00,0.00,0.19,1,41.00,6,2266.04,0,1,2,java.lang.Object,0.00,19,0,27,0,19,14,0,23,493,1
"org.apache.http.impl.conn.tsccm.PoolEntryRequest",2,0.00,1.00,3,0.02,80.08,2,0,2,2,3,120.82,25,6,2,1,158.38,0.00,0.00,0.00,0,2.00,1,56.05,0,1,1,,0.00,0,0,2,0,0,1,0,3,20,1
"org.apache.http.impl.conn.tsccm.TestConnPoolByRoute",5,0.00,1.20,72,1.25,72624.04,5,0,10,26,5,135.31,12,86,1,4,95.43,0.00,0.75,0.00,0,7.00,2,3738.62,1,1,4,org.apache.http.localserver.ServerTestBase,0.00,21,3,6,0,21,4,0,12,641,1
"org.apache.http.impl.conn.tsccm.TestSpuriousWakeup",4,0.50,1.50,41,0.56,20169.23,6,2,16,29,7,72.23,27,52,1,2,104.45,0.00,0.50,0.12,0,6.00,3,1684.81,0,1,6,junit.framework.TestCase,0.00,25,1,6,0,25,3,0,17,305,1
"org.apache.http.impl.conn.tsccm.TestSpuriousWakeup$XConnPoolByRoute",2,1.00,1.00,8,0.08,1349.16,3,1,16,2,2,126.26,1,17,0,2,126.26,0.00,0.50,0.50,0,2.00,1,235.56,1,0,2,ConnPoolByRoute,0.00,0,1,2,0,0,2,0,1,60,2
"org.apache.http.impl.conn.tsccm.TestSpuriousWakeup$XTSCCM",2,1.00,1.00,7,0.05,620.30,3,1,16,3,0,183.58,2,11,0,2,133.58,0.00,0.50,0.50,0,2.00,1,151.51,0,0,0,org.apache.http.impl.conn.ThreadSafeClientConnManager,0.00,1,1,2,0,1,2,0,2,42,2
"org.apache.http.impl.conn.tsccm.TestWaitingThread",7,1.00,1.29,84,1.10,30242.17,8,1,8,35,2,152.06,13,101,1,2,102.06,0.00,0.50,0.14,0,12.00,2,3296.20,0,1,1,junit.framework.TestCase,0.00,28,1,9,0,28,6,0,11,619,1
"org.apache.http.impl.conn.tsccm.ThreadSafe",20,0.00,1.55,93,0.99,27358.69,26,6,16,50,8,105.87,109,142,0,1,123.75,0.00,0.00,0.17,2,102.00,9,2969.34,1,3,8,java.lang.Object,0.00,30,0,31,0,30,17,1,29,650,1
"org.apache.http.impl.conn.tsccm.ThreadSafe$ClientConnectionRequest",2,0.00,2.00,10,0.12,2736.26,2,0,16,6,3,120.07,0,17,0,1,120.07,0.00,0.00,0.00,0,2.00,3,360.99,0,1,3,java.lang.Object,0.00,4,0,4,0,4,1,0,0,76,0
"org.apache.http.impl.conn.tsccm.ThreadSafe$PoolEntryRequest",2,0.00,1.00,8,0.06,684.00,2,0,18,6,1,128.59,0,15,0,1,128.59,0.00,0.00,0.00,0,2.00,1,186.94,0,0,1,java.lang.Object,0.00,4,0,2,0,4,2,0,0,49,0
"org.apache.http.conn.util.Immutable",5,0.17,1.00,13,0.17,3395.79,8,3,2,8,0,187.47,5,25,0,1,137.47,0.00,0.00,0.20,1,14.00,1,501.27,0,0,0,java.lang.Object,0.00,3,0,5,0,3,5,0,1,125,1
"org.apache.http.conn.util.TestInetAddressUtils",7,0.00,1.00,26,0.24,3452.24,7,0,3,16,1,132.00,4,34,1,2,132.00,0.00,0.50,0.00,0,7.00,1,732.47,0,1,0,junit.framework.TestCase,0.00,9,1,7,0,9,6,0,2,193,1
"org.apache.http.conn.ClientConnectionManager",6,0.00,1.00,7,0.04,120.22,6,0,3,6,19,112.27,65,8,17,1,160.75,0.00,0.00,0.00,0,6.00,1,115.22,0,1,2,,0.00,0,0,6,0,0,5,0,7,43,1
"org.apache.http.conn.ClientConnectionManagerFactory",1,0.00,1.00,2,0.01,39.00,1,0,2,1,2,115.02,6,5,1,1,147.24,0.00,0.00,0.00,0,1.00,1,34.00,0,1,1,,0.00,0,0,1,0,0,0,0,1,13,1
"org.apache.http.conn.ClientConnectionOperator",3,0.00,1.00,4,0.05,198.95,3,0,7,3,13,156.18,48,14,11,1,156.65,0.00,0.00,0.00,0,3.00,1,135.30,0,1,2,,0.00,0,0,3,0,0,2,0,4,39,1
"org.apache.http.conn.ClientConnectionRequest",2,0.00,1.00,3,0.02,80.08,2,0,1,2,15,157.91,32,5,14,1,158.38,0.00,0.00,0.00,0,2.00,1,56.05,0,1,1,,0.00,0,0,2,0,0,1,0,3,20,1
"org.apache.http.conn.ConnectionKeepAliveStrategy",1,0.00,1.00,2,0.01,39.00,1,0,3,1,1,188.72,29,3,1,1,147.24,0.00,0.00,0.00,0,1.00,1,34.00,0,0,0,,0.00,0,0,1,0,0,1,0,2,13,1
"org.apache.http.conn.ConnectionReleaseTrigger",2,0.00,1.00,3,0.01,61.53,2,0,1,2,4,148.92,31,6,4,1,159.28,0.00,0.00,0.00,0,2.00,1,41.02,0,0,0,,0.00,0,0,2,0,0,2,0,3,17,1
"org.apache.http.conn.EofSensorWatcher",3,0.00,1.00,4,0.03,123.00,3,0,2,3,1,167.43,52,8,1,1,158.30,0.00,0.00,0.00,0,3.00,1,82.00,0,0,0,,0.00,0,0,3,0,0,3,0,4,29,1
"org.apache.http.conn.Immutable",2,1.00,1.00,6,0.04,643.49,3,1,2,2,0,91.17,15,9,0,2,133.46,0.00,0.50,0.00,0,2.00,1,130.63,0,0,0,java.io.InterruptedIOException,0.00,0,1,2,0,0,2,0,3,37,1
"org.apache.http.conn.ManagedClientConnection",13,0.00,1.00,14,0.09,378.23,13,0,9,13,23,115.35,151,20,23,4,159.47,0.00,0.75,0.00,0,13.00,1,274.99,0,3,0,,0.00,0,3,13,0,0,10,0,14,95,1
"org.apache.http.conn.NotThreadSafe",12,0.15,2.58,78,0.71,21451.13,15,3,3,20,2,66.15,110,127,0,2,116.14,0.00,0.50,0.47,5,0.00,4,2139.65,0,0,2,java.io.InputStream,0.00,8,1,31,0,8,12,1,20,475,1
"org.apache.http.conn.OperatedClientConnection",6,0.00,1.00,7,0.06,248.53,6,0,6,6,10,157.79,96,12,10,3,158.26,0.00,0.67,0.00,0,6.00,1,166.20,0,2,0,,0.00,0,2,6,0,0,4,0,7,54,1
"org.apache.http.conn.TestConnectionAutoRelease",8,0.00,1.75,99,1.42,41202.50,8,0,24,33,4,141.27,17,119,1,4,101.39,0.00,0.75,0.00,1,20.00,3,4259.93,1,2,3,org.apache.http.localserver.ServerTestBase,0.00,25,3,14,0,25,6,0,17,757,1
"org.apache.http.conn.TestConnectionAutoRelease$HttpRequestHandler",1,0.00,1.00,5,0.05,728.53,1,0,24,4,0,122.39,0,9,0,1,122.39,0.00,0.00,0.00,0,1.00,1,157.28,0,0,0,java.lang.Object,0.00,3,0,1,0,3,1,0,0,37,0
"org.apache.http.conn.TestConnectionAutoRelease$HttpRequestHandler$BasicHttpEntity",1,0.00,2.00,8,0.10,2613.39,1,0,24,5,0,150.13,2,14,0,1,110.24,0.00,0.00,0.00,0,1.00,2,308.16,0,0,0,java.lang.Object,0.00,4,0,2,0,4,1,0,2,63,0
"org.apache.http.conn.TestConnectionReuse",8,1.00,3.12,200,3.15,141893.94,9,1,34,55,5,135.13,8,212,1,2,85.13,0.00,0.50,0.12,0,14.00,5,9449.74,0,1,4,junit.framework.TestCase,0.00,47,1,25,0,47,7,0,8,1509,1
"org.apache.http.conn.TestConnectionReuse$AlwaysCloseConn",1,0.00,1.00,3,0.04,482.77,1,0,34,2,0,132.07,0,7,0,1,132.07,0.00,0.00,0.00,0,1.00,1,125.85,0,0,0,java.lang.Object,0.00,1,0,1,0,1,1,1,0,32,2
"org.apache.http.conn.TestConnectionReuse$ResponseKeepAlive",1,0.00,3.00,6,0.09,1582.53,1,0,34,5,0,116.53,0,11,0,1,116.53,0.00,0.00,0.00,0,1.00,3,265.00,0,0,0,java.lang.Object,0.00,4,0,3,0,4,1,1,0,57,2
"org.apache.http.conn.TestConnectionReuse$WorkerThread",3,0.17,2.33,31,0.31,8724.31,9,6,34,8,1,106.23,0,45,0,2,106.23,0.00,0.50,0.06,0,4.00,5,933.34,0,1,1,java.lang.Thread,0.00,5,1,7,0,5,2,0,0,194,2
"org.apache.http.conn.TestExceptions",5,0.00,1.00,22,0.23,4289.72,5,0,3,18,1,125.44,4,30,1,2,125.44,0.00,0.50,0.00,0,5.00,1,692.78,0,1,0,junit.framework.TestCase,0.00,13,1,5,0,13,4,0,1,165,1
"org.apache.http.conn.TestScheme",11,0.00,2.45,121,1.64,64100.76,11,0,9,42,2,142.18,25,178,1,2,102.30,0.00,0.50,0.00,0,11.00,7,4920.96,0,1,1,junit.framework.TestCase,0.00,31,1,27,0,31,10,0,22,976,1
"org.apache.http.conn.routing.HttpRouteDirector",1,7.00,1.00,9,0.11,1853.20,8,7,0,1,3,159.67,25,10,2,1,109.67,0.00,0.00,0.00,0,1.00,1,334.60,0,0,1,,0.00,0,0,1,0,0,1,0,9,77,1
"org.apache.http.conn.routing.HttpRoutePlanner",1,0.00,1.00,2,0.02,108.21,1,0,4,1,1,193.24,26,5,1,1,143.75,0.00,0.00,0.00,0,1.00,1,56.11,0,0,0,,0.00,0,0,1,0,0,1,0,2,17,1
"org.apache.http.conn.routing.Immutable",22,0.10,2.27,117,1.70,90193.89,29,7,3,28,1,84.07,134,186,0,1,116.29,0.00,0.00,0.05,3,114.00,6,5101.49,1,10,1,java.lang.Object,0.00,6,0,50,0,6,12,2,25,1046,2
"org.apache.http.conn.routing.NotThreadSafe",23,0.13,2.43,141,1.92,111960.17,30,7,3,33,1,112.97,101,212,0,1,112.73,0.00,0.00,0.02,3,61.00,8,5748.96,1,8,1,java.lang.Object,0.00,10,0,56,0,10,15,2,27,1167,2
"org.apache.http.conn.routing.RouteInfo",10,0.00,1.00,13,0.04,154.89,10,0,2,10,3,113.15,101,12,3,1,161.63,0.00,0.00,0.00,0,10.00,1,121.20,0,6,0,,0.00,0,0,10,0,0,4,0,13,54,1
"org.apache.http.conn.routing.RouteInfo$LayerType",0,0.00,0.00,2,0.01,23.26,0,0,2,0,0,171.00,0,1,0,1,171.00,0.00,0.00,0.00,0,0.00,0,15.51,0,0,0,java.lang.Object,0.00,0,0,0,0,0,0,0,0,6,1
"org.apache.http.conn.routing.RouteInfo$TunnelType",0,0.00,0.00,2,0.01,23.26,0,0,2,0,0,171.00,0,1,0,1,171.00,0.00,0.00,0.00,0,0.00,0,15.51,0,0,0,java.lang.Object,0.00,0,0,0,0,0,0,0,0,6,1
"org.apache.http.conn.routing.TestHttpRoute",14,0.26,1.86,305,6.18,419948.05,23,9,10,54,1,106.90,48,441,1,2,86.28,0.00,0.50,0.36,0,0.00,7,18538.37,0,1,0,junit.framework.TestCase,0.00,40,1,26,0,40,13,0,46,3056,1
"org.apache.http.conn.routing.TestRouteDirector",10,0.11,1.10,211,3.45,164697.11,19,9,7,19,2,128.34,20,321,1,2,88.45,0.00,0.50,0.21,0,0.00,2,10349.28,0,1,1,junit.framework.TestCase,0.00,9,1,11,0,9,9,0,18,1908,1
"org.apache.http.conn.routing.TestRouteTracker",14,0.18,3.07,345,5.92,676838.62,23,9,9,59,2,50.15,86,461,1,2,82.37,0.00,0.50,0.28,3,0.00,9,17750.84,0,2,1,junit.framework.TestCase,0.00,45,1,43,0,45,12,0,67,3111,1
"org.apache.http.client.protocol.ClientContext",0,0.00,0.00,12,0.18,3079.91,11,11,0,0,8,171.00,49,14,8,1,171.00,0.00,0.00,0.00,0,0.00,0,534.71,0,0,0,,0.00,0,0,0,0,0,0,0,12,106,1
"org.apache.http.client.protocol.Immutable",2,1.00,13.00,78,1.43,120287.21,3,1,28,41,7,44.04,27,114,0,1,73.43,0.00,0.00,0.00,0,2.00,25,4278.98,0,0,7,java.lang.Object,0.00,39,0,26,0,39,2,1,13,617,1
"org.apache.http.client.protocol.NotThreadSafe",6,1.00,1.17,15,0.17,2454.14,7,1,7,8,3,189.17,8,24,0,1,139.17,0.00,0.00,0.00,0,26.00,2,512.19,0,0,3,java.lang.Object,0.00,2,0,7,0,2,6,1,2,130,1
"org.apache.http.client.protocol.TestCookie2Support",8,0.00,1.88,102,1.61,43493.07,8,0,28,37,9,101.18,7,119,1,3,101.18,0.00,0.67,0.00,0,14.00,3,4832.04,1,1,8,org.apache.http.localserver.BasicServerTestBase,0.00,29,2,15,0,29,7,0,4,833,1
"org.apache.http.client.protocol.TestCookie2Support$CookieVer0Service",1,0.00,1.00,7,0.11,1836.66,1,0,28,8,0,113.77,0,12,0,1,113.77,0.00,0.00,0.00,0,1.00,1,329.99,0,0,0,java.lang.Object,0.00,7,0,1,0,7,1,1,0,68,2
"org.apache.http.client.protocol.TestCookie2Support$CookieVer1Service",1,0.00,1.00,8,0.13,2312.69,1,0,28,8,0,110.82,0,13,0,1,110.82,0.00,0.00,0.00,0,1.00,1,386.72,0,0,0,java.lang.Object,0.00,7,0,1,0,7,1,1,0,78,2
"org.apache.http.client.protocol.TestCookie2Support$CookieVer2Service",1,0.00,1.00,7,0.11,1836.66,1,0,28,8,0,113.77,0,12,0,1,113.77,0.00,0.00,0.00,0,1.00,1,329.99,0,0,0,java.lang.Object,0.00,7,0,1,0,7,1,1,0,68,2
"org.apache.http.client.protocol.TestCookie2Support$SetCookieVersionMixService",1,0.00,1.00,8,0.13,2312.69,1,0,28,8,0,110.82,0,13,0,1,110.82,0.00,0.00,0.00,0,1.00,1,386.72,0,0,0,java.lang.Object,0.00,7,0,1,0,7,1,1,0,78,2
"org.apache.http.client.protocol.TestRedirects",22,0.00,1.82,281,4.78,107931.37,22,0,34,71,6,101.54,10,361,1,3,101.54,0.00,0.67,0.00,0,42.00,2,14354.63,1,1,5,org.apache.http.localserver.BasicServerTestBase,0.00,49,2,40,0,49,21,0,7,2499,1
"org.apache.http.client.protocol.TestRedirects$BasicRedirectService",3,3.00,2.00,25,0.36,9475.16,6,3,34,12,0,109.60,0,35,0,1,109.60,0.00,0.00,0.00,0,3.00,3,1071.11,0,0,0,java.lang.Object,0.00,9,0,6,0,9,3,1,0,212,1
"org.apache.http.client.protocol.TestRedirects$BogusRedirectService",2,1.00,2.00,17,0.23,5531.91,3,1,34,11,0,110.05,0,24,0,1,110.05,0.00,0.00,0.50,0,2.00,3,683.72,0,0,0,java.lang.Object,0.00,9,0,4,0,9,2,1,0,135,1
"org.apache.http.client.protocol.TestRedirects$CircularRedirectService",2,0.00,2.00,14,0.19,5791.82,2,0,34,9,0,112.06,0,21,0,1,112.06,0.00,0.00,0.00,0,2.00,3,584.64,0,0,0,java.lang.Object,0.00,7,0,4,0,7,2,1,0,118,1
"org.apache.http.client.protocol.TestRedirects$RelativeRedirectService",2,0.00,2.00,15,0.21,5455.07,2,0,34,11,0,112.26,0,22,0,1,112.26,0.00,0.00,0.00,0,2.00,3,625.07,0,0,0,java.lang.Object,0.00,9,0,4,0,9,2,1,0,122,1
"org.apache.http.client.protocol.TestRedirects$RelativeRedirectService2",2,0.00,2.00,15,0.21,5323.73,2,0,34,11,0,112.34,0,22,0,1,112.34,0.00,0.00,0.00,0,2.00,3,628.68,0,0,0,java.lang.Object,0.00,9,0,4,0,9,2,1,0,122,1
"org.apache.http.client.protocol.TestUriEscapes",17,0.00,1.06,56,0.58,13193.91,17,0,16,34,3,130.43,0,76,1,3,130.43,0.00,0.67,0.00,1,32.00,2,1725.36,0,1,2,org.apache.http.localserver.BasicServerTestBase,0.00,17,2,18,0,17,16,0,0,391,1
"org.apache.http.client.protocol.TestUriEscapes$UriListeningService",2,1.00,1.00,10,0.13,2086.37,3,1,16,8,0,121.16,0,16,0,1,121.16,0.00,0.00,0.50,0,2.00,1,381.66,0,1,0,java.lang.Object,0.00,6,0,2,0,6,1,1,0,83,1
"org.apache.http.auth.AuthScheme",7,0.00,1.00,8,0.04,190.08,7,0,2,7,13,111.23,74,10,12,1,159.71,0.00,0.00,0.00,0,7.00,1,121.84,0,4,1,,0.00,0,0,7,0,0,3,0,8,47,1
"org.apache.http.auth.AuthSchemeFactory",1,0.00,1.00,2,0.01,30.51,1,0,1,1,2,110.52,12,3,1,1,148.08,0.00,0.00,0.00,0,1.00,1,25.51,0,1,1,,0.00,0,0,1,0,0,0,0,2,11,1
"org.apache.http.auth.Credentials",2,0.00,1.00,3,0.01,31.00,2,0,1,2,16,182.24,7,4,16,1,161.63,0.00,0.00,0.00,0,2.00,1,26.00,0,2,0,,0.00,0,0,2,0,0,0,0,1,13,1
"org.apache.http.auth.Immutable",1,4.00,1.00,6,0.06,1031.50,5,4,1,1,0,136.38,18,8,0,1,118.24,0.00,0.00,0.00,0,1.00,1,194.91,0,0,0,java.lang.Object,0.00,0,0,1,0,0,1,0,5,48,2
"org.apache.http.auth.NotThreadSafe",10,3.00,1.20,35,0.27,5755.98,13,3,1,13,2,131.66,47,48,0,1,131.43,0.00,0.00,0.00,1,10.00,2,822.26,0,2,2,java.lang.Object,0.00,3,0,12,0,3,8,0,12,208,1
"org.apache.http.auth.TestCredentials",9,0.00,1.00,102,1.51,66882.02,9,0,3,31,1,101.67,3,157,1,2,101.67,0.00,0.50,0.00,0,9.00,1,4523.77,0,1,0,junit.framework.TestCase,0.00,22,1,9,0,22,8,0,3,940,1
"org.apache.http.auth.ThreadSafe",6,0.20,2.00,30,0.37,9189.07,7,1,8,18,2,71.58,50,47,0,1,119.69,0.00,0.00,0.83,0,0.00,3,1104.91,0,2,2,java.lang.Object,0.00,12,0,12,0,12,4,0,6,240,2
"org.apache.http.client.benchmark.TestHttpClient3",1,0.00,7.00,71,1.13,110313.09,1,0,7,19,0,61.79,0,81,0,1,61.79,0.00,0.00,0.00,0,1.00,7,3391.72,0,0,0,java.lang.Object,0.00,18,0,7,0,18,1,0,0,509,1
"org.apache.http.client.benchmark.TestHttpClient4",1,0.00,8.00,76,1.24,119383.13,1,0,11,19,0,60.38,0,88,0,1,60.38,0.00,0.00,0.00,0,1.00,8,3718.00,0,0,0,java.lang.Object,0.00,18,0,8,0,18,1,0,0,544,1
"org.apache.http.client.benchmark.TestHttpCore",1,0.00,11.00,95,1.75,188587.35,1,0,25,44,0,95.02,2,113,0,1,55.13,0.00,0.00,0.00,0,1.00,11,5246.20,0,0,0,java.lang.Object,0.00,43,0,11,0,43,1,0,2,723,1
"org.apache.http.client.benchmark.TestHttpJRE",1,0.00,8.00,70,1.06,113009.20,1,0,5,13,0,61.90,0,77,0,1,61.90,0.00,0.00,0.00,0,1.00,8,3169.36,0,0,0,java.lang.Object,0.00,12,0,8,0,12,1,0,0,483,1
"org.apache.http.client.utils.Idn",1,0.00,1.00,2,0.01,33.58,1,0,0,1,1,103.63,11,3,1,1,147.75,0.00,0.00,0.00,0,1.00,1,23.93,0,1,0,,0.00,0,0,1,0,0,0,0,2,11,1
"org.apache.http.client.utils.Immutable",2,0.00,3.50,14,0.21,6458.01,3,1,3,10,1,93.68,11,23,0,1,111.55,0.00,0.00,1.00,0,0.00,4,619.53,0,1,1,java.lang.Object,0.00,8,0,7,0,8,1,1,4,133,1
"org.apache.http.client.utils.TestRfc3492Idn",5,0.00,1.00,19,0.24,4518.06,5,0,4,12,1,179.92,9,38,1,2,129.92,0.00,0.50,0.00,0,5.00,1,714.99,0,1,0,junit.framework.TestCase,0.00,7,1,5,0,7,4,0,7,164,1
"org.apache.http.client.utils.TestURIUtils",48,1.00,1.00,99,1.41,11393.88,49,1,5,55,1,141.06,5,162,1,2,141.06,0.00,0.50,0.00,0,48.00,1,4240.68,0,1,0,junit.framework.TestCase,0.00,7,1,48,0,7,47,0,2,1063,1
"org.apache.http.client.utils.TestURLEncodedUtils",9,0.00,1.00,91,1.39,60788.94,9,0,9,32,1,103.54,0,104,1,2,103.54,0.00,0.50,0.00,1,9.00,1,4184.40,0,2,0,junit.framework.TestCase,0.00,23,1,9,0,23,7,0,0,787,1
"org.apache.http.auth.params.AuthPNames",0,0.00,0.00,4,0.04,529.87,3,3,1,0,2,171.00,29,5,1,1,171.00,0.00,0.00,0.00,0,0.00,0,121.11,0,0,1,,0.00,0,0,0,0,0,0,0,4,31,1
"org.apache.http.auth.params.AuthParamBean",2,0.00,1.00,5,0.03,355.08,2,0,2,3,0,162.67,7,8,0,2,142.06,0.00,0.50,0.00,0,2.00,1,104.15,0,0,0,org.apache.http.params.HttpAbstractParamBean,0.00,1,1,2,0,1,2,0,1,32,1
"org.apache.http.auth.params.Immutable",3,0.00,2.00,14,0.14,3565.07,3,0,3,6,1,81.88,21,22,0,1,124.17,0.00,0.00,0.00,0,3.00,3,420.15,0,1,1,java.lang.Object,0.00,3,0,6,0,3,2,0,3,97,2
"org.apache.http.client.entity.DeflateDecompressingEntity",4,0.00,2.75,31,0.39,23032.72,4,0,9,14,1,99.28,61,47,1,2,109.63,0.00,0.50,0.00,1,4.00,8,1160.21,0,2,0,org.apache.http.entity.HttpEntityWrapper,0.00,10,1,11,0,10,2,0,14,221,1
"org.apache.http.client.entity.GzipDecompressingEntity",4,0.00,1.00,10,0.08,1240.50,4,0,6,6,0,122.28,22,18,0,2,140.15,0.00,0.50,0.00,0,4.00,1,232.68,0,2,0,org.apache.http.entity.HttpEntityWrapper,0.00,2,1,4,0,2,2,0,8,65,1
"org.apache.http.client.entity.NotThreadSafe",2,0.00,2.00,7,0.11,2312.58,2,0,7,4,0,84.79,22,15,0,2,128.92,0.00,0.50,0.00,0,2.00,2,330.08,0,0,0,org.apache.http.entity.StringEntity,0.00,2,1,4,0,2,2,0,4,76,1
"org.apache.http.client.methods.AbortableHttpRequest",3,0.00,1.00,4,0.02,95.00,3,0,7,3,6,121.62,36,5,1,1,159.18,0.00,0.00,0.00,0,3.00,1,66.00,0,0,5,,0.00,0,0,3,0,0,3,0,4,25,1
"org.apache.http.client.methods.HttpUriRequest",4,0.00,1.00,5,0.02,83.45,4,0,2,4,3,110.61,38,6,3,2,160.61,0.00,0.50,0.00,0,4.00,1,57.60,0,2,0,,0.00,0,1,4,0,0,2,0,5,25,1
"org.apache.http.client.methods.NotThreadSafe",5,1.00,1.20,16,0.17,3580.13,6,1,6,9,0,180.68,7,26,0,2,130.68,0.00,0.50,0.00,0,5.00,2,498.25,1,2,0,HttpRequestBase,0.00,4,1,6,0,4,3,1,2,123,2
"org.apache.http.client.methods.TestHttpOptions",4,0.00,1.00,18,0.22,4478.45,4,0,7,15,1,124.53,3,23,1,2,124.53,0.00,0.50,0.00,0,4.00,1,647.51,0,1,0,junit.framework.TestCase,0.00,11,1,4,0,11,3,0,3,144,1
"org.apache.http.client.methods.TestHttpRequestBase",7,0.00,1.14,63,1.06,42216.47,7,0,10,43,1,105.60,3,74,1,2,105.60,0.00,0.50,0.00,0,7.00,2,3172.13,0,1,0,junit.framework.TestCase,0.00,36,1,8,0,36,6,0,3,587,1
"org.apache.http.cookie.params.CookieSpecPNames",0,0.00,0.00,3,0.03,332.42,2,2,0,0,2,171.00,25,4,2,1,171.00,0.00,0.00,0.00,0,0.00,0,81.41,0,0,0,,0.00,0,0,0,0,0,0,0,3,22,1
"org.apache.http.cookie.params.NotThreadSafe",3,0.00,1.00,7,0.07,780.74,3,0,4,5,1,180.64,7,11,0,2,140.75,0.00,0.50,0.00,0,3.00,1,208.34,0,0,1,org.apache.http.params.HttpAbstractParamBean,0.00,2,1,3,0,2,3,0,1,57,1
"org.apache.http.localserver.BasicServerTestBase",4,0.67,1.25,11,0.09,1181.50,5,1,3,9,2,160.88,15,20,1,2,140.27,14.00,0.06,0.50,1,4.00,2,275.60,0,2,1,junit.framework.TestCase,0.00,5,1,5,14,5,2,0,4,76,2
"org.apache.http.localserver.EchoHandler",1,0.00,5.00,18,0.32,14881.27,1,0,13,15,1,134.89,22,31,1,1,90.95,0.00,0.00,0.00,0,1.00,5,962.23,0,0,0,java.lang.Object,0.00,14,0,5,0,14,1,1,6,165,1
"org.apache.http.localserver.LocalTestServer",16,0.01,1.81,86,1.00,24013.50,25,9,31,57,13,77.49,118,135,11,1,119.78,0.00,0.00,0.10,1,90.00,4,2998.02,0,6,2,java.lang.Object,0.00,41,0,29,0,41,10,0,30,650,1
"org.apache.http.localserver.LocalTestServer$RequestListener",3,0.50,2.67,33,0.42,11476.25,4,1,31,22,1,124.33,11,51,0,1,103.72,0.00,0.00,0.67,2,0.00,4,1266.54,0,0,1,java.lang.Object,0.00,19,0,8,0,19,3,1,9,252,1
"org.apache.http.localserver.LocalTestServer$RequestListener$Worker",2,2.00,3.00,14,0.19,5019.28,4,2,31,6,0,162.45,2,26,0,1,112.45,0.00,0.00,0.00,0,2.00,5,566.78,0,0,0,java.lang.Object,0.00,4,0,6,0,4,2,1,2,121,1
"org.apache.http.localserver.RandomHandler",1,0.00,7.00,28,0.52,30140.70,1,0,13,22,2,107.53,32,43,2,1,81.30,0.00,0.00,0.00,0,1.00,7,1551.68,0,0,0,java.lang.Object,0.00,21,0,7,0,21,1,1,8,253,1
"org.apache.http.localserver.RandomHandler$RandomEntity",6,0.20,1.83,41,0.42,23150.26,8,2,13,13,0,81.37,40,57,0,2,113.59,0.00,0.50,0.33,0,6.00,4,1270.87,0,1,0,org.apache.http.entity.AbstractHttpEntity,0.00,7,1,11,0,7,5,0,12,264,2
"org.apache.http.localserver.RequestBasicAuth",1,0.00,7.00,21,0.35,16481.06,1,0,12,14,1,88.02,0,32,1,1,88.02,0.00,0.00,0.00,0,1.00,7,1053.51,0,0,0,java.lang.Object,0.00,13,0,7,0,13,1,1,0,179,1
"org.apache.http.localserver.ResponseBasicUnauthorized",1,0.00,2.00,4,0.06,900.87,1,0,7,4,1,125.12,0,9,1,1,125.12,0.00,0.00,0.00,0,1.00,2,187.33,0,0,0,java.lang.Object,0.00,3,0,2,0,3,1,1,0,43,1
"org.apache.http.localserver.ServerTestBase",5,0.10,2.00,41,0.51,11611.54,10,5,16,30,3,81.27,66,61,0,3,110.65,3.50,0.20,0.28,1,5.00,6,1515.07,0,2,3,org.apache.http.localserver.BasicServerTestBase,0.33,25,2,10,7,25,3,0,13,298,2
"org.apache.http.conn.scheme.HostNameResolver",1,0.00,1.00,2,0.01,51.00,1,0,2,1,2,108.76,12,3,2,1,146.32,0.00,0.00,0.00,0,1.00,1,34.00,0,1,0,,0.00,0,0,1,0,0,0,0,2,13,1
"org.apache.http.conn.scheme.Immutable",6,0.50,2.50,38,0.45,22805.11,8,2,9,16,2,95.70,35,61,0,1,113.57,0.00,0.00,0.08,0,10.00,8,1345.41,0,2,2,java.lang.Object,0.00,10,0,15,0,10,4,1,8,268,2
"org.apache.http.conn.scheme.LayeredSocketFactory",1,0.00,1.00,2,0.03,129.64,1,0,3,1,2,190.40,23,8,2,2,143.13,0.00,0.50,0.00,0,1.00,1,75.21,0,1,0,,0.00,0,1,1,0,0,0,0,2,22,1
"org.apache.http.conn.scheme.SocketFactory",3,0.00,1.00,4,0.04,216.04,3,0,6,3,14,203.64,69,14,14,1,156.37,0.00,0.00,0.00,0,3.00,1,132.91,0,2,0,,0.00,0,0,3,0,0,1,0,4,39,1
"org.apache.http.conn.scheme.TestScheme",4,0.00,1.00,14,0.16,3141.74,4,0,3,11,1,130.40,3,19,1,2,130.40,0.00,0.50,0.00,0,4.00,1,474.27,0,1,0,junit.framework.TestCase,0.00,7,1,4,0,7,3,0,1,116,1
"org.apache.http.conn.scheme.ThreadSafe",8,0.29,1.75,33,0.37,9496.46,9,1,7,20,0,74.20,72,50,0,1,124.20,0.00,0.00,0.75,2,0.00,2,1123.05,0,1,0,java.lang.Object,0.00,12,0,14,0,12,7,0,14,257,2
