Name, No. Methods, LCOM, AVCC, NOS, HBUG, HEFF, UWCS, INST, PACK, RFC, CBO, MI, CCML, NLOC, F-IN, DIT, MINC, S-R, R-R, COH, LMC, LCOM2, MAXCC, HVOL, HIER, NQU, FOUT, Superclass, SIX, EXT, NSUP, TCC, NSUB, MPC, NCO, INTR, CCOM, HLTH, MOD
"org.apache.http.cookie.Cookie",22,0.02,1.14,83,0.65,16681.71,32,10,2,29,33,80.50,208,110,33,1,130.49,0.00,0.00,0.08,0,330.00,2,1947.71,0,7,0,java.lang.Object,0.00,7,0,25,0,7,15,0,31,476,1
"org.apache.http.cookie.CookieAttributeHandler",3,0.00,1.00,4,0.03,138.66,3,0,0,3,14,113.76,35,7,11,1,157.89,0.00,0.00,0.00,0,3.00,1,100.44,0,0,3,,0.00,0,0,3,0,0,3,0,4,33,1
"org.apache.http.cookie.CookieIdentityComparator",1,0.00,4.00,14,0.16,5262.30,1,0,1,5,2,54.50,11,19,1,1,98.62,0.00,0.00,0.00,0,1.00,4,467.30,0,0,1,java.lang.Object,0.00,4,0,4,0,4,1,1,2,99,1
"org.apache.http.cookie.CookieOrigin",6,4.00,2.00,41,0.41,14747.31,10,4,1,14,25,165.11,8,57,25,1,115.11,0.00,0.00,0.00,0,6.00,6,1220.79,0,3,0,java.lang.Object,0.00,8,0,12,0,8,3,0,1,265,2
"org.apache.http.cookie.CookiePathComparator",2,0.00,3.50,21,0.20,7055.58,2,0,1,6,3,63.18,15,27,2,1,105.47,0.00,0.00,0.00,1,2.00,4,589.16,0,1,1,java.lang.Object,0.00,4,0,7,0,4,1,1,2,130,1
"org.apache.http.cookie.CookieSpec",4,0.00,1.00,5,0.04,198.62,4,0,1,4,14,128.26,52,6,11,1,157.64,0.00,0.00,0.00,0,4.00,1,127.73,0,1,3,,0.00,0,0,4,0,0,3,0,5,42,1
"org.apache.http.cookie.CookieSpecFactory",1,0.00,1.00,2,0.01,30.51,1,0,1,1,5,115.86,6,3,4,1,148.08,0.00,0.00,0.00,0,1.00,1,25.51,0,1,1,,0.00,0,0,1,0,0,0,0,1,11,1
"org.apache.http.cookie.CookieSpecRegistry",6,0.40,1.83,27,0.29,7591.73,7,1,5,16,6,73.97,55,41,4,1,123.97,0.00,0.00,0.67,1,0.00,3,872.06,0,3,2,java.lang.Object,0.00,10,0,11,0,10,3,0,6,197,2
"org.apache.http.cookie.MalformedCookieException",3,1.00,1.00,8,0.05,538.90,4,1,1,3,26,99.73,23,12,26,2,142.02,0.00,0.50,0.00,0,3.00,1,153.79,0,0,0,org.apache.http.ProtocolException,0.00,0,1,3,0,0,3,0,4,46,1
"org.apache.http.cookie.SM",0,0.00,0.00,3,0.03,332.42,2,2,0,0,4,171.00,7,4,4,1,171.00,0.00,0.00,0.00,0,0.00,0,81.41,0,0,0,,0.00,0,0,0,0,0,0,0,1,22,1
"org.apache.http.cookie.TestAllCookie",3,0.00,1.00,12,0.12,2866.67,3,0,3,10,5,125.07,0,16,2,2,125.07,0.00,0.50,0.00,0,3.00,1,349.20,0,1,3,junit.framework.TestCase,0.00,7,1,3,0,7,2,0,0,90,1
"org.apache.http.cookie.TestCookieOrigin",8,0.00,1.50,29,0.28,3934.85,8,0,3,16,3,181.91,9,46,2,2,131.91,0.00,0.50,0.00,0,8.00,2,839.18,0,1,1,junit.framework.TestCase,0.00,8,1,12,0,8,7,0,7,205,1
"org.apache.http.cookie.TestCookiePathComparator",8,0.00,1.00,53,0.62,15666.30,8,0,4,14,4,116.05,5,62,2,2,116.05,0.00,0.50,0.00,0,8.00,1,1861.55,0,1,2,junit.framework.TestCase,0.00,6,1,8,0,6,7,0,3,414,1
"org.apache.http.cookie.TestCookiePolicy",5,0.08,2.20,64,0.73,25368.64,8,3,9,21,6,141.27,11,90,2,2,101.38,0.00,0.50,0.40,0,7.00,5,2190.40,0,1,4,junit.framework.TestCase,0.00,16,1,11,0,16,4,0,9,460,1
"org.apache.http.impl.cookie.AbstractCookieAttributeHandler",2,0.00,1.00,4,0.04,321.06,2,0,4,2,9,192.40,2,8,5,1,142.40,0.00,0.00,0.00,0,2.00,1,118.06,0,0,4,java.lang.Object,0.00,0,0,2,5,0,2,1,2,34,2
"org.apache.http.impl.cookie.AbstractCookieSpec",5,2.00,1.80,25,0.25,5545.16,7,2,7,14,5,88.59,34,37,3,1,120.81,0.00,0.00,0.00,1,5.00,4,749.73,0,3,2,java.lang.Object,0.00,9,0,9,5,9,2,1,6,175,2
"org.apache.http.impl.cookie.BasicCommentHandler",2,0.00,1.50,7,0.06,1034.91,2,0,2,4,7,131.74,0,12,4,2,131.74,0.00,0.50,0.00,0,2.00,2,171.85,0,0,3,org.apache.http.impl.cookie.AbstractCookieAttributeHandler,0.00,2,1,3,0,2,2,0,0,44,1
"org.apache.http.impl.cookie.BasicDomainHandler",4,0.00,5.00,44,0.58,24338.67,4,0,4,18,7,141.87,8,71,3,1,101.98,0.00,0.00,0.00,0,4.00,9,1729.53,0,0,4,java.lang.Object,0.00,14,0,20,1,14,4,1,8,334,1
"org.apache.http.impl.cookie.BasicExpiresHandler",2,1.00,3.00,14,0.16,4394.70,3,1,2,6,9,112.91,1,24,4,2,112.91,0.00,0.50,0.00,0,2.00,4,484.94,0,0,5,org.apache.http.impl.cookie.AbstractCookieAttributeHandler,0.00,4,1,6,0,4,2,0,1,104,1
"org.apache.http.impl.cookie.BasicMaxAgeHandler",2,0.00,2.50,13,0.15,4859.92,2,0,3,8,7,115.10,0,22,4,2,115.10,0.00,0.50,0.00,0,2.00,4,451.15,0,0,3,org.apache.http.impl.cookie.AbstractCookieAttributeHandler,0.00,6,1,5,0,6,2,0,0,92,1
"org.apache.http.impl.cookie.BasicPathHandler",4,0.00,3.25,29,0.41,20468.51,4,0,4,17,8,110.00,2,47,4,1,110.00,0.00,0.00,0.00,0,4.00,7,1231.21,0,0,4,java.lang.Object,0.00,13,0,13,0,13,4,1,2,248,1
"org.apache.http.impl.cookie.BasicSecureHandler",3,0.00,2.33,13,0.13,3261.09,3,0,3,7,8,124.44,0,21,4,2,124.44,0.00,0.50,0.00,0,3.00,4,396.74,0,0,4,org.apache.http.impl.cookie.AbstractCookieAttributeHandler,0.00,4,1,7,0,4,3,0,0,92,1
"org.apache.http.impl.cookie.BrowserCompatSpec",4,0.50,4.00,60,0.80,40394.16,6,2,9,27,15,115.89,13,91,2,3,95.28,0.00,0.67,0.12,1,6.00,7,2405.30,1,2,13,org.apache.http.impl.cookie.CookieSpecBase,0.00,23,2,16,0,23,2,0,5,441,1
"org.apache.http.impl.cookie.BrowserCompatSpecFactory",1,0.00,2.00,6,0.06,1283.23,1,0,4,3,6,85.12,6,10,2,1,117.34,0.00,0.00,0.00,0,1.00,2,176.05,0,1,4,java.lang.Object,0.00,2,0,2,0,2,0,1,1,42,1
"org.apache.http.impl.cookie.CookieSpecBase",5,0.00,3.60,61,0.71,38439.19,5,0,7,25,8,149.85,9,70,3,2,99.85,3.00,0.20,0.00,2,5.00,5,2133.92,1,3,5,org.apache.http.impl.cookie.AbstractCookieSpec,0.00,20,1,18,3,20,2,0,3,404,2
"org.apache.http.impl.cookie.DateParseException",2,1.00,1.00,6,0.03,318.41,3,1,0,2,4,103.64,13,9,4,2,135.86,0.00,0.50,0.00,0,2.00,1,99.90,0,0,0,java.lang.Exception,0.00,0,1,2,0,0,2,0,3,31,1
"org.apache.http.impl.cookie.DateUtils",6,0.07,2.50,49,0.66,33362.15,12,6,6,19,8,78.23,79,73,7,1,107.61,0.00,0.00,0.11,2,18.00,8,1981.21,0,5,1,java.lang.Object,0.00,13,0,15,0,13,1,0,14,394,2
"org.apache.http.impl.cookie.NetscapeDomainHandler",4,0.00,3.00,30,0.40,12934.01,4,0,4,13,6,161.59,7,55,2,2,111.59,0.00,0.50,0.00,1,4.00,5,1208.65,1,0,4,org.apache.http.impl.cookie.BasicDomainHandler,0.00,9,1,12,0,9,4,0,2,246,1
"org.apache.http.impl.cookie.NetscapeDraftSpec",3,0.00,3.33,38,0.45,21033.90,3,0,9,17,13,80.04,42,47,2,3,100.18,0.00,0.67,0.00,1,3.00,6,1338.54,1,2,11,org.apache.http.impl.cookie.CookieSpecBase,0.00,14,2,10,0,14,1,0,3,262,1
"org.apache.http.impl.cookie.NetscapeDraftSpecFactory",1,0.00,1.00,3,0.02,194.14,1,0,3,2,5,102.96,6,5,2,1,135.18,0.00,0.00,0.00,0,1.00,1,62.11,0,1,3,java.lang.Object,0.00,1,0,1,0,1,0,1,1,19,1
"org.apache.http.impl.cookie.RFC2109DomainHandler",4,0.00,4.75,46,0.69,36151.16,4,0,4,19,6,100.64,3,79,2,1,100.64,0.00,0.00,0.00,0,4.00,10,2079.46,0,0,4,java.lang.Object,0.00,15,0,19,0,15,4,1,3,385,1
"org.apache.http.impl.cookie.RFC2109Spec",9,0.22,2.89,101,1.23,45169.88,13,4,10,35,16,123.38,34,127,2,3,102.77,0.00,0.67,0.06,5,23.00,4,3677.24,2,4,14,org.apache.http.impl.cookie.CookieSpecBase,0.00,26,2,26,0,26,5,0,6,733,1
"org.apache.http.impl.cookie.RFC2109SpecFactory",1,0.00,2.00,6,0.07,1728.53,1,0,4,4,6,84.10,6,11,2,1,116.32,0.00,0.00,0.00,0,1.00,2,219.84,0,1,4,java.lang.Object,0.00,3,0,2,0,3,0,1,1,50,1
"org.apache.http.impl.cookie.RFC2109VersionHandler",3,0.00,3.00,18,0.21,5755.35,3,0,3,11,6,115.87,0,32,2,2,115.87,0.00,0.50,0.00,0,3.00,5,643.29,0,0,4,org.apache.http.impl.cookie.AbstractCookieAttributeHandler,0.00,8,1,9,0,8,3,0,0,135,1
"org.apache.http.impl.cookie.TestAbstractCookieSpec",6,0.00,1.50,44,0.49,12913.21,6,0,10,22,7,113.14,4,57,2,2,113.14,0.00,0.50,0.00,0,6.00,3,1476.16,0,1,5,junit.framework.TestCase,0.00,16,1,9,0,16,5,0,4,317,1
"org.apache.http.impl.cookie.TestAbstractCookieSpec$DummyCookieAttribHandler",3,0.00,1.00,5,0.05,308.89,3,0,10,3,4,155.15,0,9,0,1,155.15,0.00,0.00,0.00,0,3.00,1,138.78,0,0,4,java.lang.Object,0.00,0,0,3,0,0,3,1,0,41,2
"org.apache.http.impl.cookie.TestAbstractCookieSpec$DummyCookieSpec",4,0.00,1.00,8,0.07,562.44,4,0,10,4,4,142.86,0,13,0,2,142.86,0.00,0.50,0.00,0,4.00,1,200.84,0,2,4,org.apache.http.impl.cookie.AbstractCookieSpec,0.00,0,1,4,0,0,2,0,0,57,2
"org.apache.http.impl.cookie.TestAllCookieImpl",3,0.00,1.00,17,0.19,6384.35,3,0,3,15,10,118.72,0,21,2,2,118.72,0.00,0.50,0.00,0,3.00,1,563.72,0,1,8,junit.framework.TestCase,0.00,12,1,3,0,12,2,0,0,135,1
"org.apache.http.impl.cookie.TestBasicCookieAttribHandlers",33,0.00,1.79,257,3.02,70302.40,33,0,11,67,13,113.13,27,343,2,2,113.13,0.00,0.50,0.00,0,33.00,6,9072.00,0,1,11,junit.framework.TestCase,0.00,34,1,59,0,34,32,0,27,1898,1
"org.apache.http.impl.cookie.TestBrowserCompatSpec",57,0.00,1.77,687,9.81,309567.47,57,0,10,89,8,151.20,76,737,2,2,101.20,0.00,0.50,0.00,1,57.00,9,29429.96,0,1,6,junit.framework.TestCase,0.00,32,1,101,0,32,56,0,39,5367,1
"org.apache.http.impl.cookie.TestCookieNetscapeDraft",13,0.00,2.00,136,1.86,50568.40,13,0,9,34,7,145.15,29,160,2,2,105.27,0.00,0.50,0.00,0,13.00,5,5575.25,0,1,5,junit.framework.TestCase,0.00,21,1,26,0,21,12,0,15,1048,1
"org.apache.http.impl.cookie.TestCookieRFC2109Spec",21,0.00,2.14,264,3.40,102672.79,21,0,9,45,8,141.40,57,321,2,2,101.52,0.00,0.50,0.00,0,21.00,6,10205.45,0,1,6,junit.framework.TestCase,0.00,24,1,45,0,24,20,0,26,1920,1
"org.apache.http.impl.cookie.TestDateUtils",9,0.00,1.44,72,0.94,27708.75,9,0,5,22,4,159.76,9,95,2,2,109.76,0.00,0.50,0.00,0,9.00,5,2812.61,0,1,2,junit.framework.TestCase,0.00,13,1,13,0,13,8,0,5,577,1
"org.apache.http.impl.cookie.TestNetscapeCookieAttribHandlers",10,0.00,1.70,74,0.87,19083.44,10,0,7,22,7,113.52,8,99,2,2,113.52,0.00,0.50,0.00,0,10.00,3,2597.22,0,1,5,junit.framework.TestCase,0.00,12,1,17,0,12,9,0,8,536,1
"org.apache.http.impl.cookie.TestRFC2109CookieAttribHandlers",17,0.00,2.18,149,1.70,43924.09,17,0,7,35,8,160.26,21,207,2,2,110.26,0.00,0.50,0.00,0,17.00,6,5096.43,0,1,6,junit.framework.TestCase,0.00,18,1,37,0,18,16,0,21,1051,1
"org.apache.http.examples.conn.ManagerConnectDirect",6,0.10,1.50,58,0.81,38743.74,8,2,19,35,8,55.31,57,71,0,1,105.31,0.00,0.00,0.42,5,6.00,4,2421.79,0,4,8,java.lang.Object,0.00,29,0,9,0,29,2,0,16,428,1
"org.apache.http.examples.conn.ManagerConnectProxy",8,0.21,1.50,86,1.28,67172.43,10,2,20,44,9,54.60,70,106,0,1,102.70,0.00,0.00,0.31,7,16.00,4,3846.84,0,5,9,java.lang.Object,0.00,36,0,12,0,36,3,0,21,663,1
"org.apache.http.examples.conn.OperatorConnectDirect",6,0.20,1.17,46,0.58,18801.06,8,2,18,28,7,61.91,58,53,0,1,111.91,0.00,0.00,0.33,4,10.00,2,1727.70,0,4,7,java.lang.Object,0.00,22,0,7,0,22,2,0,17,329,1
"org.apache.http.examples.conn.OperatorConnectProxy",8,0.29,1.25,74,1.04,43450.98,10,2,19,37,8,55.94,76,87,0,1,105.94,0.00,0.00,0.25,6,18.00,2,3109.53,0,5,8,java.lang.Object,0.00,29,0,10,0,29,3,0,27,565,1
"org.apache.http.client.params.AuthPolicy",1,3.00,1.00,6,0.05,583.15,4,3,0,1,1,82.63,12,8,1,1,120.19,0.00,0.00,0.00,0,1.00,1,143.12,0,0,0,java.lang.Object,0.00,0,0,1,0,0,1,0,3,39,2
"org.apache.http.client.params.CookiePolicy",1,4.00,1.00,7,0.06,798.71,5,4,0,1,3,87.24,13,9,3,1,116.62,0.00,0.00,0.00,0,1.00,1,185.68,0,0,0,java.lang.Object,0.00,0,0,1,0,0,1,0,4,48,2
"org.apache.http.client.params.HttpClientParams",11,0.01,2.00,60,0.70,14070.24,25,14,1,18,7,82.74,137,83,6,1,120.30,0.00,0.00,0.06,0,81.00,3,2099.61,0,1,1,java.lang.Object,0.00,7,0,22,0,7,10,0,19,450,1
"org.apache.http.impl.conn.AbstractClientConnAdapter",23,0.09,1.22,74,0.48,5890.68,26,3,10,41,5,154.81,69,110,2,1,134.19,0.00,0.00,0.42,2,0.00,2,1454.96,0,4,3,java.lang.Object,0.00,18,0,28,4,18,19,1,28,397,2
"org.apache.http.impl.conn.AbstractPoolEntry",6,0.30,3.00,41,0.64,25193.66,8,2,8,24,7,112.72,97,78,3,1,113.19,0.00,0.00,0.25,2,6.00,6,1927.38,0,1,4,java.lang.Object,0.00,18,0,18,2,18,5,0,37,378,2
"org.apache.http.impl.conn.AbstractPooledConnAdapter",9,0.12,1.67,32,0.28,4123.65,10,1,6,17,7,132.37,42,54,2,2,132.13,2.00,0.25,0.89,1,0.00,3,843.96,0,1,5,org.apache.http.impl.conn.AbstractClientConnAdapter,0.00,8,1,15,2,8,8,1,12,217,2
"org.apache.http.impl.conn.ClientConnAdapterMockup",7,0.00,1.00,15,0.11,973.93,7,0,3,8,3,142.89,3,23,1,2,142.89,0.00,0.50,0.00,0,7.00,1,332.62,0,1,2,org.apache.http.impl.conn.AbstractClientConnAdapter,0.00,1,1,7,0,1,6,0,1,95,1
"org.apache.http.impl.conn.DefaultClientConnection",12,0.02,2.08,76,0.85,22796.82,18,6,14,29,5,155.87,35,117,1,2,115.99,0.00,0.50,0.18,0,74.00,4,2554.70,7,5,4,org.apache.http.impl.SocketHttpClientConnection,0.00,17,1,25,0,17,7,1,18,542,1
"org.apache.http.impl.conn.DefaultClientConnectionOperator",5,0.50,3.60,52,0.82,29216.76,6,1,13,30,11,55.64,43,102,4,1,103.74,0.00,0.00,0.60,1,2.00,7,2467.48,0,1,7,java.lang.Object,0.00,25,0,18,0,25,4,1,18,448,1
"org.apache.http.impl.conn.ExecReqThread",6,0.13,1.67,30,0.37,10307.31,9,3,10,16,4,101.46,34,51,1,3,119.33,0.00,0.67,0.44,2,2.00,4,1098.61,1,1,3,org.apache.http.impl.conn.GetConnThread,0.30,10,2,10,0,10,5,0,8,234,1
"org.apache.http.impl.conn.ExecReqThread$RequestSpec",0,0.00,0.00,5,0.03,237.96,4,4,10,0,0,171.00,0,6,0,1,171.00,0.00,0.00,0.00,0,0.00,0,95.18,0,0,0,java.lang.Object,0.00,0,0,0,0,0,0,0,0,25,2
"org.apache.http.impl.conn.GetConnThread",4,0.40,1.25,18,0.12,1245.84,9,5,3,5,5,149.47,13,26,2,2,128.86,1.00,0.33,0.50,0,0.00,2,367.47,0,2,3,java.lang.Thread,0.00,1,1,5,1,1,2,0,4,94,1
"org.apache.http.impl.conn.Helper",2,0.00,1.00,12,0.17,4682.98,2,0,10,7,1,115.68,8,22,1,1,115.44,0.00,0.00,0.00,0,2.00,1,500.41,0,1,0,java.lang.Object,0.00,5,0,2,0,5,1,0,4,102,2
"org.apache.http.impl.conn.IdleConnectionHandler",5,0.00,2.20,29,0.35,9403.16,7,2,7,21,1,86.74,34,42,1,1,118.96,0.00,0.00,0.50,0,2.00,6,1046.75,0,0,0,java.lang.Object,0.00,16,0,11,0,16,5,0,8,219,1
"org.apache.http.impl.conn.LoggingHttpDataReceiverDecorator",8,2.00,1.62,38,0.48,15876.28,10,2,4,13,2,162.35,16,52,1,1,122.46,0.00,0.00,0.00,4,8.00,2,1454.93,0,2,1,java.lang.Object,0.00,5,0,13,0,5,6,1,4,327,0
"org.apache.http.impl.conn.LoggingHttpDataTransmitterDecorator",8,2.00,1.62,32,0.38,7621.91,10,2,4,13,2,174.97,14,46,1,1,124.97,0.00,0.00,0.00,4,8.00,2,1128.44,0,1,1,java.lang.Object,0.00,5,0,13,0,5,7,1,4,271,0
"org.apache.http.impl.conn.SingleClientConnManager",10,0.10,3.50,90,1.13,39263.99,20,10,11,31,10,58.34,106,150,3,1,106.81,0.00,0.00,0.19,3,14.00,8,3377.42,0,4,7,java.lang.Object,0.00,21,0,35,0,21,6,1,40,655,1
"org.apache.http.impl.conn.SingleClientConnManager$ConnAdapter",1,0.00,1.00,5,0.04,482.50,1,0,11,1,3,91.57,6,7,0,3,123.80,0.00,0.67,0.00,0,1.00,1,125.87,0,0,3,org.apache.http.impl.conn.AbstractPooledConnAdapter,0.00,0,2,1,0,0,1,0,1,33,1
"org.apache.http.impl.conn.SingleClientConnManager$PoolEntry",4,1.00,1.50,12,0.09,1012.00,5,1,11,7,5,154.80,14,21,0,2,134.19,0.00,0.50,0.00,0,4.00,2,261.80,1,1,5,org.apache.http.impl.conn.AbstractPoolEntry,0.20,3,1,6,0,3,3,0,6,75,1
"org.apache.http.impl.conn.TestAllConnImpl",3,0.00,1.00,12,0.12,2866.67,3,0,3,10,5,125.07,1,16,2,2,125.07,0.00,0.50,0.00,0,3.00,1,349.20,0,1,3,junit.framework.TestCase,0.00,7,1,3,0,7,2,0,1,90,1
"org.apache.http.impl.conn.TestLocalServer",5,0.00,1.60,51,0.83,32357.60,5,0,14,26,6,103.58,4,75,2,3,103.58,0.00,0.67,0.00,0,7.00,4,2495.03,2,1,4,org.apache.http.localserver.ServerTestBase,0.00,21,2,8,0,21,4,0,1,436,1
"org.apache.http.impl.conn.TestTSCCMNoServer",15,0.00,2.27,228,3.06,103889.69,15,0,17,58,14,78.83,88,297,2,2,96.70,0.00,0.50,0.00,3,15.00,6,9190.80,0,4,12,junit.framework.TestCase,0.00,43,1,34,0,43,11,0,68,1670,1
"org.apache.http.impl.conn.TestTSCCMWithServer",8,0.00,1.88,139,2.22,88340.01,8,0,18,51,11,43.12,77,175,2,3,93.12,0.00,0.67,0.00,1,0.00,4,6671.05,1,2,9,org.apache.http.localserver.ServerTestBase,0.00,43,2,15,0,43,6,0,57,1091,1
"org.apache.http.impl.conn.ThreadSafeClientConnManager",21,0.02,2.71,184,2.22,116152.51,31,10,23,83,20,70.05,261,289,10,1,107.61,0.00,0.00,0.11,5,164.00,14,6659.33,0,5,10,java.lang.Object,0.00,62,0,57,0,62,16,1,95,1260,1
"org.apache.http.impl.conn.ThreadSafeClientConnManager$ConnectionPool",12,0.15,3.00,122,1.38,40830.43,17,5,23,40,3,57.53,104,167,0,1,105.63,0.00,0.00,0.33,3,0.00,7,4130.92,0,0,3,java.lang.Object,0.00,28,0,36,0,28,12,0,42,845,1
"org.apache.http.impl.conn.ThreadSafeClientConnManager$ConnectionSource",0,0.00,0.00,3,0.02,155.67,2,2,23,0,1,171.00,2,4,0,1,171.00,0.00,0.00,0.00,0,0.00,0,51.89,0,0,1,java.lang.Object,0.00,0,0,0,0,0,0,0,2,15,2
"org.apache.http.impl.conn.ThreadSafeClientConnManager$HostConnectionPool",0,0.00,0.00,5,0.05,875.68,4,4,23,1,1,171.00,4,6,0,1,171.00,0.00,0.00,0.00,0,0.00,0,145.95,0,0,1,java.lang.Object,0.00,1,0,0,0,1,0,0,4,35,2
"org.apache.http.impl.conn.ThreadSafeClientConnManager$HttpConnectionAdapter",1,0.00,1.00,4,0.03,302.29,1,0,23,1,2,111.14,5,6,0,3,129.01,0.00,0.67,0.00,0,1.00,1,87.85,0,0,2,org.apache.http.impl.conn.AbstractPooledConnAdapter,0.00,0,2,1,0,0,1,0,1,25,1
"org.apache.http.impl.conn.ThreadSafeClientConnManager$ReferenceQueueThread",4,1.00,2.25,23,0.21,4277.13,5,1,23,8,0,141.50,14,37,0,2,120.89,0.00,0.50,0.00,1,4.00,4,625.65,0,0,0,java.lang.Thread,0.00,4,1,9,0,4,4,0,6,144,2
"org.apache.http.impl.conn.ThreadSafeClientConnManager$TrackingPoolEntry",2,3.00,1.00,10,0.08,879.61,5,3,23,3,5,81.82,15,13,0,2,124.11,0.00,0.50,0.00,0,2.00,1,233.67,0,1,5,org.apache.http.impl.conn.AbstractPoolEntry,0.25,1,1,2,0,1,1,0,7,61,1
"org.apache.http.impl.conn.ThreadSafeClientConnManager$WaitingThread",0,0.00,0.00,4,0.03,300.83,3,3,23,0,0,171.00,10,5,0,1,171.00,0.00,0.00,0.00,0,0.00,0,85.95,0,0,0,java.lang.Object,0.00,0,0,0,0,0,0,0,3,22,2
"org.apache.http.impl.conn.Wire",13,0.92,2.00,65,0.76,27312.91,14,1,4,25,3,118.60,7,101,3,1,118.60,0.00,0.00,0.15,3,31.00,6,2274.34,0,0,0,java.lang.Object,0.00,12,0,26,0,12,13,0,1,483,1
"org.apache.http.examples.client.ClientAbortMethod",1,0.00,2.00,14,0.22,8643.73,1,0,5,11,3,79.21,5,17,0,1,97.09,0.00,0.00,0.00,0,1.00,2,668.59,0,0,3,java.lang.Object,0.00,10,0,2,0,10,1,0,3,125,1
"org.apache.http.examples.client.ClientAuthentication",1,0.00,3.00,15,0.26,8507.07,1,0,6,15,4,96.17,4,21,0,1,95.93,0.00,0.00,0.00,0,1.00,3,775.56,0,0,4,java.lang.Object,0.00,14,0,3,0,14,1,0,1,140,1
"org.apache.http.examples.client.ClientChunkEncodedPost",1,0.00,4.00,22,0.36,13994.00,1,0,8,18,3,39.85,8,29,0,1,87.96,0.00,0.00,0.00,0,1.00,4,1088.96,0,0,3,java.lang.Object,0.00,17,0,4,0,17,1,0,6,187,1
"org.apache.http.examples.client.ClientConnectionRelease",1,0.00,4.00,18,0.28,13466.89,1,0,8,14,3,80.98,15,26,0,1,91.34,0.00,0.00,0.00,0,1.00,4,838.55,0,0,3,java.lang.Object,0.00,13,0,4,0,13,1,0,12,149,1
"org.apache.http.examples.client.ClientCustomContext",1,0.00,3.00,24,0.38,18664.98,1,0,9,16,6,37.15,10,25,0,1,85.63,0.00,0.00,0.00,0,1.00,3,1154.00,0,0,6,java.lang.Object,0.00,15,0,3,0,15,1,0,7,195,1
"org.apache.http.examples.client.ClientCustomSSL",1,0.00,3.00,22,0.39,16082.35,1,0,9,23,4,87.78,4,28,0,1,87.55,0.00,0.00,0.00,0,1.00,3,1162.48,0,0,4,java.lang.Object,0.00,22,0,3,0,22,1,0,1,195,1
"org.apache.http.examples.client.ClientExecuteDirect",5,0.12,1.60,45,0.60,24765.29,7,2,21,26,10,56.20,46,57,0,1,106.20,0.00,0.00,0.40,4,6.00,4,1793.84,0,3,10,java.lang.Object,0.00,21,0,8,0,21,2,0,19,336,1
"org.apache.http.examples.client.ClientExecuteProxy",5,0.00,1.60,48,0.69,29159.19,7,2,22,29,11,55.64,47,64,0,1,105.64,0.00,0.00,0.50,4,1.00,4,2080.23,0,3,11,java.lang.Object,0.00,24,0,8,0,24,2,0,20,380,1
"org.apache.http.examples.client.ClientFormLogin",1,0.00,7.00,38,0.63,39144.79,1,0,12,17,7,75.69,4,47,0,1,75.46,0.00,0.00,0.00,0,1.00,7,1894.30,0,0,7,java.lang.Object,0.00,16,0,7,0,16,1,0,1,305,1
"org.apache.http.examples.client.ClientGZipContentCompression",1,0.00,2.00,16,0.22,8503.49,1,0,16,13,2,74.84,14,19,0,1,94.98,0.00,0.00,0.00,0,1.00,2,664.87,0,0,2,java.lang.Object,0.00,12,0,2,0,12,1,0,2,127,1
"org.apache.http.examples.client.ClientGZipContentCompression$GzipDecompressingEntity",3,0.00,1.00,8,0.06,791.29,3,0,16,5,0,140.70,2,13,0,2,140.70,0.00,0.50,0.00,0,3.00,1,166.91,0,1,0,org.apache.http.entity.HttpEntityWrapper,0.00,2,1,3,0,2,2,0,2,48,1
"org.apache.http.examples.client.ClientGZipContentCompression$HttpRequestInterceptor",1,0.00,2.00,4,0.05,753.20,1,0,16,3,0,125.73,0,8,0,1,125.73,0.00,0.00,0.00,0,1.00,2,139.77,0,0,0,java.lang.Object,0.00,2,0,2,0,2,1,0,0,34,0
"org.apache.http.examples.client.ClientGZipContentCompression$HttpResponseInterceptor",1,0.00,4.00,13,0.16,5529.91,1,0,16,8,0,99.66,0,17,0,1,99.66,0.00,0.00,0.00,0,1.00,4,485.51,0,0,0,java.lang.Object,0.00,7,0,4,0,7,1,0,0,92,0
"org.apache.http.examples.client.ClientMultiThreadedExecution",1,0.00,3.00,24,0.35,12474.61,1,0,19,14,11,86.54,16,29,0,1,87.01,0.00,0.00,0.00,0,1.00,3,1042.21,0,0,11,java.lang.Object,0.00,13,0,3,0,13,1,0,10,180,1
"org.apache.http.examples.client.ClientMultiThreadedExecution$GetThread",2,0.50,2.00,21,0.28,6922.36,6,4,19,10,3,145.55,5,27,0,2,105.67,0.00,0.50,0.50,0,2.00,3,831.60,0,0,3,java.lang.Thread,0.00,8,1,4,0,8,2,0,3,170,1
"org.apache.http.examples.client.ClientProxyAuthentication",1,0.00,3.00,20,0.38,13597.88,1,0,9,18,6,89.90,4,26,0,1,89.67,0.00,0.00,0.00,0,1.00,3,1131.73,0,0,6,java.lang.Object,0.00,17,0,3,0,17,1,0,1,192,1
"org.apache.http.conn.ssl.AbstractVerifier",0,0.00,0.00,122,2.09,310290.62,1,1,14,3,4,171.00,101,164,3,1,171.00,0.00,0.00,0.00,0,0.00,0,6277.52,0,0,1,java.lang.Object,0.00,3,0,0,3,3,0,1,35,882,2
"org.apache.http.conn.ssl.AllowAllHostnameVerifier",2,0.00,1.00,4,0.03,312.64,2,0,0,2,3,163.11,7,10,2,2,142.49,0.00,0.50,0.00,0,2.00,1,102.85,0,1,1,org.apache.http.conn.ssl.AbstractVerifier,0.00,0,1,2,0,0,1,0,2,32,1
"org.apache.http.conn.ssl.BrowserCompatHostnameVerifier",2,0.00,1.00,5,0.05,738.78,2,0,1,2,3,107.33,12,11,2,2,139.55,0.00,0.50,0.00,1,2.00,1,145.62,0,1,1,org.apache.http.conn.ssl.AbstractVerifier,0.00,0,1,2,0,0,1,0,1,41,1
"org.apache.http.conn.ssl.CertificatesToPlayWith",0,0.00,0.00,20,2.27,55234.06,19,19,0,1,2,171.00,53,347,2,1,171.00,0.00,0.00,0.00,0,0.00,0,6819.35,0,0,0,,0.00,1,0,0,0,1,0,0,13,846,1
"org.apache.http.conn.ssl.HostnameVerifier",4,0.00,1.00,5,0.06,376.98,4,0,5,4,3,107.35,33,7,3,2,155.45,0.00,0.50,0.00,0,4.00,1,180.08,0,0,0,,0.00,0,1,4,0,0,4,0,2,55,1
"org.apache.http.conn.ssl.SSLSocketFactory",14,0.05,2.21,87,1.20,43673.93,24,10,21,36,13,66.17,121,161,8,1,114.28,0.00,0.00,0.06,2,74.00,8,3613.57,0,7,5,java.lang.Object,0.00,22,0,31,0,22,7,1,19,723,1
"org.apache.http.conn.ssl.StrictHostnameVerifier",2,0.00,1.00,5,0.05,738.78,2,0,1,2,3,89.55,19,11,2,2,139.55,0.00,0.50,0.00,1,2.00,1,145.62,0,1,1,org.apache.http.conn.ssl.AbstractVerifier,0.00,0,1,2,0,0,1,0,1,41,1
"org.apache.http.conn.ssl.TestAllSSL",3,0.00,1.00,11,0.10,2271.14,3,0,3,9,4,130.53,0,15,2,2,130.53,0.00,0.50,0.00,0,3.00,1,310.03,0,1,2,junit.framework.TestCase,0.00,6,1,3,0,6,2,0,0,81,1
"org.apache.http.conn.ssl.TestHostnameVerifier",5,0.00,1.20,122,1.55,162012.25,5,0,8,17,7,51.73,30,133,2,2,83.95,0.00,0.50,0.00,1,8.00,2,4663.59,0,1,5,junit.framework.TestCase,0.00,12,1,6,0,12,4,1,19,845,1
"org.apache.http.conn.ssl.TestSSLSocketFactory",6,0.00,1.33,75,1.26,40967.62,6,0,22,51,4,140.37,13,100,2,2,100.48,0.00,0.50,0.00,2,10.00,3,3779.34,0,1,2,junit.framework.TestCase,0.00,45,1,8,0,45,5,1,8,614,1
"org.apache.http.conn.ssl.TestSSLSocketFactory$Runnable",1,0.00,2.00,14,0.16,3837.04,1,0,22,10,0,99.86,0,18,0,1,99.86,0.00,0.00,0.00,0,1.00,2,471.64,0,0,0,java.lang.Object,0.00,9,0,2,0,9,1,0,0,93,0
"org.apache.http.conn.params.HttpConnectionManagerParams",6,0.10,2.50,42,0.52,18384.19,10,4,4,16,7,91.67,88,81,6,1,111.81,0.00,0.00,0.17,2,14.00,5,1553.27,0,0,1,java.lang.Object,0.00,10,0,15,0,10,6,0,17,324,2
"org.apache.http.client.AuthState",9,3.00,1.22,33,0.26,5162.31,12,3,4,12,6,113.56,48,44,3,1,131.43,0.00,0.00,0.00,1,9.00,2,777.94,0,4,3,java.lang.Object,0.00,3,0,11,0,3,5,0,12,197,1
"org.apache.http.client.AuthenticationHandler",5,0.00,1.00,6,0.06,227.19,5,0,6,5,7,157.95,3,18,4,1,157.95,0.00,0.00,0.00,0,5.00,1,167.46,0,3,3,,0.00,0,0,5,0,0,2,0,1,53,1
"org.apache.http.client.CircularRedirectException",3,1.00,1.00,8,0.05,483.35,4,1,0,3,2,100.10,22,12,1,3,142.39,0.00,0.67,0.00,0,3.00,1,148.39,0,0,1,org.apache.http.client.RedirectException,0.00,0,2,3,0,0,3,0,4,45,1
"org.apache.http.client.ClientRequestDirector",2,0.00,1.00,3,0.02,80.08,2,0,5,2,4,206.21,55,6,2,1,158.38,0.00,0.00,0.00,0,2.00,1,56.05,0,2,2,,0.00,0,0,2,0,0,0,0,3,20,1
"org.apache.http.client.HttpClient",7,0.00,1.00,8,0.06,238.75,7,0,7,7,12,138.79,98,19,9,1,158.93,0.00,0.00,0.00,0,7.00,1,167.17,0,7,3,,0.00,0,0,7,0,0,0,0,8,57,1
"org.apache.http.client.HttpRequestRetryHandler",1,0.00,1.00,2,0.01,48.22,1,0,2,1,4,195.79,24,3,4,1,146.52,0.00,0.00,0.00,0,1.00,1,43.22,0,0,0,,0.00,0,0,1,0,0,1,0,2,15,1
"org.apache.http.client.HttpState",12,0.15,2.17,74,0.74,23027.18,15,3,9,36,11,65.94,112,95,7,1,115.94,0.00,0.00,0.19,5,34.00,5,2231.81,0,4,4,java.lang.Object,0.00,24,0,26,0,24,8,0,22,490,1
"org.apache.http.client.RedirectException",3,1.00,1.00,8,0.05,483.35,4,1,1,3,2,100.10,22,12,2,2,142.39,1.00,0.33,0.00,0,3.00,1,148.39,0,0,0,org.apache.http.ProtocolException,0.00,0,1,3,1,0,3,0,4,45,1
"org.apache.http.client.RedirectHandler",2,0.00,1.00,3,0.02,88.83,2,0,4,2,4,157.55,32,5,4,1,158.03,0.00,0.00,0.00,0,2.00,1,67.22,0,1,0,,0.00,0,0,2,0,0,1,0,3,23,1
"org.apache.http.client.RoutedRequest",2,0.00,1.00,4,0.02,178.00,2,0,2,2,10,106.86,25,6,9,1,144.42,0.00,0.00,0.00,0,2.00,1,52.00,0,2,1,,0.00,0,0,2,0,0,0,0,5,20,1
"org.apache.http.client.RoutedRequest$Impl",3,0.25,1.00,10,0.07,774.64,5,2,2,3,2,174.09,8,14,0,1,134.21,0.00,0.00,0.33,0,5.00,1,205.55,0,2,2,java.lang.Object,0.00,0,0,3,0,0,1,1,3,57,2
"org.apache.http.client.TestAll",3,0.00,1.00,16,0.17,5625.39,3,0,9,14,8,119.15,0,20,1,2,119.15,0.00,0.50,0.00,0,3.00,1,518.63,0,1,7,junit.framework.TestCase,0.00,11,1,3,0,11,2,0,0,126,1
"org.apache.http.client.TestHttpState",13,0.01,1.00,97,1.51,63299.17,19,6,4,25,6,160.44,18,134,2,2,110.44,0.00,0.50,0.15,0,59.00,1,4542.46,0,1,4,junit.framework.TestCase,0.00,12,1,13,0,12,12,0,7,946,1
"org.apache.http.client.VersionInfo",2,0.33,3.50,24,0.25,7940.31,5,3,3,10,2,152.12,2,37,2,1,102.12,0.00,0.00,0.50,1,2.00,4,743.44,0,2,0,java.lang.Object,0.00,8,0,7,0,8,0,0,2,158,1
"org.apache.http.mockup.HttpConnectionMockup",8,1.00,1.00,17,0.10,845.18,9,1,3,8,0,143.83,5,26,0,1,143.83,0.00,0.00,0.00,0,8.00,1,285.78,0,1,0,java.lang.Object,0.00,0,0,8,0,0,7,1,1,87,1
"org.apache.http.mockup.SecureSocketFactoryMockup",3,1.00,1.00,8,0.07,1044.82,4,1,4,5,3,189.75,5,15,1,2,139.75,0.00,0.50,0.00,0,4.00,1,220.88,0,2,2,org.apache.http.mockup.SocketFactoryMockup,0.25,2,1,3,0,2,1,1,3,59,1
"org.apache.http.mockup.SocketFactoryMockup",5,0.38,1.20,13,0.13,1975.02,7,2,4,10,2,189.28,7,22,1,1,139.28,0.00,0.00,0.20,0,7.00,2,401.87,0,3,1,java.lang.Object,0.00,5,0,6,1,5,2,1,5,103,1
"org.apache.http.impl.auth.BasicScheme",7,1.00,1.86,39,0.46,17008.74,8,1,11,19,8,68.13,65,59,2,2,118.12,0.00,0.50,0.00,1,7.00,5,1370.31,1,3,6,org.apache.http.impl.auth.RFC2617Scheme,0.00,12,1,13,0,12,4,0,9,276,1
"org.apache.http.impl.auth.BasicSchemeFactory",1,0.00,1.00,3,0.02,194.14,1,0,3,2,4,102.96,6,5,1,1,135.18,0.00,0.00,0.00,0,1.00,1,62.11,0,1,3,java.lang.Object,0.00,1,0,1,0,1,0,1,1,19,1
"org.apache.http.impl.auth.DigestScheme",12,0.05,3.33,191,2.77,185499.95,20,8,15,48,9,45.39,127,240,2,2,93.86,0.00,0.50,0.17,5,38.00,8,8317.38,4,8,7,org.apache.http.impl.auth.RFC2617Scheme,0.00,36,1,40,0,36,4,0,31,1432,1
"org.apache.http.impl.auth.DigestSchemeFactory",1,0.00,1.00,3,0.02,194.14,1,0,3,2,4,102.96,6,5,1,1,135.18,0.00,0.00,0.00,0,1.00,1,62.11,0,1,3,java.lang.Object,0.00,1,0,1,0,1,0,1,1,19,1
"org.apache.http.impl.auth.RFC2617Scheme",6,2.00,3.00,58,0.76,57257.86,8,2,11,26,6,55.71,52,73,3,1,103.81,0.00,0.00,0.00,1,6.00,11,2294.58,0,3,3,java.lang.Object,0.00,20,0,18,3,20,3,1,9,409,2
"org.apache.http.impl.auth.TestAllAuthImpl",3,0.00,1.00,12,0.12,2866.67,3,0,3,10,4,125.07,0,16,1,2,125.07,0.00,0.50,0.00,0,3.00,1,349.20,0,1,3,junit.framework.TestCase,0.00,7,1,3,0,7,2,0,0,90,1
"org.apache.http.impl.auth.TestBasicScheme",7,0.00,1.29,53,0.75,15143.01,7,0,14,32,7,163.15,11,65,2,2,113.15,0.00,0.50,0.00,0,7.00,2,2256.49,0,1,5,junit.framework.TestCase,0.00,25,1,9,0,25,6,0,5,432,1
"org.apache.http.impl.auth.TestDigestScheme",14,0.00,1.36,164,2.51,65819.88,14,0,16,39,8,143.05,30,199,2,2,103.17,0.00,0.50,0.00,1,14.00,3,7538.01,0,2,6,junit.framework.TestCase,0.00,25,1,19,0,25,12,0,18,1345,1
"org.apache.http.impl.auth.TestRFC2617Scheme",7,0.00,1.43,42,0.46,8497.04,7,0,12,18,6,117.60,5,58,2,2,117.60,0.00,0.50,0.00,0,7.00,2,1393.78,0,1,4,junit.framework.TestCase,0.00,11,1,10,0,11,6,0,5,301,1
"org.apache.http.impl.auth.TestRFC2617Scheme$TestAuthScheme",4,0.00,1.00,9,0.05,429.81,4,0,12,4,3,143.78,0,16,0,2,143.78,0.00,0.50,0.00,0,4.00,1,150.02,0,2,3,org.apache.http.impl.auth.RFC2617Scheme,0.00,0,1,4,0,0,2,0,0,46,1
"org.apache.http.impl.auth.UnsupportedDigestAlgorithmException",3,1.00,1.00,8,0.05,483.35,4,1,0,3,1,100.10,23,12,1,2,142.39,0.00,0.50,0.00,0,3.00,1,148.39,0,0,0,java.lang.RuntimeException,0.00,0,1,3,0,0,3,0,4,45,1
"org.apache.http.impl.client.AbstractHttpClient",46,0.06,1.39,137,1.22,25959.05,57,11,27,67,14,177.91,92,216,1,1,138.03,0.00,0.00,0.03,6,722.00,5,3671.31,0,29,13,java.lang.Object,0.00,21,0,64,1,21,17,3,34,889,2
"org.apache.http.impl.client.DefaultAuthenticationHandler",7,0.42,3.57,83,1.16,68754.68,9,2,24,36,9,100.42,5,124,1,1,100.42,0.00,0.00,0.14,1,12.00,10,3485.84,0,4,8,java.lang.Object,0.00,29,0,25,0,29,3,1,3,628,1
"org.apache.http.impl.client.DefaultClientRequestDirector",13,0.09,7.62,359,5.97,416983.50,27,14,55,140,28,37.53,146,552,1,1,81.66,0.00,0.00,0.15,9,0.00,26,17901.29,0,6,27,java.lang.Object,0.00,127,0,99,0,127,7,1,73,2804,1
"org.apache.http.impl.client.DefaultHttpClient",16,0.00,1.44,85,1.02,30668.36,16,0,47,71,45,168.99,26,142,12,2,118.99,0.00,0.50,0.00,0,16.00,5,3048.65,2,12,33,org.apache.http.impl.client.AbstractHttpClient,0.35,55,1,23,0,55,4,0,9,647,1
"org.apache.http.impl.client.DefaultHttpRequestRetryHandler",5,0.38,2.60,33,0.30,11880.23,7,2,8,8,2,82.95,33,50,1,1,115.17,0.00,0.00,0.20,0,11.00,9,907.91,0,0,1,java.lang.Object,0.00,3,0,13,0,3,5,1,16,189,1
"org.apache.http.impl.client.DefaultRedirectHandler",3,0.25,5.67,52,0.91,54709.22,5,2,17,34,4,73.28,16,103,1,1,91.15,0.00,0.00,0.33,0,4.00,14,2742.63,0,1,3,java.lang.Object,0.00,31,0,17,0,31,2,1,7,453,1
"org.apache.http.impl.client.EntityEnclosingRequestWrapper",4,1.00,1.00,12,0.12,1709.49,5,1,5,8,2,153.10,14,19,1,3,132.49,0.00,0.67,0.00,0,4.00,1,352.87,0,1,1,org.apache.http.impl.client.RequestWrapper,0.00,4,2,4,0,4,3,1,1,90,0
"org.apache.http.impl.client.RequestWrapper",9,4.00,1.56,50,0.48,13354.54,13,4,9,24,3,169.85,16,65,2,2,119.85,1.00,0.33,0.00,3,9.00,3,1432.33,0,5,1,org.apache.http.message.AbstractHttpMessage,0.00,15,1,14,1,15,4,1,3,313,0
"org.apache.http.impl.client.TestAllHttpClientImpl",3,0.00,1.00,9,0.08,1319.19,3,0,3,6,2,132.39,0,13,2,2,132.39,0.00,0.50,0.00,0,3.00,1,232.55,0,1,0,junit.framework.TestCase,0.00,3,1,3,0,3,2,0,0,63,1
"org.apache.http.impl.client.TunnelRefusedException",2,2.00,1.00,8,0.07,930.01,4,2,2,2,1,127.54,0,11,1,2,127.54,0.00,0.50,0.00,0,2.00,1,199.29,0,1,0,org.apache.http.HttpException,0.00,0,1,2,0,0,1,0,0,52,1
"org.apache.http.conn.BasicEofSensorWatcher",4,0.50,1.75,24,0.18,2892.32,6,2,2,9,2,87.11,27,40,0,1,119.33,0.00,0.00,0.88,0,0.00,2,545.93,0,0,2,java.lang.Object,0.00,5,0,7,0,5,4,1,11,130,1
"org.apache.http.conn.BasicManagedEntity",10,0.06,1.80,49,0.39,7474.53,12,2,4,18,5,126.01,47,87,1,2,125.78,0.00,0.50,0.55,2,0.00,3,1163.31,0,1,4,org.apache.http.entity.HttpEntityWrapper,0.00,8,1,18,0,8,9,3,18,276,1
"org.apache.http.conn.ClientConnectionManager",6,0.00,1.00,7,0.04,127.36,6,0,0,6,18,110.55,59,14,14,1,160.55,0.00,0.00,0.00,0,6.00,1,105.75,0,3,4,,0.00,0,0,6,0,0,3,0,6,41,1
"org.apache.http.conn.ClientConnectionManagerFactory",1,0.00,1.00,2,0.01,39.00,1,0,1,1,3,115.02,6,5,1,1,147.24,0.00,0.00,0.00,0,1.00,1,34.00,0,1,2,,0.00,0,0,1,0,0,0,0,1,13,1
"org.apache.http.conn.ClientConnectionOperator",3,0.00,1.00,4,0.05,198.95,3,0,5,3,8,165.79,51,17,7,1,156.65,0.00,0.00,0.00,0,3.00,1,135.30,0,1,1,,0.00,0,0,3,0,0,2,0,4,39,1
"org.apache.http.conn.ConnectTimeoutException",2,1.00,1.00,6,0.04,402.15,3,1,1,2,3,86.96,16,9,3,2,135.06,1.00,0.33,0.00,0,2.00,1,110.07,0,0,0,java.io.InterruptedIOException,0.00,0,1,2,1,0,2,0,3,33,1
"org.apache.http.conn.ConnectionPoolTimeoutException",2,1.00,1.00,6,0.04,423.74,3,1,0,2,7,86.78,16,9,6,3,134.89,0.00,0.67,0.00,0,2.00,1,110.60,0,0,1,org.apache.http.conn.ConnectTimeoutException,0.00,0,2,2,0,0,2,0,3,33,1
"org.apache.http.conn.ConnectionReleaseTrigger",2,0.00,1.00,3,0.01,61.53,2,0,1,2,4,177.42,37,7,4,1,159.28,0.00,0.00,0.00,0,2.00,1,41.02,0,0,0,,0.00,0,0,2,0,0,2,0,3,17,1
"org.apache.http.conn.EofSensorInputStream",12,0.15,2.58,78,0.68,19230.05,15,3,2,20,3,68.04,126,123,1,2,116.52,0.00,0.50,0.47,5,0.00,4,2034.21,0,0,2,java.io.InputStream,0.00,8,1,31,0,8,12,1,25,458,1
"org.apache.http.conn.EofSensorWatcher",3,0.00,1.00,4,0.03,123.00,3,0,2,3,3,184.58,58,10,3,1,158.30,0.00,0.00,0.00,0,3.00,1,82.00,0,0,0,,0.00,0,0,3,0,0,3,0,4,29,1
"org.apache.http.conn.HostConfiguration",8,4.00,1.75,48,0.51,17728.40,12,4,3,16,8,67.39,65,67,8,1,115.50,0.00,0.00,0.00,0,8.00,4,1530.49,0,4,0,java.lang.Object,0.00,8,0,14,0,8,4,0,14,349,1
"org.apache.http.conn.HttpRoute",21,0.15,2.38,120,1.65,98252.07,27,6,3,29,28,67.35,214,178,27,1,115.83,0.00,0.00,0.02,3,55.00,7,4945.87,1,9,1,java.lang.Object,0.00,8,0,50,0,8,12,1,31,1029,2
"org.apache.http.conn.ManagedClientConnection",8,0.00,1.00,9,0.06,258.19,8,0,5,8,14,121.56,102,21,13,4,159.12,0.00,0.75,0.00,0,8.00,1,176.46,0,0,1,,0.00,0,3,8,0,0,8,0,9,61,1
"org.apache.http.conn.OperatedClientConnection",6,0.00,1.00,7,0.06,244.34,6,0,6,6,10,176.46,109,18,10,3,158.32,0.00,0.67,0.00,0,6.00,1,168.57,0,2,0,,0.00,0,2,6,0,0,4,0,9,54,1
"org.apache.http.conn.PlainSocketFactory",7,1.00,2.14,34,0.38,15907.26,8,1,6,17,13,79.64,54,57,12,1,121.93,0.00,0.00,0.14,0,12.00,6,1140.74,0,3,1,java.lang.Object,0.00,10,0,15,0,10,4,1,19,244,2
"org.apache.http.conn.RouteDirector",4,0.29,5.50,39,0.68,39997.96,11,7,0,13,4,112.64,71,65,3,1,103.51,0.00,0.00,0.36,0,0.00,11,2033.60,0,0,1,java.lang.Object,0.00,9,0,22,0,9,4,0,27,412,1
"org.apache.http.conn.RouteTracker",22,0.13,2.64,139,1.84,104893.80,29,7,3,33,5,64.68,182,208,3,1,112.78,0.00,0.00,0.02,3,58.00,8,5529.70,1,8,2,java.lang.Object,0.00,11,0,58,0,11,14,1,37,1134,2
"org.apache.http.conn.Scheme",9,0.02,1.89,48,0.54,18358.56,14,5,2,18,17,68.72,86,70,16,1,118.72,0.00,0.00,0.22,0,34.00,4,1633.52,0,3,1,java.lang.Object,0.00,9,0,17,0,9,6,0,16,367,2
"org.apache.http.conn.SchemeRegistry",7,0.33,1.71,28,0.30,8127.54,8,1,5,17,18,75.81,72,42,17,1,124.28,0.00,0.00,0.71,2,0.00,2,899.95,0,1,1,java.lang.Object,0.00,10,0,12,0,10,6,0,13,210,2
"org.apache.http.conn.SecureSocketFactory",1,0.00,1.00,2,0.03,129.64,1,0,3,1,3,193.13,25,8,3,2,143.13,0.00,0.50,0.00,0,1.00,1,75.21,0,1,0,,0.00,0,1,1,0,0,0,0,2,22,1
"org.apache.http.conn.SocketFactory",3,0.00,1.00,4,0.04,216.04,3,0,5,3,13,206.37,75,16,12,1,156.37,0.00,0.00,0.00,0,3.00,1,132.91,0,2,1,,0.00,0,0,3,0,0,1,0,4,39,1
"org.apache.http.conn.TestAllConn",3,0.00,1.00,15,0.16,4890.67,3,0,3,13,8,119.63,0,19,2,2,119.63,0.00,0.50,0.00,0,3.00,1,474.55,0,1,6,junit.framework.TestCase,0.00,10,1,3,0,10,2,0,0,117,1
"org.apache.http.conn.TestExceptions",5,0.00,1.00,22,0.23,4289.72,5,0,3,18,4,125.44,4,30,2,2,125.44,0.00,0.50,0.00,0,5.00,1,692.78,0,1,2,junit.framework.TestCase,0.00,13,1,5,0,13,4,0,1,165,1
"org.apache.http.conn.TestHttpRoute",14,0.28,1.93,306,5.64,340089.52,23,9,7,49,3,107.61,48,426,2,2,86.99,0.00,0.50,0.37,0,0.00,7,16911.76,0,1,1,junit.framework.TestCase,0.00,35,1,27,0,35,13,0,46,2850,1
"org.apache.http.conn.TestParams",5,0.38,2.00,38,0.39,10486.38,7,2,7,19,4,70.87,36,66,2,2,113.16,0.00,0.50,0.20,0,7.00,6,1184.24,0,1,2,junit.framework.TestCase,0.00,14,1,10,0,14,4,0,9,264,1
"org.apache.http.conn.TestRouteDirector",10,0.11,1.10,213,3.36,167792.56,19,9,7,19,4,128.27,20,317,2,2,88.39,0.00,0.50,0.21,0,0.00,2,10086.13,0,1,2,junit.framework.TestCase,0.00,9,1,11,0,9,9,0,18,1885,1
"org.apache.http.conn.TestRouteTracker",14,0.18,3.07,347,5.74,606987.64,23,9,7,58,5,50.52,88,458,2,2,82.74,0.00,0.50,0.28,3,0.00,9,17224.92,0,2,3,junit.framework.TestCase,0.00,44,1,43,0,44,12,0,69,3006,1
"org.apache.http.conn.TestScheme",11,0.00,2.45,121,1.64,61076.18,11,0,6,42,6,142.35,27,178,2,2,102.46,0.00,0.50,0.00,0,11.00,7,4914.44,0,1,4,junit.framework.TestCase,0.00,31,1,27,0,31,10,0,22,977,1
"org.apache.http.client.protocol.HttpClientContext",1,7.00,1.00,10,0.12,1843.04,8,7,2,1,10,107.98,0,12,10,2,107.98,0.00,0.50,0.00,0,1.00,1,355.30,0,0,0,org.apache.http.protocol.HttpExecutionContext,0.00,0,1,1,0,0,1,0,0,80,1
"org.apache.http.client.protocol.RequestAddCookies",2,1.00,8.50,60,1.02,76249.94,3,1,23,32,10,30.86,21,83,1,1,79.33,0.00,0.00,0.50,0,2.00,16,3073.09,0,0,9,java.lang.Object,0.00,30,0,17,0,30,2,1,11,465,1
"org.apache.http.client.protocol.RequestProxyAuthentication",2,1.00,5.50,26,0.35,15198.88,3,1,12,16,7,98.73,8,41,1,1,98.50,0.00,0.00,0.50,0,2.00,10,1041.21,0,0,6,java.lang.Object,0.00,14,0,11,0,14,2,1,2,188,1
"org.apache.http.client.protocol.RequestTargetAuthentication",2,1.00,5.50,26,0.35,15198.88,3,1,12,16,7,98.73,8,41,1,1,98.50,0.00,0.00,0.50,0,2.00,10,1041.21,0,0,6,java.lang.Object,0.00,14,0,11,0,14,2,1,2,188,1
"org.apache.http.client.protocol.ResponseProcessCookies",3,0.50,5.00,45,0.60,26699.93,4,1,14,16,8,95.89,13,68,1,1,95.66,0.00,0.00,0.67,1,1.00,8,1800.25,0,0,7,java.lang.Object,0.00,13,0,15,0,13,3,1,4,330,1
"org.apache.http.auth.AUTH",1,4.00,1.00,6,0.06,774.52,5,4,0,1,9,145.51,19,8,9,1,119.22,0.00,0.00,0.00,0,1.00,1,175.59,0,0,0,java.lang.Object,0.00,0,0,1,0,0,1,0,5,45,2
"org.apache.http.auth.AuthScheme",7,0.00,1.00,8,0.04,190.08,7,0,2,7,15,122.15,86,10,12,1,159.71,0.00,0.00,0.00,0,7.00,1,121.84,0,4,3,,0.00,0,0,7,0,0,3,0,8,47,1
"org.apache.http.auth.AuthSchemeFactory",1,0.00,1.00,2,0.01,30.51,1,0,1,1,2,115.86,6,3,1,1,148.08,0.00,0.00,0.00,0,1.00,1,25.51,0,1,1,,0.00,0,0,1,0,0,0,0,1,11,1
"org.apache.http.auth.AuthSchemeRegistry",4,0.00,2.25,22,0.26,7203.50,5,1,5,14,5,81.54,48,35,3,1,119.10,0.00,0.00,1.00,0,0.00,3,774.20,0,2,2,java.lang.Object,0.00,10,0,9,0,10,2,0,5,169,2
"org.apache.http.auth.AuthScope",12,0.01,2.67,92,1.13,52120.62,21,9,1,25,7,62.50,105,127,7,1,110.60,0.00,0.00,0.10,0,28.00,9,3386.53,1,4,0,java.lang.Object,0.00,13,0,32,0,13,8,0,22,724,1
"org.apache.http.auth.AuthenticationException",3,1.00,1.00,8,0.05,538.90,4,1,1,3,11,99.73,22,12,11,2,142.02,1.00,0.33,0.00,0,3.00,1,153.79,0,0,0,org.apache.http.ProtocolException,0.00,0,1,3,1,0,3,0,4,46,1
"org.apache.http.auth.Credentials",2,0.00,1.00,3,0.01,31.00,2,0,0,2,13,161.86,8,4,13,1,161.63,0.00,0.00,0.00,0,2.00,1,26.00,0,2,0,,0.00,0,0,2,0,0,0,0,1,13,1
"org.apache.http.auth.InvalidCredentialsException",3,1.00,1.00,8,0.05,538.90,4,1,0,3,1,99.73,23,12,0,3,142.02,0.00,0.67,0.00,0,3.00,1,153.79,0,0,1,org.apache.http.auth.AuthenticationException,0.00,0,2,3,0,0,3,0,4,46,1
"org.apache.http.auth.MalformedChallengeException",3,1.00,1.00,8,0.05,483.35,4,1,1,3,10,100.10,23,12,10,2,142.39,0.00,0.50,0.00,0,3.00,1,148.39,0,0,0,org.apache.http.ProtocolException,0.00,0,1,3,0,0,3,0,4,45,1
"org.apache.http.auth.UsernamePasswordCredentials",8,0.43,2.00,44,0.44,13083.42,10,2,1,18,7,77.17,62,59,6,1,119.46,0.00,0.00,0.12,1,20.00,5,1310.14,0,4,1,java.lang.Object,0.00,10,0,16,0,10,4,1,15,303,1
"org.apache.http.client.utils.URLUtils",3,1.00,3.00,25,0.32,16181.27,4,1,4,11,1,116.80,52,38,1,1,107.67,0.00,0.00,0.33,1,4.00,5,948.18,0,2,0,java.lang.Object,0.00,8,0,9,0,8,1,0,6,189,1
"org.apache.http.auth.params.AuthParams",3,0.50,2.00,15,0.14,3537.90,4,1,2,6,2,76.45,35,22,2,1,120.58,0.00,0.00,0.67,0,1.00,3,423.03,0,1,0,java.lang.Object,0.00,3,0,6,0,3,2,0,4,99,2
"org.apache.http.client.methods.AbortableHttpRequest",2,0.00,1.00,3,0.01,38.51,2,0,1,2,3,143.01,11,4,2,1,160.88,0.00,0.00,0.00,0,2.00,1,33.51,0,0,1,,0.00,0,0,2,0,0,2,0,1,15,1
"org.apache.http.client.methods.HttpEntityEnclosingRequestBase",4,1.00,1.00,11,0.10,1352.80,5,1,4,7,3,179.74,9,17,2,3,139.85,1.00,0.40,0.00,0,4.00,1,288.27,0,1,1,org.apache.http.client.methods.HttpRequestBase,0.00,3,2,4,2,3,3,1,1,76,1
"org.apache.http.client.methods.HttpGet",4,1.00,1.00,12,0.07,747.10,5,1,2,5,13,117.44,21,17,12,3,135.32,0.00,0.67,0.25,0,6.00,1,216.45,1,1,1,org.apache.http.client.methods.HttpRequestBase,0.25,1,2,4,0,1,3,0,1,63,1
"org.apache.http.client.methods.HttpHead",4,1.00,1.00,12,0.07,747.10,5,1,2,5,1,117.44,21,17,0,3,135.32,0.00,0.67,0.25,0,6.00,1,216.45,1,1,1,org.apache.http.client.methods.HttpRequestBase,0.25,1,2,4,0,1,3,0,1,63,1
"org.apache.http.client.methods.HttpOptions",5,1.00,1.60,26,0.23,6904.57,6,1,8,12,1,140.71,19,32,0,3,120.09,0.00,0.67,0.20,0,8.00,4,690.10,1,2,1,org.apache.http.client.methods.HttpRequestBase,0.23,7,2,8,0,7,3,0,1,152,1
"org.apache.http.client.methods.HttpPost",4,1.00,1.00,12,0.07,747.10,5,1,2,5,4,103.09,25,17,3,4,135.32,0.00,0.75,0.25,0,6.00,1,216.45,1,1,1,org.apache.http.client.methods.HttpEntityEnclosingRequestBase,0.25,1,3,4,0,1,3,0,1,63,1
"org.apache.http.client.methods.HttpPut",4,1.00,1.00,12,0.07,747.10,5,1,2,5,1,135.55,17,17,0,4,135.32,0.00,0.75,0.25,0,6.00,1,216.45,1,1,1,org.apache.http.client.methods.HttpEntityEnclosingRequestBase,0.25,1,3,4,0,1,3,0,1,63,1
"org.apache.http.client.methods.HttpRequestBase",8,2.00,1.38,28,0.22,3753.31,10,2,8,13,8,182.09,10,41,5,2,132.09,7.00,0.11,0.00,3,8.00,3,648.78,0,4,3,org.apache.http.message.AbstractHttpMessage,0.00,5,1,11,7,5,4,2,2,163,1
"org.apache.http.client.methods.HttpTrace",4,1.00,1.00,12,0.07,747.10,5,1,2,5,1,117.44,20,17,0,3,135.32,0.00,0.67,0.25,0,6.00,1,216.45,1,1,1,org.apache.http.client.methods.HttpRequestBase,0.25,1,2,4,0,1,3,0,1,63,1
"org.apache.http.client.methods.HttpUriRequest",3,0.00,1.00,4,0.01,60.19,3,0,3,3,5,160.98,12,5,5,2,160.74,0.00,0.50,0.00,0,3.00,1,42.09,0,3,0,,0.00,0,1,3,0,0,0,0,1,19,1
"org.apache.http.client.methods.UrlEncodedFormEntity",8,0.50,1.12,26,0.25,3807.34,10,2,12,16,2,132.09,1,39,1,2,132.09,0.00,0.50,0.06,0,14.00,2,756.69,0,2,1,org.apache.http.entity.AbstractHttpEntity,0.00,8,1,9,0,8,6,0,1,183,1
"org.apache.http.cookie.params.CookieSpecParams",0,0.00,0.00,3,0.03,347.53,2,2,1,0,2,171.00,25,4,2,1,171.00,0.00,0.00,0.00,0,0.00,0,85.11,0,0,0,java.lang.Object,0.00,0,0,0,0,0,0,0,3,23,2
"org.apache.http.localserver.EchoHandler",1,0.00,4.00,17,0.30,13378.02,1,0,12,15,1,142.28,25,29,1,1,92.29,0.00,0.00,0.00,0,1.00,4,909.67,0,0,0,java.lang.Object,0.00,14,0,4,0,14,1,1,6,158,1
"org.apache.http.localserver.LocalTestServer",11,0.06,1.73,63,0.72,17173.78,18,7,27,46,4,71.55,94,96,2,1,119.65,0.00,0.00,0.19,1,40.00,4,2159.94,0,3,2,java.lang.Object,0.00,35,0,19,0,35,8,0,24,473,1
"org.apache.http.localserver.LocalTestServer$RequestListener",3,0.50,2.67,32,0.41,11282.01,4,1,27,23,1,125.93,11,50,0,1,105.32,0.00,0.00,0.67,2,0.00,4,1226.12,0,0,1,java.lang.Object,0.00,20,0,8,0,20,3,1,9,246,1
"org.apache.http.localserver.LocalTestServer$RequestListener$Worker",2,2.00,3.00,14,0.19,5019.28,4,2,27,6,0,162.45,2,26,0,1,112.45,0.00,0.00,0.00,0,2.00,5,566.78,0,0,0,java.lang.Object,0.00,4,0,6,0,4,2,1,2,121,1
"org.apache.http.localserver.RandomHandler",1,0.00,7.00,28,0.51,30094.73,1,0,12,22,1,88.57,35,43,1,1,81.30,0.00,0.00,0.00,0,1.00,7,1523.94,0,0,0,java.lang.Object,0.00,21,0,7,0,21,1,1,8,250,1
"org.apache.http.localserver.RandomHandler$RandomEntity",6,0.20,1.83,41,0.43,24481.62,8,2,12,13,0,81.18,40,57,0,2,113.40,0.00,0.50,0.33,0,6.00,4,1301.88,0,1,0,org.apache.http.entity.AbstractHttpEntity,0.00,7,1,11,0,7,5,0,12,270,2
"org.apache.http.localserver.ServerTestBase",6,0.13,1.83,44,0.53,11099.28,12,6,17,37,5,76.05,72,65,0,2,113.61,2.00,0.25,0.28,1,6.00,6,1589.58,0,3,5,junit.framework.TestCase,0.00,31,1,11,2,31,3,0,15,319,2
