Name, No. Methods, LCOM, AVCC, NOS, HBUG, HEFF, UWCS, INST, PACK, RFC, CBO, MI, CCML, NLOC, F-IN, DIT, MINC, S-R, R-R, COH, LMC, LCOM2, MAXCC, HVOL, HIER, NQU, FOUT, Superclass, SIX, EXT, NSUP, TCC, NSUB, MPC, NCO, INTR, CCOM, HLTH, MOD
"org.apache.http.cookie.Cookie",21,0.02,1.10,60,0.39,5716.15,31,10,1,25,28,90.58,207,85,28,1,140.58,0.00,0.00,0.09,0,311.00,2,1181.41,0,6,0,java.lang.Object,0.00,4,0,23,0,4,15,0,31,318,1
"org.apache.http.cookie.CookieAttributeHandler",3,0.00,1.00,4,0.03,138.66,3,0,0,3,14,113.76,35,7,11,1,157.89,0.00,0.00,0.00,0,3.00,1,100.44,0,0,3,,0.00,0,0,3,0,0,3,0,4,33,1
"org.apache.http.cookie.CookieOrigin",5,4.00,2.00,30,0.29,11126.84,9,4,0,9,24,165.45,8,44,24,1,115.45,0.00,0.00,0.00,0,5.00,6,863.22,0,2,0,java.lang.Object,0.00,4,0,10,0,4,3,0,1,188,2
"org.apache.http.cookie.CookiePathComparator",2,0.00,3.50,21,0.20,7055.58,2,0,1,6,3,63.18,15,27,2,1,105.47,0.00,0.00,0.00,1,2.00,4,589.16,0,1,1,java.lang.Object,0.00,4,0,7,0,4,1,1,2,130,1
"org.apache.http.cookie.CookieSpec",4,0.00,1.00,5,0.04,198.62,4,0,1,4,13,128.26,52,6,10,1,157.64,0.00,0.00,0.00,0,4.00,1,127.73,0,1,3,,0.00,0,0,4,0,0,3,0,5,42,1
"org.apache.http.cookie.CookieSpecFactory",1,0.00,1.00,2,0.01,30.51,1,0,1,1,5,115.86,6,3,4,1,148.08,0.00,0.00,0.00,0,1.00,1,25.51,0,1,1,,0.00,0,0,1,0,0,0,0,1,11,1
"org.apache.http.cookie.CookieSpecRegistry",7,0.25,1.86,32,0.35,9314.03,9,2,6,19,4,73.80,69,49,1,1,123.80,0.00,0.00,0.29,1,3.00,3,1063.66,0,4,3,java.lang.Object,0.00,12,0,13,0,12,3,0,7,240,2
"org.apache.http.cookie.MalformedCookieException",3,1.00,1.00,8,0.05,538.90,4,1,1,3,25,99.73,23,12,25,2,142.02,0.00,0.50,0.00,0,3.00,1,153.79,0,0,0,org.apache.http.ProtocolException,0.00,0,1,3,0,0,3,0,4,46,1
"org.apache.http.cookie.TestAllCookie",3,0.00,1.00,12,0.12,2866.67,3,0,3,10,5,125.07,0,16,2,2,125.07,0.00,0.50,0.00,0,3.00,1,349.20,0,1,3,junit.framework.TestCase,0.00,7,1,3,0,7,2,0,0,90,1
"org.apache.http.cookie.TestCookieOrigin",8,0.00,1.50,29,0.28,3934.85,8,0,3,16,3,181.91,9,46,2,2,131.91,0.00,0.50,0.00,0,8.00,2,839.18,0,1,1,junit.framework.TestCase,0.00,8,1,12,0,8,7,0,7,205,1
"org.apache.http.cookie.TestCookiePathComparator",8,0.00,1.00,53,0.62,15666.30,8,0,4,14,4,116.05,5,62,2,2,116.05,0.00,0.50,0.00,0,8.00,1,1861.55,0,1,2,junit.framework.TestCase,0.00,6,1,8,0,6,7,0,3,414,1
"org.apache.http.cookie.TestCookiePolicy",5,0.00,2.40,67,0.84,32700.52,5,0,11,24,9,139.08,12,95,2,2,99.20,0.00,0.50,0.00,0,5.00,6,2510.37,0,1,7,junit.framework.TestCase,0.00,19,1,12,0,19,4,0,10,509,1
"org.apache.http.impl.cookie.AbstractCookieAttributeHandler",2,0.00,1.00,4,0.04,321.06,2,0,4,2,9,192.40,2,8,5,1,142.40,0.00,0.00,0.00,0,2.00,1,118.06,0,0,4,java.lang.Object,0.00,0,0,2,5,0,2,1,2,34,2
"org.apache.http.impl.cookie.AbstractCookieSpec",5,2.00,1.80,25,0.25,5545.16,7,2,7,14,5,88.59,34,37,3,1,120.81,0.00,0.00,0.00,1,5.00,4,749.73,0,3,2,java.lang.Object,0.00,9,0,9,5,9,2,1,6,175,2
"org.apache.http.impl.cookie.BasicCommentHandler",2,0.00,1.50,7,0.06,1034.91,2,0,2,4,7,131.74,0,12,4,2,131.74,0.00,0.50,0.00,0,2.00,2,171.85,0,0,3,org.apache.http.impl.cookie.AbstractCookieAttributeHandler,0.00,2,1,3,0,2,2,0,0,44,1
"org.apache.http.impl.cookie.BasicDomainHandler",4,0.00,5.00,44,0.58,24338.67,4,0,4,18,7,141.87,8,71,3,1,101.98,0.00,0.00,0.00,0,4.00,9,1729.53,0,0,4,java.lang.Object,0.00,14,0,20,1,14,4,1,8,334,1
"org.apache.http.impl.cookie.BasicExpiresHandler",3,1.00,2.67,18,0.21,5357.94,4,1,5,8,8,116.14,1,30,4,2,116.14,0.00,0.50,0.00,0,3.00,4,618.72,0,0,4,org.apache.http.impl.cookie.AbstractCookieAttributeHandler,0.00,5,1,8,0,5,3,0,1,134,1
"org.apache.http.impl.cookie.BasicMaxAgeHandler",2,0.00,2.50,13,0.15,4859.92,2,0,3,8,7,115.10,0,22,4,2,115.10,0.00,0.50,0.00,0,2.00,4,451.15,0,0,3,org.apache.http.impl.cookie.AbstractCookieAttributeHandler,0.00,6,1,5,0,6,2,0,0,92,1
"org.apache.http.impl.cookie.BasicPathHandler",4,0.00,3.25,29,0.41,20468.51,4,0,4,17,8,110.00,2,47,4,1,110.00,0.00,0.00,0.00,0,4.00,7,1231.21,0,0,4,java.lang.Object,0.00,13,0,13,0,13,4,1,2,248,1
"org.apache.http.impl.cookie.BasicSecureHandler",3,0.00,2.33,13,0.13,3261.09,3,0,3,7,8,124.44,0,21,4,2,124.44,0.00,0.50,0.00,0,3.00,4,396.74,0,0,4,org.apache.http.impl.cookie.AbstractCookieAttributeHandler,0.00,4,1,7,0,4,3,0,0,92,1
"org.apache.http.impl.cookie.BrowserCompatSpec",4,0.50,4.00,59,0.78,39405.45,6,2,10,27,13,117.10,13,90,3,3,96.48,0.00,0.67,0.12,1,6.00,7,2352.51,1,2,10,org.apache.http.impl.cookie.CookieSpecBase,0.00,23,2,16,0,23,2,0,5,433,1
"org.apache.http.impl.cookie.BrowserCompatSpecFactory",1,0.00,2.00,6,0.06,1283.23,1,0,4,3,5,85.12,6,10,1,1,117.34,0.00,0.00,0.00,0,1.00,2,176.05,0,1,4,java.lang.Object,0.00,2,0,2,0,2,0,1,1,42,1
"org.apache.http.impl.cookie.CookieSpecBase",5,0.00,3.60,61,0.71,38439.19,5,0,7,25,8,149.85,9,70,3,2,99.85,3.00,0.20,0.00,2,5.00,5,2133.92,1,3,5,org.apache.http.impl.cookie.AbstractCookieSpec,0.00,20,1,18,3,20,2,0,3,404,2
"org.apache.http.impl.cookie.NetscapeDomainHandler",4,0.00,3.00,30,0.40,12934.01,4,0,4,13,6,161.59,7,55,2,2,111.59,0.00,0.50,0.00,1,4.00,5,1208.65,1,0,4,org.apache.http.impl.cookie.BasicDomainHandler,0.00,9,1,12,0,9,4,0,2,246,1
"org.apache.http.impl.cookie.NetscapeDraftSpec",3,0.00,3.33,37,0.43,20045.19,3,0,8,17,12,80.20,42,46,2,3,100.35,0.00,0.67,0.00,1,3.00,6,1285.76,1,2,10,org.apache.http.impl.cookie.CookieSpecBase,0.00,14,2,10,0,14,1,0,3,254,1
"org.apache.http.impl.cookie.NetscapeDraftSpecFactory",1,0.00,1.00,3,0.02,194.14,1,0,3,2,4,102.96,6,5,1,1,135.18,0.00,0.00,0.00,0,1.00,1,62.11,0,1,3,java.lang.Object,0.00,1,0,1,0,1,0,1,1,19,1
"org.apache.http.impl.cookie.RFC2109DomainHandler",4,0.00,4.75,46,0.69,36151.16,4,0,4,19,6,100.64,3,79,2,1,100.64,0.00,0.00,0.00,0,4.00,10,2079.46,0,0,4,java.lang.Object,0.00,15,0,19,0,15,4,1,3,385,1
"org.apache.http.impl.cookie.RFC2109Spec",9,0.22,2.89,100,1.21,44406.55,13,4,10,35,14,123.44,34,126,2,3,102.83,0.00,0.67,0.06,5,23.00,4,3625.00,2,4,12,org.apache.http.impl.cookie.CookieSpecBase,0.00,26,2,26,0,26,5,0,6,725,1
"org.apache.http.impl.cookie.RFC2109SpecFactory",1,0.00,2.00,6,0.07,1728.53,1,0,4,4,5,84.10,6,11,1,1,116.32,0.00,0.00,0.00,0,1.00,2,219.84,0,1,4,java.lang.Object,0.00,3,0,2,0,3,0,1,1,50,1
"org.apache.http.impl.cookie.RFC2109VersionHandler",3,0.00,3.00,18,0.21,5755.35,3,0,3,11,6,115.87,0,32,2,2,115.87,0.00,0.50,0.00,0,3.00,5,643.29,0,0,4,org.apache.http.impl.cookie.AbstractCookieAttributeHandler,0.00,8,1,9,0,8,3,0,0,135,1
"org.apache.http.impl.cookie.TestAbstractCookieSpec",6,0.00,1.50,44,0.49,12913.21,6,0,10,22,7,113.14,4,57,2,2,113.14,0.00,0.50,0.00,0,6.00,3,1476.16,0,1,5,junit.framework.TestCase,0.00,16,1,9,0,16,5,0,4,317,1
"org.apache.http.impl.cookie.TestAbstractCookieSpec$DummyCookieAttribHandler",3,0.00,1.00,5,0.05,308.89,3,0,10,3,4,155.15,0,9,0,1,155.15,0.00,0.00,0.00,0,3.00,1,138.78,0,0,4,java.lang.Object,0.00,0,0,3,0,0,3,1,0,41,2
"org.apache.http.impl.cookie.TestAbstractCookieSpec$DummyCookieSpec",4,0.00,1.00,8,0.07,562.44,4,0,10,4,4,142.86,0,13,0,2,142.86,0.00,0.50,0.00,0,4.00,1,200.84,0,2,4,org.apache.http.impl.cookie.AbstractCookieSpec,0.00,0,1,4,0,0,2,0,0,57,2
"org.apache.http.impl.cookie.TestAllCookieImpl",3,0.00,1.00,16,0.17,5625.39,3,0,3,14,9,119.15,0,20,2,2,119.15,0.00,0.50,0.00,0,3.00,1,518.63,0,1,7,junit.framework.TestCase,0.00,11,1,3,0,11,2,0,0,126,1
"org.apache.http.impl.cookie.TestBasicCookieAttribHandlers",34,0.00,1.79,270,3.22,76538.59,34,0,11,71,12,112.94,28,359,2,2,112.94,0.00,0.50,0.00,0,34.00,6,9655.23,0,1,10,junit.framework.TestCase,0.00,37,1,61,0,37,33,0,28,2010,1
"org.apache.http.impl.cookie.TestBrowserCompatSpec",57,0.00,1.77,687,9.81,309567.47,57,0,11,89,7,151.20,76,737,2,2,101.20,0.00,0.50,0.00,1,57.00,9,29429.96,0,1,5,junit.framework.TestCase,0.00,32,1,101,0,32,56,0,39,5367,1
"org.apache.http.impl.cookie.TestCookieNetscapeDraft",13,0.00,2.00,136,1.86,50568.40,13,0,9,34,7,145.15,29,160,2,2,105.27,0.00,0.50,0.00,0,13.00,5,5575.25,0,1,5,junit.framework.TestCase,0.00,21,1,26,0,21,12,0,15,1048,1
"org.apache.http.impl.cookie.TestCookieRFC2109Spec",21,0.00,2.14,264,3.40,102672.79,21,0,10,45,7,141.40,57,321,2,2,101.52,0.00,0.50,0.00,0,21.00,6,10205.45,0,1,5,junit.framework.TestCase,0.00,24,1,45,0,24,20,0,26,1920,1
"org.apache.http.impl.cookie.TestNetscapeCookieAttribHandlers",10,0.00,1.70,74,0.87,19083.44,10,0,7,22,7,113.52,8,99,2,2,113.52,0.00,0.50,0.00,0,10.00,3,2597.22,0,1,5,junit.framework.TestCase,0.00,12,1,17,0,12,9,0,8,536,1
"org.apache.http.impl.cookie.TestRFC2109CookieAttribHandlers",17,0.00,2.18,149,1.70,43924.09,17,0,7,35,8,160.26,21,207,2,2,110.26,0.00,0.50,0.00,0,17.00,6,5096.43,0,1,6,junit.framework.TestCase,0.00,18,1,37,0,18,16,0,21,1051,1
"org.apache.http.examples.conn.ManagerConnectDirect",6,0.10,1.50,58,0.81,39266.22,8,2,19,35,8,55.26,57,71,0,1,105.26,0.00,0.00,0.42,5,6.00,4,2434.51,0,4,8,java.lang.Object,0.00,29,0,9,0,29,2,0,16,430,1
"org.apache.http.examples.conn.ManagerConnectProxy",8,0.21,1.50,86,1.29,68384.89,10,2,20,44,9,54.54,70,106,0,1,102.64,0.00,0.00,0.31,7,16.00,4,3873.41,0,5,9,java.lang.Object,0.00,36,0,12,0,36,3,0,21,667,1
"org.apache.http.examples.conn.OperatorConnectDirect",6,0.20,1.17,46,0.58,19142.88,8,2,18,28,7,61.85,58,53,0,1,111.85,0.00,0.00,0.33,5,10.00,2,1739.65,0,4,7,java.lang.Object,0.00,22,0,7,0,22,2,0,17,331,1
"org.apache.http.examples.conn.OperatorConnectProxy",8,0.29,1.25,74,1.04,44387.33,10,2,19,37,8,55.87,76,87,0,1,105.87,0.00,0.00,0.25,7,18.00,2,3134.89,0,5,8,java.lang.Object,0.00,29,0,10,0,29,3,0,27,569,1
"org.apache.http.impl.conn.AbstractClientConnAdapter",22,0.10,1.23,73,0.50,6345.78,25,3,10,39,4,173.67,64,110,1,1,133.78,0.00,0.00,0.42,2,0.00,2,1493.13,0,3,3,java.lang.Object,0.00,17,0,27,3,17,19,1,27,399,2
"org.apache.http.impl.conn.AbstractPoolEntry",6,0.30,3.00,41,0.64,25193.66,8,2,8,24,7,112.72,97,78,3,1,113.19,0.00,0.00,0.25,2,6.00,6,1927.38,0,1,4,java.lang.Object,0.00,18,0,18,2,18,5,0,37,378,2
"org.apache.http.impl.conn.AbstractPooledConnAdapter",9,0.12,1.67,31,0.28,4057.17,10,1,6,17,7,132.42,41,53,2,2,132.19,2.00,0.25,0.89,1,0.00,3,828.33,0,1,5,org.apache.http.impl.conn.AbstractClientConnAdapter,0.00,8,1,15,2,8,8,1,11,213,2
"org.apache.http.impl.conn.DefaultClientConnection",11,0.00,2.18,71,0.77,21319.80,16,5,14,28,5,136.52,35,103,1,2,115.91,0.00,0.50,0.20,0,59.00,4,2323.26,5,5,4,org.apache.http.impl.SocketHttpClientConnection,0.00,17,1,24,0,17,6,1,18,492,1
"org.apache.http.impl.conn.DefaultClientConnectionOperator",6,0.60,3.17,52,0.83,29253.59,7,1,13,31,11,59.90,49,101,4,1,108.01,0.00,0.00,0.50,1,6.00,7,2476.17,0,1,7,java.lang.Object,0.00,25,0,19,0,25,5,1,19,453,1
"org.apache.http.impl.conn.IdleConnectionHandler",5,0.00,2.20,29,0.35,9403.16,7,2,7,21,1,86.74,34,42,1,1,118.96,0.00,0.00,0.50,0,2.00,6,1046.75,0,0,0,java.lang.Object,0.00,16,0,11,0,16,5,0,8,219,1
"org.apache.http.impl.conn.LoggingHttpDataReceiverDecorator",8,2.00,1.62,38,0.49,15943.78,10,2,4,13,2,162.33,16,52,1,1,122.45,0.00,0.00,0.00,4,8.00,2,1469.10,0,1,1,java.lang.Object,0.00,5,0,13,0,5,7,1,4,330,0
"org.apache.http.impl.conn.LoggingHttpDataTransmitterDecorator",8,2.00,1.62,32,0.38,7689.40,10,2,4,13,2,174.94,14,46,1,1,124.94,0.00,0.00,0.00,4,8.00,2,1142.61,0,0,1,java.lang.Object,0.00,5,0,13,0,5,8,1,4,274,0
"org.apache.http.impl.conn.SingleClientConnManager",9,0.14,3.67,84,1.08,38101.17,18,9,11,31,10,62.42,105,142,3,1,106.55,0.00,0.00,0.23,3,7.00,8,3241.61,0,3,7,java.lang.Object,0.00,22,0,33,0,22,6,1,39,626,1
"org.apache.http.impl.conn.SingleClientConnManager$ConnAdapter",1,0.00,1.00,5,0.04,482.50,1,0,11,1,3,91.57,6,7,0,3,123.80,0.00,0.67,0.00,0,1.00,1,125.87,0,0,3,org.apache.http.impl.conn.AbstractPooledConnAdapter,0.00,0,2,1,0,0,1,0,1,33,1
"org.apache.http.impl.conn.SingleClientConnManager$PoolEntry",4,1.00,1.50,12,0.09,1012.00,5,1,11,7,5,154.80,14,21,0,2,134.19,0.00,0.50,0.00,0,4.00,2,261.80,1,1,5,org.apache.http.impl.conn.AbstractPoolEntry,0.20,3,1,6,0,3,3,0,6,75,1
"org.apache.http.impl.conn.TestAllConnImpl",3,0.00,1.00,10,0.09,1733.04,3,0,3,8,3,131.45,0,14,2,2,131.45,0.00,0.50,0.00,0,3.00,1,272.38,0,1,1,junit.framework.TestCase,0.00,5,1,3,0,5,2,0,0,72,1
"org.apache.http.impl.conn.TestLocalServer",5,0.00,1.60,37,0.58,19382.74,5,0,12,22,6,111.11,4,51,2,3,111.11,0.00,0.67,0.00,0,7.00,4,1739.23,2,1,4,org.apache.http.localserver.ServerTestBase,0.00,17,2,8,0,17,4,0,1,322,1
"org.apache.http.impl.conn.ThreadSafeClientConnManager",20,0.02,2.80,180,2.19,115157.35,29,9,23,83,17,76.18,260,284,7,1,105.56,0.00,0.00,0.13,5,146.00,14,6580.90,0,4,10,java.lang.Object,0.00,63,0,56,0,63,16,1,94,1243,1
"org.apache.http.impl.conn.ThreadSafeClientConnManager$ConnectionPool",12,0.15,3.00,122,1.38,40934.72,17,5,23,41,3,57.52,104,167,0,1,105.62,0.00,0.00,0.33,3,0.00,7,4149.63,0,0,3,java.lang.Object,0.00,29,0,36,0,29,12,0,42,848,1
"org.apache.http.impl.conn.ThreadSafeClientConnManager$ConnectionSource",0,0.00,0.00,3,0.02,155.67,2,2,23,0,1,171.00,2,4,0,1,171.00,0.00,0.00,0.00,0,0.00,0,51.89,0,0,1,java.lang.Object,0.00,0,0,0,0,0,0,0,2,15,2
"org.apache.http.impl.conn.ThreadSafeClientConnManager$HostConnectionPool",0,0.00,0.00,5,0.05,875.68,4,4,23,1,1,171.00,4,6,0,1,171.00,0.00,0.00,0.00,0,0.00,0,145.95,0,0,1,java.lang.Object,0.00,1,0,0,0,1,0,0,4,35,2
"org.apache.http.impl.conn.ThreadSafeClientConnManager$HttpConnectionAdapter",1,0.00,1.00,4,0.03,302.29,1,0,23,1,2,111.14,5,6,0,3,129.01,0.00,0.67,0.00,0,1.00,1,87.85,0,0,2,org.apache.http.impl.conn.AbstractPooledConnAdapter,0.00,0,2,1,0,0,1,0,1,25,1
"org.apache.http.impl.conn.ThreadSafeClientConnManager$ReferenceQueueThread",4,1.00,2.25,23,0.21,4277.13,5,1,23,8,0,141.50,14,37,0,2,120.89,0.00,0.50,0.00,1,4.00,4,625.65,0,0,0,java.lang.Thread,0.00,4,1,9,0,4,4,0,6,144,2
"org.apache.http.impl.conn.ThreadSafeClientConnManager$TrackingPoolEntry",2,3.00,1.00,10,0.08,879.61,5,3,23,3,5,81.82,15,13,0,2,124.11,0.00,0.50,0.00,0,2.00,1,233.67,0,1,5,org.apache.http.impl.conn.AbstractPoolEntry,0.25,1,1,2,0,1,1,0,7,61,1
"org.apache.http.impl.conn.ThreadSafeClientConnManager$WaitingThread",0,0.00,0.00,4,0.03,300.83,3,3,23,0,0,171.00,10,5,0,1,171.00,0.00,0.00,0.00,0,0.00,0,85.95,0,0,0,java.lang.Object,0.00,0,0,0,0,0,0,0,3,22,2
"org.apache.http.impl.conn.Wire",13,0.92,2.00,65,0.76,27312.91,14,1,4,25,3,118.60,7,101,3,1,118.60,0.00,0.00,0.15,3,31.00,6,2274.34,0,0,0,java.lang.Object,0.00,12,0,26,0,12,13,0,1,483,1
"org.apache.http.examples.client.ClientExecuteDirect",5,0.12,1.60,50,0.64,24702.79,7,2,25,32,8,54.50,48,62,0,1,104.50,0.00,0.00,0.40,4,6.00,4,1928.19,0,3,8,java.lang.Object,0.00,27,0,8,0,27,2,0,21,369,1
"org.apache.http.examples.client.ClientExecuteProxy",5,0.00,1.60,55,0.79,32198.41,7,2,28,37,11,52.05,49,71,0,1,102.05,0.00,0.00,0.50,4,1.00,4,2378.11,0,3,11,java.lang.Object,0.00,32,0,8,0,32,2,0,22,436,1
"org.apache.http.examples.client.MethodAbort",1,0.00,2.00,26,0.50,20375.09,1,0,18,27,6,63.98,14,33,0,1,84.13,0.00,0.00,0.00,0,1.00,2,1501.12,0,0,6,java.lang.Object,0.00,26,0,2,0,26,1,0,7,246,1
"org.apache.http.conn.ssl.CertificatesToPlayWith",0,0.00,0.00,20,2.27,55234.06,19,19,0,1,2,171.00,53,347,2,1,171.00,0.00,0.00,0.00,0,0.00,0,6819.35,0,0,0,,0.00,1,0,0,0,1,0,0,13,846,1
"org.apache.http.conn.ssl.HostnameVerifier",4,0.00,1.00,12,0.13,3681.96,4,0,14,5,4,119.50,63,16,4,2,129.86,0.00,0.50,0.00,0,4.00,1,384.14,0,0,0,,0.00,1,1,4,0,1,4,0,5,97,1
"org.apache.http.conn.ssl.HostnameVerifier$AbstractVerifier",2,0.00,1.00,5,0.05,719.76,2,0,14,2,0,139.64,0,7,0,1,139.64,0.00,0.00,0.00,1,2.00,1,138.11,0,1,0,java.lang.Object,0.00,0,0,2,0,0,1,0,0,39,0
"org.apache.http.conn.ssl.HostnameVerifier$AbstractVerifier_0",2,0.00,1.00,5,0.05,719.76,2,0,14,2,0,139.64,0,7,0,1,139.64,0.00,0.00,0.00,1,2.00,1,138.11,0,1,0,java.lang.Object,0.00,0,0,2,0,0,1,0,0,39,0
"org.apache.http.conn.ssl.HostnameVerifier$AbstractVerifier_1",2,0.00,1.00,4,0.03,293.62,2,0,14,2,0,142.71,1,5,0,1,142.71,0.00,0.00,0.00,0,2.00,1,95.34,0,1,0,java.lang.Object,0.00,0,0,2,0,0,1,0,1,30,0
"org.apache.http.conn.ssl.HostnameVerifier$AbstractVerifier_2",0,0.00,0.00,121,2.08,310526.77,1,1,14,3,1,171.00,95,163,0,1,171.00,0.00,0.00,0.00,0,0.00,0,6241.19,0,0,1,java.lang.Object,0.00,3,0,0,0,3,0,1,34,878,1
"org.apache.http.conn.ssl.SSLSocketFactory",14,0.07,2.21,85,1.15,42353.12,21,7,21,33,8,66.27,121,156,6,1,114.38,0.00,0.00,0.08,2,74.00,8,3449.74,0,7,2,java.lang.Object,0.00,19,0,31,0,19,7,1,19,696,1
"org.apache.http.conn.ssl.TestAllSSL",3,0.00,1.00,11,0.10,2271.14,3,0,3,9,4,130.53,0,15,2,2,130.53,0.00,0.50,0.00,0,3.00,1,310.03,0,1,2,junit.framework.TestCase,0.00,6,1,3,0,6,2,0,0,81,1
"org.apache.http.conn.ssl.TestHostnameVerifier",5,0.00,1.20,122,1.53,172084.26,5,0,8,14,4,51.53,30,133,2,2,83.75,0.00,0.50,0.00,1,8.00,2,4601.63,0,1,2,junit.framework.TestCase,0.00,9,1,6,0,9,4,1,19,845,1
"org.apache.http.conn.ssl.TestSSLSocketFactory",12,0.00,1.17,81,1.28,40831.39,12,0,22,57,5,164.13,13,106,2,2,114.13,0.00,0.50,0.00,2,22.00,3,3854.01,0,1,3,junit.framework.TestCase,0.00,45,1,14,0,45,11,1,8,644,1
"org.apache.http.conn.ssl.TestSSLSocketFactory$Runnable",1,0.00,2.00,14,0.16,3837.04,1,0,22,10,0,99.86,0,18,0,1,99.86,0.00,0.00,0.00,0,1.00,2,471.64,0,0,0,java.lang.Object,0.00,9,0,2,0,9,1,0,0,93,0
"org.apache.http.conn.params.HttpConnectionManagerParams",6,0.10,2.50,42,0.52,18384.19,10,4,4,16,3,101.45,90,81,2,1,111.81,0.00,0.00,0.17,2,14.00,5,1553.27,0,0,1,java.lang.Object,0.00,10,0,15,0,10,6,0,17,324,2
"org.apache.http.client.ClientRequestDirector",2,0.00,1.00,3,0.02,80.08,2,0,5,2,4,206.21,55,6,2,1,158.38,0.00,0.00,0.00,0,2.00,1,56.05,0,2,2,,0.00,0,0,2,0,0,0,0,3,20,1
"org.apache.http.client.HttpClient",6,0.00,1.00,7,0.05,225.32,6,0,8,6,5,148.24,91,17,3,1,158.60,0.00,0.00,0.00,0,6.00,1,158.21,0,6,2,,0.00,0,0,6,0,0,0,0,7,52,1
"org.apache.http.client.HttpState",15,0.17,2.07,82,0.81,23989.92,18,3,6,37,4,71.05,154,110,1,1,119.53,0.00,0.00,0.18,6,61.00,5,2420.59,0,5,3,java.lang.Object,0.00,22,0,31,0,22,10,0,26,543,1
"org.apache.http.client.RoutedRequest",2,0.00,1.00,4,0.02,178.00,2,0,2,2,8,106.86,25,6,7,1,144.42,0.00,0.00,0.00,0,2.00,1,52.00,0,2,1,,0.00,0,0,2,0,0,0,0,5,20,1
"org.apache.http.client.RoutedRequest$Impl",3,0.25,1.00,10,0.07,774.64,5,2,2,3,2,174.09,8,14,0,1,134.21,0.00,0.00,0.33,0,5.00,1,205.55,0,2,2,java.lang.Object,0.00,0,0,3,0,0,1,1,3,57,2
"org.apache.http.client.TestAll",3,0.00,1.00,15,0.16,4890.67,3,0,8,13,7,119.63,0,19,1,2,119.63,0.00,0.50,0.00,0,3.00,1,474.55,0,1,6,junit.framework.TestCase,0.00,10,1,3,0,10,2,0,0,117,1
"org.apache.http.client.TestHttpState",16,0.06,1.00,111,1.66,65818.84,22,6,4,30,6,163.51,18,151,2,2,113.51,0.00,0.50,0.22,0,86.00,1,4967.90,0,1,4,junit.framework.TestCase,0.00,14,1,16,0,14,15,0,7,1048,1
"org.apache.http.mockup.HttpConnectionMockup",7,1.00,1.00,15,0.09,785.18,8,1,2,7,0,143.63,5,23,0,1,143.63,0.00,0.00,0.00,0,7.00,1,261.78,0,0,0,java.lang.Object,0.00,0,0,7,0,0,7,1,1,79,1
"org.apache.http.impl.auth.BasicScheme",7,1.00,1.86,39,0.46,17008.74,8,1,11,19,7,69.65,75,59,1,2,118.12,0.00,0.50,0.00,1,7.00,5,1370.31,1,3,6,org.apache.http.impl.auth.RFC2617Scheme,0.00,12,1,13,0,12,4,0,9,276,1
"org.apache.http.impl.auth.DigestScheme",12,0.05,3.33,191,2.77,185499.95,20,8,15,48,8,49.74,134,240,1,2,93.86,0.00,0.50,0.17,5,38.00,8,8317.38,4,8,7,org.apache.http.impl.auth.RFC2617Scheme,0.00,36,1,40,0,36,4,0,31,1432,1
"org.apache.http.impl.auth.RFC2617Scheme",6,2.00,3.00,58,0.76,57257.86,8,2,11,26,6,53.81,56,73,3,1,103.81,0.00,0.00,0.00,1,6.00,11,2294.58,0,3,3,java.lang.Object,0.00,20,0,18,3,20,3,1,9,409,2
"org.apache.http.impl.auth.TestAllAuthImpl",3,0.00,1.00,12,0.12,2866.67,3,0,3,10,4,125.07,0,16,1,2,125.07,0.00,0.50,0.00,0,3.00,1,349.20,0,1,3,junit.framework.TestCase,0.00,7,1,3,0,7,2,0,0,90,1
"org.apache.http.impl.auth.TestBasicScheme",7,0.00,1.29,53,0.75,15143.01,7,0,14,32,7,163.15,11,65,2,2,113.15,0.00,0.50,0.00,0,7.00,2,2256.49,0,1,5,junit.framework.TestCase,0.00,25,1,9,0,25,6,0,5,432,1
"org.apache.http.impl.auth.TestDigestScheme",14,0.00,1.36,164,2.51,65819.88,14,0,16,39,8,143.05,30,199,2,2,103.17,0.00,0.50,0.00,1,14.00,3,7538.01,0,2,6,junit.framework.TestCase,0.00,25,1,19,0,25,12,0,18,1345,1
"org.apache.http.impl.auth.TestRFC2617Scheme",7,0.00,1.43,42,0.46,8497.04,7,0,12,18,6,117.60,5,58,2,2,117.60,0.00,0.50,0.00,0,7.00,2,1393.78,0,1,4,junit.framework.TestCase,0.00,11,1,10,0,11,6,0,5,301,1
"org.apache.http.impl.auth.TestRFC2617Scheme$TestAuthScheme",4,0.00,1.00,9,0.05,429.81,4,0,12,4,3,143.78,0,16,0,2,143.78,0.00,0.50,0.00,0,4.00,1,150.02,0,2,3,org.apache.http.impl.auth.RFC2617Scheme,0.00,0,1,4,0,0,2,0,0,46,1
"org.apache.http.impl.auth.UnsupportedDigestAlgorithmException",3,1.00,1.00,8,0.05,483.35,4,1,0,3,1,100.10,23,12,1,2,142.39,0.00,0.50,0.00,0,3.00,1,148.39,0,0,0,java.lang.RuntimeException,0.00,0,1,3,0,0,3,0,4,45,1
"org.apache.http.impl.client.AbstractHttpClient",11,0.07,1.73,41,0.42,9360.70,17,6,14,13,5,80.01,99,74,1,1,130.00,0.00,0.00,0.23,2,33.00,5,1261.29,0,7,4,java.lang.Object,0.00,2,0,19,1,2,4,1,24,289,2
"org.apache.http.impl.client.DefaultClientRequestDirector",11,0.06,2.45,93,1.25,50332.00,16,5,20,42,9,117.41,193,161,1,1,108.28,0.00,0.00,0.25,8,0.00,7,3759.11,0,5,8,java.lang.Object,0.00,31,0,27,0,31,6,1,85,725,1
"org.apache.http.impl.client.DefaultHttpClient",6,0.00,1.83,32,0.36,8847.71,6,0,17,20,11,69.84,58,54,3,2,119.83,0.00,0.50,0.00,1,18.00,5,1072.10,0,5,8,org.apache.http.impl.client.AbstractHttpClient,0.00,14,1,11,0,14,1,0,21,235,1
"org.apache.http.impl.client.TestAllHttpClientImpl",3,0.00,1.00,9,0.08,1319.19,3,0,3,6,2,132.39,0,13,2,2,132.39,0.00,0.50,0.00,0,3.00,1,232.55,0,1,0,junit.framework.TestCase,0.00,3,1,3,0,3,2,0,0,63,1
"org.apache.http.conn.BasicEofSensorWatcher",4,0.50,1.75,24,0.18,2892.32,6,2,2,9,2,87.11,27,40,0,1,119.33,0.00,0.00,0.88,0,0.00,2,545.93,0,0,2,java.lang.Object,0.00,5,0,7,0,5,4,1,11,130,1
"org.apache.http.conn.BasicManagedEntity",10,0.06,1.80,49,0.39,7474.53,12,2,4,18,5,126.01,47,87,1,2,125.78,0.00,0.50,0.55,2,0.00,3,1163.31,0,1,4,org.apache.http.entity.HttpEntityWrapper,0.00,8,1,18,0,8,9,3,18,276,1
"org.apache.http.conn.ClientConnectionManager",5,0.00,1.00,6,0.03,119.36,5,0,0,5,13,116.02,59,13,10,1,160.15,0.00,0.00,0.00,0,5.00,1,97.75,0,2,3,,0.00,0,0,5,0,0,3,0,6,37,1
"org.apache.http.conn.ClientConnectionOperator",3,0.00,1.00,4,0.05,198.95,3,0,5,3,8,165.79,51,17,7,1,156.65,0.00,0.00,0.00,0,3.00,1,135.30,0,1,1,,0.00,0,0,3,0,0,2,0,4,39,1
"org.apache.http.conn.ConnectTimeoutException",2,1.00,1.00,6,0.04,402.15,3,1,1,2,2,86.96,16,9,2,2,135.06,1.00,0.33,0.00,0,2.00,1,110.07,0,0,0,java.io.InterruptedIOException,0.00,0,1,2,1,0,2,0,3,33,1
"org.apache.http.conn.ConnectionPoolTimeoutException",2,1.00,1.00,6,0.04,423.74,3,1,0,2,3,86.78,16,9,2,3,134.89,0.00,0.67,0.00,0,2.00,1,110.60,0,0,1,org.apache.http.conn.ConnectTimeoutException,0.00,0,2,2,0,0,2,0,3,33,1
"org.apache.http.conn.ConnectionReleaseTrigger",2,0.00,1.00,3,0.01,61.53,2,0,1,2,4,177.42,37,7,4,1,159.28,0.00,0.00,0.00,0,2.00,1,41.02,0,0,0,,0.00,0,0,2,0,0,2,0,3,17,1
"org.apache.http.conn.EofSensorInputStream",12,0.15,2.25,66,0.58,14254.54,15,3,2,20,3,72.05,126,103,1,2,120.53,0.00,0.50,0.47,5,0.00,4,1749.78,0,0,2,java.io.InputStream,0.00,8,1,27,0,8,12,1,25,406,1
"org.apache.http.conn.EofSensorWatcher",3,0.00,1.00,4,0.03,123.00,3,0,2,3,3,176.43,55,10,3,1,158.30,0.00,0.00,0.00,0,3.00,1,82.00,0,0,0,,0.00,0,0,3,0,0,3,0,4,29,1
"org.apache.http.conn.HostConfiguration",8,4.00,1.75,48,0.51,17889.30,12,4,3,16,6,67.36,65,67,6,1,115.47,0.00,0.00,0.00,0,8.00,4,1544.28,0,4,0,java.lang.Object,0.00,8,0,14,0,8,4,1,14,351,1
"org.apache.http.conn.HttpRoute",13,0.15,2.15,72,0.92,41510.42,19,6,3,20,18,67.16,124,115,17,1,117.16,0.00,0.00,0.03,2,24.00,6,2762.93,0,5,1,java.lang.Object,0.00,7,0,28,0,7,8,1,20,599,2
"org.apache.http.conn.ManagedClientConnection",8,0.00,1.00,9,0.06,258.19,8,0,5,8,10,121.56,102,21,9,4,159.12,0.00,0.75,0.00,0,8.00,1,176.46,0,0,1,,0.00,0,3,8,0,0,8,0,9,61,1
"org.apache.http.conn.OperatedClientConnection",6,0.00,1.00,7,0.06,244.34,6,0,6,6,10,176.46,109,18,10,3,158.32,0.00,0.67,0.00,0,6.00,1,168.57,0,2,0,,0.00,0,2,6,0,0,4,0,9,54,1
"org.apache.http.conn.PlainSocketFactory",7,1.00,2.14,34,0.38,15907.26,8,1,6,17,11,79.64,54,57,10,1,121.93,0.00,0.00,0.14,0,12.00,6,1140.74,0,3,1,java.lang.Object,0.00,10,0,15,0,10,4,1,19,244,2
"org.apache.http.conn.RouteDirector",4,0.28,4.25,28,0.49,18056.11,10,6,0,12,2,109.89,66,51,1,1,110.36,0.00,0.00,0.38,0,0.00,7,1463.06,0,0,1,java.lang.Object,0.00,8,0,17,0,8,4,0,22,319,1
"org.apache.http.conn.RouteTracker",18,0.13,2.11,90,1.12,46472.51,25,7,3,29,4,69.78,147,142,2,1,117.89,0.00,0.00,0.02,2,34.00,7,3362.53,0,6,2,java.lang.Object,0.00,11,0,38,0,11,12,1,30,734,2
"org.apache.http.conn.Scheme",9,0.02,1.89,48,0.54,18358.56,14,5,2,18,14,68.72,86,70,13,1,118.72,0.00,0.00,0.22,0,34.00,4,1633.52,0,3,1,java.lang.Object,0.00,9,0,17,0,9,6,0,16,367,2
"org.apache.http.conn.SchemeRegistry",7,0.17,1.71,29,0.32,8651.15,9,2,5,18,15,79.94,80,43,14,1,124.07,0.00,0.00,0.36,2,0.00,2,948.84,0,1,1,java.lang.Object,0.00,11,0,12,0,11,6,0,14,221,2
"org.apache.http.conn.SecureSocketFactory",1,0.00,1.00,2,0.03,129.64,1,0,3,1,2,193.13,25,8,2,2,143.13,0.00,0.50,0.00,0,1.00,1,75.21,0,1,0,,0.00,0,1,1,0,0,0,0,2,22,1
"org.apache.http.conn.SocketFactory",3,0.00,1.00,4,0.04,216.04,3,0,5,3,11,206.37,75,16,10,1,156.37,0.00,0.00,0.00,0,3.00,1,132.91,0,2,1,,0.00,0,0,3,0,0,1,0,4,39,1
"org.apache.http.conn.TestScheme",11,0.00,2.45,116,1.54,57591.62,11,0,6,42,5,154.21,19,172,1,2,104.21,0.00,0.50,0.00,0,11.00,7,4629.11,0,1,4,junit.framework.TestCase,0.00,31,1,27,0,31,10,0,14,935,1
"org.apache.http.auth.AuthScheme",7,0.00,1.00,8,0.04,190.08,7,0,2,7,7,122.15,86,10,4,1,159.71,0.00,0.00,0.00,0,7.00,1,121.84,0,4,3,,0.00,0,0,7,0,0,3,0,8,47,1
"org.apache.http.auth.AuthSchemeFactory",1,0.00,1.00,2,0.01,30.51,1,0,1,1,2,115.86,6,3,1,1,148.08,0.00,0.00,0.00,0,1.00,1,25.51,0,1,1,,0.00,0,0,1,0,0,0,0,1,11,1
"org.apache.http.auth.AuthSchemeRegistry",4,0.00,2.25,23,0.27,7664.77,6,2,5,15,2,74.76,47,36,0,1,118.89,0.00,0.00,0.50,0,0.00,3,820.27,0,2,2,java.lang.Object,0.00,11,0,9,0,11,2,0,5,180,2
"org.apache.http.auth.AuthScope",12,0.01,2.67,92,1.13,52120.62,21,9,1,25,3,62.13,123,127,3,1,110.60,0.00,0.00,0.10,0,28.00,9,3386.53,1,4,0,java.lang.Object,0.00,13,0,32,0,13,8,0,22,724,1
"org.apache.http.auth.AuthenticationException",3,1.00,1.00,8,0.05,538.90,4,1,1,3,6,99.73,22,12,6,2,142.02,1.00,0.33,0.00,0,3.00,1,153.79,0,0,0,org.apache.http.ProtocolException,0.00,0,1,3,1,0,3,0,4,46,1
"org.apache.http.auth.Credentials",2,0.00,1.00,3,0.01,31.00,2,0,0,2,9,161.86,8,4,9,1,161.63,0.00,0.00,0.00,0,2.00,1,26.00,0,2,0,,0.00,0,0,2,0,0,0,0,1,13,1
"org.apache.http.auth.HTTPAuth",1,4.00,1.00,6,0.06,774.52,5,4,0,1,6,145.51,19,8,6,1,119.22,0.00,0.00,0.00,0,1.00,1,175.59,0,0,0,java.lang.Object,0.00,0,0,1,0,0,1,0,5,45,2
"org.apache.http.auth.InvalidCredentialsException",3,1.00,1.00,8,0.05,538.90,4,1,0,3,1,99.73,23,12,0,3,142.02,0.00,0.67,0.00,0,3.00,1,153.79,0,0,1,org.apache.http.auth.AuthenticationException,0.00,0,2,3,0,0,3,0,4,46,1
"org.apache.http.auth.MalformedChallengeException",3,1.00,1.00,8,0.05,483.35,4,1,1,3,7,100.10,23,12,7,2,142.39,0.00,0.50,0.00,0,3.00,1,148.39,0,0,0,org.apache.http.ProtocolException,0.00,0,1,3,0,0,3,0,4,45,1
"org.apache.http.auth.UsernamePasswordCredentials",8,0.43,2.00,44,0.44,13083.42,10,2,1,18,5,71.36,64,59,4,1,119.46,0.00,0.00,0.12,1,20.00,5,1310.14,0,4,1,java.lang.Object,0.00,10,0,16,0,10,4,1,15,303,1
"org.apache.http.client.utils.URLUtils",3,1.00,3.00,25,0.32,16181.27,4,1,4,11,1,125.81,56,38,1,1,107.67,0.00,0.00,0.33,1,4.00,5,948.18,0,2,0,java.lang.Object,0.00,8,0,9,0,8,1,0,6,189,1
"org.apache.http.auth.params.AuthParams",3,0.50,2.00,15,0.14,3537.90,4,1,2,6,2,70.58,29,22,2,1,120.58,0.00,0.00,0.67,0,1.00,3,423.03,0,1,0,java.lang.Object,0.00,3,0,6,0,3,2,0,4,99,2
"org.apache.http.client.methods.AbortableHttpRequest",2,0.00,1.00,3,0.01,38.51,2,0,1,2,3,143.01,11,4,2,1,160.88,0.00,0.00,0.00,0,2.00,1,33.51,0,0,1,,0.00,0,0,2,0,0,2,0,1,15,1
"org.apache.http.client.methods.HttpEntityEnclosingRequestBase",4,1.00,1.00,11,0.10,1352.80,5,1,4,7,3,179.74,9,17,2,3,139.85,1.00,0.40,0.00,0,4.00,1,288.27,0,1,1,org.apache.http.client.methods.HttpRequestBase,0.00,3,2,4,2,3,3,1,1,76,1
"org.apache.http.client.methods.HttpGet",4,1.00,1.00,12,0.07,747.10,5,1,2,5,3,117.44,21,17,2,3,135.32,0.00,0.67,0.25,0,6.00,1,216.45,1,1,1,org.apache.http.client.methods.HttpRequestBase,0.25,1,2,4,0,1,3,0,1,63,1
"org.apache.http.client.methods.HttpHead",4,1.00,1.00,12,0.07,747.10,5,1,2,5,1,117.44,21,17,0,3,135.32,0.00,0.67,0.25,0,6.00,1,216.45,1,1,1,org.apache.http.client.methods.HttpRequestBase,0.25,1,2,4,0,1,3,0,1,63,1
"org.apache.http.client.methods.HttpOptions",5,1.00,1.60,26,0.23,6904.57,6,1,8,12,1,140.71,19,32,0,3,120.09,0.00,0.67,0.20,0,8.00,4,690.10,1,2,1,org.apache.http.client.methods.HttpRequestBase,0.23,7,2,8,0,7,3,0,1,152,1
"org.apache.http.client.methods.HttpPost",4,1.00,1.00,12,0.07,747.10,5,1,2,5,2,103.09,25,17,1,4,135.32,0.00,0.75,0.25,0,6.00,1,216.45,1,1,1,org.apache.http.client.methods.HttpEntityEnclosingRequestBase,0.25,1,3,4,0,1,3,0,1,63,1
"org.apache.http.client.methods.HttpPut",4,1.00,1.00,12,0.07,747.10,5,1,2,5,1,135.55,17,17,0,4,135.32,0.00,0.75,0.25,0,6.00,1,216.45,1,1,1,org.apache.http.client.methods.HttpEntityEnclosingRequestBase,0.25,1,3,4,0,1,3,0,1,63,1
"org.apache.http.client.methods.HttpRequestBase",8,2.00,1.38,28,0.22,3753.31,10,2,9,13,7,182.09,10,41,5,2,132.09,7.00,0.11,0.00,3,8.00,3,648.78,0,4,2,org.apache.http.message.AbstractHttpMessage,0.00,5,1,11,7,5,4,2,2,163,1
"org.apache.http.client.methods.HttpTrace",4,1.00,1.00,12,0.07,747.10,5,1,2,5,1,117.44,20,17,0,3,135.32,0.00,0.67,0.25,0,6.00,1,216.45,1,1,1,org.apache.http.client.methods.HttpRequestBase,0.25,1,2,4,0,1,3,0,1,63,1
"org.apache.http.client.methods.UrlEncodedFormEntity",8,0.50,1.12,26,0.25,3807.34,10,2,12,16,1,132.09,1,39,0,2,132.09,0.00,0.50,0.06,0,14.00,2,756.69,0,2,1,org.apache.http.entity.AbstractHttpEntity,0.00,8,1,9,0,8,6,0,1,183,1
"org.apache.http.cookie.params.CookieSpecParams",2,0.14,2.50,19,0.22,4409.03,9,7,1,5,4,158.86,50,25,4,1,108.87,0.00,0.00,0.21,0,0.00,3,645.71,0,1,0,java.lang.Object,0.00,3,0,5,0,3,1,0,9,142,2
"org.apache.http.localserver.EchoHandler",1,0.00,4.00,17,0.30,13378.02,1,0,12,15,1,142.28,25,29,1,1,92.29,0.00,0.00,0.00,0,1.00,4,909.67,0,0,0,java.lang.Object,0.00,14,0,4,0,14,1,1,6,158,1
"org.apache.http.localserver.LocalTestServer",11,0.06,1.73,63,0.72,17173.78,18,7,27,46,4,71.55,94,96,2,1,119.65,0.00,0.00,0.19,1,40.00,4,2159.94,0,3,2,java.lang.Object,0.00,35,0,19,0,35,8,0,24,473,1
"org.apache.http.localserver.LocalTestServer$RequestListener",3,0.50,2.67,32,0.41,11282.01,4,1,27,23,1,125.93,11,50,0,1,105.32,0.00,0.00,0.67,2,0.00,4,1226.12,0,0,1,java.lang.Object,0.00,20,0,8,0,20,3,1,9,246,1
"org.apache.http.localserver.LocalTestServer$RequestListener$Worker",2,2.00,3.00,14,0.19,5019.28,4,2,27,6,0,162.45,2,26,0,1,112.45,0.00,0.00,0.00,0,2.00,5,566.78,0,0,0,java.lang.Object,0.00,4,0,6,0,4,2,1,2,121,1
"org.apache.http.localserver.RandomHandler",1,0.00,7.00,28,0.51,30094.73,1,0,12,22,1,88.57,35,43,1,1,81.30,0.00,0.00,0.00,0,1.00,7,1523.94,0,0,0,java.lang.Object,0.00,21,0,7,0,21,1,1,8,250,1
"org.apache.http.localserver.RandomHandler$RandomEntity",6,0.20,1.83,41,0.43,24481.62,8,2,12,13,0,81.18,40,57,0,2,113.40,0.00,0.50,0.33,0,6.00,4,1301.88,0,1,0,org.apache.http.entity.AbstractHttpEntity,0.00,7,1,11,0,7,5,0,12,270,2
"org.apache.http.localserver.ServerTestBase",6,0.13,2.00,46,0.56,12259.03,12,6,17,38,5,69.12,68,68,0,2,113.25,1.00,0.33,0.28,1,6.00,7,1667.38,0,3,5,junit.framework.TestCase,0.00,32,1,12,1,32,3,0,14,332,2
