Name, No. Methods, LCOM, AVCC, NOS, HBUG, HEFF, UWCS, INST, PACK, RFC, CBO, MI, CCML, NLOC, F-IN, DIT, MINC, S-R, R-R, COH, LMC, LCOM2, MAXCC, HVOL, HIER, NQU, FOUT, Superclass, SIX, EXT, NSUP, TCC, NSUB, MPC, NCO, INTR, CCOM, HLTH, MOD
"org.apache.http.cookie.ClientCookie",2,10.00,1.00,13,0.17,2680.92,12,10,0,2,12,75.06,15,14,12,2,117.35,0.00,0.50,0.00,0,2.00,1,505.04,0,1,0,,0.00,0,1,2,0,0,1,0,3,108,1
"org.apache.http.cookie.Cookie",12,0.00,1.00,13,0.04,141.89,12,0,1,12,35,130.33,76,14,35,1,162.55,0.00,0.00,0.00,0,12.00,1,121.26,0,7,0,,0.00,0,0,12,0,0,5,0,13,57,1
"org.apache.http.cookie.CookieAttributeHandler",3,0.00,1.00,4,0.03,138.66,3,0,0,3,21,113.76,35,7,17,1,157.89,0.00,0.00,0.00,0,3.00,1,100.44,0,0,4,,0.00,0,0,3,0,0,3,0,4,33,1
"org.apache.http.cookie.CookieIdentityComparator",1,0.00,4.00,14,0.16,5262.30,1,0,1,5,2,54.50,11,19,1,1,98.62,0.00,0.00,0.00,0,1.00,4,467.30,0,0,1,java.lang.Object,0.00,4,0,4,0,4,1,1,2,99,1
"org.apache.http.cookie.CookieOrigin",6,4.00,2.00,41,0.41,14747.31,10,4,1,14,32,165.11,8,57,32,1,115.11,0.00,0.00,0.00,0,6.00,6,1220.79,0,3,0,java.lang.Object,0.00,8,0,12,0,8,3,0,1,265,2
"org.apache.http.cookie.CookiePathComparator",2,0.00,3.50,21,0.20,7055.58,2,0,1,6,3,63.18,15,27,2,1,105.47,0.00,0.00,0.00,1,2.00,4,589.16,0,1,1,java.lang.Object,0.00,4,0,7,0,4,1,1,2,130,1
"org.apache.http.cookie.CookieSpec",6,0.00,1.00,7,0.05,214.62,6,0,1,6,16,110.29,63,8,13,1,158.77,0.00,0.00,0.00,0,6.00,1,143.73,0,2,3,,0.00,0,0,6,0,0,4,0,7,50,1
"org.apache.http.cookie.CookieSpecFactory",1,0.00,1.00,2,0.01,30.51,1,0,1,1,6,115.86,6,3,5,1,148.08,0.00,0.00,0.00,0,1.00,1,25.51,0,1,1,,0.00,0,0,1,0,0,0,0,1,11,1
"org.apache.http.cookie.CookieSpecRegistry",6,0.40,1.83,27,0.29,7591.73,7,1,5,16,6,73.97,55,41,4,1,123.97,0.00,0.00,0.67,1,0.00,3,872.06,0,3,2,java.lang.Object,0.00,10,0,11,0,10,3,0,6,197,2
"org.apache.http.cookie.MalformedCookieException",3,1.00,1.00,8,0.05,538.90,4,1,1,3,33,99.73,23,12,33,2,142.02,0.00,0.50,0.00,0,3.00,1,153.79,0,0,0,org.apache.http.ProtocolException,0.00,0,1,3,0,0,3,0,4,46,1
"org.apache.http.cookie.SM",0,0.00,0.00,5,0.05,743.92,4,4,0,0,7,171.00,7,6,7,1,171.00,0.00,0.00,0.00,0,0.00,0,163.50,0,0,0,,0.00,0,0,0,0,0,0,0,1,40,1
"org.apache.http.cookie.SetCookie",7,0.00,1.00,8,0.04,144.76,7,0,1,7,17,112.54,62,9,17,2,160.64,0.00,0.50,0.00,0,7.00,1,126.66,0,0,0,,0.00,0,1,7,0,0,7,0,7,49,1
"org.apache.http.cookie.SetCookie2",3,0.00,1.00,4,0.02,96.69,3,0,0,3,6,116.83,23,5,6,2,159.12,0.00,0.50,0.00,0,3.00,1,68.77,0,0,0,,0.00,0,1,3,0,0,3,0,4,26,1
"org.apache.http.cookie.TestAllCookie",3,0.00,1.00,12,0.12,2866.67,3,0,3,10,5,125.07,0,16,2,2,125.07,0.00,0.50,0.00,0,3.00,1,349.20,0,1,3,junit.framework.TestCase,0.00,7,1,3,0,7,2,0,0,90,1
"org.apache.http.cookie.TestCookieOrigin",8,0.00,1.50,29,0.28,3934.85,8,0,3,16,3,181.91,9,46,2,2,131.91,0.00,0.50,0.00,0,8.00,2,839.18,0,1,1,junit.framework.TestCase,0.00,8,1,12,0,8,7,0,7,205,1
"org.apache.http.cookie.TestCookiePathComparator",8,0.00,1.00,53,0.62,15666.30,8,0,5,14,4,116.05,5,62,2,2,116.05,0.00,0.50,0.00,0,8.00,1,1861.55,0,1,2,junit.framework.TestCase,0.00,6,1,8,0,6,7,0,3,414,1
"org.apache.http.cookie.TestCookiePolicy",5,0.08,2.20,64,0.73,25368.64,8,3,9,21,6,141.27,11,90,2,2,101.38,0.00,0.50,0.40,0,7.00,5,2190.40,0,1,4,junit.framework.TestCase,0.00,16,1,11,0,16,4,0,9,460,1
"org.apache.http.impl.cookie.AbstractCookieAttributeHandler",2,0.00,1.00,4,0.04,321.06,2,0,4,2,9,192.40,2,8,5,1,142.40,0.00,0.00,0.00,0,2.00,1,118.06,0,0,4,java.lang.Object,0.00,0,0,2,5,0,2,1,2,34,2
"org.apache.http.impl.cookie.AbstractCookieSpec",5,1.00,1.60,21,0.20,3933.52,6,1,5,12,5,93.41,31,32,3,1,125.63,0.00,0.00,0.00,1,5.00,3,597.40,0,3,2,java.lang.Object,0.00,7,0,8,6,7,2,1,5,144,2
"org.apache.http.impl.cookie.BasicClientCookie",24,0.05,1.12,87,0.72,17984.29,33,9,6,34,13,88.25,168,116,11,1,130.54,0.00,0.00,0.06,0,288.00,2,2171.52,0,9,2,java.lang.Object,0.00,10,0,27,1,10,15,2,31,529,1
"org.apache.http.impl.cookie.BasicClientCookie2",8,3.00,1.00,20,0.17,2236.16,11,3,2,8,4,190.51,13,29,2,2,140.51,0.00,0.50,0.00,0,8.00,1,503.31,2,1,2,org.apache.http.impl.cookie.BasicClientCookie,0.19,0,1,8,0,0,7,1,2,137,1
"org.apache.http.impl.cookie.BasicCommentHandler",2,0.00,1.50,7,0.06,1034.91,2,0,2,4,7,131.74,0,12,4,2,131.74,0.00,0.50,0.00,0,2.00,2,171.85,0,0,3,org.apache.http.impl.cookie.AbstractCookieAttributeHandler,0.00,2,1,3,0,2,2,0,0,44,1
"org.apache.http.impl.cookie.BasicDomainHandler",4,0.00,5.00,43,0.56,24047.16,4,0,5,17,8,143.45,8,70,3,1,103.57,0.00,0.00,0.00,0,4.00,9,1694.20,0,0,5,java.lang.Object,0.00,13,0,20,1,13,4,1,8,328,1
"org.apache.http.impl.cookie.BasicExpiresHandler",2,1.00,3.00,14,0.16,4394.70,3,1,2,6,9,112.91,1,24,4,2,112.91,0.00,0.50,0.00,0,2.00,4,484.94,0,0,5,org.apache.http.impl.cookie.AbstractCookieAttributeHandler,0.00,4,1,6,0,4,2,0,1,104,1
"org.apache.http.impl.cookie.BasicMaxAgeHandler",2,0.00,3.00,15,0.18,6546.40,2,0,3,8,7,111.54,0,26,4,2,111.54,0.00,0.50,0.00,0,2.00,5,535.09,0,0,3,org.apache.http.impl.cookie.AbstractCookieAttributeHandler,0.00,6,1,6,0,6,2,0,0,106,1
"org.apache.http.impl.cookie.BasicPathHandler",4,0.00,3.25,28,0.40,20134.46,4,0,5,16,9,110.05,2,46,4,1,110.05,0.00,0.00,0.00,0,4.00,7,1196.90,0,0,5,java.lang.Object,0.00,12,0,13,0,12,4,1,2,242,1
"org.apache.http.impl.cookie.BasicSecureHandler",3,0.00,2.33,13,0.13,3261.09,3,0,4,7,9,124.44,0,21,4,2,124.44,0.00,0.50,0.00,0,3.00,4,396.74,0,0,5,org.apache.http.impl.cookie.AbstractCookieAttributeHandler,0.00,4,1,7,0,4,3,0,0,92,1
"org.apache.http.impl.cookie.BrowserCompatSpec",6,0.50,3.00,64,0.84,41683.10,8,2,10,29,16,143.08,13,98,2,3,103.19,0.00,0.67,0.08,1,10.00,7,2527.78,1,3,14,org.apache.http.impl.cookie.CookieSpecBase,0.00,23,2,18,0,23,3,0,5,470,1
"org.apache.http.impl.cookie.BrowserCompatSpecFactory",1,0.00,2.00,6,0.06,1283.23,1,0,4,3,6,85.12,6,10,2,1,117.34,0.00,0.00,0.00,0,1.00,2,176.05,0,1,4,java.lang.Object,0.00,2,0,2,0,2,0,1,1,42,1
"org.apache.http.impl.cookie.CookieSpecBase",5,0.00,3.60,62,0.73,40293.54,5,0,7,26,9,149.69,9,71,3,2,99.69,4.00,0.17,0.00,2,5.00,5,2202.21,1,3,6,org.apache.http.impl.cookie.AbstractCookieSpec,0.00,21,1,18,4,21,2,0,3,414,2
"org.apache.http.impl.cookie.DateParseException",2,1.00,1.00,6,0.03,318.41,3,1,0,2,4,103.64,13,9,4,2,135.86,0.00,0.50,0.00,0,2.00,1,99.90,0,0,0,java.lang.Exception,0.00,0,1,2,0,0,2,0,3,31,1
"org.apache.http.impl.cookie.DateUtils",6,0.10,2.33,44,0.59,25833.60,12,6,9,17,8,90.52,86,66,7,1,110.66,0.00,0.00,0.08,2,14.00,7,1755.78,0,5,1,java.lang.Object,0.00,11,0,14,0,11,1,0,15,359,2
"org.apache.http.impl.cookie.DateUtils$DateFormatHolder",1,0.00,3.00,15,0.18,6022.81,1,0,9,12,0,59.55,12,20,0,1,97.11,0.00,0.00,0.00,0,1.00,3,540.94,0,1,0,java.lang.Object,0.00,11,0,3,0,11,0,0,1,113,2
"org.apache.http.impl.cookie.DateUtils$DateFormatHolder$ThreadLocal",1,0.00,1.00,3,0.02,141.56,1,0,9,3,0,136.26,0,4,0,1,136.26,0.00,0.00,0.00,0,1.00,1,51.19,0,1,0,java.lang.Object,0.00,2,0,1,0,2,0,0,0,17,0
"org.apache.http.impl.cookie.NetscapeDomainHandler",4,0.00,3.00,30,0.40,12934.01,4,0,4,13,6,161.59,7,55,2,2,111.59,0.00,0.50,0.00,1,4.00,5,1208.65,1,0,4,org.apache.http.impl.cookie.BasicDomainHandler,0.00,9,1,12,0,9,4,0,2,246,1
"org.apache.http.impl.cookie.NetscapeDraftSpec",5,0.00,2.40,42,0.49,21889.48,5,0,10,19,14,60.33,42,53,2,3,108.44,0.00,0.67,0.00,1,5.00,6,1456.56,1,3,12,org.apache.http.impl.cookie.CookieSpecBase,0.00,14,2,12,0,14,2,0,3,291,1
"org.apache.http.impl.cookie.NetscapeDraftSpecFactory",1,0.00,1.00,3,0.02,194.14,1,0,3,2,5,102.96,6,5,2,1,135.18,0.00,0.00,0.00,0,1.00,1,62.11,0,1,3,java.lang.Object,0.00,1,0,1,0,1,0,1,1,19,1
"org.apache.http.impl.cookie.RFC2109DomainHandler",4,0.00,4.75,45,0.68,35859.66,4,0,5,18,7,100.67,3,78,2,1,100.67,0.00,0.00,0.00,0,4.00,10,2044.13,0,0,5,java.lang.Object,0.00,14,0,19,0,14,4,1,3,379,1
"org.apache.http.impl.cookie.RFC2109Spec",11,0.22,2.73,109,1.33,51380.96,15,4,11,36,18,126.89,34,142,3,3,106.28,0.50,0.50,0.05,5,29.00,5,3978.13,2,5,15,org.apache.http.impl.cookie.CookieSpecBase,0.00,25,2,30,1,25,6,0,6,797,1
"org.apache.http.impl.cookie.RFC2109SpecFactory",1,0.00,2.00,6,0.07,1728.53,1,0,4,4,6,84.10,6,11,2,1,116.32,0.00,0.00,0.00,0,1.00,2,219.84,0,1,4,java.lang.Object,0.00,3,0,2,0,3,0,1,1,50,1
"org.apache.http.impl.cookie.RFC2109VersionHandler",3,0.00,3.00,18,0.21,5755.35,3,0,4,11,7,115.87,0,32,2,2,115.87,0.00,0.50,0.00,0,3.00,5,643.29,0,0,5,org.apache.http.impl.cookie.AbstractCookieAttributeHandler,0.00,8,1,9,0,8,3,0,0,135,1
"org.apache.http.impl.cookie.RFC2965CommentUrlAttributeHandler",4,0.00,1.25,10,0.09,1445.55,4,0,6,5,7,139.58,3,18,1,1,139.58,0.00,0.00,0.00,0,4.00,2,270.32,0,0,6,java.lang.Object,0.00,1,0,5,0,1,4,1,1,72,1
"org.apache.http.impl.cookie.RFC2965DiscardAttributeHandler",4,0.00,1.25,10,0.09,1361.35,4,0,6,5,7,139.78,3,18,1,1,139.78,0.00,0.00,0.00,0,4.00,2,272.57,0,0,6,java.lang.Object,0.00,1,0,5,0,1,4,1,1,72,1
"org.apache.http.impl.cookie.RFC2965DomainAttributeHandler",5,0.00,4.40,53,0.92,50727.69,5,0,6,21,7,51.81,46,98,1,1,101.81,0.00,0.00,0.00,0,5.00,10,2747.25,0,0,6,java.lang.Object,0.00,16,0,22,0,16,5,1,20,494,1
"org.apache.http.impl.cookie.RFC2965PortAttributeHandler",6,0.00,3.83,54,0.69,29560.25,6,0,8,20,8,88.14,34,84,1,1,106.02,0.00,0.00,0.00,1,6.00,6,2058.94,0,0,7,java.lang.Object,0.00,14,0,23,0,14,6,1,7,404,1
"org.apache.http.impl.cookie.RFC2965Spec",11,0.00,2.91,121,1.56,85264.86,11,0,14,55,16,121.90,33,149,2,4,101.28,0.00,0.75,0.00,1,11.00,9,4668.57,7,5,14,org.apache.http.impl.cookie.RFC2109Spec,0.25,44,3,32,0,44,6,0,11,864,1
"org.apache.http.impl.cookie.RFC2965SpecFactory",1,0.00,2.00,6,0.07,1728.53,1,0,4,4,5,84.10,6,11,1,1,116.32,0.00,0.00,0.00,0,1.00,2,219.84,0,1,4,java.lang.Object,0.00,3,0,2,0,3,0,1,1,50,1
"org.apache.http.impl.cookie.RFC2965VersionAttributeHandler",4,0.00,2.75,23,0.26,8270.48,4,0,7,9,8,158.47,9,41,1,1,118.59,0.00,0.00,0.00,0,4.00,5,774.57,0,0,7,java.lang.Object,0.00,5,0,11,0,5,4,1,3,163,1
"org.apache.http.impl.cookie.TestAbstractCookieSpec",6,0.00,1.50,46,0.52,14509.76,6,0,11,22,8,112.74,4,59,2,2,112.74,0.00,0.50,0.00,0,6.00,3,1546.78,0,1,6,junit.framework.TestCase,0.00,16,1,9,0,16,5,0,4,331,1
"org.apache.http.impl.cookie.TestAbstractCookieSpec$DummyCookieAttribHandler",3,0.00,1.00,5,0.05,308.89,3,0,11,3,5,155.15,0,9,0,1,155.15,0.00,0.00,0.00,0,3.00,1,138.78,0,0,5,java.lang.Object,0.00,0,0,3,0,0,3,1,0,41,2
"org.apache.http.impl.cookie.TestAbstractCookieSpec$DummyCookieSpec",6,0.00,1.00,12,0.08,682.44,6,0,11,6,4,143.58,0,19,0,2,143.58,0.00,0.50,0.00,0,6.00,1,248.84,0,3,4,org.apache.http.impl.cookie.AbstractCookieSpec,0.00,0,1,6,0,0,3,0,0,73,2
"org.apache.http.impl.cookie.TestAllCookieImpl",3,0.00,1.00,18,0.20,7165.21,3,0,3,16,11,115.37,0,22,2,2,115.37,0.00,0.50,0.00,0,3.00,1,609.76,0,1,9,junit.framework.TestCase,0.00,13,1,3,0,13,2,0,0,144,1
"org.apache.http.impl.cookie.TestBasicCookieAttribHandlers",33,0.00,1.79,253,2.98,68768.07,33,0,10,65,13,113.21,27,339,2,2,113.21,0.00,0.50,0.00,0,33.00,6,8927.74,0,1,11,junit.framework.TestCase,0.00,32,1,59,0,32,32,0,27,1870,1
"org.apache.http.impl.cookie.TestBrowserCompatSpec",57,0.00,1.77,687,10.00,313593.46,57,0,11,90,10,151.16,76,737,2,2,101.16,0.00,0.50,0.00,1,57.00,9,29997.88,0,1,8,junit.framework.TestCase,0.00,33,1,101,0,33,56,0,39,5463,1
"org.apache.http.impl.cookie.TestCookieNetscapeDraft",13,0.00,2.00,136,1.88,51110.12,13,0,10,35,9,145.12,29,160,2,2,105.23,0.00,0.50,0.00,0,13.00,5,5654.92,0,1,7,junit.framework.TestCase,0.00,22,1,26,0,22,12,0,15,1060,1
"org.apache.http.impl.cookie.TestCookieRFC2109Spec",21,0.00,2.14,263,3.54,106374.73,21,0,10,46,10,141.28,57,320,2,2,101.40,0.00,0.50,0.00,0,21.00,6,10624.06,0,1,8,junit.framework.TestCase,0.00,25,1,45,0,25,20,0,26,1986,1
"org.apache.http.impl.cookie.TestCookieRFC2965Spec",47,0.00,1.74,626,8.64,279351.28,47,0,11,91,9,120.21,166,676,2,2,99.60,0.00,0.50,0.00,0,47.00,6,25924.84,0,1,7,junit.framework.TestCase,0.00,44,1,82,0,44,46,0,94,4779,1
"org.apache.http.impl.cookie.TestDateUtils",9,0.00,1.44,72,0.94,27708.75,9,0,5,22,4,159.76,9,95,2,2,109.76,0.00,0.50,0.00,0,9.00,5,2812.61,0,1,2,junit.framework.TestCase,0.00,13,1,13,0,13,8,0,5,577,1
"org.apache.http.impl.cookie.TestNetscapeCookieAttribHandlers",10,0.00,1.70,74,0.87,19083.44,10,0,6,22,7,113.52,8,99,2,2,113.52,0.00,0.50,0.00,0,10.00,3,2597.22,0,1,5,junit.framework.TestCase,0.00,12,1,17,0,12,9,0,8,536,1
"org.apache.http.impl.cookie.TestRFC2109CookieAttribHandlers",17,0.00,2.18,149,1.70,43924.09,17,0,6,35,8,160.26,21,207,2,2,110.26,0.00,0.50,0.00,0,17.00,6,5096.43,0,1,6,junit.framework.TestCase,0.00,18,1,37,0,18,16,0,21,1051,1
"org.apache.http.examples.conn.ManagerConnectDirect",6,0.10,1.50,58,0.81,38743.74,8,2,19,35,8,55.31,57,71,0,1,105.31,0.00,0.00,0.42,5,6.00,4,2421.79,0,4,8,java.lang.Object,0.00,29,0,9,0,29,2,0,16,428,1
"org.apache.http.examples.conn.ManagerConnectProxy",8,0.21,1.50,86,1.28,67172.43,10,2,20,44,9,54.60,70,106,0,1,102.70,0.00,0.00,0.31,7,16.00,4,3846.84,0,5,9,java.lang.Object,0.00,36,0,12,0,36,3,0,21,663,1
"org.apache.http.examples.conn.OperatorConnectDirect",6,0.20,1.17,46,0.58,18801.06,8,2,18,28,7,61.91,58,53,0,1,111.91,0.00,0.00,0.33,4,10.00,2,1727.70,0,4,7,java.lang.Object,0.00,22,0,7,0,22,2,0,17,329,1
"org.apache.http.examples.conn.OperatorConnectProxy",8,0.29,1.25,74,1.04,43450.98,10,2,19,37,8,55.94,76,87,0,1,105.94,0.00,0.00,0.25,6,18.00,2,3109.53,0,5,8,java.lang.Object,0.00,29,0,10,0,29,3,0,27,565,1
"org.apache.http.client.params.AllClientPNames",0,0.00,0.00,1,0.02,96.21,0,0,7,0,5,171.00,16,5,0,9,171.00,0.00,0.89,0.00,0,0.00,0,48.11,0,0,5,,0.00,0,8,0,0,0,0,0,2,13,1
"org.apache.http.client.params.AuthPolicy",1,3.00,1.00,6,0.05,583.15,4,3,0,1,1,82.63,12,8,1,1,120.19,0.00,0.00,0.00,0,1.00,1,143.12,0,0,0,java.lang.Object,0.00,0,0,1,0,0,1,0,3,39,2
"org.apache.http.client.params.ClientPNames",0,0.00,0.00,13,0.19,2814.00,12,12,0,0,8,171.00,88,14,8,1,171.00,0.00,0.00,0.00,0,0.00,0,564.97,0,0,0,,0.00,0,0,0,0,0,0,0,13,112,1
"org.apache.http.client.params.CookiePolicy",1,4.00,1.00,7,0.06,798.71,5,4,0,1,4,87.24,13,9,4,1,116.62,0.00,0.00,0.00,0,1.00,1,185.68,0,0,0,java.lang.Object,0.00,0,0,1,0,0,1,0,4,48,2
"org.apache.http.client.params.HttpClientParams",11,0.00,2.00,46,0.51,11288.86,11,0,1,18,4,145.28,36,78,2,1,124.67,0.00,0.00,0.00,0,11.00,3,1540.93,0,1,2,java.lang.Object,0.00,7,0,22,0,7,10,0,5,344,1
"org.apache.http.impl.conn.AbstractClientConnAdapter",24,0.09,1.29,81,0.55,7507.85,27,3,13,44,5,173.38,70,120,2,1,133.49,0.00,0.00,0.42,2,0.00,3,1652.62,0,5,3,java.lang.Object,0.00,20,0,31,4,20,19,1,29,442,2
"org.apache.http.impl.conn.AbstractPoolEntry",7,0.22,3.14,52,0.79,30055.43,10,3,8,24,8,110.13,118,97,4,1,110.60,0.00,0.00,0.14,4,10.00,6,2383.21,0,1,4,java.lang.Object,0.00,17,0,22,2,17,6,0,42,471,2
"org.apache.http.impl.conn.AbstractPooledConnAdapter",10,0.11,1.60,35,0.31,4524.97,11,1,7,19,7,132.42,43,59,2,2,132.18,2.00,0.25,0.90,1,0.00,3,942.06,0,1,5,org.apache.http.impl.conn.AbstractClientConnAdapter,0.00,9,1,16,2,9,9,1,13,241,2
"org.apache.http.impl.conn.ClientConnAdapterMockup",8,0.00,1.00,17,0.13,1177.93,8,0,4,9,3,142.70,3,26,1,2,142.70,0.00,0.50,0.00,0,8.00,1,400.62,0,1,2,org.apache.http.impl.conn.AbstractClientConnAdapter,0.00,1,1,8,0,1,7,0,1,112,1
"org.apache.http.impl.conn.DefaultClientConnection",13,0.00,2.00,78,0.88,23224.57,19,6,16,31,6,156.09,36,124,1,2,116.21,0.00,0.50,0.17,0,84.00,4,2648.71,7,6,5,org.apache.http.impl.SocketHttpClientConnection,0.00,18,1,26,0,18,7,1,19,565,1
"org.apache.http.impl.conn.DefaultClientConnectionOperator",5,0.50,4.00,56,0.88,35682.32,6,1,15,31,12,53.38,43,109,4,1,101.49,0.00,0.00,0.60,1,2.00,8,2643.67,0,1,8,java.lang.Object,0.00,26,0,20,0,26,4,1,18,472,1
"org.apache.http.impl.conn.DefaultHttpRoutePlanner",3,1.00,2.00,20,0.24,7722.76,4,1,9,11,6,135.57,9,34,1,1,114.96,0.00,0.00,0.00,1,3.00,4,722.48,0,1,5,java.lang.Object,0.00,8,0,6,0,8,2,1,5,147,1
"org.apache.http.impl.conn.DefaultResponseParser",2,3.00,3.00,26,0.38,16999.57,5,3,13,13,2,118.87,6,40,1,2,98.25,0.00,0.50,0.00,0,2.00,4,1127.21,0,1,1,org.apache.http.impl.io.AbstractMessageParser,0.00,11,1,6,0,11,1,0,6,211,1
"org.apache.http.impl.conn.ExecReqThread",6,0.13,1.67,30,0.37,10307.31,9,3,10,16,4,101.46,34,51,1,3,119.33,0.00,0.67,0.44,2,2.00,4,1098.61,1,1,3,org.apache.http.impl.conn.GetConnThread,0.30,10,2,10,0,10,5,0,8,234,1
"org.apache.http.impl.conn.ExecReqThread$RequestSpec",0,0.00,0.00,5,0.03,237.96,4,4,10,0,0,171.00,0,6,0,1,171.00,0.00,0.00,0.00,0,0.00,0,95.18,0,0,0,java.lang.Object,0.00,0,0,0,0,0,0,0,0,25,2
"org.apache.http.impl.conn.GetConnThread",4,0.40,1.25,18,0.12,1245.84,9,5,3,5,5,149.47,13,26,2,2,128.86,1.00,0.33,0.50,0,0.00,2,367.47,0,2,3,java.lang.Thread,0.00,1,1,5,1,1,2,0,4,94,1
"org.apache.http.impl.conn.Helper",2,0.00,1.00,12,0.17,4682.98,2,0,10,7,1,115.68,8,22,1,1,115.44,0.00,0.00,0.00,0,2.00,1,500.41,0,1,0,java.lang.Object,0.00,5,0,2,0,5,1,0,4,102,2
"org.apache.http.impl.conn.IdleConnectionHandler",5,0.00,2.20,29,0.35,9403.16,7,2,7,21,1,86.74,34,42,1,1,118.96,0.00,0.00,0.50,0,2.00,6,1046.75,0,0,0,java.lang.Object,0.00,16,0,11,0,16,5,0,8,219,1
"org.apache.http.impl.conn.LoggingSessionInputBuffer",8,2.00,1.62,38,0.48,15876.28,10,2,4,13,2,162.35,16,52,1,1,122.46,0.00,0.00,0.00,4,8.00,2,1454.93,0,2,1,java.lang.Object,0.00,5,0,13,0,5,6,1,4,327,0
"org.apache.http.impl.conn.LoggingSessionOutputBuffer",8,2.00,1.62,32,0.38,7621.91,10,2,4,13,2,174.97,14,46,1,1,124.97,0.00,0.00,0.00,4,8.00,2,1128.44,0,1,1,java.lang.Object,0.00,5,0,13,0,5,7,1,4,271,0
"org.apache.http.impl.conn.SingleClientConnManager",11,0.08,3.27,92,1.14,39363.64,21,10,10,32,10,59.06,108,155,3,1,109.06,0.00,0.00,0.17,3,21.00,8,3410.64,0,5,7,java.lang.Object,0.00,21,0,36,0,21,6,1,42,665,1
"org.apache.http.impl.conn.SingleClientConnManager$ConnAdapter",1,0.00,1.00,5,0.04,482.50,1,0,10,1,3,91.57,6,7,0,3,123.80,0.00,0.67,0.00,0,1.00,1,125.87,0,0,3,org.apache.http.impl.conn.AbstractPooledConnAdapter,0.00,0,2,1,0,0,1,0,1,33,1
"org.apache.http.impl.conn.SingleClientConnManager$PoolEntry",4,0.00,1.50,11,0.08,964.53,4,0,10,7,4,161.53,12,20,0,2,140.92,0.00,0.50,0.00,0,4.00,2,247.31,1,1,4,org.apache.http.impl.conn.AbstractPoolEntry,0.18,3,1,6,0,3,3,0,4,71,1
"org.apache.http.impl.conn.TestAllConnImpl",3,0.00,1.00,12,0.12,2866.67,3,0,3,10,5,125.07,1,16,2,2,125.07,0.00,0.50,0.00,0,3.00,1,349.20,0,1,3,junit.framework.TestCase,0.00,7,1,3,0,7,2,0,1,90,1
"org.apache.http.impl.conn.TestLocalServer",5,0.00,1.60,51,0.83,32357.60,5,0,14,26,6,103.58,4,75,2,3,103.58,0.00,0.67,0.00,0,7.00,4,2495.03,2,1,4,org.apache.http.localserver.ServerTestBase,0.00,21,2,8,0,21,4,0,1,436,1
"org.apache.http.impl.conn.TestTSCCMNoServer",15,0.00,2.27,232,3.09,107807.99,15,0,17,57,13,78.70,82,299,2,2,96.57,0.00,0.50,0.00,3,15.00,6,9277.67,0,4,11,junit.framework.TestCase,0.00,42,1,34,0,42,11,0,62,1682,1
"org.apache.http.impl.conn.TestTSCCMWithServer",8,0.00,1.88,135,2.19,86548.37,8,0,20,51,11,44.17,79,171,2,3,94.17,0.00,0.67,0.00,1,0.00,4,6580.98,1,2,9,org.apache.http.localserver.ServerTestBase,0.00,43,2,15,0,43,6,0,59,1075,1
"org.apache.http.impl.conn.Wire",13,0.92,2.00,65,0.76,27312.91,14,1,4,25,3,118.60,7,101,3,1,118.60,0.00,0.00,0.15,3,31.00,6,2274.34,0,0,0,java.lang.Object,0.00,12,0,26,0,12,13,0,1,483,1
"org.apache.http.examples.client.ClientAbortMethod",1,0.00,2.00,14,0.22,8643.73,1,0,5,11,3,79.21,5,17,0,1,97.09,0.00,0.00,0.00,0,1.00,2,668.59,0,0,3,java.lang.Object,0.00,10,0,2,0,10,1,0,3,125,1
"org.apache.http.examples.client.ClientAuthentication",1,0.00,3.00,15,0.26,8507.07,1,0,6,15,4,96.17,4,21,0,1,95.93,0.00,0.00,0.00,0,1.00,3,775.56,0,0,4,java.lang.Object,0.00,14,0,3,0,14,1,0,1,140,1
"org.apache.http.examples.client.ClientChunkEncodedPost",1,0.00,4.00,22,0.36,13994.00,1,0,8,18,3,39.85,8,29,0,1,87.96,0.00,0.00,0.00,0,1.00,4,1088.96,0,0,3,java.lang.Object,0.00,17,0,4,0,17,1,0,6,187,1
"org.apache.http.examples.client.ClientConnectionRelease",1,0.00,4.00,18,0.28,13466.89,1,0,8,14,3,80.98,15,26,0,1,91.34,0.00,0.00,0.00,0,1.00,4,838.55,0,0,3,java.lang.Object,0.00,13,0,4,0,13,1,0,12,149,1
"org.apache.http.examples.client.ClientCustomContext",1,0.00,3.00,24,0.39,18036.01,1,0,11,16,7,37.27,10,25,0,1,85.75,0.00,0.00,0.00,0,1.00,3,1162.48,0,0,7,java.lang.Object,0.00,15,0,3,0,15,1,0,7,195,1
"org.apache.http.examples.client.ClientCustomSSL",1,0.00,3.00,22,0.39,16082.35,1,0,9,23,4,87.78,4,28,0,1,87.55,0.00,0.00,0.00,0,1.00,3,1162.48,0,0,4,java.lang.Object,0.00,22,0,3,0,22,1,0,1,195,1
"org.apache.http.examples.client.ClientExecuteDirect",5,0.12,1.60,45,0.60,24765.29,7,2,21,26,10,56.20,46,57,0,1,106.20,0.00,0.00,0.40,4,6.00,4,1793.84,0,3,10,java.lang.Object,0.00,21,0,8,0,21,2,0,19,336,1
"org.apache.http.examples.client.ClientExecuteProxy",5,0.00,1.60,48,0.69,29159.19,7,2,22,29,11,55.64,47,64,0,1,105.64,0.00,0.00,0.50,4,1.00,4,2080.23,0,3,11,java.lang.Object,0.00,24,0,8,0,24,2,0,20,380,1
"org.apache.http.examples.client.ClientFormLogin",1,0.00,7.00,38,0.63,39144.79,1,0,12,17,7,75.69,4,47,0,1,75.46,0.00,0.00,0.00,0,1.00,7,1894.30,0,0,7,java.lang.Object,0.00,16,0,7,0,16,1,0,1,305,1
"org.apache.http.examples.client.ClientGZipContentCompression",1,0.00,2.00,16,0.22,8503.49,1,0,16,13,2,74.84,14,19,0,1,94.98,0.00,0.00,0.00,0,1.00,2,664.87,0,0,2,java.lang.Object,0.00,12,0,2,0,12,1,0,2,127,1
"org.apache.http.examples.client.ClientGZipContentCompression$GzipDecompressingEntity",3,0.00,1.00,8,0.06,791.29,3,0,16,5,0,140.70,2,13,0,2,140.70,0.00,0.50,0.00,0,3.00,1,166.91,0,1,0,org.apache.http.entity.HttpEntityWrapper,0.00,2,1,3,0,2,2,0,2,48,1
"org.apache.http.examples.client.ClientGZipContentCompression$HttpRequestInterceptor",1,0.00,2.00,4,0.05,753.20,1,0,16,3,0,125.73,0,8,0,1,125.73,0.00,0.00,0.00,0,1.00,2,139.77,0,0,0,java.lang.Object,0.00,2,0,2,0,2,1,0,0,34,0
"org.apache.http.examples.client.ClientGZipContentCompression$HttpResponseInterceptor",1,0.00,4.00,13,0.16,5529.91,1,0,16,8,0,99.66,0,17,0,1,99.66,0.00,0.00,0.00,0,1.00,4,485.51,0,0,0,java.lang.Object,0.00,7,0,4,0,7,1,0,0,92,0
"org.apache.http.examples.client.ClientInteractiveAuthentication",1,0.00,7.00,39,0.69,38323.67,1,0,14,25,7,25.11,9,47,0,1,75.11,0.00,0.00,0.00,0,1.00,7,2078.90,0,0,7,java.lang.Object,0.00,24,0,7,0,24,1,0,6,323,1
"org.apache.http.examples.client.ClientMultiThreadedExecution",1,0.00,3.00,24,0.35,12474.61,1,0,19,14,10,86.54,16,29,0,1,87.01,0.00,0.00,0.00,0,1.00,3,1042.21,0,0,10,java.lang.Object,0.00,13,0,3,0,13,1,0,10,180,1
"org.apache.http.examples.client.ClientMultiThreadedExecution$GetThread",2,0.50,2.00,21,0.28,6922.36,6,4,19,10,2,145.55,5,27,0,2,105.67,0.00,0.50,0.50,0,2.00,3,831.60,0,0,2,java.lang.Thread,0.00,8,1,4,0,8,2,0,3,170,1
"org.apache.http.examples.client.ClientProxyAuthentication",1,0.00,3.00,20,0.38,13597.88,1,0,9,18,6,89.90,4,26,0,1,89.67,0.00,0.00,0.00,0,1.00,3,1131.73,0,0,6,java.lang.Object,0.00,17,0,3,0,17,1,0,1,192,1
"org.apache.http.conn.ssl.AbstractVerifier",0,0.00,0.00,122,2.11,310819.32,1,1,15,3,5,171.00,101,165,3,1,171.00,0.00,0.00,0.00,0,0.00,0,6344.64,0,0,2,java.lang.Object,0.00,3,0,0,3,3,0,1,35,889,2
"org.apache.http.conn.ssl.AllowAllHostnameVerifier",2,0.00,1.00,4,0.03,312.64,2,0,0,2,3,163.11,7,10,2,2,142.49,0.00,0.50,0.00,0,2.00,1,102.85,0,1,1,org.apache.http.conn.ssl.AbstractVerifier,0.00,0,1,2,0,0,1,0,2,32,1
"org.apache.http.conn.ssl.BrowserCompatHostnameVerifier",2,0.00,1.00,5,0.05,738.78,2,0,1,2,3,107.33,12,11,2,2,139.55,0.00,0.50,0.00,1,2.00,1,145.62,0,1,1,org.apache.http.conn.ssl.AbstractVerifier,0.00,0,1,2,0,0,1,0,1,41,1
"org.apache.http.conn.ssl.CertificatesToPlayWith",0,0.00,0.00,20,2.27,55234.06,19,19,0,1,2,171.00,53,347,2,1,171.00,0.00,0.00,0.00,0,0.00,0,6819.35,0,0,0,,0.00,1,0,0,0,1,0,0,13,846,1
"org.apache.http.conn.ssl.HostnameVerifier",4,0.00,1.00,5,0.06,376.98,4,0,5,4,3,107.35,33,7,3,2,155.45,0.00,0.50,0.00,0,4.00,1,180.08,0,0,0,,0.00,0,1,4,0,0,4,0,2,55,1
"org.apache.http.conn.ssl.SSLSocketFactory",14,0.05,2.21,87,1.20,43673.93,24,10,21,36,13,66.17,120,161,8,1,114.28,0.00,0.00,0.06,2,74.00,8,3613.57,0,7,5,java.lang.Object,0.00,22,0,31,0,22,7,1,19,723,1
"org.apache.http.conn.ssl.StrictHostnameVerifier",2,0.00,1.00,5,0.05,738.78,2,0,1,2,3,89.55,19,11,2,2,139.55,0.00,0.50,0.00,1,2.00,1,145.62,0,1,1,org.apache.http.conn.ssl.AbstractVerifier,0.00,0,1,2,0,0,1,0,1,41,1
"org.apache.http.conn.ssl.TestAllSSL",3,0.00,1.00,11,0.10,2271.14,3,0,3,9,4,130.53,0,15,2,2,130.53,0.00,0.50,0.00,0,3.00,1,310.03,0,1,2,junit.framework.TestCase,0.00,6,1,3,0,6,2,0,0,81,1
"org.apache.http.conn.ssl.TestHostnameVerifier",5,0.00,1.20,122,1.55,162012.25,5,0,8,17,7,51.73,30,133,2,2,83.95,0.00,0.50,0.00,1,8.00,2,4663.59,0,1,5,junit.framework.TestCase,0.00,12,1,6,0,12,4,1,19,845,1
"org.apache.http.conn.ssl.TestSSLSocketFactory",6,0.00,1.33,75,1.26,40967.62,6,0,22,51,4,140.37,13,100,2,2,100.48,0.00,0.50,0.00,2,10.00,3,3779.34,0,1,2,junit.framework.TestCase,0.00,45,1,8,0,45,5,1,8,614,1
"org.apache.http.conn.ssl.TestSSLSocketFactory$Runnable",1,0.00,2.00,14,0.16,3837.04,1,0,22,10,0,99.86,0,18,0,1,99.86,0.00,0.00,0.00,0,1.00,2,471.64,0,0,0,java.lang.Object,0.00,9,0,2,0,9,1,0,0,93,0
"org.apache.http.conn.params.ConnConnectionPNames",0,0.00,0.00,2,0.01,157.40,1,1,0,0,1,171.00,25,3,1,1,171.00,0.00,0.00,0.00,0,0.00,0,44.97,0,0,0,,0.00,0,0,0,0,0,0,0,2,13,1
"org.apache.http.conn.params.ConnManagerPNames",0,0.00,0.00,3,0.03,332.42,2,2,0,0,1,171.00,26,4,1,1,171.00,0.00,0.00,0.00,0,0.00,0,81.41,0,0,0,,0.00,0,0,0,0,0,0,0,3,22,1
"org.apache.http.conn.params.ConnRoutePNames",0,0.00,0.00,2,0.01,157.40,1,1,0,0,0,171.00,16,3,0,1,171.00,0.00,0.00,0.00,0,0.00,0,44.97,0,0,0,,0.00,0,0,0,0,0,0,0,2,13,1
"org.apache.http.conn.params.HttpConnParams",1,1.00,1.00,3,0.02,169.40,2,1,1,1,1,161.93,19,5,1,1,135.65,0.00,0.00,0.00,0,1.00,1,52.97,0,0,0,java.lang.Object,0.00,0,0,1,0,0,1,0,4,17,1
"org.apache.http.conn.params.HttpConnectionManagerParams",8,0.14,2.38,49,0.60,18584.72,11,3,4,18,7,71.14,88,92,5,1,115.27,0.00,0.00,0.21,2,20.00,5,1806.21,0,0,2,java.lang.Object,0.00,10,0,19,0,10,8,0,17,382,2
"org.apache.http.client.AuthState",9,3.00,1.22,33,0.26,5162.31,12,3,4,12,7,113.56,48,44,4,1,131.43,0.00,0.00,0.00,1,9.00,2,777.94,0,4,3,java.lang.Object,0.00,3,0,11,0,3,5,0,12,197,1
"org.apache.http.client.AuthenticationHandler",3,0.00,1.00,4,0.04,153.36,3,0,6,3,7,207.55,3,7,4,1,157.55,0.00,0.00,0.00,0,3.00,1,110.24,0,2,3,,0.00,0,0,3,0,0,1,0,1,35,1
"org.apache.http.client.CircularRedirectException",3,1.00,1.00,8,0.05,483.35,4,1,0,3,3,100.10,22,12,2,3,142.39,0.00,0.67,0.00,0,3.00,1,148.39,0,0,1,org.apache.http.client.RedirectException,0.00,0,2,3,0,0,3,0,4,45,1
"org.apache.http.client.ClientRequestDirector",2,0.00,1.00,3,0.02,87.53,2,0,5,2,4,203.20,56,6,2,1,158.08,0.00,0.00,0.00,0,2.00,1,61.02,0,2,2,,0.00,0,0,2,0,0,0,0,3,21,1
"org.apache.http.client.CookieStore",4,0.00,1.00,5,0.02,71.43,4,0,2,4,9,118.85,28,6,8,1,161.14,0.00,0.00,0.00,0,4.00,1,60.63,0,1,1,,0.00,0,0,4,0,0,3,0,5,26,1
"org.apache.http.client.CredentialsProvider",3,0.00,1.00,4,0.02,62.51,3,0,2,3,6,110.62,28,5,4,1,160.61,0.00,0.00,0.00,0,3.00,1,57.51,0,1,2,,0.00,0,0,3,0,0,2,0,4,23,1
"org.apache.http.client.HttpClient",7,0.00,1.00,8,0.06,267.72,7,0,7,7,12,138.40,102,19,9,1,158.54,0.00,0.00,0.00,0,7.00,1,186.48,0,7,3,,0.00,0,0,7,0,0,0,0,8,61,1
"org.apache.http.client.HttpRequestRetryHandler",1,0.00,1.00,2,0.01,48.22,1,0,2,1,4,195.79,24,3,4,1,146.52,0.00,0.00,0.00,0,1.00,1,43.22,0,0,0,,0.00,0,0,1,0,0,1,0,2,15,1
"org.apache.http.client.RedirectException",3,1.00,1.00,8,0.05,483.35,4,1,1,3,3,100.10,22,12,3,2,142.39,1.00,0.33,0.00,0,3.00,1,148.39,0,0,0,org.apache.http.ProtocolException,0.00,0,1,3,1,0,3,0,4,45,1
"org.apache.http.client.RedirectHandler",2,0.00,1.00,3,0.02,88.83,2,0,4,2,4,157.55,32,5,4,1,158.03,0.00,0.00,0.00,0,2.00,1,67.22,0,1,0,,0.00,0,0,2,0,0,1,0,3,23,1
"org.apache.http.client.RoutedRequest",2,0.00,1.00,4,0.02,178.00,2,0,2,2,12,106.86,25,6,11,1,144.42,0.00,0.00,0.00,0,2.00,1,52.00,0,2,1,,0.00,0,0,2,0,0,0,0,5,20,1
"org.apache.http.client.RoutedRequest$Impl",3,0.25,1.00,10,0.07,774.64,5,2,2,3,2,174.09,8,14,0,1,134.21,0.00,0.00,0.33,0,5.00,1,205.55,0,2,2,java.lang.Object,0.00,0,0,3,0,0,1,1,3,57,2
"org.apache.http.client.TestAll",3,0.00,1.00,15,0.16,4890.67,3,0,9,13,7,119.63,0,19,1,2,119.63,0.00,0.50,0.00,0,3.00,1,474.55,0,1,6,junit.framework.TestCase,0.00,10,1,3,0,10,2,0,0,117,1
"org.apache.http.mockup.HttpConnectionMockup",8,1.00,1.00,17,0.10,845.18,9,1,3,8,0,143.83,5,26,0,1,143.83,0.00,0.00,0.00,0,8.00,1,285.78,0,1,0,java.lang.Object,0.00,0,0,8,0,0,7,1,1,87,1
"org.apache.http.mockup.SecureSocketFactoryMockup",3,1.00,1.00,8,0.07,1044.82,4,1,2,5,3,189.75,5,15,1,2,139.75,0.00,0.50,0.00,0,4.00,1,220.88,0,2,2,org.apache.http.mockup.SocketFactoryMockup,0.25,2,1,3,0,2,1,1,3,59,1
"org.apache.http.mockup.SocketFactoryMockup",5,0.38,1.20,13,0.13,1975.02,7,2,4,10,2,189.28,7,22,1,1,139.28,0.00,0.00,0.20,0,7.00,2,401.87,0,3,1,java.lang.Object,0.00,5,0,6,1,5,2,1,5,103,1
"org.apache.http.impl.auth.BasicScheme",7,1.00,1.86,39,0.46,17008.74,8,1,11,19,8,68.13,65,59,2,2,118.12,0.00,0.50,0.00,1,7.00,5,1370.31,1,3,6,org.apache.http.impl.auth.RFC2617Scheme,0.00,12,1,13,0,12,4,0,9,276,1
"org.apache.http.impl.auth.BasicSchemeFactory",1,0.00,1.00,3,0.02,194.14,1,0,3,2,4,102.96,6,5,1,1,135.18,0.00,0.00,0.00,0,1.00,1,62.11,0,1,3,java.lang.Object,0.00,1,0,1,0,1,0,1,1,19,1
"org.apache.http.impl.auth.DigestScheme",12,0.05,3.33,191,2.78,184932.69,20,8,16,48,9,45.40,128,241,2,2,93.87,0.00,0.50,0.17,5,38.00,8,8340.81,4,8,7,org.apache.http.impl.auth.RFC2617Scheme,0.00,36,1,40,0,36,4,0,31,1434,1
"org.apache.http.impl.auth.DigestSchemeFactory",1,0.00,1.00,3,0.02,194.14,1,0,3,2,4,102.96,6,5,1,1,135.18,0.00,0.00,0.00,0,1.00,1,62.11,0,1,3,java.lang.Object,0.00,1,0,1,0,1,0,1,1,19,1
"org.apache.http.impl.auth.RFC2617Scheme",6,2.00,3.00,58,0.77,57132.83,8,2,11,26,6,55.72,52,73,3,1,103.82,0.00,0.00,0.00,1,6.00,11,2313.05,0,3,3,java.lang.Object,0.00,20,0,18,3,20,3,1,9,411,2
"org.apache.http.impl.auth.TestAllAuthImpl",3,0.00,1.00,12,0.12,2866.67,3,0,3,10,4,125.07,0,16,1,2,125.07,0.00,0.50,0.00,0,3.00,1,349.20,0,1,3,junit.framework.TestCase,0.00,7,1,3,0,7,2,0,0,90,1
"org.apache.http.impl.auth.TestBasicScheme",7,0.00,1.29,53,0.75,15143.01,7,0,14,32,7,163.15,11,65,2,2,113.15,0.00,0.50,0.00,0,7.00,2,2256.49,0,1,5,junit.framework.TestCase,0.00,25,1,9,0,25,6,0,5,432,1
"org.apache.http.impl.auth.TestDigestScheme",14,0.00,1.36,164,2.51,66051.32,14,0,16,39,8,143.04,30,199,2,2,103.15,0.00,0.50,0.00,1,14.00,3,7543.37,0,2,6,junit.framework.TestCase,0.00,25,1,19,0,25,12,0,18,1346,1
"org.apache.http.impl.auth.TestRFC2617Scheme",7,0.00,1.43,42,0.46,8497.04,7,0,12,18,6,117.60,5,58,2,2,117.60,0.00,0.50,0.00,0,7.00,2,1393.78,0,1,4,junit.framework.TestCase,0.00,11,1,10,0,11,6,0,5,301,1
"org.apache.http.impl.auth.TestRFC2617Scheme$TestAuthScheme",4,0.00,1.00,9,0.05,429.81,4,0,12,4,3,143.78,0,16,0,2,143.78,0.00,0.50,0.00,0,4.00,1,150.02,0,2,3,org.apache.http.impl.auth.RFC2617Scheme,0.00,0,1,4,0,0,2,0,0,46,1
"org.apache.http.impl.auth.UnsupportedDigestAlgorithmException",3,1.00,1.00,8,0.05,483.35,4,1,0,3,1,100.10,23,12,1,2,142.39,0.00,0.50,0.00,0,3.00,1,148.39,0,0,0,java.lang.RuntimeException,0.00,0,1,3,0,0,3,0,4,45,1
"org.apache.http.impl.client.AbstractAuthenticationHandler",4,0.33,4.25,62,0.84,57307.58,6,2,19,27,8,144.07,5,86,2,1,94.07,0.00,0.00,0.25,1,8.00,9,2519.49,0,3,6,java.lang.Object,0.00,23,0,17,2,23,1,1,3,444,2
"org.apache.http.impl.client.AbstractHttpClient",60,0.05,1.35,171,1.55,31657.06,74,14,29,85,16,188.26,97,269,1,1,138.26,0.00,0.00,0.02,6,1022.00,5,4642.95,0,36,15,java.lang.Object,0.00,25,0,81,1,25,24,3,37,1134,2
"org.apache.http.impl.client.BasicCookieStore",7,0.08,2.29,42,0.40,10395.71,9,2,7,23,7,68.70,56,53,4,1,116.81,0.00,0.00,0.43,1,0.00,5,1188.20,0,2,3,java.lang.Object,0.00,16,0,16,0,16,5,1,9,266,1
"org.apache.http.impl.client.BasicCredentialsProvider",6,0.80,2.00,32,0.34,12496.83,7,1,5,15,5,70.53,49,45,2,1,118.63,0.00,0.00,0.33,2,10.00,5,1013.95,0,3,3,java.lang.Object,0.00,9,0,12,0,9,3,1,9,221,1
"org.apache.http.impl.client.ClientParamsStack",11,0.12,2.27,52,0.57,24878.51,15,4,2,19,2,84.38,134,87,2,2,121.94,0.00,0.50,0.36,0,14.00,6,1706.45,0,7,0,org.apache.http.params.AbstractHttpParams,0.00,8,1,25,0,8,4,0,16,401,1
"org.apache.http.impl.client.DefaultClientRequestDirector",14,0.07,7.07,360,5.96,409923.24,29,15,54,142,30,45.67,179,568,1,1,83.23,0.00,0.00,0.13,10,6.00,25,17891.68,0,6,29,java.lang.Object,0.00,128,0,99,0,128,8,1,88,2825,1
"org.apache.http.impl.client.DefaultHttpClient",19,0.00,1.37,89,1.05,29424.11,19,0,52,77,55,173.35,26,153,15,2,123.35,0.00,0.50,0.00,0,19.00,5,3146.36,3,15,40,org.apache.http.impl.client.AbstractHttpClient,0.35,58,1,26,0,58,4,0,9,680,1
"org.apache.http.impl.client.DefaultHttpRequestRetryHandler",5,0.38,2.60,33,0.30,11880.23,7,2,8,8,2,82.95,33,51,1,1,115.17,0.00,0.00,0.20,0,11.00,9,907.91,0,0,1,java.lang.Object,0.00,3,0,13,0,3,5,1,16,189,1
"org.apache.http.impl.client.DefaultProxyAuthenticationHandler",3,0.00,1.67,13,0.14,3183.97,3,0,7,7,4,174.60,3,23,1,2,124.60,0.00,0.50,0.00,0,3.00,2,434.64,1,1,3,org.apache.http.impl.client.AbstractAuthenticationHandler,0.00,4,1,5,0,4,2,0,1,96,1
"org.apache.http.impl.client.DefaultRedirectHandler",3,0.25,5.67,52,0.91,54709.22,5,2,17,34,4,73.28,17,103,1,1,91.15,0.00,0.00,0.33,0,4.00,14,2742.63,0,1,3,java.lang.Object,0.00,31,0,17,0,31,2,1,7,453,1
"org.apache.http.impl.client.DefaultTargetAuthenticationHandler",3,0.00,1.67,13,0.14,3183.97,3,0,7,7,4,174.60,3,23,1,2,124.60,0.00,0.50,0.00,0,3.00,2,434.64,1,1,3,org.apache.http.impl.client.AbstractAuthenticationHandler,0.00,4,1,5,0,4,2,0,1,96,1
"org.apache.http.impl.client.EntityEnclosingRequestWrapper",4,1.00,1.00,12,0.12,1709.49,5,1,5,8,2,153.10,14,19,1,3,132.49,0.00,0.67,0.00,0,4.00,1,352.87,0,1,1,org.apache.http.impl.client.RequestWrapper,0.00,4,2,4,0,4,3,1,1,90,0
"org.apache.http.impl.client.RequestWrapper",9,4.00,1.56,50,0.48,13354.54,13,4,9,24,3,169.85,16,65,2,2,119.85,1.00,0.33,0.00,3,9.00,3,1432.33,0,5,1,org.apache.http.message.AbstractHttpMessage,0.00,15,1,14,1,15,4,1,3,313,0
"org.apache.http.impl.client.TestAllHttpClientImpl",3,0.00,1.00,10,0.09,1733.04,3,0,3,8,3,131.45,0,14,2,2,131.45,0.00,0.50,0.00,0,3.00,1,272.38,0,1,1,junit.framework.TestCase,0.00,5,1,3,0,5,2,0,0,72,1
"org.apache.http.impl.client.TestBasicCredentialsProvider",13,0.01,1.00,97,1.51,63299.17,19,6,4,25,6,160.44,18,134,2,2,110.44,0.00,0.50,0.15,0,59.00,1,4542.46,0,1,4,junit.framework.TestCase,0.00,12,1,13,0,12,12,0,7,946,1
"org.apache.http.impl.client.TunnelRefusedException",2,2.00,1.00,8,0.07,930.01,4,2,2,2,1,127.54,0,11,1,2,127.54,0.00,0.50,0.00,0,2.00,1,199.29,0,1,0,org.apache.http.HttpException,0.00,0,1,2,0,0,1,0,0,52,1
"org.apache.http.impl.conn.tsccm.AbstractConnPool",9,0.07,2.33,59,0.64,14781.36,18,9,16,33,12,67.98,93,84,2,1,116.46,0.00,0.00,0.17,3,20.00,6,1928.54,0,1,10,java.lang.Object,0.00,24,0,21,1,24,8,1,32,401,2
"org.apache.http.impl.conn.tsccm.AbstractConnPool$ConnMgrRef",1,0.00,1.00,3,0.02,164.29,1,0,16,1,1,103.53,6,6,0,2,135.75,0.00,0.50,0.00,0,1.00,1,62.84,0,0,1,java.lang.ref.WeakReference,0.00,0,1,1,0,0,1,0,1,20,2
"org.apache.http.impl.conn.tsccm.BasicPoolEntry",5,2.00,1.20,17,0.14,2225.38,7,2,6,8,9,132.54,20,27,5,2,132.30,0.00,0.50,0.00,0,5.00,2,420.96,0,4,5,org.apache.http.impl.conn.AbstractPoolEntry,0.17,3,1,6,0,3,1,0,7,105,1
"org.apache.http.impl.conn.tsccm.BasicPoolEntryRef",2,1.00,1.50,9,0.07,1236.81,3,1,3,4,3,106.33,29,14,2,2,126.47,0.00,0.50,0.50,0,2.00,2,220.12,0,1,2,java.lang.ref.WeakReference,0.00,2,1,3,0,2,1,0,5,55,1
"org.apache.http.impl.conn.tsccm.BasicPooledConnAdapter",4,0.00,1.00,10,0.06,628.74,4,0,3,4,4,124.60,23,16,1,3,142.47,0.00,0.67,0.00,0,4.00,1,184.29,1,2,4,org.apache.http.impl.conn.AbstractPooledConnAdapter,0.08,0,2,4,0,0,2,0,6,55,1
"org.apache.http.impl.conn.tsccm.ConnPoolByRoute",14,0.17,3.64,167,2.07,103892.31,18,4,11,61,9,52.90,140,231,1,2,101.38,0.00,0.50,0.41,4,0.00,14,6215.92,2,0,8,org.apache.http.impl.conn.tsccm.AbstractConnPool,0.26,47,1,51,0,47,14,0,65,1173,1
"org.apache.http.impl.conn.tsccm.ConnPoolByRoute$WaitingThread",0,0.00,0.00,4,0.03,300.83,3,3,11,0,1,171.00,10,5,0,1,171.00,0.00,0.00,0.00,0,0.00,0,85.95,0,0,1,java.lang.Object,0.00,0,0,0,0,0,0,0,3,22,2
"org.apache.http.impl.conn.tsccm.RefQueueHandler",1,0.00,1.00,2,0.01,41.48,1,0,1,1,2,98.93,8,4,2,1,147.03,0.00,0.00,0.00,0,1.00,1,27.65,0,0,0,,0.00,0,0,1,0,0,1,0,2,11,1
"org.apache.http.impl.conn.tsccm.RefQueueWorker",4,0.08,2.75,28,0.29,6416.06,8,4,4,12,2,65.53,40,41,1,1,114.00,0.00,0.00,0.31,1,4.00,5,868.79,0,1,1,java.lang.Object,0.00,8,0,11,0,8,3,1,12,192,1
"org.apache.http.impl.conn.tsccm.RouteSpecificPool",9,0.12,1.67,39,0.34,6431.98,13,4,2,19,4,77.84,72,60,2,1,125.95,0.00,0.00,0.36,0,0.00,3,1033.04,0,1,2,java.lang.Object,0.00,10,0,15,0,10,8,0,17,251,1
"org.apache.http.impl.conn.tsccm.ThreadSafeClientConnManager",12,0.04,2.00,58,0.65,19140.76,17,5,12,31,19,75.06,98,102,8,1,123.16,0.00,0.00,0.17,1,14.00,8,1960.27,0,6,12,java.lang.Object,0.00,19,0,24,0,19,6,1,35,419,1
"org.apache.http.conn.util.InetAddressUtils",4,0.11,1.00,12,0.16,3007.18,7,3,1,7,1,130.55,0,23,1,1,130.55,0.00,0.00,0.25,1,10.00,1,473.89,0,0,0,java.lang.Object,0.00,3,0,4,0,3,4,0,0,118,1
"org.apache.http.conn.util.TestAllUtil",3,0.00,1.00,10,0.09,1733.04,3,0,3,8,3,131.45,0,14,2,2,131.45,0.00,0.50,0.00,0,3.00,1,272.38,0,1,1,junit.framework.TestCase,0.00,5,1,3,0,5,2,0,0,72,1
"org.apache.http.conn.util.TestInetAddressUtils",7,0.00,1.00,26,0.24,3452.24,7,0,3,16,3,132.00,4,34,2,2,132.00,0.00,0.50,0.00,0,7.00,1,732.47,0,1,1,junit.framework.TestCase,0.00,9,1,7,0,9,6,0,2,193,1
"org.apache.http.conn.BasicEofSensorWatcher",4,0.50,1.75,24,0.18,2892.32,6,2,2,9,2,87.11,27,40,0,1,119.33,0.00,0.00,0.88,0,0.00,2,545.93,0,0,2,java.lang.Object,0.00,5,0,7,0,5,4,1,11,130,1
"org.apache.http.conn.BasicManagedEntity",10,0.06,1.80,49,0.39,7474.53,12,2,4,18,5,126.01,47,87,1,2,125.78,0.00,0.50,0.55,2,0.00,3,1163.31,0,1,4,org.apache.http.entity.HttpEntityWrapper,0.00,8,1,18,0,8,9,3,18,276,1
"org.apache.http.conn.BasicRouteDirector",4,0.00,5.50,32,0.58,38224.38,4,0,0,13,5,95.22,63,58,3,1,105.58,0.00,0.00,0.00,0,0.00,11,1741.51,0,0,2,java.lang.Object,0.00,9,0,22,0,9,4,1,20,350,1
"org.apache.http.conn.ClientConnectionManager",7,0.00,1.00,8,0.04,163.10,7,0,1,7,23,111.76,74,18,19,1,160.23,0.00,0.00,0.00,0,7.00,1,127.07,0,4,4,,0.00,0,0,7,0,0,3,0,8,48,1
"org.apache.http.conn.ClientConnectionManagerFactory",1,0.00,1.00,2,0.01,39.00,1,0,1,1,3,115.02,6,5,1,1,147.24,0.00,0.00,0.00,0,1.00,1,34.00,0,1,2,,0.00,0,0,1,0,0,0,0,1,13,1
"org.apache.http.conn.ClientConnectionOperator",3,0.00,1.00,4,0.05,198.95,3,0,5,3,10,165.79,51,17,9,1,156.65,0.00,0.00,0.00,0,3.00,1,135.30,0,1,1,,0.00,0,0,3,0,0,2,0,4,39,1
"org.apache.http.conn.ConnectTimeoutException",2,1.00,1.00,6,0.04,402.15,3,1,1,2,3,86.96,16,9,3,2,135.06,1.00,0.33,0.00,0,2.00,1,110.07,0,0,0,java.io.InterruptedIOException,0.00,0,1,2,1,0,2,0,3,33,1
"org.apache.http.conn.ConnectionPoolTimeoutException",2,1.00,1.00,6,0.04,423.74,3,1,0,2,9,86.78,16,9,8,3,134.89,0.00,0.67,0.00,0,2.00,1,110.60,0,0,1,org.apache.http.conn.ConnectTimeoutException,0.00,0,2,2,0,0,2,0,3,33,1
"org.apache.http.conn.ConnectionReleaseTrigger",2,0.00,1.00,3,0.01,61.53,2,0,1,2,4,177.42,37,7,4,1,159.28,0.00,0.00,0.00,0,2.00,1,41.02,0,0,0,,0.00,0,0,2,0,0,2,0,3,17,1
"org.apache.http.conn.EofSensorInputStream",12,0.15,2.58,78,0.68,19230.05,15,3,2,20,3,68.04,126,123,1,2,116.52,0.00,0.50,0.47,5,0.00,4,2034.21,0,0,2,java.io.InputStream,0.00,8,1,31,0,8,12,1,25,458,1
"org.apache.http.conn.EofSensorWatcher",3,0.00,1.00,4,0.03,123.00,3,0,2,3,3,184.58,58,10,3,1,158.30,0.00,0.00,0.00,0,3.00,1,82.00,0,0,0,,0.00,0,0,3,0,0,3,0,4,29,1
"org.apache.http.conn.HttpHostConnectException",2,2.00,1.00,9,0.08,1203.12,4,2,2,3,1,126.66,0,12,1,2,126.66,0.00,0.50,0.00,0,2.00,1,239.90,0,1,0,java.net.ConnectException,0.00,1,1,2,0,1,1,0,0,60,1
"org.apache.http.conn.HttpRoute",20,0.15,2.40,116,1.58,96413.30,26,6,3,26,38,67.24,205,171,38,1,115.72,0.00,0.00,0.02,3,52.00,7,4746.19,1,8,0,java.lang.Object,0.00,6,0,48,0,6,12,1,30,986,2
"org.apache.http.conn.HttpRouteDirector",1,7.00,1.00,9,0.11,1853.20,8,7,0,1,5,141.58,31,10,4,1,109.67,0.00,0.00,0.00,0,1.00,1,334.60,0,0,1,,0.00,0,0,1,0,0,1,0,9,77,1
"org.apache.http.conn.HttpRoutePlanner",1,0.00,1.00,2,0.02,108.21,1,0,4,1,3,177.14,20,7,2,1,143.75,0.00,0.00,0.00,0,1.00,1,56.11,0,1,1,,0.00,0,0,1,0,0,0,0,2,17,1
"org.apache.http.conn.LayeredSocketFactory",1,0.00,1.00,2,0.03,129.64,1,0,3,1,2,193.13,25,8,2,2,143.13,0.00,0.50,0.00,0,1.00,1,75.21,0,1,0,,0.00,0,1,1,0,0,0,0,2,22,1
"org.apache.http.conn.ManagedClientConnection",10,0.00,1.00,11,0.08,330.72,10,0,7,10,14,129.65,138,26,13,4,159.03,0.00,0.75,0.00,0,10.00,1,227.48,0,1,1,,0.00,0,3,10,0,0,9,0,11,77,1
"org.apache.http.conn.OperatedClientConnection",6,0.00,1.00,7,0.06,244.34,6,0,6,6,9,176.46,109,18,9,3,158.32,0.00,0.67,0.00,0,6.00,1,168.57,0,2,0,,0.00,0,2,6,0,0,4,0,9,54,1
"org.apache.http.conn.PlainSocketFactory",7,1.00,2.14,34,0.38,15907.26,8,1,6,17,13,79.64,54,57,12,1,121.93,0.00,0.00,0.14,0,12.00,6,1140.74,0,3,1,java.lang.Object,0.00,10,0,15,0,10,4,1,19,244,2
"org.apache.http.conn.RouteTracker",21,0.13,2.67,135,1.78,103055.03,28,7,3,31,4,64.58,169,201,3,1,112.68,0.00,0.00,0.02,3,55.00,8,5330.01,1,7,1,java.lang.Object,0.00,10,0,56,0,10,14,1,36,1091,2
"org.apache.http.conn.Scheme",9,0.02,1.89,48,0.54,18358.56,14,5,2,18,18,68.72,86,70,17,1,118.72,0.00,0.00,0.22,0,34.00,4,1633.52,0,3,1,java.lang.Object,0.00,9,0,17,0,9,6,0,16,367,2
"org.apache.http.conn.SchemeRegistry",7,0.33,1.71,28,0.30,8127.54,8,1,5,17,18,75.81,72,42,17,1,124.28,0.00,0.00,0.71,2,0.00,2,899.95,0,1,1,java.lang.Object,0.00,10,0,12,0,10,6,0,13,210,2
"org.apache.http.conn.SocketFactory",3,0.00,1.00,4,0.04,216.04,3,0,5,3,13,206.37,75,16,12,1,156.37,0.00,0.00,0.00,0,3.00,1,132.91,0,2,1,,0.00,0,0,3,0,0,1,0,4,39,1
"org.apache.http.conn.TestAllConn",3,0.00,1.00,17,0.19,6384.35,3,0,5,15,10,118.72,0,21,2,2,118.72,0.00,0.50,0.00,0,3.00,1,563.72,0,1,8,junit.framework.TestCase,0.00,12,1,3,0,12,2,0,0,135,1
"org.apache.http.conn.TestExceptions",5,0.00,1.00,22,0.23,4289.72,5,0,3,18,4,125.44,4,30,2,2,125.44,0.00,0.50,0.00,0,5.00,1,692.78,0,1,2,junit.framework.TestCase,0.00,13,1,5,0,13,4,0,1,165,1
"org.apache.http.conn.TestHttpRoute",13,0.28,1.92,299,5.56,338426.05,22,9,7,47,3,105.90,45,416,2,2,85.28,0.00,0.50,0.37,0,0.00,7,16678.44,0,1,1,junit.framework.TestCase,0.00,34,1,25,0,34,12,0,43,2800,1
"org.apache.http.conn.TestParams",5,0.38,2.00,38,0.39,10361.49,7,2,7,19,4,70.91,36,66,2,2,113.20,0.00,0.50,0.20,0,7.00,6,1173.43,0,1,2,junit.framework.TestCase,0.00,14,1,10,0,14,4,0,9,262,1
"org.apache.http.conn.TestRouteDirector",10,0.11,1.10,211,3.34,162896.93,19,9,5,19,5,128.37,20,315,2,2,88.49,0.00,0.50,0.21,0,0.00,2,10030.92,0,1,3,junit.framework.TestCase,0.00,9,1,11,0,9,9,0,18,1868,1
"org.apache.http.conn.TestRouteTracker",14,0.18,2.93,344,5.62,523406.24,23,9,7,57,6,51.04,86,452,2,2,83.26,0.00,0.50,0.28,3,0.00,9,16870.99,0,2,4,junit.framework.TestCase,0.00,43,1,41,0,43,12,0,67,2980,1
"org.apache.http.conn.TestScheme",11,0.00,2.45,121,1.64,61076.18,11,0,6,42,6,142.35,27,178,2,2,102.46,0.00,0.50,0.00,0,11.00,7,4914.44,0,1,4,junit.framework.TestCase,0.00,31,1,27,0,31,10,0,22,977,1
"org.apache.http.client.protocol.ClientContext",0,0.00,0.00,9,0.12,1715.65,8,8,0,0,10,171.00,4,10,10,1,171.00,0.00,0.00,0.00,0,0.00,0,352.93,0,0,0,,0.00,0,0,0,0,0,0,0,1,76,1
"org.apache.http.client.protocol.RequestAddCookies",2,1.00,11.00,73,1.21,100734.30,3,1,23,35,10,31.24,22,98,1,1,75.37,0.00,0.00,0.50,0,2.00,21,3633.35,0,0,9,java.lang.Object,0.00,33,0,22,0,33,2,1,12,539,1
"org.apache.http.client.protocol.RequestDefaultHeaders",2,0.00,2.50,13,0.14,3855.56,2,0,9,7,2,98.02,10,18,1,1,115.89,0.00,0.00,0.00,0,2.00,4,427.20,0,0,1,java.lang.Object,0.00,5,0,5,0,5,2,1,2,88,1
"org.apache.http.client.protocol.RequestProxyAuthentication",2,1.00,5.50,26,0.35,15198.88,3,1,12,16,7,98.73,8,41,1,1,98.50,0.00,0.00,0.50,0,2.00,10,1041.21,0,0,6,java.lang.Object,0.00,14,0,11,0,14,2,1,2,188,1
"org.apache.http.client.protocol.RequestTargetAuthentication",2,1.00,5.50,26,0.35,15198.88,3,1,12,16,7,98.73,8,41,1,1,98.50,0.00,0.00,0.50,0,2.00,10,1041.21,0,0,6,java.lang.Object,0.00,14,0,11,0,14,2,1,2,188,1
"org.apache.http.client.protocol.ResponseProcessCookies",3,0.50,5.33,45,0.64,28345.49,4,1,15,18,8,77.57,16,72,1,1,95.44,0.00,0.00,0.67,1,1.00,8,1916.36,0,0,7,java.lang.Object,0.00,15,0,16,0,15,3,1,7,346,1
"org.apache.http.client.protocol.TestAllProtocol",3,0.00,1.00,11,0.10,2271.14,3,0,3,9,4,130.53,0,15,2,2,130.53,0.00,0.50,0.00,0,3.00,1,310.03,0,1,2,junit.framework.TestCase,0.00,6,1,3,0,6,2,0,0,81,1
"org.apache.http.client.protocol.TestCookie2Support",7,0.00,2.00,104,1.68,43954.95,7,0,26,35,14,148.18,10,119,2,3,98.18,0.00,0.67,0.00,0,7.00,3,5052.42,0,1,12,org.apache.http.localserver.ServerTestBase,0.00,28,2,14,0,28,6,0,4,857,1
"org.apache.http.client.protocol.TestCookie2Support$CookieVer0Service",1,0.00,1.00,7,0.11,1836.66,1,0,26,8,0,113.77,0,12,0,1,113.77,0.00,0.00,0.00,0,1.00,1,329.99,0,0,0,java.lang.Object,0.00,7,0,1,0,7,1,1,0,68,2
"org.apache.http.client.protocol.TestCookie2Support$CookieVer1Service",1,0.00,1.00,8,0.13,2312.69,1,0,26,8,0,110.82,0,13,0,1,110.82,0.00,0.00,0.00,0,1.00,1,386.72,0,0,0,java.lang.Object,0.00,7,0,1,0,7,1,1,0,78,2
"org.apache.http.client.protocol.TestCookie2Support$CookieVer2Service",1,0.00,1.00,7,0.11,1836.66,1,0,26,8,0,113.77,0,12,0,1,113.77,0.00,0.00,0.00,0,1.00,1,329.99,0,0,0,java.lang.Object,0.00,7,0,1,0,7,1,1,0,68,2
"org.apache.http.client.protocol.TestCookie2Support$SetCookieVersionMixService",1,0.00,1.00,8,0.13,2312.69,1,0,26,8,0,110.82,0,13,0,1,110.82,0.00,0.00,0.00,0,1.00,1,386.72,0,0,0,java.lang.Object,0.00,7,0,1,0,7,1,1,0,78,2
"org.apache.http.client.protocol.TestRedirects",19,0.00,1.84,254,4.39,98060.25,19,0,32,64,14,100.07,15,323,2,3,100.07,0.00,0.67,0.00,0,19.00,2,13171.62,0,1,12,org.apache.http.localserver.ServerTestBase,0.00,45,2,35,0,45,18,0,9,2274,1
"org.apache.http.client.protocol.TestRedirects$BasicRedirectService",3,3.00,2.00,25,0.36,9475.16,6,3,32,12,0,109.60,0,35,0,1,109.60,0.00,0.00,0.00,0,3.00,3,1071.11,0,0,0,java.lang.Object,0.00,9,0,6,0,9,3,1,0,212,1
"org.apache.http.client.protocol.TestRedirects$BogusRedirectService",2,1.00,2.00,17,0.23,5531.91,3,1,32,11,0,110.05,0,24,0,1,110.05,0.00,0.00,0.50,0,2.00,3,683.72,0,0,0,java.lang.Object,0.00,9,0,4,0,9,2,1,0,135,1
"org.apache.http.client.protocol.TestRedirects$CircularRedirectService",2,1.00,2.00,15,0.23,7537.38,3,1,32,9,0,111.15,0,22,0,1,111.15,0.00,0.00,0.00,0,2.00,3,701.82,0,0,0,java.lang.Object,0.00,7,0,4,0,7,2,1,0,137,1
"org.apache.http.client.protocol.TestRedirects$RelativeRedirectService",2,0.00,2.00,15,0.21,5455.07,2,0,32,11,0,112.26,0,22,0,1,112.26,0.00,0.00,0.00,0,2.00,3,625.07,0,0,0,java.lang.Object,0.00,9,0,4,0,9,2,1,0,122,1
"org.apache.http.auth.AUTH",1,4.00,1.00,6,0.06,774.52,5,4,0,1,10,145.51,19,8,10,1,119.22,0.00,0.00,0.00,0,1.00,1,175.59,0,0,0,java.lang.Object,0.00,0,0,1,0,0,1,0,5,45,2
"org.apache.http.auth.AuthScheme",7,0.00,1.00,8,0.04,190.08,7,0,2,7,15,122.15,86,10,12,1,159.71,0.00,0.00,0.00,0,7.00,1,121.84,0,4,3,,0.00,0,0,7,0,0,3,0,8,47,1
"org.apache.http.auth.AuthSchemeFactory",1,0.00,1.00,2,0.01,30.51,1,0,1,1,2,115.86,6,3,1,1,148.08,0.00,0.00,0.00,0,1.00,1,25.51,0,1,1,,0.00,0,0,1,0,0,0,0,1,11,1
"org.apache.http.auth.AuthSchemeRegistry",4,0.00,2.25,22,0.26,7203.50,5,1,5,14,5,81.54,48,35,3,1,119.10,0.00,0.00,1.00,0,0.00,3,774.20,0,2,2,java.lang.Object,0.00,10,0,9,0,10,2,0,5,169,2
"org.apache.http.auth.AuthScope",12,0.01,2.67,92,1.13,52120.62,21,9,1,25,9,62.50,105,127,9,1,110.60,0.00,0.00,0.10,0,28.00,9,3386.53,1,4,0,java.lang.Object,0.00,13,0,32,0,13,8,0,22,724,1
"org.apache.http.auth.AuthenticationException",3,1.00,1.00,8,0.05,538.90,4,1,1,3,11,99.73,22,12,11,2,142.02,1.00,0.33,0.00,0,3.00,1,153.79,0,0,0,org.apache.http.ProtocolException,0.00,0,1,3,1,0,3,0,4,46,1
"org.apache.http.auth.Credentials",2,0.00,1.00,3,0.01,31.00,2,0,0,2,15,161.86,8,4,15,1,161.63,0.00,0.00,0.00,0,2.00,1,26.00,0,2,0,,0.00,0,0,2,0,0,0,0,1,13,1
"org.apache.http.auth.InvalidCredentialsException",3,1.00,1.00,8,0.05,538.90,4,1,0,3,1,99.73,23,12,0,3,142.02,0.00,0.67,0.00,0,3.00,1,153.79,0,0,1,org.apache.http.auth.AuthenticationException,0.00,0,2,3,0,0,3,0,4,46,1
"org.apache.http.auth.MalformedChallengeException",3,1.00,1.00,8,0.05,483.35,4,1,1,3,12,100.10,23,12,12,2,142.39,0.00,0.50,0.00,0,3.00,1,148.39,0,0,0,org.apache.http.ProtocolException,0.00,0,1,3,0,0,3,0,4,45,1
"org.apache.http.auth.UsernamePasswordCredentials",8,0.43,2.00,44,0.44,13083.42,10,2,1,18,8,77.17,62,59,7,1,119.46,0.00,0.00,0.12,1,20.00,5,1310.14,0,4,1,java.lang.Object,0.00,10,0,16,0,10,4,1,15,303,1
"org.apache.http.client.utils.URLUtils",3,1.00,3.00,25,0.32,16181.27,4,1,4,11,1,116.80,52,38,1,1,107.67,0.00,0.00,0.33,1,4.00,5,948.18,0,2,0,java.lang.Object,0.00,8,0,9,0,8,1,0,6,189,1
"org.apache.http.auth.params.AuthPNames",0,0.00,0.00,2,0.01,157.40,1,1,0,0,1,171.00,18,3,1,1,171.00,0.00,0.00,0.00,0,0.00,0,44.97,0,0,0,,0.00,0,0,0,0,0,0,0,2,13,1
"org.apache.http.auth.params.AuthParams",3,0.00,2.00,14,0.14,3504.07,3,0,2,6,3,75.75,31,22,2,1,124.23,0.00,0.00,0.00,0,3.00,3,409.30,0,1,1,java.lang.Object,0.00,3,0,6,0,3,2,0,5,94,2
"org.apache.http.client.methods.AbortableHttpRequest",2,0.00,1.00,3,0.01,38.51,2,0,1,2,3,143.01,11,4,2,1,160.88,0.00,0.00,0.00,0,2.00,1,33.51,0,0,1,,0.00,0,0,2,0,0,2,0,1,15,1
"org.apache.http.client.methods.HttpEntityEnclosingRequestBase",4,1.00,1.00,11,0.10,1352.80,5,1,4,7,3,179.74,9,17,2,3,139.85,1.00,0.40,0.00,0,4.00,1,288.27,0,1,1,org.apache.http.client.methods.HttpRequestBase,0.00,3,2,4,2,3,3,1,1,76,1
"org.apache.http.client.methods.HttpGet",4,1.00,1.00,12,0.07,747.10,5,1,2,5,16,117.44,21,17,15,3,135.32,0.00,0.67,0.25,0,6.00,1,216.45,1,1,1,org.apache.http.client.methods.HttpRequestBase,0.25,1,2,4,0,1,3,0,1,63,1
"org.apache.http.client.methods.HttpHead",4,1.00,1.00,12,0.07,747.10,5,1,2,5,1,117.44,21,17,0,3,135.32,0.00,0.67,0.25,0,6.00,1,216.45,1,1,1,org.apache.http.client.methods.HttpRequestBase,0.25,1,2,4,0,1,3,0,1,63,1
"org.apache.http.client.methods.HttpOptions",5,1.00,1.60,26,0.24,7420.63,6,1,9,12,1,140.46,19,33,0,3,119.84,0.00,0.67,0.20,0,8.00,4,707.15,1,2,1,org.apache.http.client.methods.HttpRequestBase,0.23,7,2,8,0,7,3,0,1,154,1
"org.apache.http.client.methods.HttpPost",4,1.00,1.00,12,0.07,747.10,5,1,2,5,5,103.09,25,17,4,4,135.32,0.00,0.75,0.25,0,6.00,1,216.45,1,1,1,org.apache.http.client.methods.HttpEntityEnclosingRequestBase,0.25,1,3,4,0,1,3,0,1,63,1
"org.apache.http.client.methods.HttpPut",4,1.00,1.00,12,0.07,747.10,5,1,2,5,1,135.55,17,17,0,4,135.32,0.00,0.75,0.25,0,6.00,1,216.45,1,1,1,org.apache.http.client.methods.HttpEntityEnclosingRequestBase,0.25,1,3,4,0,1,3,0,1,63,1
"org.apache.http.client.methods.HttpRequestBase",8,2.00,1.38,28,0.22,3753.31,10,2,8,13,8,182.09,10,41,5,2,132.09,7.00,0.11,0.00,3,8.00,3,648.78,0,4,3,org.apache.http.message.AbstractHttpMessage,0.00,5,1,11,7,5,4,2,2,163,1
"org.apache.http.client.methods.HttpTrace",4,1.00,1.00,12,0.07,747.10,5,1,2,5,1,117.44,20,17,0,3,135.32,0.00,0.67,0.25,0,6.00,1,216.45,1,1,1,org.apache.http.client.methods.HttpRequestBase,0.25,1,2,4,0,1,3,0,1,63,1
"org.apache.http.client.methods.HttpUriRequest",2,0.00,1.00,3,0.01,52.19,2,0,2,2,5,127.62,12,4,5,2,159.84,0.00,0.50,0.00,0,2.00,1,34.09,0,2,0,,0.00,0,1,2,0,0,0,0,1,15,1
"org.apache.http.client.methods.UrlEncodedFormEntity",8,0.50,1.12,26,0.25,3807.34,10,2,12,16,2,132.09,1,39,1,2,132.09,0.00,0.50,0.06,0,14.00,2,756.69,0,2,1,org.apache.http.entity.AbstractHttpEntity,0.00,8,1,9,0,8,6,0,1,183,1
"org.apache.http.cookie.params.CookieSpecPNames",0,0.00,0.00,3,0.03,332.42,2,2,0,0,4,171.00,28,4,4,1,171.00,0.00,0.00,0.00,0,0.00,0,81.41,0,0,0,,0.00,0,0,0,0,0,0,0,3,22,1
"org.apache.http.localserver.EchoHandler",1,0.00,4.00,17,0.30,13378.02,1,0,12,15,1,142.28,25,29,1,1,92.29,0.00,0.00,0.00,0,1.00,4,909.67,0,0,0,java.lang.Object,0.00,14,0,4,0,14,1,1,6,158,1
"org.apache.http.localserver.LocalTestServer",11,0.06,1.73,63,0.72,17173.78,18,7,27,46,4,71.55,94,96,2,1,119.65,0.00,0.00,0.19,1,40.00,4,2159.94,0,3,2,java.lang.Object,0.00,35,0,19,0,35,8,0,24,473,1
"org.apache.http.localserver.LocalTestServer$RequestListener",3,0.50,2.67,32,0.41,11282.01,4,1,27,23,1,125.93,11,50,0,1,105.32,0.00,0.00,0.67,2,0.00,4,1226.12,0,0,1,java.lang.Object,0.00,20,0,8,0,20,3,1,9,246,1
"org.apache.http.localserver.LocalTestServer$RequestListener$Worker",2,2.00,3.00,14,0.19,5019.28,4,2,27,6,0,162.45,2,26,0,1,112.45,0.00,0.00,0.00,0,2.00,5,566.78,0,0,0,java.lang.Object,0.00,4,0,6,0,4,2,1,2,121,1
"org.apache.http.localserver.RandomHandler",1,0.00,7.00,28,0.51,30094.73,1,0,12,22,1,88.57,35,43,1,1,81.30,0.00,0.00,0.00,0,1.00,7,1523.94,0,0,0,java.lang.Object,0.00,21,0,7,0,21,1,1,8,250,1
"org.apache.http.localserver.RandomHandler$RandomEntity",6,0.20,1.83,41,0.43,24481.62,8,2,12,13,0,81.18,40,57,0,2,113.40,0.00,0.50,0.33,0,6.00,4,1301.88,0,1,0,org.apache.http.entity.AbstractHttpEntity,0.00,7,1,11,0,7,5,0,12,270,2
"org.apache.http.localserver.ServerTestBase",7,0.11,1.71,46,0.55,11371.26,13,6,18,39,6,72.44,77,68,0,2,116.57,4.00,0.17,0.26,1,5.00,6,1656.19,0,4,6,junit.framework.TestCase,0.00,32,1,12,4,32,3,0,16,337,2
