Name, No. Methods, LCOM, AVCC, NOS, HBUG, HEFF, UWCS, INST, PACK, RFC, CBO, MI, CCML, NLOC, F-IN, DIT, MINC, S-R, R-R, COH, LMC, LCOM2, MAXCC, HVOL, HIER, NQU, FOUT, Superclass, SIX, EXT, NSUP, TCC, NSUB, MPC, NCO, INTR, CCOM, HLTH, MOD
"org.apache.jackrabbit.core.fs.BasedFileSystem",22,0.02,1.32,61,0.67,13866.82,24,2,2,46,6,158.28,72,92,3,1,137.66,0.00,0.00,0.48,1,0.00,6,2015.61,0,6,3,java.lang.Object,0.00,24,0,29,0,24,16,1,25,502,1
"org.apache.jackrabbit.core.fs.FileSystem",20,2.00,1.00,23,0.22,1581.24,22,2,2,20,24,107.95,177,25,22,1,156.05,0.00,0.00,0.00,0,20.00,1,662.13,0,5,2,,0.00,0,0,20,0,0,15,0,23,205,1
"org.apache.jackrabbit.core.fs.FileSystemException",4,0.00,1.00,9,0.05,332.37,4,0,1,4,19,112.43,27,14,18,3,144.65,0.00,0.67,0.00,0,4.00,1,136.79,0,0,1,org.apache.jackrabbit.core.BaseException,0.00,0,2,4,0,0,4,0,5,46,1
"org.apache.jackrabbit.core.fs.FileSystemPathUtil",7,0.08,2.00,73,0.77,33719.21,11,4,2,23,5,62.25,54,78,4,1,104.54,0.00,0.00,0.18,1,23.00,4,2310.87,0,6,1,java.lang.Object,0.00,16,0,14,0,16,1,0,11,470,2
"org.apache.jackrabbit.core.fs.FileSystemResource",19,0.22,1.58,65,0.66,18145.18,21,2,3,37,19,129.87,90,101,15,1,129.63,0.00,0.00,0.71,3,0.00,5,1978.22,0,7,4,java.lang.Object,0.00,18,0,30,0,18,12,0,21,470,1
"org.apache.jackrabbit.core.fs.RandomAccessOutputStream",1,0.00,1.00,2,0.02,132.18,1,0,2,1,5,105.50,12,3,5,2,143.07,1.00,0.33,0.00,0,1.00,1,52.87,0,0,0,java.io.OutputStream,0.00,0,1,1,1,0,1,0,2,17,2
"org.apache.jackrabbit.examples.FirstSteps",3,0.00,3.67,51,0.73,29851.98,3,0,15,33,1,61.10,20,63,0,1,93.32,0.00,0.00,0.00,2,3.00,6,2183.23,0,1,1,java.lang.Object,0.00,30,0,11,0,30,2,0,4,393,1
"org.apache.jackrabbit.core.state.AbstractPersistenceManager",9,0.00,1.89,40,0.45,19413.66,9,0,3,21,14,89.92,55,55,5,1,122.14,0.00,0.00,0.00,2,9.00,9,1341.99,0,0,9,java.lang.Object,0.00,12,0,17,5,12,9,1,10,300,2
"org.apache.jackrabbit.core.state.ChangeLog",15,0.14,2.20,96,1.06,28901.83,19,4,4,40,18,83.70,96,133,11,1,115.92,0.00,0.00,0.38,2,15.00,6,3172.63,0,4,7,java.lang.Object,0.00,25,0,33,0,25,11,0,22,727,1
"org.apache.jackrabbit.core.state.ItemState",31,0.05,1.74,161,1.64,47830.86,47,16,10,57,29,87.47,194,220,28,1,119.69,0.00,0.00,0.11,6,440.00,4,4919.22,0,3,2,java.lang.Object,0.00,26,0,54,8,26,28,2,62,1050,2
"org.apache.jackrabbit.core.state.ItemStateCache",13,0.00,1.85,59,0.62,13080.23,15,2,8,34,7,92.53,82,83,5,1,124.76,0.00,0.00,0.50,3,0.00,10,1868.17,0,2,2,java.lang.Object,0.00,21,0,24,5,21,11,0,17,422,2
"org.apache.jackrabbit.core.state.ItemStateException",4,0.00,1.00,9,0.05,332.37,4,0,1,4,39,112.43,27,14,38,3,144.65,0.50,0.50,0.00,0,4.00,1,136.79,0,0,1,org.apache.jackrabbit.core.BaseException,0.00,0,2,4,1,0,4,0,5,46,1
"org.apache.jackrabbit.core.state.ItemStateListener",4,0.00,1.00,5,0.03,129.91,4,0,0,4,3,116.81,31,6,3,1,159.10,0.00,0.00,0.00,0,4.00,1,86.61,0,0,1,,0.00,0,0,4,0,0,4,0,5,32,1
"org.apache.jackrabbit.core.state.ItemStateManager",3,0.00,1.00,4,0.03,174.35,3,0,1,3,22,109.00,24,7,16,1,157.11,0.00,0.00,0.00,0,3.00,1,94.09,0,2,6,,0.00,0,0,3,0,0,1,0,4,31,1
"org.apache.jackrabbit.core.state.LocalItemStateManager",21,0.06,1.86,108,1.06,23540.42,26,5,8,48,19,88.55,127,157,2,2,120.77,1.00,0.33,0.26,3,19.00,4,3169.96,6,3,17,org.apache.jackrabbit.core.state.ItemStateCache,0.00,27,1,39,1,27,18,2,45,713,1
"org.apache.jackrabbit.core.state.NoSuchItemStateException",4,0.00,1.00,9,0.05,332.37,4,0,0,4,27,112.43,27,14,26,4,144.65,0.00,0.75,0.00,0,4.00,1,136.79,0,0,1,org.apache.jackrabbit.core.state.ItemStateException,0.00,0,3,4,0,0,4,0,5,46,1
"org.apache.jackrabbit.core.state.NodeReferences",9,0.06,1.00,23,0.19,2792.47,13,4,4,18,23,107.93,55,33,21,1,140.15,0.00,0.00,0.19,0,14.00,1,555.55,0,3,2,java.lang.Object,0.00,9,0,9,0,9,6,1,14,149,1
"org.apache.jackrabbit.core.state.NodeReferencesId",3,0.00,2.00,14,0.11,2378.42,3,0,1,6,22,83.26,22,21,21,3,125.55,0.00,0.67,0.00,0,4.00,3,331.13,0,1,1,org.apache.jackrabbit.core.NodeId,0.00,3,2,6,0,3,2,0,4,83,1
"org.apache.jackrabbit.core.state.NodeState",42,0.00,1.81,217,2.32,54832.61,50,8,8,86,39,88.03,289,296,35,2,120.25,5.00,0.14,0.12,0,786.00,5,6952.24,3,15,4,org.apache.jackrabbit.core.state.ItemState,0.05,44,1,76,5,44,27,0,57,1515,1
"org.apache.jackrabbit.core.state.NodeState$ChildEntry",2,1.00,1.00,6,0.04,425.80,3,1,8,2,1,134.87,0,9,0,1,134.87,0.00,0.00,0.50,0,2.00,1,110.47,0,1,1,java.lang.Object,0.00,0,0,2,0,0,1,1,0,33,3
"org.apache.jackrabbit.core.state.NodeState$ChildNodeEntries",8,0.14,1.88,52,0.56,23638.94,10,2,8,29,1,164.50,9,65,0,1,114.50,0.00,0.00,0.62,2,0.00,6,1694.20,0,2,1,java.lang.Object,0.00,21,0,15,0,21,6,1,9,360,2
"org.apache.jackrabbit.core.state.NodeState$ChildNodeEntry",6,0.20,1.83,34,0.32,9422.18,9,3,8,12,1,119.62,2,47,0,2,119.62,0.00,0.50,0.50,0,0.00,3,952.21,0,2,1,org.apache.jackrabbit.core.state.ChildEntry,0.00,6,1,11,0,6,4,0,2,222,2
"org.apache.jackrabbit.core.state.NodeState$PropertyEntry",4,1.00,1.75,17,0.12,2592.16,5,1,8,7,1,126.27,1,25,0,2,126.27,0.00,0.50,0.25,0,6.00,3,373.83,0,1,1,org.apache.jackrabbit.core.state.ChildEntry,0.00,3,1,7,0,3,3,0,1,97,2
"org.apache.jackrabbit.core.state.PMContext",6,0.04,1.00,22,0.15,1838.37,11,5,4,6,9,85.52,53,33,7,1,133.62,0.00,0.00,0.17,0,26.00,1,445.88,0,5,2,java.lang.Object,0.00,0,0,6,0,0,1,0,12,118,1
"org.apache.jackrabbit.core.state.PersistenceManager",11,0.00,1.00,12,0.10,594.87,11,0,2,11,15,125.13,71,16,5,1,157.35,0.00,0.00,0.00,0,11.00,1,309.26,0,3,10,,0.00,0,0,11,0,0,8,0,12,100,1
"org.apache.jackrabbit.core.state.PropertyState",15,0.07,1.53,94,1.01,38493.53,21,6,9,46,33,97.15,84,117,26,2,115.03,1.00,0.33,0.23,0,44.00,6,3020.76,2,3,7,org.apache.jackrabbit.core.state.ItemState,0.09,31,1,23,1,31,12,0,24,602,1
"org.apache.jackrabbit.core.state.SessionItemStateManager",27,0.08,2.41,198,2.41,176478.52,32,5,20,87,21,59.23,268,265,1,1,109.23,0.00,0.00,0.27,0,0.00,22,7244.96,0,7,20,java.lang.Object,0.00,60,0,65,0,60,20,1,83,1352,1
"org.apache.jackrabbit.core.state.SessionItemStateManager$PathComparator",1,0.00,8.00,26,0.31,19573.92,1,0,20,7,2,41.65,7,32,0,1,83.94,0.00,0.00,0.00,0,0.00,8,920.27,0,0,2,java.lang.Object,0.00,6,0,8,0,6,1,1,3,168,1
"org.apache.jackrabbit.core.state.SharedItemStateManager",20,0.07,2.60,185,2.21,95926.73,24,4,17,85,30,63.91,156,241,6,2,106.20,0.00,0.50,0.19,6,96.00,10,6616.03,6,1,24,org.apache.jackrabbit.core.state.ItemStateCache,0.00,65,1,52,0,65,19,2,60,1293,1
"org.apache.jackrabbit.core.state.TransactionContext",7,0.00,1.43,39,0.32,6946.59,9,2,4,19,4,78.96,51,48,4,1,121.25,0.00,0.00,0.50,1,6.00,2,948.72,0,1,1,java.lang.Object,0.00,12,0,10,0,12,6,0,10,225,1
"org.apache.jackrabbit.core.state.TransactionException",3,0.00,1.00,7,0.04,296.18,3,0,1,3,3,101.77,21,11,2,3,144.07,0.00,0.67,0.00,0,3.00,1,118.69,0,0,1,org.apache.jackrabbit.core.BaseException,0.00,0,2,3,0,0,3,0,4,39,1
"org.apache.jackrabbit.core.state.TransactionListener",2,0.00,1.00,3,0.02,70.95,2,0,0,2,1,110.69,16,4,1,1,158.79,0.00,0.00,0.00,0,2.00,1,47.30,0,0,1,,0.00,0,0,2,0,0,2,0,3,18,1
"org.apache.jackrabbit.core.state.TransactionalItemStateManager",8,0.05,3.50,75,0.83,26538.83,11,3,3,24,12,58.91,82,107,1,3,107.39,0.00,0.67,0.38,0,0.00,7,2492.08,4,2,12,org.apache.jackrabbit.core.state.LocalItemStateManager,0.00,16,2,28,0,16,6,0,23,525,1
"org.apache.jackrabbit.core.state.TransactionalItemStateManager$CommitLog",2,1.00,1.00,6,0.03,323.88,3,1,3,2,1,103.58,12,9,0,1,135.80,0.00,0.00,0.50,0,2.00,1,98.97,0,1,1,java.lang.Object,0.00,0,0,2,0,0,1,0,3,31,2
"org.apache.jackrabbit.core.state.TransactionalItemStateManager$ThreadLocal",1,0.00,1.00,3,0.01,139.89,1,0,3,2,0,136.30,0,4,0,1,136.30,0.00,0.00,0.00,0,1.00,1,44.54,0,1,0,java.lang.Object,0.00,1,0,1,0,1,0,0,0,15,0
"org.apache.jackrabbit.core.state.TransientItemStateManager",20,0.18,1.35,95,0.88,19868.31,22,2,8,45,14,107.00,118,129,1,2,124.87,0.00,0.50,0.32,2,86.00,3,2627.48,7,2,13,org.apache.jackrabbit.core.state.ItemStateCache,0.00,25,1,27,0,25,18,1,46,613,0
"org.apache.jackrabbit.core.state.TransientItemStateManager$Attic",4,0.00,1.25,13,0.11,2256.84,4,0,8,7,8,171.37,9,21,0,2,131.48,0.00,0.50,0.00,0,4.00,2,326.61,2,0,8,org.apache.jackrabbit.core.state.ItemStateCache,0.00,3,1,5,0,3,4,1,3,85,0
"org.apache.jackrabbit.core.state.UpdatableItemStateManager",8,0.00,1.00,9,0.06,320.91,8,0,1,8,14,126.15,53,11,8,2,158.37,0.00,0.50,0.00,0,8.00,1,190.45,0,2,6,,0.00,0,1,8,0,0,6,0,9,66,1
"org.apache.jackrabbit.core.search.xpath.QueryFormat",15,0.14,3.93,220,3.05,135848.53,18,3,12,74,21,136.66,38,260,2,1,96.77,0.00,0.00,0.47,1,0.00,13,9158.65,0,13,19,java.lang.Object,0.00,59,0,59,0,59,2,2,9,1673,0
"org.apache.jackrabbit.core.search.xpath.SimpleNode",20,0.06,1.45,68,0.59,14946.68,25,5,0,27,2,130.49,17,90,2,1,130.49,0.00,0.00,0.14,3,204.00,4,1770.85,0,5,0,java.lang.Object,0.00,7,0,29,0,7,15,1,6,428,1
"org.apache.jackrabbit.core.search.xpath.XPathQueryBuilder",13,0.08,7.08,304,5.21,345612.21,34,21,9,94,24,64.77,189,398,2,1,84.91,0.00,0.00,0.12,3,0.00,22,15633.88,0,8,22,java.lang.Object,0.00,81,0,92,0,81,5,2,69,2572,1
"org.apache.jackrabbit.core.config.AccessManagerConfig",1,0.00,1.00,3,0.02,106.02,1,0,0,1,4,126.90,15,5,3,2,137.25,0.00,0.50,0.00,0,1.00,1,45.51,0,0,1,org.apache.jackrabbit.core.config.BeanConfig,0.00,0,1,1,0,0,1,0,2,16,1
"org.apache.jackrabbit.core.config.BeanConfig",5,0.12,1.40,22,0.22,5550.12,7,2,3,15,8,76.38,43,32,8,1,124.48,0.00,0.00,0.40,0,6.00,3,670.66,0,3,0,java.lang.Object,0.00,10,0,7,3,10,2,0,8,155,1
"org.apache.jackrabbit.core.config.ConfigurationEntityResolver",1,0.00,2.00,10,0.13,2728.61,4,3,5,6,1,138.39,31,18,1,1,106.48,0.00,0.00,1.00,0,0.00,2,380.51,0,1,0,java.lang.Object,0.00,5,0,2,0,5,0,1,5,83,1
"org.apache.jackrabbit.core.config.ConfigurationException",2,0.00,1.00,5,0.03,221.18,2,0,1,2,1,101.39,14,8,1,2,143.68,0.00,0.50,0.00,0,2.00,1,88.69,0,0,0,javax.jcr.RepositoryException,0.00,0,1,2,0,0,2,0,3,29,1
"org.apache.jackrabbit.core.config.ConfigurationParser",13,0.08,3.62,202,3.19,149131.39,35,22,20,74,12,94.39,209,292,4,1,94.87,0.00,0.00,0.12,6,44.00,10,9569.05,0,12,9,java.lang.Object,0.00,61,0,47,0,61,1,0,53,1659,1
"org.apache.jackrabbit.core.config.PersistenceManagerConfig",1,0.00,1.00,3,0.02,106.02,1,0,0,1,6,126.90,15,5,5,2,137.25,0.00,0.50,0.00,0,1.00,1,45.51,0,0,1,org.apache.jackrabbit.core.config.BeanConfig,0.00,0,1,1,0,0,1,0,2,16,1
"org.apache.jackrabbit.core.config.RepositoryConfig",13,0.00,1.08,53,0.48,8656.95,23,10,7,23,11,94.07,86,76,6,1,126.29,0.00,0.00,0.10,0,107.00,2,1437.54,0,11,6,java.lang.Object,0.00,10,0,14,0,10,2,0,19,335,1
"org.apache.jackrabbit.core.config.RepositoryConfigTest",2,0.00,1.00,18,0.28,5163.33,3,1,5,25,5,108.77,9,27,1,2,108.54,0.00,0.50,1.00,0,0.00,1,825.13,0,0,4,junit.framework.TestCase,0.00,23,1,2,0,23,2,0,2,159,1
"org.apache.jackrabbit.core.config.SearchConfig",3,1.00,1.00,9,0.06,628.32,4,1,2,3,6,135.16,14,14,4,2,134.92,0.00,0.50,0.33,0,4.00,1,174.56,1,2,2,org.apache.jackrabbit.core.config.BeanConfig,0.00,0,1,3,0,0,1,0,4,50,1
"org.apache.jackrabbit.core.config.TestAll",1,0.00,1.00,6,0.05,1283.53,1,0,3,3,2,79.93,12,8,0,2,117.50,0.00,0.50,0.00,0,1.00,1,150.40,0,1,2,junit.framework.TestCase,0.00,2,1,1,0,2,0,0,2,39,1
"org.apache.jackrabbit.core.config.VersioningConfig",4,0.11,1.00,14,0.09,1222.82,7,3,2,6,7,133.87,16,19,4,1,133.63,0.00,0.00,0.25,0,10.00,1,281.75,0,2,3,java.lang.Object,0.00,2,0,4,0,2,2,0,6,80,1
"org.apache.jackrabbit.core.config.WorkspaceConfig",6,0.04,1.00,22,0.15,1696.01,11,5,1,7,13,91.61,44,29,9,1,133.90,0.00,0.00,0.17,0,26.00,1,437.43,0,3,4,java.lang.Object,0.00,1,0,6,0,1,3,0,11,116,1
"org.apache.jackrabbit.core.config.WorkspaceConfigTest",2,0.00,1.00,21,0.33,6255.77,3,1,4,23,5,106.41,9,30,1,2,106.17,0.00,0.50,1.00,0,0.00,1,985.73,0,0,4,junit.framework.TestCase,0.00,21,1,2,0,21,2,0,2,186,1
"org.apache.jackrabbit.rmi.xml.ImportContentHandler",13,0.00,1.08,32,0.33,4913.98,15,2,7,29,2,179.34,37,53,2,1,139.46,0.00,0.00,0.50,1,0.00,2,1002.08,0,0,0,java.lang.Object,0.00,16,0,14,2,16,13,1,16,264,2
"org.apache.jackrabbit.rmi.xml.SessionImportContentHandler",2,0.00,1.00,8,0.07,966.42,4,2,2,4,2,98.02,26,11,1,2,127.40,0.00,0.50,0.50,0,2.00,1,209.06,0,0,1,org.apache.jackrabbit.rmi.xml.ImportContentHandler,0.13,2,1,2,0,2,2,0,5,56,1
"org.apache.jackrabbit.rmi.xml.WorkspaceImportContentHandler",2,0.33,1.00,10,0.09,1299.15,5,3,2,4,2,102.64,28,13,1,2,122.78,0.00,0.50,0.50,0,2.00,1,272.40,0,0,1,org.apache.jackrabbit.rmi.xml.ImportContentHandler,0.13,2,1,2,0,2,2,0,6,70,1
"org.apache.jackrabbit.core.fs.local.FileUtil",3,0.00,5.00,45,0.58,43930.82,3,0,4,21,1,61.73,19,55,1,1,93.96,0.00,0.00,0.00,2,3.00,10,1739.07,0,0,0,java.lang.Object,0.00,18,0,15,0,18,3,0,8,316,2
"org.apache.jackrabbit.core.fs.local.LocalFileSystem",26,0.16,2.23,181,2.29,90794.97,28,2,5,56,9,134.50,88,240,4,1,113.89,0.00,0.00,0.65,2,0.00,6,6879.80,0,8,5,java.lang.Object,0.00,30,0,58,0,30,18,1,29,1419,1
"org.apache.jackrabbit.core.fs.local.LocalFileSystem$FileFilter",1,0.00,1.00,3,0.02,173.90,1,0,5,2,0,135.56,0,4,0,1,135.56,0.00,0.00,0.00,0,1.00,1,52.97,0,0,0,java.lang.Object,0.00,1,0,1,0,1,1,0,0,17,0
"org.apache.jackrabbit.core.fs.local.LocalFileSystem$FileFilter_0",1,0.00,1.00,3,0.02,173.90,1,0,5,2,0,135.56,0,4,0,1,135.56,0.00,0.00,0.00,0,1.00,1,52.97,0,0,0,java.lang.Object,0.00,1,0,1,0,1,1,0,0,17,0
"org.apache.jackrabbit.core.fs.local.RAFOutputStream",9,0.12,1.11,39,0.37,7311.79,15,6,3,14,2,93.38,58,50,1,3,125.60,0.00,0.67,0.28,2,17.00,2,1095.68,0,0,1,org.apache.jackrabbit.core.fs.RandomAccessOutputStream,0.30,5,2,10,0,5,9,0,16,260,0
"org.apache.jackrabbit.test.api.util.TestAll",1,0.00,1.00,4,0.03,457.63,1,0,3,2,0,90.03,12,6,0,2,127.59,0.00,0.50,0.00,0,1.00,1,76.45,0,1,0,junit.framework.TestCase,0.00,1,1,1,0,1,0,0,3,23,1
"org.apache.jackrabbit.tck.TckHelper",1,0.00,4.00,10,0.08,2307.49,1,0,0,1,2,127.51,3,16,1,1,106.90,0.00,0.00,0.00,0,1.00,4,244.84,0,1,1,java.lang.Object,0.00,0,0,4,0,0,0,0,1,55,1
"org.apache.jackrabbit.tck.TckTestRunner",12,0.07,1.83,74,0.79,28926.46,23,11,9,31,4,115.44,58,101,1,2,115.20,0.00,0.50,0.15,1,36.00,9,2372.41,0,1,3,junit.runner.BaseTestRunner,0.00,19,1,22,0,19,11,0,20,485,1
"org.apache.jackrabbit.tck.TestResult",9,0.08,1.00,26,0.19,2384.31,17,8,1,9,3,190.69,12,36,3,1,140.69,0.00,0.00,0.06,0,37.00,1,562.52,0,2,0,java.lang.Object,0.00,0,0,9,0,0,7,0,10,148,1
"org.apache.jackrabbit.tck.Tester",5,0.20,2.40,47,0.74,20088.35,10,5,10,37,5,56.82,47,61,0,1,106.82,0.00,0.00,0.36,1,4.00,5,2216.10,0,1,5,java.lang.Object,0.00,32,0,12,0,32,4,0,15,419,1
"org.apache.jackrabbit.tck.WebAppTestConfig",7,1.00,2.86,72,1.25,47379.87,8,1,12,40,5,61.00,54,113,2,1,103.29,0.00,0.00,0.00,5,7.00,4,3759.23,0,5,3,java.lang.Object,0.00,33,0,20,0,33,2,0,17,730,1
"org.apache.jackrabbit.core.state.mem.InMemPersistenceManager",30,0.09,2.47,291,3.63,171538.01,44,14,14,115,20,87.74,150,377,0,2,105.61,0.00,0.50,0.15,3,98.00,6,10898.03,1,8,20,org.apache.jackrabbit.core.state.AbstractPersistenceManager,0.00,85,1,74,0,85,22,1,85,2057,1
"org.apache.jackrabbit.test.AbstractJCRTest",6,0.19,6.67,175,2.60,168176.33,37,31,12,50,40,120.29,131,209,37,3,80.99,44.00,0.02,0.19,2,10.00,21,7794.84,0,3,3,org.apache.jackrabbit.test.JUnitTest,0.00,44,2,40,88,44,3,0,49,1267,2
"org.apache.jackrabbit.test.JNDIRepositoryStub",2,0.00,3.00,17,0.22,8528.71,4,2,5,8,3,90.60,10,25,1,2,108.48,0.00,0.50,0.50,0,2.00,5,661.04,0,1,2,org.apache.jackrabbit.test.RepositoryStub,0.22,6,1,6,0,6,1,0,3,133,1
"org.apache.jackrabbit.test.JUnitTest",0,0.00,0.00,3,0.05,1456.80,2,2,2,2,2,171.00,9,4,1,2,171.00,89.00,0.01,0.00,0,0.00,0,142.62,0,0,1,junit.framework.TestCase,0.00,2,1,0,89,2,0,0,3,33,2
"org.apache.jackrabbit.test.JackrabbitRepositoryStub",2,0.67,2.50,26,0.37,15055.35,8,6,6,12,3,132.09,41,33,0,2,98.71,0.00,0.50,0.50,0,2.00,4,1115.46,0,1,3,org.apache.jackrabbit.test.RepositoryStub,0.22,10,1,5,0,10,1,0,12,210,1
"org.apache.jackrabbit.test.LogPrintWriter",12,0.12,1.33,46,0.38,6072.91,15,3,5,22,1,132.08,52,64,1,2,131.84,0.00,0.50,0.22,1,22.00,4,1130.33,2,0,0,java.io.PrintWriter,0.00,10,1,16,0,10,12,0,15,282,1
"org.apache.jackrabbit.test.LogPrintWriter$NullWriter",3,0.00,1.00,4,0.04,273.44,3,0,5,3,0,205.57,3,8,0,2,155.57,0.00,0.50,0.00,0,3.00,1,110.76,0,0,0,java.io.Writer,0.00,0,1,3,0,0,3,0,3,35,2
"org.apache.jackrabbit.test.NotExecutableException",2,0.00,1.00,4,0.02,118.02,2,0,0,2,31,95.83,18,7,31,2,145.83,0.00,0.50,0.00,0,2.00,1,53.51,0,0,0,java.lang.Exception,0.00,0,1,2,0,0,2,0,3,20,1
"org.apache.jackrabbit.test.RepositoryHelper",10,0.17,1.20,27,0.25,4141.90,12,2,5,20,4,96.83,75,41,2,1,139.12,0.00,0.00,0.35,4,14.00,3,748.69,0,8,2,java.lang.Object,0.00,10,0,12,0,10,2,0,14,193,1
"org.apache.jackrabbit.test.RepositoryStub",7,0.08,3.00,76,1.31,68104.16,31,24,11,26,7,64.48,85,106,6,1,102.04,0.00,0.00,0.11,0,21.00,14,3921.97,0,6,1,java.lang.Object,0.00,19,0,21,2,19,1,0,9,687,2
"org.apache.jackrabbit.test.RepositoryStubException",1,0.00,1.00,3,0.02,106.02,1,0,0,1,4,157.87,3,5,4,2,137.25,0.00,0.50,0.00,0,1.00,1,45.51,0,0,0,java.lang.Exception,0.00,0,1,1,0,0,1,0,1,16,1
"org.apache.jackrabbit.test.api.observation.AbstractObservationTest",11,0.40,1.45,49,0.63,15605.51,13,2,10,30,13,75.53,97,75,12,4,123.64,4.00,0.19,0.14,2,35.00,3,1879.64,1,1,1,org.apache.jackrabbit.test.AbstractJCRTest,0.24,19,3,16,12,19,10,0,14,413,1
"org.apache.jackrabbit.test.api.observation.AddEventListenerTest",7,0.00,1.29,71,1.02,25995.52,7,0,4,19,4,63.24,53,99,1,5,105.53,0.00,0.80,0.00,0,0.00,2,3064.70,2,1,3,org.apache.jackrabbit.test.api.observation.AbstractObservationTest,0.00,12,4,9,0,12,6,0,10,583,1
"org.apache.jackrabbit.test.api.observation.EventIteratorTest",3,0.00,1.67,47,0.59,15877.45,3,0,5,15,4,53.56,33,54,1,5,97.69,0.00,0.80,0.00,0,0.00,2,1770.04,2,0,3,org.apache.jackrabbit.test.api.observation.AbstractObservationTest,0.00,12,4,5,0,12,3,0,8,328,1
"org.apache.jackrabbit.test.api.observation.EventResult",5,0.00,2.00,30,0.28,5242.03,8,3,8,16,12,73.90,56,43,12,1,118.03,0.00,0.00,0.33,2,2.00,3,832.75,0,3,0,java.lang.Object,0.00,11,0,10,0,11,2,1,11,193,0
"org.apache.jackrabbit.test.api.observation.EventTest",3,0.00,1.00,33,0.42,8149.26,3,0,3,13,3,62.82,22,37,1,5,105.11,0.00,0.80,0.00,0,0.00,1,1256.61,2,0,2,org.apache.jackrabbit.test.api.observation.AbstractObservationTest,0.00,10,4,3,0,10,3,0,4,243,1
"org.apache.jackrabbit.test.api.observation.GetRegisteredEventListenersTest",2,0.00,1.00,21,0.24,6030.45,2,0,2,5,3,74.08,12,24,1,5,106.30,0.00,0.80,0.00,0,0.00,1,725.25,3,0,2,org.apache.jackrabbit.test.api.observation.AbstractObservationTest,0.00,3,4,2,0,3,2,0,2,152,1
"org.apache.jackrabbit.test.api.observation.LockingTest",3,0.00,2.67,56,0.76,26224.52,3,0,5,18,3,48.78,33,54,1,5,92.91,0.00,0.80,0.00,1,0.00,3,2285.30,2,1,2,org.apache.jackrabbit.test.api.observation.AbstractObservationTest,0.00,15,4,8,0,15,2,0,6,397,1
"org.apache.jackrabbit.test.api.observation.NodeAddedTest",4,0.00,1.00,37,0.45,9306.06,4,0,3,9,3,66.60,29,42,1,5,108.89,0.00,0.80,0.00,0,0.00,1,1340.86,3,0,2,org.apache.jackrabbit.test.api.observation.AbstractObservationTest,0.00,5,4,4,0,5,4,0,5,272,1
"org.apache.jackrabbit.test.api.observation.NodeMovedTest",1,0.00,1.00,17,0.23,6351.80,1,0,3,7,3,128.54,20,19,1,5,95.15,0.00,0.80,0.00,0,0.00,1,688.37,4,0,2,org.apache.jackrabbit.test.api.observation.AbstractObservationTest,0.00,6,4,1,0,6,1,0,2,130,1
"org.apache.jackrabbit.test.api.observation.NodeRemovedTest",2,0.00,1.00,22,0.26,5683.06,2,0,3,7,3,60.83,22,25,1,5,104.96,0.00,0.80,0.00,0,0.00,1,780.98,3,0,2,org.apache.jackrabbit.test.api.observation.AbstractObservationTest,0.00,5,4,2,0,5,2,0,3,157,1
"org.apache.jackrabbit.test.api.observation.PropertyAddedTest",3,0.00,1.33,37,0.48,12114.70,3,0,5,13,3,52.28,28,40,1,5,102.28,0.00,0.80,0.00,0,0.00,2,1451.08,3,0,2,org.apache.jackrabbit.test.api.observation.AbstractObservationTest,0.00,10,4,4,0,10,3,0,4,274,1
"org.apache.jackrabbit.test.api.observation.PropertyChangedTest",4,0.00,1.75,65,1.04,45926.22,4,0,8,24,4,45.51,43,72,1,5,93.98,0.00,0.80,0.00,0,0.00,4,3125.82,3,0,3,org.apache.jackrabbit.test.api.observation.AbstractObservationTest,0.00,20,4,7,0,20,4,0,7,540,1
"org.apache.jackrabbit.test.api.observation.PropertyRemovedTest",2,0.00,1.00,26,0.35,8251.55,2,0,4,8,3,56.85,23,30,1,5,100.98,0.00,0.80,0.00,0,0.00,1,1046.31,3,0,2,org.apache.jackrabbit.test.api.observation.AbstractObservationTest,0.00,6,4,2,0,6,2,0,3,199,1
"org.apache.jackrabbit.test.api.observation.TestAll",1,0.00,1.00,16,0.18,6826.31,1,0,3,3,12,47.41,10,18,0,2,95.89,0.00,0.50,0.00,0,1.00,1,552.81,0,1,12,junit.framework.TestCase,0.00,2,1,1,0,2,0,0,2,119,1
"org.apache.jackrabbit.test.api.observation.WorkspaceOperationTest",3,0.00,1.00,44,0.66,18361.59,3,0,3,11,3,48.43,28,48,1,5,98.43,0.00,0.80,0.00,0,0.00,1,1975.37,4,0,2,org.apache.jackrabbit.test.api.observation.AbstractObservationTest,0.00,8,4,3,0,8,3,0,4,367,1
"org.apache.jackrabbit.core.search.sql.ASTContainsExpression",5,1.00,1.00,12,0.08,818.27,6,1,0,6,3,142.34,3,18,2,2,142.34,0.00,0.50,0.20,0,8.00,1,241.61,0,2,1,SimpleNode,0.00,1,1,5,0,1,3,0,1,72,1
"org.apache.jackrabbit.core.search.sql.ASTIdentifier",6,0.80,1.00,14,0.10,1044.12,7,1,1,7,8,142.13,1,21,6,2,142.13,0.00,0.50,0.33,0,10.00,1,295.38,1,3,2,SimpleNode,0.08,1,1,6,0,1,3,0,1,87,1
"org.apache.jackrabbit.core.search.sql.ASTLiteral",8,0.29,1.00,19,0.13,1418.97,10,2,0,9,3,142.06,3,28,2,2,142.06,0.00,0.50,0.25,0,18.00,1,403.74,1,3,1,SimpleNode,0.14,1,1,8,0,1,5,0,1,117,1
"org.apache.jackrabbit.core.search.sql.ASTPredicate",14,0.12,1.00,34,0.24,2461.65,19,5,1,15,4,142.09,1,49,2,2,142.09,0.00,0.50,0.09,0,70.00,1,709.22,1,5,2,SimpleNode,0.06,1,1,14,0,1,9,0,1,199,1
"org.apache.jackrabbit.core.search.sql.DefaultParserVisitor",17,0.00,1.00,35,0.23,2389.27,17,0,0,17,6,142.86,4,53,1,1,142.86,0.00,0.00,0.00,0,17.00,1,689.28,0,17,5,java.lang.Object,0.00,0,0,17,0,0,0,1,1,209,0
"org.apache.jackrabbit.core.search.sql.JCRSQLQueryBuilder",24,0.09,3.21,285,4.16,318550.76,31,7,29,127,27,81.55,124,359,2,1,99.42,0.00,0.00,0.06,3,122.00,16,12482.85,0,22,25,java.lang.Object,0.00,103,0,77,0,103,2,1,53,2193,1
"org.apache.jackrabbit.core.search.sql.JCRSQLQueryBuilder$DefaultParserVisitor",1,0.00,1.00,4,0.03,341.81,1,0,29,2,1,128.59,0,5,0,1,128.59,0.00,0.00,0.00,0,0.00,1,87.95,0,1,1,java.lang.Object,0.00,1,0,1,0,1,0,0,0,25,0
"org.apache.jackrabbit.core.search.sql.JCRSQLQueryBuilder$DefaultParserVisitor_0",1,0.00,2.00,6,0.07,1619.60,1,0,29,4,3,166.54,1,9,0,1,116.54,0.00,0.00,0.00,0,0.00,2,207.04,0,1,3,java.lang.Object,0.00,3,0,2,0,3,0,0,1,48,0
"org.apache.jackrabbit.core.search.sql.JCRSQLQueryBuilder$DefaultParserVisitor_1",1,0.00,2.00,4,0.05,1364.28,1,0,29,2,1,173.70,1,5,0,1,123.70,0.00,0.00,0.00,0,1.00,2,146.30,0,1,1,java.lang.Object,0.00,1,0,2,0,1,0,0,1,36,0
"org.apache.jackrabbit.core.search.sql.JCRSQLQueryBuilder$DefaultParserVisitor_2",1,0.00,1.00,4,0.03,474.00,1,0,29,2,1,127.47,0,5,0,1,127.47,0.00,0.00,0.00,0,1.00,1,92.00,0,1,1,java.lang.Object,0.00,1,0,1,0,1,0,0,0,25,0
"org.apache.jackrabbit.core.search.sql.JCRSQLQueryBuilder$MergingPathQueryNode",5,0.75,6.00,101,1.44,155355.11,6,1,29,26,3,42.55,56,113,0,4,86.68,0.00,0.75,0.40,2,6.00,13,4330.26,0,3,3,org.apache.jackrabbit.core.search.PathQueryNode,0.00,21,3,30,0,21,2,0,15,758,2
"org.apache.jackrabbit.core.search.sql.QueryFormat",18,0.01,4.78,325,4.50,376252.81,22,4,25,77,20,110.41,61,380,2,1,89.80,0.00,0.00,0.24,4,62.00,14,13512.33,0,13,18,java.lang.Object,0.00,59,0,86,0,59,5,2,24,2403,0
"org.apache.jackrabbit.core.security.AMContext",5,0.06,1.00,18,0.12,1410.94,9,4,4,5,6,83.91,46,27,4,1,133.90,0.00,0.00,0.20,0,17.00,1,352.54,0,4,2,java.lang.Object,0.00,0,0,5,0,0,1,0,10,96,1
"org.apache.jackrabbit.core.security.AccessManager",4,3.00,1.00,8,0.09,808.48,7,3,4,4,10,121.47,57,11,8,1,141.61,0.00,0.00,0.00,0,4.00,1,260.42,0,0,2,,0.00,0,0,4,0,0,4,0,8,72,1
"org.apache.jackrabbit.core.security.AnonymousPrincipal",5,0.75,1.40,15,0.09,1176.27,6,1,2,6,2,174.34,10,23,2,1,134.45,0.00,0.00,0.40,0,7.00,3,268.38,0,2,0,java.lang.Object,0.00,1,0,7,0,1,3,2,4,76,1
"org.apache.jackrabbit.core.security.CredentialsCallback",3,1.00,1.00,7,0.04,385.42,4,1,3,3,2,125.29,16,11,2,1,143.16,0.00,0.00,0.33,0,4.00,1,118.49,0,1,0,java.lang.Object,0.00,0,0,3,0,0,2,2,4,37,1
"org.apache.jackrabbit.core.security.CredentialsCallbackHandler",2,0.50,3.00,23,0.30,17106.54,4,2,9,9,2,58.65,15,28,1,1,100.94,0.00,0.00,0.25,0,2.00,5,889.06,0,0,1,java.lang.Object,0.00,7,0,6,0,7,2,1,7,175,1
"org.apache.jackrabbit.core.security.SimpleAccessManager",5,0.42,3.00,40,0.41,9999.51,11,6,7,12,6,78.84,31,59,0,1,111.07,0.00,0.00,0.50,0,0.00,5,1234.58,0,0,6,java.lang.Object,0.00,7,0,15,0,7,5,1,15,262,1
"org.apache.jackrabbit.core.security.SimpleLoginModule",6,0.03,2.33,54,0.58,22945.41,12,6,13,25,3,74.78,37,73,0,1,107.00,0.00,0.00,0.19,1,0.00,7,1744.37,0,0,3,java.lang.Object,0.00,19,0,14,0,19,6,1,23,346,1
"org.apache.jackrabbit.core.security.SystemPrincipal",5,0.75,1.40,15,0.09,1176.27,6,1,2,6,2,174.34,10,23,2,1,134.45,0.00,0.00,0.40,0,7.00,3,268.38,0,2,0,java.lang.Object,0.00,1,0,7,0,1,3,2,4,76,1
"org.apache.jackrabbit.core.security.UserPrincipal",5,0.25,1.60,19,0.14,2767.72,6,1,2,8,2,171.38,13,28,2,1,131.49,0.00,0.00,0.80,0,0.00,3,417.31,0,2,0,java.lang.Object,0.00,3,0,8,0,3,3,2,4,108,1
"org.apache.jackrabbit.core.virtual.VirtualItemStateProvider",8,0.00,1.00,9,0.09,530.92,8,0,9,8,14,114.36,62,17,5,3,156.65,0.00,0.67,0.00,0,8.00,1,270.76,0,3,10,,0.00,0,2,8,0,0,5,0,9,83,1
"org.apache.jackrabbit.core.virtual.VirtualNodeState",14,0.21,1.43,59,0.73,16684.87,17,3,10,30,13,76.13,112,83,6,3,124.24,2.00,0.29,0.14,5,82.00,2,2203.46,3,5,8,org.apache.jackrabbit.core.state.NodeState,0.00,16,2,20,4,16,9,1,21,492,1
"org.apache.jackrabbit.core.virtual.VirtualNodeState$VirtualChildNodeEntry",1,0.00,1.00,3,0.03,217.74,1,0,10,1,1,134.79,0,5,0,2,134.79,0.00,0.50,0.00,0,1.00,1,81.36,0,0,1,NodeState.ChildNodeEntry,0.00,0,1,1,0,0,1,0,0,24,1
"org.apache.jackrabbit.core.virtual.VirtualNodeState$VirtualPropertyEntry",1,0.00,1.00,3,0.02,135.00,1,0,10,1,1,136.43,0,5,0,2,136.43,0.00,0.50,0.00,0,1.00,1,54.00,0,0,1,NodeState.PropertyEntry,0.00,0,1,1,0,0,1,0,0,18,1
"org.apache.jackrabbit.core.virtual.VirtualPropertyState",1,0.00,1.00,3,0.03,228.79,1,0,3,1,8,86.52,8,5,5,3,134.62,0.00,0.67,0.00,0,1.00,1,80.23,0,0,3,org.apache.jackrabbit.core.state.PropertyState,0.00,0,2,1,0,0,1,0,2,23,1
"org.apache.jackrabbit.test.api.AbstractPropertyTest",2,0.25,2.00,19,0.24,6046.12,6,4,6,10,12,65.55,14,25,9,4,107.84,3.00,0.23,0.38,1,2.00,3,706.60,1,0,3,org.apache.jackrabbit.test.AbstractJCRTest,0.50,8,3,4,9,8,2,0,7,141,1
"org.apache.jackrabbit.test.api.AddNodeTest",8,0.00,1.75,44,0.50,9546.30,8,0,7,19,2,102.70,43,65,1,4,120.57,0.00,0.75,0.00,0,0.00,3,1491.37,0,0,1,org.apache.jackrabbit.test.AbstractJCRTest,0.00,11,3,14,0,11,8,0,14,326,1
"org.apache.jackrabbit.test.api.BinaryPropertyTest",12,0.00,2.75,101,1.17,30463.16,12,0,7,45,4,92.40,70,162,1,5,110.27,0.00,0.80,0.00,0,0.00,5,3521.58,0,0,3,org.apache.jackrabbit.test.api.AbstractPropertyTest,0.25,33,4,33,0,33,12,0,22,710,1
"org.apache.jackrabbit.test.api.BooleanPropertyTest",11,0.00,2.82,84,0.99,33245.26,11,0,7,37,3,93.96,62,143,1,5,111.83,0.00,0.80,0.00,0,0.00,6,2983.70,0,0,2,org.apache.jackrabbit.test.api.AbstractPropertyTest,0.26,26,4,31,0,26,11,0,24,591,1
"org.apache.jackrabbit.test.api.DatePropertyTest",11,0.00,2.64,87,1.05,34507.37,11,0,8,39,3,93.85,65,139,1,5,111.72,0.00,0.80,0.00,0,0.00,6,3152.27,0,0,2,org.apache.jackrabbit.test.api.AbstractPropertyTest,0.26,28,4,29,0,28,11,0,27,624,1
"org.apache.jackrabbit.test.api.DoublePropertyTest",11,0.00,2.64,84,1.03,34966.27,11,0,8,40,3,93.80,59,136,1,5,111.67,0.00,0.80,0.00,0,0.00,6,3076.20,0,0,2,org.apache.jackrabbit.test.api.AbstractPropertyTest,0.26,29,4,29,0,29,11,0,22,611,1
"org.apache.jackrabbit.test.api.LongPropertyTest",11,0.00,2.64,84,1.00,32155.95,11,0,8,39,3,94.09,60,136,1,5,111.96,0.00,0.80,0.00,0,0.00,6,2996.98,0,0,2,org.apache.jackrabbit.test.api.AbstractPropertyTest,0.26,28,4,29,0,28,11,0,22,597,1
"org.apache.jackrabbit.test.api.NamePropertyTest",8,0.00,1.88,37,0.38,6498.83,8,0,4,20,3,93.26,50,68,1,5,125.48,0.00,0.80,0.00,0,0.00,4,1129.15,0,0,2,org.apache.jackrabbit.test.api.AbstractPropertyTest,0.31,12,4,15,0,12,8,0,15,255,1
"org.apache.jackrabbit.test.api.NamespaceRegistryReadMethodsTest",5,0.33,2.20,54,0.68,17596.70,8,3,10,19,3,73.37,33,64,1,4,105.59,0.00,0.75,0.60,0,0.00,3,2026.25,1,0,2,org.apache.jackrabbit.test.AbstractJCRTest,0.36,14,3,11,0,14,5,0,10,394,1
"org.apache.jackrabbit.test.api.NamespaceRegistryTest",8,0.24,2.62,67,0.73,16430.59,14,6,7,27,2,68.71,56,96,1,4,111.01,0.00,0.75,0.38,0,0.00,5,2196.49,2,2,1,org.apache.jackrabbit.test.AbstractJCRTest,0.57,19,3,21,0,19,6,0,26,469,1
"org.apache.jackrabbit.test.api.NamespaceRemappingTest",10,0.06,1.70,72,0.81,16130.16,12,2,10,34,2,81.87,62,98,1,4,114.09,0.00,0.75,0.55,2,0.00,3,2431.11,2,2,1,org.apache.jackrabbit.test.AbstractJCRTest,0.50,24,3,17,0,24,8,0,24,514,1
"org.apache.jackrabbit.test.api.NodeDiscoveringNodeTypesTest",6,0.13,2.83,64,0.83,27638.15,9,3,9,28,3,54.61,54,101,1,4,104.61,0.00,0.75,0.44,1,2.00,5,2491.03,2,1,2,org.apache.jackrabbit.test.AbstractJCRTest,0.67,22,3,17,0,22,5,0,15,477,1
"org.apache.jackrabbit.test.api.NodeIteratorTest",5,0.00,2.80,45,0.45,14239.92,5,0,5,13,3,75.74,30,63,1,4,107.96,0.00,0.75,0.00,0,0.00,5,1336.28,1,0,2,org.apache.jackrabbit.test.AbstractJCRTest,0.36,8,3,14,0,8,5,0,11,280,1
"org.apache.jackrabbit.test.api.NodeOrderableChildNodesTest",10,0.52,1.50,82,1.02,16612.69,13,3,10,27,3,63.38,104,115,1,4,111.86,0.00,0.75,0.80,2,0.00,2,3063.82,1,0,2,org.apache.jackrabbit.test.AbstractJCRTest,0.00,17,3,15,0,17,10,0,41,627,1
"org.apache.jackrabbit.test.api.NodeReadMethodsTest",36,0.01,3.42,409,5.80,380290.47,39,3,16,101,3,67.96,232,626,1,4,100.18,0.00,0.75,0.34,6,0.00,14,17386.41,3,6,2,org.apache.jackrabbit.test.AbstractJCRTest,0.19,65,3,123,0,65,30,0,90,3136,1
"org.apache.jackrabbit.test.api.NodeReadMethodsTest$ItemVisitor",2,0.00,1.00,5,0.03,251.60,2,0,16,5,0,143.24,0,8,0,1,143.24,0.00,0.00,0.00,0,2.00,1,103.75,0,0,0,java.lang.Object,0.00,3,0,2,0,3,2,0,0,31,0
"org.apache.jackrabbit.test.api.NodeTest",31,0.87,1.74,290,3.91,82553.28,32,1,12,71,2,70.74,393,364,1,4,108.30,0.00,0.75,0.16,0,0.00,4,11723.15,4,0,1,org.apache.jackrabbit.test.AbstractJCRTest,0.22,40,3,54,0,40,31,0,213,2331,1
"org.apache.jackrabbit.test.api.NodeUUIDTest",4,0.00,1.75,45,0.64,14215.26,4,0,8,19,3,151.33,92,57,1,4,104.06,0.00,0.75,0.00,1,0.00,2,1916.40,0,0,2,org.apache.jackrabbit.test.AbstractJCRTest,0.00,15,3,7,0,15,4,0,34,365,1
"org.apache.jackrabbit.test.api.PathPropertyTest",8,0.00,1.88,37,0.38,6498.83,8,0,4,20,3,107.61,44,68,1,5,125.48,0.00,0.80,0.00,0,0.00,4,1129.15,0,0,2,org.apache.jackrabbit.test.api.AbstractPropertyTest,0.31,12,4,15,0,12,8,0,15,255,1
"org.apache.jackrabbit.test.api.PropertyReadMethodsTest",13,0.11,1.31,51,0.55,7676.77,16,3,10,38,3,113.44,71,87,1,4,131.32,0.00,0.75,0.44,0,0.00,2,1649.65,2,0,2,org.apache.jackrabbit.test.AbstractJCRTest,0.42,25,3,17,0,25,13,0,21,383,1
"org.apache.jackrabbit.test.api.PropertyReadMethodsTest$ItemVisitor",2,0.00,1.00,5,0.03,251.60,2,0,10,5,0,143.24,0,8,0,1,143.24,0.00,0.00,0.00,0,2.00,1,103.75,0,0,0,java.lang.Object,0.00,3,0,2,0,3,2,0,0,31,0
"org.apache.jackrabbit.test.api.PropertyTypeTest",3,0.00,2.67,29,0.38,15285.13,3,0,8,18,2,73.76,18,45,1,4,105.99,0.00,0.75,0.00,1,5.00,6,1138.07,1,0,1,org.apache.jackrabbit.test.AbstractJCRTest,0.44,15,3,8,0,15,3,0,3,212,1
"org.apache.jackrabbit.test.api.PropertyUtil",12,0.04,3.58,159,2.26,93208.67,30,18,14,37,11,56.23,91,243,11,1,98.52,0.00,0.00,0.02,1,52.00,8,6773.18,0,3,0,java.lang.Object,0.00,25,0,43,0,25,9,0,20,1216,1
"org.apache.jackrabbit.test.api.ReferencePropertyTest",11,0.70,1.64,51,0.60,10544.74,12,1,7,36,3,125.18,54,84,1,5,124.95,0.00,0.80,0.36,0,0.00,4,1810.00,1,0,2,org.apache.jackrabbit.test.api.AbstractPropertyTest,0.53,25,4,18,0,25,11,0,17,390,1
"org.apache.jackrabbit.test.api.ReferencesTest",3,0.00,6.00,85,1.31,83960.79,3,0,2,27,2,33.48,25,103,1,4,81.59,0.00,0.75,0.00,0,0.00,10,3942.87,0,0,1,org.apache.jackrabbit.test.AbstractJCRTest,0.00,24,3,18,0,24,3,0,12,706,1
"org.apache.jackrabbit.test.api.RepositoryDescriptorTest",4,0.00,1.75,34,0.32,5185.68,6,2,8,15,2,94.80,22,39,1,4,112.67,0.00,0.75,0.50,0,0.00,2,965.97,2,0,1,org.apache.jackrabbit.test.AbstractJCRTest,0.80,11,3,7,0,11,4,0,6,226,1
"org.apache.jackrabbit.test.api.RootNodeTest",6,0.10,1.33,22,0.18,2075.96,8,2,5,15,2,133.38,29,32,1,4,133.14,0.00,0.75,0.58,0,0.00,2,549.08,2,0,1,org.apache.jackrabbit.test.AbstractJCRTest,0.67,9,3,8,0,9,6,0,10,140,1
"org.apache.jackrabbit.test.api.SerializationContext",2,0.96,1.50,57,0.59,9494.27,27,25,2,4,3,127.86,5,61,2,1,87.97,0.00,0.00,0.52,0,0.00,2,1768.00,0,1,1,java.lang.Object,0.00,2,0,3,0,2,1,0,2,325,0
"org.apache.jackrabbit.test.api.SerializationTest",32,0.21,1.66,192,2.26,55067.11,44,12,25,72,4,136.99,112,264,0,4,116.38,0.00,0.75,0.28,5,0.00,7,6773.27,2,1,4,org.apache.jackrabbit.test.AbstractJCRTest,0.21,40,3,53,0,40,31,0,33,1382,1
"org.apache.jackrabbit.test.api.SessionReadMethodsTest",8,0.07,2.00,50,0.54,14492.80,10,2,9,30,3,83.94,48,76,1,4,116.16,0.00,0.75,0.44,2,0.00,4,1632.55,1,2,2,org.apache.jackrabbit.test.AbstractJCRTest,0.29,22,3,16,0,22,6,0,14,355,1
"org.apache.jackrabbit.test.api.SessionTest",15,0.00,1.60,161,2.37,56822.85,15,0,9,34,2,123.54,274,195,1,4,105.41,0.00,0.75,0.00,0,0.00,2,7113.93,0,0,1,org.apache.jackrabbit.test.AbstractJCRTest,0.00,19,3,24,0,19,15,0,146,1395,1
"org.apache.jackrabbit.test.api.SessionUUIDTest",3,0.00,1.67,36,0.54,12673.04,3,0,6,12,2,128.31,96,45,1,4,102.07,0.00,0.75,0.00,0,0.00,2,1616.80,0,0,1,org.apache.jackrabbit.test.AbstractJCRTest,0.00,9,3,5,0,9,3,0,33,310,1
"org.apache.jackrabbit.test.api.StringPropertyTest",11,0.00,3.00,96,1.14,33028.19,11,0,7,43,4,61.57,92,156,1,5,109.68,0.00,0.80,0.00,0,0.00,5,3405.21,0,0,3,org.apache.jackrabbit.test.api.AbstractPropertyTest,0.26,32,4,33,0,32,11,0,24,674,1
"org.apache.jackrabbit.test.api.TestAll",1,0.00,1.00,33,0.46,18822.70,1,0,3,3,29,60.55,14,35,0,2,80.69,0.00,0.50,0.00,0,1.00,1,1374.91,0,1,29,junit.framework.TestCase,0.00,2,1,1,0,2,0,0,5,255,1
"org.apache.jackrabbit.test.api.TreeComparator",20,0.04,3.35,250,3.66,150875.54,34,14,19,65,3,57.64,149,337,1,4,99.93,0.00,0.75,0.11,10,96.00,11,10983.76,1,2,2,org.apache.jackrabbit.test.AbstractJCRTest,0.00,45,3,67,0,45,18,0,50,1935,0
"org.apache.jackrabbit.test.api.UndefinedPropertyTest",2,0.00,1.00,8,0.08,966.76,2,0,6,6,4,85.11,15,11,1,4,127.40,0.00,0.75,0.00,0,2.00,1,243.08,1,0,3,org.apache.jackrabbit.test.AbstractJCRTest,0.50,4,3,2,0,4,2,0,3,59,1
"org.apache.jackrabbit.test.api.WorkspaceReadMethodsTest",5,0.00,1.40,29,0.30,5734.67,5,0,4,18,2,102.88,29,36,1,4,120.76,0.00,0.75,0.00,0,0.00,2,893.57,1,0,1,org.apache.jackrabbit.test.AbstractJCRTest,0.36,13,3,7,0,13,5,0,7,201,1
"org.apache.jackrabbit.core.nodetype.BooleanConstraint",4,0.67,2.25,28,0.32,8714.71,5,1,11,13,3,113.00,1,41,1,2,113.00,0.00,0.50,0.50,1,0.00,3,950.72,0,0,3,org.apache.jackrabbit.core.nodetype.ValueConstraint,0.00,9,1,9,0,9,4,0,1,203,0
"org.apache.jackrabbit.core.nodetype.ChildItemDef",16,0.02,1.38,48,0.47,14152.70,23,7,4,19,10,129.92,7,74,7,1,129.92,0.00,0.00,0.12,0,96.00,5,1420.89,1,3,3,java.lang.Object,0.00,3,0,22,2,3,13,1,5,341,1
"org.apache.jackrabbit.core.nodetype.ChildNodeDef",9,0.12,1.44,28,0.27,7541.99,12,3,3,12,19,150.71,27,44,16,2,130.10,0.00,0.50,0.22,0,25.00,4,809.29,1,2,3,org.apache.jackrabbit.core.nodetype.ChildItemDef,0.08,3,1,13,0,3,7,0,9,196,1
"org.apache.jackrabbit.core.nodetype.DateConstraint",3,0.62,7.00,70,0.99,73548.63,7,4,11,20,3,135.19,5,97,1,2,85.19,0.00,0.50,0.67,0,0.00,10,2977.54,0,0,3,org.apache.jackrabbit.core.nodetype.ValueConstraint,0.00,17,1,21,0,17,3,0,5,546,0
"org.apache.jackrabbit.core.nodetype.EffectiveNodeType",33,0.04,4.18,447,6.12,497062.44,40,7,13,97,17,64.00,214,542,9,1,96.22,0.00,0.00,0.19,8,224.00,22,18365.55,0,18,9,java.lang.Object,0.00,64,0,138,0,64,15,1,98,3380,1
"org.apache.jackrabbit.core.nodetype.InvalidConstraintException",4,0.00,1.00,9,0.05,332.37,4,0,1,4,10,112.43,27,14,9,3,144.65,0.00,0.67,0.00,0,4.00,1,136.79,0,0,1,org.apache.jackrabbit.core.BaseException,0.00,0,2,4,0,0,4,0,5,46,1
"org.apache.jackrabbit.core.nodetype.InvalidNodeTypeDefException",4,0.00,1.00,9,0.05,332.37,4,0,1,4,3,112.43,27,14,2,3,144.65,0.00,0.67,0.00,0,4.00,1,136.79,0,0,1,org.apache.jackrabbit.core.BaseException,0.00,0,2,4,0,0,4,0,5,46,1
"org.apache.jackrabbit.core.nodetype.ItemDefImpl",8,0.11,1.38,33,0.29,4890.42,13,5,7,20,7,126.76,33,47,2,1,126.53,0.00,0.00,0.30,0,0.00,3,858.96,0,3,5,java.lang.Object,0.00,12,0,11,3,12,5,1,13,211,1
"org.apache.jackrabbit.core.nodetype.NameConstraint",3,0.00,2.67,28,0.35,11878.81,4,1,11,14,8,106.85,2,44,1,2,106.85,0.00,0.50,1.00,0,0.00,3,1042.03,0,1,8,org.apache.jackrabbit.core.nodetype.ValueConstraint,0.00,11,1,8,0,11,2,0,2,211,0
"org.apache.jackrabbit.core.nodetype.NodeDefId",6,0.20,2.00,40,0.40,14658.49,8,2,3,22,17,135.75,19,50,15,1,115.13,0.00,0.00,0.33,0,0.00,4,1209.90,0,2,2,java.lang.Object,0.00,16,0,12,0,16,4,1,5,256,1
"org.apache.jackrabbit.core.nodetype.NodeDefImpl",5,0.12,2.00,33,0.34,14036.53,7,2,7,11,11,114.90,23,43,6,2,114.66,1.00,0.33,0.60,0,0.00,4,1028.53,0,3,6,org.apache.jackrabbit.core.nodetype.ItemDefImpl,0.00,6,1,10,1,6,2,1,9,220,1
"org.apache.jackrabbit.core.nodetype.NodeTypeConflictException",4,0.00,1.00,9,0.05,332.37,4,0,1,4,6,112.43,27,14,5,3,144.65,0.00,0.67,0.00,0,4.00,1,136.79,0,0,1,org.apache.jackrabbit.core.BaseException,0.00,0,2,4,0,0,4,0,5,46,1
"org.apache.jackrabbit.core.nodetype.NodeTypeDef",19,0.08,1.79,97,0.96,51375.15,27,8,6,29,13,99.89,105,121,8,1,117.77,0.00,0.00,0.20,1,121.00,12,2872.03,1,6,5,java.lang.Object,0.00,10,0,34,0,10,13,1,25,620,1
"org.apache.jackrabbit.core.nodetype.NodeTypeDefDiff",13,0.15,2.46,124,1.50,86836.48,22,9,2,38,7,60.95,145,145,2,1,105.08,0.00,0.00,0.25,3,6.00,7,4502.27,0,1,5,java.lang.Object,0.00,25,0,32,0,25,12,0,33,877,1
"org.apache.jackrabbit.core.nodetype.NodeTypeDefDiff$ChildItemDefDiff",6,0.27,2.17,38,0.31,10096.89,9,3,2,11,1,156.28,14,54,0,1,116.39,0.00,0.00,0.56,3,0.00,8,929.80,0,0,1,java.lang.Object,0.00,5,0,13,0,5,6,0,11,221,1
"org.apache.jackrabbit.core.nodetype.NodeTypeDefDiff$ChildNodeDefDiff",4,0.00,2.25,22,0.23,7277.90,4,0,2,10,1,158.95,10,32,0,2,119.07,0.00,0.50,0.00,2,10.00,6,693.70,1,2,1,org.apache.jackrabbit.core.nodetype.ChildItemDefDiff,0.00,6,1,9,0,6,2,0,5,152,1
"org.apache.jackrabbit.core.nodetype.NodeTypeDefDiff$PropDefDiff",4,0.00,3.50,43,0.48,30773.69,4,0,2,13,2,103.04,17,51,0,2,102.81,0.00,0.50,0.00,2,10.00,11,1448.00,1,0,2,org.apache.jackrabbit.core.nodetype.ChildItemDefDiff,0.00,9,1,14,0,9,4,0,9,273,1
"org.apache.jackrabbit.core.nodetype.NodeTypeDefStore",11,0.18,7.55,355,7.21,1068076.31,38,27,19,129,15,27.01,97,430,1,1,75.12,0.00,0.00,0.20,4,10.00,51,21618.15,0,3,14,java.lang.Object,0.00,118,0,83,0,118,8,0,68,3130,0
"org.apache.jackrabbit.core.nodetype.NodeTypeDefStore$NamespaceResolver",2,0.00,2.00,9,0.10,3415.52,2,0,19,7,0,122.93,0,13,0,1,122.93,0.00,0.00,0.00,0,2.00,2,310.53,0,2,0,java.lang.Object,0.00,5,0,4,0,5,0,0,0,74,0
"org.apache.jackrabbit.core.nodetype.NodeTypeImpl",29,0.25,2.52,227,2.63,93338.02,34,5,9,78,24,79.42,193,279,11,1,111.64,0.00,0.00,0.44,5,0.00,9,7902.33,0,6,14,java.lang.Object,0.00,49,0,73,0,49,23,1,57,1613,1
"org.apache.jackrabbit.core.nodetype.NodeTypeManagerImpl",14,0.06,1.71,81,0.89,24099.75,19,5,13,39,21,119.56,68,98,8,1,119.32,0.00,0.00,0.26,1,18.00,3,2656.04,0,3,16,java.lang.Object,0.00,25,0,24,0,25,11,2,26,573,1
"org.apache.jackrabbit.core.nodetype.NodeTypeManagerImpl$RootNodeDefinition",3,0.00,1.00,7,0.04,283.17,3,0,13,3,4,164.83,11,11,0,3,144.22,0.00,0.67,0.00,0,3.00,1,122.35,0,2,4,org.apache.jackrabbit.core.nodetype.NodeDefImpl,0.38,0,2,3,0,0,1,0,5,39,2
"org.apache.jackrabbit.core.nodetype.NodeTypeRegistry",29,0.08,6.69,764,11.64,1428414.10,44,15,19,180,37,80.36,490,928,18,1,80.83,0.00,0.00,0.15,12,121.00,53,34923.27,0,3,20,java.lang.Object,0.00,151,0,194,0,151,26,1,165,5631,1
"org.apache.jackrabbit.core.nodetype.NodeTypeRegistry$EffectiveNodeTypeCache",10,0.11,1.40,42,0.40,7548.04,12,2,19,25,2,165.69,28,57,0,1,125.80,0.00,0.00,0.60,1,0.00,4,1203.63,0,1,2,java.lang.Object,0.00,15,0,14,0,15,9,0,15,291,1
"org.apache.jackrabbit.core.nodetype.NodeTypeRegistry$WeightedKey",16,0.07,1.44,59,0.52,12031.21,18,2,19,36,1,170.35,38,75,0,1,130.47,0.00,0.00,0.44,2,0.00,3,1574.27,0,6,1,java.lang.Object,0.00,20,0,23,0,20,10,1,11,393,1
"org.apache.jackrabbit.core.nodetype.NodeTypeRegistryListener",3,0.00,1.00,4,0.02,100.43,3,0,1,3,4,116.70,22,5,3,1,158.99,0.00,0.00,0.00,0,3.00,1,66.95,0,0,1,,0.00,0,0,3,0,0,3,0,4,25,1
"org.apache.jackrabbit.core.nodetype.NumericConstraint",5,0.19,5.00,82,1.10,71590.57,9,4,11,24,4,142.99,5,114,1,2,92.99,0.00,0.50,0.40,1,0.00,9,3295.74,0,0,4,org.apache.jackrabbit.core.nodetype.ValueConstraint,0.00,19,1,25,0,19,5,0,5,611,0
"org.apache.jackrabbit.core.nodetype.PathConstraint",3,0.75,4.67,44,0.58,28162.91,5,2,11,19,7,136.50,6,67,1,2,96.61,0.00,0.50,1.00,0,0.00,7,1730.66,0,1,7,org.apache.jackrabbit.core.nodetype.ValueConstraint,0.00,16,1,14,0,16,2,0,6,323,0
"org.apache.jackrabbit.core.nodetype.PropDef",11,0.08,1.36,31,0.32,7620.11,15,4,3,12,19,157.95,33,51,16,2,137.33,0.00,0.50,0.18,0,40.00,3,953.23,1,2,3,org.apache.jackrabbit.core.nodetype.ChildItemDef,0.07,1,1,15,0,1,9,0,11,233,1
"org.apache.jackrabbit.core.nodetype.PropDefId",6,0.20,2.00,35,0.35,11749.12,8,2,1,20,15,139.46,18,47,14,1,118.84,0.00,0.00,0.33,0,0.00,4,1061.91,0,2,1,java.lang.Object,0.00,14,0,12,0,14,4,1,4,235,1
"org.apache.jackrabbit.core.nodetype.PropertyDefImpl",6,0.00,2.00,38,0.41,18042.60,8,2,6,14,11,114.66,24,45,6,2,114.42,0.00,0.50,0.50,0,0.00,5,1219.59,1,2,6,org.apache.jackrabbit.core.nodetype.ItemDefImpl,0.00,8,1,12,0,8,4,1,8,258,1
"org.apache.jackrabbit.core.nodetype.ReferenceConstraint",4,0.33,2.00,27,0.29,8739.96,5,1,11,13,10,155.40,10,42,3,2,115.52,0.00,0.50,0.75,0,0.00,3,881.18,0,2,8,org.apache.jackrabbit.core.nodetype.ValueConstraint,0.00,9,1,8,0,9,2,0,4,187,0
"org.apache.jackrabbit.core.nodetype.StringConstraint",3,0.50,2.33,24,0.30,8993.93,4,1,11,13,3,109.74,1,37,1,2,109.74,0.00,0.50,0.67,0,0.00,3,890.28,0,0,3,org.apache.jackrabbit.core.nodetype.ValueConstraint,0.00,10,1,7,0,10,3,0,1,186,0
"org.apache.jackrabbit.core.nodetype.ValueConstraint",5,0.38,1.20,23,0.33,12266.18,7,2,11,15,18,122.04,21,43,15,1,121.81,0.00,0.00,0.20,0,7.00,2,1000.49,0,3,10,java.lang.Object,0.00,10,0,6,7,10,2,0,3,203,2
"org.apache.jackrabbit.test.rmi.RemoteAdapterTest",22,0.36,1.50,198,2.12,47712.25,27,5,44,81,22,66.75,157,222,1,2,109.04,0.00,0.50,0.55,5,0.00,6,6351.33,0,1,21,junit.framework.TestCase,0.00,59,1,33,0,59,21,0,61,1314,1
"org.apache.jackrabbit.test.rmi.TestAll",2,0.00,1.00,6,0.04,857.33,2,0,2,4,1,114.60,11,9,0,1,132.47,0.00,0.00,0.00,0,2.00,1,116.00,0,1,1,java.lang.Object,0.00,2,0,2,0,2,1,0,5,33,1
"org.apache.jackrabbit.test.search.AbstractQueryTest",6,0.00,2.83,73,0.91,33369.38,6,0,13,34,8,58.72,47,75,7,4,101.01,2.33,0.27,0.00,1,14.00,5,2719.85,0,1,1,org.apache.jackrabbit.test.AbstractJCRTest,0.00,28,3,17,7,28,5,0,11,519,1
"org.apache.jackrabbit.test.search.FulltextQueryTest",7,0.00,1.00,77,1.36,31058.36,7,0,3,16,2,103.43,3,99,1,5,103.43,0.00,0.80,0.00,0,0.00,1,4070.29,1,0,1,org.apache.jackrabbit.test.search.AbstractQueryTest,0.00,9,4,7,0,9,7,0,1,746,1
"org.apache.jackrabbit.test.search.ISO9075Test",2,0.00,2.50,28,0.41,14780.35,2,0,4,17,3,55.28,14,28,1,2,97.57,0.00,0.50,0.00,0,2.00,4,1221.10,0,0,2,junit.framework.TestCase,0.00,15,1,5,0,15,2,0,3,220,1
"org.apache.jackrabbit.test.search.OrderByTest",16,0.00,1.44,182,2.85,110056.11,16,0,11,35,2,101.85,9,192,1,5,101.85,0.00,0.80,0.00,3,46.00,3,8537.11,1,0,1,org.apache.jackrabbit.test.search.AbstractQueryTest,0.00,19,4,23,0,19,16,0,7,1603,1
"org.apache.jackrabbit.test.search.SQLPathTest",9,0.17,1.00,44,0.49,8008.50,15,6,2,13,2,175.32,9,54,1,5,125.32,0.00,0.80,0.31,1,0.00,1,1471.41,3,1,1,org.apache.jackrabbit.test.search.AbstractQueryTest,0.24,4,4,9,0,4,8,0,3,331,1
"org.apache.jackrabbit.test.search.SQLTest",3,0.00,1.00,25,0.36,6067.81,3,0,3,10,2,111.28,2,29,1,5,111.28,0.00,0.80,0.00,0,0.00,1,1067.41,1,0,1,org.apache.jackrabbit.test.search.AbstractQueryTest,0.00,7,4,3,0,7,3,0,1,210,1
"org.apache.jackrabbit.test.search.SelectClauseTest",3,0.00,1.00,57,0.98,27451.34,3,0,4,10,2,142.10,3,70,1,5,92.10,0.00,0.80,0.00,0,0.00,1,2925.14,1,0,1,org.apache.jackrabbit.test.search.AbstractQueryTest,0.00,7,4,3,0,7,3,0,1,526,1
"org.apache.jackrabbit.test.search.SimpleQueryTest",15,0.00,1.00,277,4.77,191081.30,15,0,4,29,2,141.85,21,303,1,5,91.85,0.00,0.80,0.00,0,0.00,1,14312.99,1,0,1,org.apache.jackrabbit.test.search.AbstractQueryTest,0.00,14,4,15,0,14,15,0,19,2567,1
"org.apache.jackrabbit.test.search.TestAll",1,0.00,1.00,12,0.13,4399.74,1,0,3,3,8,53.58,10,14,0,2,102.05,0.00,0.50,0.00,0,1.00,1,381.92,0,1,8,junit.framework.TestCase,0.00,2,1,1,0,2,0,0,2,87,1
"org.apache.jackrabbit.test.search.XPathAxisTest",26,0.15,1.00,92,1.06,15653.56,32,6,2,30,2,131.31,3,119,1,5,131.31,0.00,0.80,0.31,0,0.00,1,3171.92,3,0,1,org.apache.jackrabbit.test.search.AbstractQueryTest,0.13,4,4,26,0,4,26,0,1,726,1
"org.apache.jackrabbit.core.jndi.BindableRepository",12,0.03,1.08,42,0.44,7953.68,18,6,8,27,5,151.58,44,63,3,1,130.97,0.00,0.00,0.19,1,0.00,2,1323.86,0,8,3,java.lang.Object,0.00,15,0,13,0,15,4,3,20,321,0
"org.apache.jackrabbit.core.jndi.BindableRepositoryFactory",2,1.00,2.50,16,0.24,8116.22,3,1,7,12,1,60.58,16,27,1,1,108.69,0.00,0.00,0.50,0,2.00,4,731.93,0,1,1,java.lang.Object,0.00,10,0,5,0,10,1,1,5,144,1
"org.apache.jackrabbit.core.jndi.RegistryHelper",3,0.00,1.33,10,0.11,2229.24,3,0,3,7,3,88.24,22,20,2,1,130.53,0.00,0.00,0.00,0,3.00,2,321.88,0,0,1,java.lang.Object,0.00,4,0,4,0,4,3,0,4,75,1
"org.apache.jackrabbit.core.state.xml.XMLPersistenceManager",23,0.13,4.87,488,8.24,482020.91,52,29,18,151,21,55.06,138,647,0,2,87.28,0.00,0.50,0.16,6,0.00,15,24711.98,1,8,21,org.apache.jackrabbit.core.state.AbstractPersistenceManager,0.00,128,1,112,0,128,15,0,90,4003,1
"org.apache.jackrabbit.core.search.AbstractQueryHandler",6,0.10,1.00,20,0.14,2001.16,10,4,3,6,4,85.23,51,30,0,1,133.33,0.00,0.00,0.17,1,22.00,1,422.12,0,3,4,java.lang.Object,0.00,0,0,6,1,0,3,1,11,110,2
"org.apache.jackrabbit.core.search.AndQueryNode",4,0.00,1.00,9,0.06,661.31,4,0,1,5,9,110.08,27,14,7,3,142.30,0.00,0.67,0.00,0,4.00,1,188.14,0,1,3,org.apache.jackrabbit.core.search.NAryQueryNode,0.20,1,2,4,0,1,3,0,5,57,1
"org.apache.jackrabbit.core.search.DefaultQueryNodeVisitor",11,0.00,1.00,23,0.15,1565.75,11,0,0,11,13,142.81,4,35,1,1,142.81,0.00,0.00,0.00,0,11.00,1,454.00,0,11,12,java.lang.Object,0.00,0,0,11,0,0,0,1,1,138,1
"org.apache.jackrabbit.core.search.ExactQueryNode",5,0.38,1.20,17,0.13,2201.76,7,2,1,7,8,100.12,34,24,6,2,132.34,1.00,0.33,0.20,0,11.00,2,375.56,0,3,3,org.apache.jackrabbit.core.search.QueryNode,0.22,2,1,6,1,2,2,0,8,99,1
"org.apache.jackrabbit.core.search.ExecutableQuery",1,0.00,1.00,2,0.01,51.30,1,0,2,1,3,102.18,11,3,3,1,146.30,0.00,0.00,0.00,0,1.00,1,27.65,0,1,0,,0.00,0,0,1,0,0,0,0,2,11,1
"org.apache.jackrabbit.core.search.LocationStepQueryNode",11,0.18,1.18,34,0.27,4402.48,15,4,1,15,13,90.38,83,48,10,3,132.67,0.00,0.67,0.09,0,47.00,2,800.97,1,3,4,org.apache.jackrabbit.core.search.NAryQueryNode,0.14,4,2,13,0,4,8,0,16,208,1
"org.apache.jackrabbit.core.search.NAryQueryNode",7,0.08,2.14,40,0.40,10950.57,9,2,3,16,9,77.31,53,53,7,2,119.60,6.00,0.12,0.43,0,0.00,4,1185.62,0,1,2,org.apache.jackrabbit.core.search.QueryNode,0.00,9,1,15,6,9,6,0,10,266,2
"org.apache.jackrabbit.core.search.NodeTypeQueryNode",3,0.00,1.00,7,0.06,585.30,3,0,2,4,12,109.51,19,11,8,3,141.74,0.00,0.67,0.00,0,3.00,1,170.84,0,1,5,org.apache.jackrabbit.core.search.ExactQueryNode,0.25,1,2,3,0,1,2,0,7,49,1
"org.apache.jackrabbit.core.search.NotQueryNode",4,0.00,1.00,9,0.07,792.86,4,0,0,5,9,123.81,21,16,7,3,141.68,0.00,0.67,0.00,0,4.00,1,200.45,0,1,3,org.apache.jackrabbit.core.search.NAryQueryNode,0.20,1,2,4,0,1,3,0,5,60,1
"org.apache.jackrabbit.core.search.OrQueryNode",4,0.00,1.00,9,0.06,661.31,4,0,0,5,9,110.08,25,14,7,3,142.30,0.00,0.67,0.00,0,4.00,1,188.14,0,1,3,org.apache.jackrabbit.core.search.NAryQueryNode,0.20,1,2,4,0,1,3,0,5,57,1
"org.apache.jackrabbit.core.search.OrderQueryNode",7,0.50,1.00,17,0.16,2084.88,8,1,3,14,11,98.00,51,25,9,2,140.29,0.00,0.50,0.57,0,3.00,1,484.92,0,1,3,org.apache.jackrabbit.core.search.QueryNode,0.18,7,1,7,0,7,6,0,11,131,1
"org.apache.jackrabbit.core.search.OrderQueryNode$OrderSpec",4,0.33,1.00,12,0.07,903.99,6,2,3,4,1,116.79,23,17,0,1,134.66,0.00,0.00,0.25,0,8.00,1,222.03,0,1,1,java.lang.Object,0.00,0,0,4,0,0,3,0,6,65,3
"org.apache.jackrabbit.core.search.PathQueryNode",7,0.42,1.14,20,0.16,2649.54,9,2,0,10,11,121.57,38,29,8,3,139.44,0.50,0.50,0.14,0,17.00,2,478.02,1,1,4,org.apache.jackrabbit.core.search.NAryQueryNode,0.17,3,2,8,1,3,6,0,10,128,1
"org.apache.jackrabbit.core.search.PropertyTypeRegistry",6,0.08,3.00,72,0.94,48213.09,11,5,15,29,11,67.52,36,82,5,1,99.74,0.00,0.00,0.27,3,6.00,7,2819.13,0,0,6,java.lang.Object,0.00,23,0,18,0,23,6,1,15,525,1
"org.apache.jackrabbit.core.search.PropertyTypeRegistry$TypeMapping",1,2.00,1.00,6,0.04,560.40,3,2,15,1,1,160.21,2,8,0,1,120.33,0.00,0.00,0.00,0,1.00,1,127.05,0,0,1,java.lang.Object,0.00,0,0,1,0,0,1,0,2,36,2
"org.apache.jackrabbit.core.search.QueryConstants",0,0.00,0.00,24,0.47,16318.02,23,23,2,1,6,171.00,72,25,4,1,171.00,0.00,0.00,0.00,0,0.00,0,1405.38,0,0,2,,0.00,1,0,0,0,1,0,0,23,242,1
"org.apache.jackrabbit.core.search.QueryHandler",5,0.00,1.00,6,0.07,417.65,5,0,8,5,10,105.87,47,13,3,1,155.87,0.00,0.00,0.00,0,5.00,1,205.11,0,0,7,,0.00,0,0,5,0,0,5,0,6,60,1
"org.apache.jackrabbit.core.search.QueryImpl",7,0.10,2.14,48,0.81,29478.57,12,5,20,35,10,70.97,51,82,1,1,113.26,0.00,0.00,0.29,0,13.00,6,2419.24,0,4,9,java.lang.Object,0.00,28,0,15,0,28,3,1,15,463,1
"org.apache.jackrabbit.core.search.QueryManagerImpl",4,0.27,1.00,16,0.22,4063.58,9,5,11,8,4,76.76,35,28,1,1,124.86,0.00,0.00,0.40,0,6.00,1,654.15,0,3,3,java.lang.Object,0.00,4,0,4,0,4,1,1,10,150,1
"org.apache.jackrabbit.core.search.QueryNode",4,0.08,1.00,19,0.22,3988.71,16,12,0,4,19,80.80,46,22,18,1,124.93,0.00,0.00,0.02,0,6.00,1,663.78,0,2,1,java.lang.Object,0.00,0,0,4,13,0,2,0,17,145,2
"org.apache.jackrabbit.core.search.QueryNodeVisitor",11,0.00,1.00,12,0.10,546.60,11,0,0,11,17,157.64,3,13,17,1,157.64,0.00,0.00,0.00,0,11.00,1,305.00,0,11,11,,0.00,0,0,11,0,0,0,0,1,103,1
"org.apache.jackrabbit.core.search.QueryParser",3,0.00,2.33,16,0.20,6952.92,3,0,5,10,5,88.85,39,28,1,1,118.23,0.00,0.00,0.00,0,3.00,3,605.59,0,1,4,java.lang.Object,0.00,7,0,7,0,7,2,0,4,130,1
"org.apache.jackrabbit.core.search.QueryRootNode",9,0.21,1.00,22,0.16,2033.26,12,3,3,14,12,109.01,55,32,8,2,141.23,0.00,0.50,0.15,0,33.00,1,487.16,0,4,5,org.apache.jackrabbit.core.search.QueryNode,0.15,5,1,9,0,5,5,0,13,137,1
"org.apache.jackrabbit.core.search.RelationQueryNode",19,0.02,1.00,67,0.49,5930.41,26,7,2,20,10,91.27,137,87,7,2,133.56,0.00,0.50,0.12,0,215.00,1,1468.40,0,4,4,org.apache.jackrabbit.core.search.QueryNode,0.09,1,1,19,0,1,15,1,27,375,1
"org.apache.jackrabbit.core.search.TextsearchQueryNode",4,1.00,1.00,11,0.08,860.02,5,1,0,5,8,109.18,25,16,7,2,141.40,0.00,0.50,0.25,0,6.00,1,228.25,0,2,2,org.apache.jackrabbit.core.search.QueryNode,0.25,1,1,4,0,1,2,0,6,65,1
"org.apache.jackrabbit.test.api.xa.TestAll",1,0.00,1.00,4,0.03,457.63,1,0,3,2,0,90.03,12,6,0,2,127.59,0.00,0.50,0.00,0,1.00,1,76.45,0,1,0,junit.framework.TestCase,0.00,1,1,1,0,1,0,0,3,23,1
"org.apache.jackrabbit.rmi.iterator.ArrayIterator",7,0.00,1.00,18,0.11,1249.98,9,2,1,8,4,162.65,22,26,4,1,142.04,0.00,0.00,0.50,0,0.00,1,343.33,0,1,0,java.lang.Object,0.00,1,0,7,4,1,6,1,10,99,1
"org.apache.jackrabbit.rmi.iterator.ArrayNodeIterator",2,0.00,1.00,5,0.03,278.97,2,0,2,2,3,100.59,14,8,2,2,142.88,0.00,0.50,0.00,0,2.00,1,91.87,1,1,1,org.apache.jackrabbit.rmi.iterator.ArrayIterator,0.00,0,1,2,0,0,1,1,3,30,1
"org.apache.jackrabbit.rmi.iterator.ArrayNodeTypeIterator",2,0.00,1.00,5,0.03,278.97,2,0,2,2,2,100.59,14,9,1,2,142.88,0.00,0.50,0.00,0,2.00,1,91.87,1,1,1,org.apache.jackrabbit.rmi.iterator.ArrayIterator,0.00,0,1,2,0,0,1,1,3,30,1
"org.apache.jackrabbit.rmi.iterator.ArrayPropertyIterator",2,0.00,1.00,5,0.03,278.97,2,0,2,2,2,100.59,14,9,1,2,142.88,0.00,0.50,0.00,0,2.00,1,91.87,1,1,1,org.apache.jackrabbit.rmi.iterator.ArrayIterator,0.00,0,1,2,0,0,1,1,3,30,1
"org.apache.jackrabbit.rmi.iterator.ArrayRowIterator",2,0.00,1.00,5,0.03,278.97,2,0,2,2,2,100.59,14,8,1,2,142.88,0.00,0.50,0.00,0,2.00,1,91.87,1,1,1,org.apache.jackrabbit.rmi.iterator.ArrayIterator,0.00,0,1,2,0,0,1,1,3,30,1
"org.apache.jackrabbit.test.api.nodetype.NodeDefTest",10,0.03,3.30,118,1.32,43667.31,14,4,11,37,3,60.92,78,147,1,4,103.21,0.00,0.75,0.28,2,22.00,5,3952.33,2,0,2,org.apache.jackrabbit.test.AbstractJCRTest,0.50,27,3,33,0,27,10,0,28,767,1
"org.apache.jackrabbit.test.api.nodetype.NodeTypeManagerTest",6,0.10,1.83,35,0.45,9255.93,8,2,7,27,2,87.46,37,59,1,4,119.68,0.00,0.75,0.58,0,0.00,3,1355.64,3,0,1,org.apache.jackrabbit.test.AbstractJCRTest,0.67,21,3,11,0,21,6,0,12,290,1
"org.apache.jackrabbit.test.api.nodetype.NodeTypeTest",14,0.00,3.50,162,1.91,64077.86,17,3,12,49,3,70.82,87,240,1,4,103.04,0.00,0.75,0.33,2,0.00,6,5731.50,3,2,2,org.apache.jackrabbit.test.AbstractJCRTest,0.40,35,3,49,0,35,12,0,26,1088,1
"org.apache.jackrabbit.test.api.nodetype.PredefinedNodeTypeTest",6,0.21,17.17,374,6.64,830393.94,33,27,22,68,2,25.44,76,567,1,4,63.00,0.00,0.75,0.21,3,14.00,41,19914.51,2,0,1,org.apache.jackrabbit.test.AbstractJCRTest,0.67,62,3,103,0,62,6,0,47,2913,1
"org.apache.jackrabbit.test.api.nodetype.PropertyDefTest",10,0.09,4.70,158,2.20,105000.59,19,9,17,45,4,47.00,81,234,1,4,95.11,0.00,0.75,0.19,2,10.00,15,6610.01,2,0,3,org.apache.jackrabbit.test.AbstractJCRTest,0.50,35,3,47,0,35,10,0,32,1176,1
"org.apache.jackrabbit.test.api.nodetype.TestAll",1,0.00,1.00,9,0.09,2740.87,1,0,3,3,5,70.77,12,11,0,2,108.33,0.00,0.50,0.00,0,1.00,1,261.86,0,1,5,junit.framework.TestCase,0.00,2,1,1,0,2,0,0,3,63,1
"org.apache.jackrabbit.core.util.Base64",11,0.12,2.27,108,1.78,229742.97,15,4,1,18,4,58.91,84,135,4,1,101.20,0.00,0.00,0.14,2,39.00,8,5351.38,0,0,0,java.lang.Object,0.00,7,0,25,0,7,11,0,23,993,1
"org.apache.jackrabbit.core.util.ChildrenCollector",3,0.17,1.67,15,0.15,2436.59,6,3,5,4,0,79.61,21,23,0,2,121.90,0.00,0.50,0.44,0,1.00,2,463.16,0,0,0,TraversingItemVisitor.Default,0.00,1,1,5,0,1,3,0,4,111,1
"org.apache.jackrabbit.core.util.ChildrenCollectorFilter",5,0.12,4.60,61,0.60,35789.30,11,6,6,13,1,55.91,56,80,1,2,100.04,0.00,0.50,0.27,2,13.00,13,1814.10,0,0,0,TraversingItemVisitor.Default,0.00,8,1,23,0,8,5,0,14,381,1
"org.apache.jackrabbit.core.util.ISO9075",5,0.38,3.40,57,0.78,60189.75,7,2,4,27,6,55.61,55,75,5,1,99.74,0.00,0.00,0.20,2,11.00,9,2329.46,0,4,1,java.lang.Object,0.00,22,0,17,0,22,1,0,18,469,1
"org.apache.jackrabbit.core.util.IteratorHelper",11,0.02,1.09,33,0.21,2861.02,15,4,5,16,2,134.40,47,47,2,1,134.16,0.00,0.00,0.23,1,38.00,2,637.88,0,4,0,java.lang.Object,0.00,5,0,12,0,5,7,3,15,179,1
"org.apache.jackrabbit.core.util.Text",7,1.00,2.71,57,0.83,57133.49,8,1,4,23,3,57.80,71,78,3,1,106.28,0.00,0.00,0.14,3,12.00,6,2493.09,0,7,0,java.lang.Object,0.00,16,0,19,0,16,0,0,12,496,1
"org.apache.jackrabbit.core.util.ValueHelper",5,0.00,6.80,108,2.04,251697.14,5,0,5,26,6,46.65,63,212,2,1,84.21,0.00,0.00,0.00,1,5.00,17,6105.35,0,4,4,java.lang.Object,0.00,21,0,34,0,21,1,0,36,1014,1
"org.apache.jackrabbit.rmi.server.RemoteAdapterFactory",17,0.00,1.00,18,0.14,627.00,17,0,35,17,35,110.56,148,26,18,1,158.66,0.00,0.00,0.00,0,17.00,1,418.00,0,17,17,,0.00,0,0,17,0,0,0,0,18,141,1
"org.apache.jackrabbit.rmi.server.ServerAdapterFactory",17,0.00,1.00,35,0.35,4156.40,17,0,35,34,36,141.20,79,67,2,1,140.96,0.00,0.00,0.00,0,17.00,1,1045.70,0,17,35,java.lang.Object,0.00,17,0,17,0,17,0,1,18,277,1
"org.apache.jackrabbit.rmi.server.ServerItem",11,0.10,1.73,41,0.37,7070.37,12,1,5,22,7,170.85,31,72,3,2,130.96,2.00,0.25,0.91,0,0.00,2,1115.93,3,4,4,org.apache.jackrabbit.rmi.server.ServerObject,0.00,11,2,19,2,11,7,1,13,277,1
"org.apache.jackrabbit.rmi.server.ServerItemDef",7,0.17,1.00,17,0.14,1794.91,8,1,4,14,7,141.04,29,26,3,2,140.80,2.00,0.25,0.86,0,0.00,1,416.21,1,2,4,org.apache.jackrabbit.rmi.server.ServerObject,0.00,7,2,7,2,7,5,1,9,116,1
"org.apache.jackrabbit.rmi.server.ServerLock",6,0.20,1.00,14,0.11,1357.97,7,1,5,11,2,161.84,22,21,1,1,141.23,0.00,0.00,0.83,0,0.00,1,321.66,0,2,1,java.rmi.server.UnicastRemoteObject,0.00,5,1,6,0,5,4,1,8,92,1
"org.apache.jackrabbit.rmi.server.ServerNamespaceRegistry",7,0.17,1.86,29,0.28,5980.53,8,1,4,13,4,145.93,26,56,1,2,125.31,0.00,0.50,0.86,0,0.00,2,840.22,1,4,3,org.apache.jackrabbit.rmi.server.ServerObject,0.00,6,2,13,0,6,3,1,9,204,1
"org.apache.jackrabbit.rmi.server.ServerNode",40,0.03,1.98,164,1.75,37690.01,41,1,12,79,9,174.96,57,312,1,3,124.96,0.00,0.67,0.98,0,0.00,2,5256.72,6,20,8,org.apache.jackrabbit.rmi.server.ServerItem,0.00,39,3,79,0,39,20,1,42,1227,1
"org.apache.jackrabbit.rmi.server.ServerNodeDef",4,0.33,1.00,11,0.10,1346.78,5,1,4,8,5,122.00,22,17,1,3,139.87,0.00,0.67,0.75,0,0.00,1,299.44,2,2,4,org.apache.jackrabbit.rmi.server.ServerItemDef,0.00,4,3,4,0,4,2,1,6,81,1
"org.apache.jackrabbit.rmi.server.ServerNodeType",17,0.19,1.00,39,0.38,5660.49,18,1,7,30,6,179.79,35,62,1,2,139.91,0.00,0.50,0.82,2,0.00,1,1136.67,3,8,5,org.apache.jackrabbit.rmi.server.ServerObject,0.00,13,2,17,0,13,9,1,19,303,1
"org.apache.jackrabbit.rmi.server.ServerNodeTypeManager",5,0.25,1.80,21,0.21,4352.24,6,1,5,10,5,125.49,24,42,1,2,125.26,0.00,0.50,0.80,0,0.00,2,643.65,3,4,4,org.apache.jackrabbit.rmi.server.ServerObject,0.00,5,2,9,0,5,1,1,7,154,1
"org.apache.jackrabbit.rmi.server.ServerObject",10,0.22,4.20,117,1.28,66710.78,11,1,36,42,19,57.58,117,133,12,1,101.71,0.00,0.00,0.80,0,0.00,19,3826.59,0,9,7,java.rmi.server.UnicastRemoteObject,0.00,32,1,42,16,32,1,0,18,793,1
"org.apache.jackrabbit.rmi.server.ServerProperty",9,0.12,1.89,37,0.36,7437.35,10,1,7,19,6,146.04,27,67,1,3,125.42,0.00,0.67,0.89,0,0.00,2,1082.59,2,3,5,org.apache.jackrabbit.rmi.server.ServerItem,0.00,10,3,17,0,10,6,1,11,261,1
"org.apache.jackrabbit.rmi.server.ServerPropertyDef",5,0.25,1.00,13,0.11,1489.26,6,1,4,9,4,140.52,24,21,1,3,140.29,0.00,0.67,0.80,0,0.00,1,318.97,0,2,3,org.apache.jackrabbit.rmi.server.ServerItemDef,0.00,4,3,5,0,4,3,1,7,88,1
"org.apache.jackrabbit.rmi.server.ServerQuery",6,0.20,1.00,15,0.13,1711.17,7,1,5,12,6,161.05,23,26,1,2,140.44,0.00,0.50,0.83,0,0.00,1,398.31,0,4,5,org.apache.jackrabbit.rmi.server.ServerObject,0.00,6,2,6,0,6,2,1,8,108,1
"org.apache.jackrabbit.rmi.server.ServerQueryManager",4,0.33,1.50,17,0.18,3679.91,5,1,7,8,4,107.24,23,31,1,2,125.11,0.00,0.50,0.75,0,0.00,2,551.08,2,3,4,org.apache.jackrabbit.rmi.server.ServerObject,0.00,4,2,6,0,4,1,1,7,128,1
"org.apache.jackrabbit.rmi.server.ServerQueryResult",4,0.33,2.00,31,0.32,11336.47,5,1,8,13,7,94.26,23,37,2,2,112.13,0.00,0.50,0.75,0,0.00,3,950.25,0,3,5,org.apache.jackrabbit.rmi.server.ServerObject,0.00,9,2,8,0,9,1,1,8,202,1
"org.apache.jackrabbit.rmi.server.ServerRepository",7,0.17,1.57,29,0.32,6558.95,8,1,7,11,5,145.65,25,50,1,2,125.04,0.00,0.50,0.86,0,0.00,2,947.88,2,6,4,org.apache.jackrabbit.rmi.server.ServerObject,0.00,4,2,11,0,4,1,1,9,219,1
"org.apache.jackrabbit.rmi.server.ServerRow",3,0.50,1.00,9,0.08,1096.85,4,1,5,5,4,100.80,20,15,1,2,133.02,0.00,0.50,0.67,0,1.00,1,244.97,0,2,3,org.apache.jackrabbit.rmi.server.ServerObject,0.00,2,2,3,0,2,1,1,5,65,1
"org.apache.jackrabbit.rmi.server.ServerSession",26,0.04,1.58,90,0.95,20458.40,27,1,12,57,7,180.29,43,165,1,2,130.29,0.00,0.50,0.96,0,0.00,2,2860.39,3,12,6,org.apache.jackrabbit.rmi.server.ServerObject,0.00,31,2,41,0,31,14,1,28,682,1
"org.apache.jackrabbit.rmi.server.ServerWorkspace",11,0.30,1.82,46,0.51,11198.14,12,1,12,23,7,164.60,26,88,1,2,124.72,0.00,0.50,0.73,2,0.00,2,1540.12,2,5,6,org.apache.jackrabbit.rmi.server.ServerObject,0.00,12,2,20,0,12,6,1,13,357,1
"org.apache.jackrabbit.test.api.version.AbstractOnParentVersionTest",2,0.60,2.50,21,0.28,5937.39,7,5,5,13,6,56.14,19,27,5,5,106.14,1.25,0.40,0.50,0,0.00,3,842.14,1,1,1,org.apache.jackrabbit.test.api.version.AbstractVersionTest,0.42,11,4,5,5,11,1,0,5,171,2
"org.apache.jackrabbit.test.api.version.AbstractVersionTest",4,0.13,3.75,49,0.62,20126.89,9,5,7,18,9,69.07,27,72,8,4,101.29,4.67,0.17,0.30,0,2.00,10,1864.43,4,1,1,org.apache.jackrabbit.test.AbstractJCRTest,0.80,14,3,15,14,14,3,0,8,352,1
"org.apache.jackrabbit.test.api.version.CheckinTest",10,0.00,1.30,44,0.48,7840.86,10,0,7,26,2,93.47,60,61,1,5,125.69,0.00,0.80,0.00,0,0.00,2,1444.15,2,0,1,org.apache.jackrabbit.test.api.version.AbstractVersionTest,0.25,16,4,13,0,16,10,0,13,334,1
"org.apache.jackrabbit.test.api.version.CheckoutTest",7,0.00,3.14,64,0.79,28676.67,7,0,7,32,2,74.47,48,89,1,5,106.69,0.00,0.80,0.00,0,0.00,7,2376.27,1,0,1,org.apache.jackrabbit.test.api.version.AbstractVersionTest,0.29,25,4,22,0,25,7,0,17,459,1
"org.apache.jackrabbit.test.api.version.OnParentVersionAbortTest",3,0.00,1.67,15,0.13,1576.55,3,0,4,9,2,81.09,23,23,0,6,123.39,0.00,0.83,0.00,0,2.00,2,375.63,2,0,2,org.apache.jackrabbit.test.api.version.AbstractOnParentVersionTest,0.40,6,5,5,0,6,3,0,6,91,1
"org.apache.jackrabbit.test.api.version.OnParentVersionComputeTest",2,0.00,1.00,13,0.12,1811.76,2,0,4,10,1,76.40,14,16,0,6,118.69,0.00,0.83,0.00,0,2.00,1,366.07,1,0,1,org.apache.jackrabbit.test.api.version.AbstractOnParentVersionTest,0.43,8,5,2,0,8,2,0,2,84,1
"org.apache.jackrabbit.test.api.version.OnParentVersionCopyTest",3,1.00,1.33,20,0.20,3810.51,4,1,4,15,1,75.17,21,25,0,6,117.46,0.00,0.83,0.33,0,2.00,2,606.93,2,0,1,org.apache.jackrabbit.test.api.version.AbstractOnParentVersionTest,0.40,12,5,4,0,12,3,0,5,132,1
"org.apache.jackrabbit.test.api.version.OnParentVersionIgnoreTest",2,0.00,1.00,13,0.12,1811.76,2,0,4,10,1,76.40,14,16,0,6,118.69,0.00,0.83,0.00,0,2.00,1,366.07,1,0,1,org.apache.jackrabbit.test.api.version.AbstractOnParentVersionTest,0.43,8,5,2,0,8,2,0,2,84,1
"org.apache.jackrabbit.test.api.version.OnParentVersionInitializeTest",2,0.00,1.00,13,0.12,1811.76,2,0,4,10,1,76.40,14,16,0,6,118.69,0.00,0.83,0.00,0,2.00,1,366.07,1,0,1,org.apache.jackrabbit.test.api.version.AbstractOnParentVersionTest,0.43,8,5,2,0,8,2,0,2,84,1
"org.apache.jackrabbit.test.api.version.RemoveVersionTest",5,0.50,3.40,65,0.71,22069.59,9,4,10,23,3,58.17,38,80,1,5,100.46,0.00,0.80,0.65,0,0.00,5,2125.89,2,0,2,org.apache.jackrabbit.test.api.version.AbstractVersionTest,0.67,18,4,17,0,18,5,0,12,410,1
"org.apache.jackrabbit.test.api.version.RestoreTest",15,0.02,1.73,76,0.81,14058.53,18,3,10,36,3,89.18,94,115,1,5,121.40,0.25,0.67,0.36,0,0.00,3,2428.43,3,0,2,org.apache.jackrabbit.test.api.version.AbstractVersionTest,0.40,21,4,26,1,21,15,0,26,529,1
"org.apache.jackrabbit.test.api.version.TestAll",1,0.00,1.00,10,0.10,3275.34,1,0,3,3,6,124.15,18,12,0,2,106.02,0.00,0.50,0.00,0,1.00,1,301.01,0,1,6,junit.framework.TestCase,0.00,2,1,1,0,2,0,0,9,71,1
"org.apache.jackrabbit.test.api.version.VersionGraphTest",4,0.00,1.50,20,0.25,4301.19,4,0,6,15,2,72.86,34,28,1,5,120.96,0.00,0.80,0.00,0,0.00,2,740.42,0,0,1,org.apache.jackrabbit.test.api.version.AbstractVersionTest,0.00,11,4,6,0,11,4,0,6,161,1
"org.apache.jackrabbit.test.api.version.VersionHistoryTest",7,0.17,2.00,47,0.47,10508.23,8,1,6,23,2,84.58,48,60,1,5,116.80,0.00,0.80,0.86,0,0.00,4,1399.29,2,0,1,org.apache.jackrabbit.test.api.version.AbstractVersionTest,0.29,16,4,14,0,16,7,0,9,298,1
"org.apache.jackrabbit.test.api.version.VersionLabelTest",16,0.52,2.06,121,1.42,34943.79,20,4,8,38,2,70.72,114,153,1,5,113.01,0.00,0.80,0.73,0,0.00,3,4271.48,3,0,1,org.apache.jackrabbit.test.api.version.AbstractVersionTest,0.38,22,4,33,0,22,16,0,23,874,1
"org.apache.jackrabbit.test.api.version.WorkspaceRestoreTest",9,0.25,2.67,91,1.21,35543.59,15,6,11,32,2,72.93,61,121,0,6,105.15,0.00,0.83,0.39,0,0.00,7,3624.30,2,0,2,org.apache.jackrabbit.test.api.version.RestoreTest,0.35,23,5,24,0,23,9,0,30,698,1
"org.apache.jackrabbit.test.api.access.TestAll",1,0.00,1.00,4,0.03,457.63,1,0,3,2,0,90.03,12,6,0,2,127.59,0.00,0.50,0.00,0,1.00,1,76.45,0,1,0,junit.framework.TestCase,0.00,1,1,1,0,1,0,0,3,23,1
"org.apache.jackrabbit.core.BLOBFileValue",17,0.06,2.88,129,1.42,49401.80,23,6,9,53,12,79.74,108,195,10,1,111.96,0.00,0.00,0.23,3,41.00,6,4245.12,0,4,2,java.lang.Object,0.00,36,0,49,0,36,13,1,39,880,1
"org.apache.jackrabbit.core.BaseException",10,0.67,1.40,35,0.24,5730.96,11,1,2,12,13,89.11,71,51,13,2,131.40,11.00,0.08,0.40,2,18.00,3,718.23,2,3,0,java.lang.Exception,0.00,2,1,14,11,2,7,0,12,193,2
"org.apache.jackrabbit.core.CachingHierarchyManager",11,0.04,1.45,52,0.57,20605.34,16,5,6,25,7,122.92,51,72,1,1,122.68,0.00,0.00,0.24,2,0.00,4,1701.93,0,8,6,java.lang.Object,0.00,14,0,16,0,14,3,1,17,392,1
"org.apache.jackrabbit.core.Constants",0,0.00,0.00,56,1.49,46445.36,55,55,0,1,25,171.00,79,57,24,1,171.00,0.00,0.00,0.00,0,0.00,0,4483.80,0,0,1,,0.00,1,0,0,0,1,0,0,50,655,1
"org.apache.jackrabbit.core.HierarchyManager",8,0.00,1.00,9,0.10,712.12,8,0,3,8,14,123.43,52,11,10,1,155.65,0.00,0.00,0.00,0,8.00,1,307.98,0,7,4,,0.00,0,0,8,0,0,1,0,9,91,1
"org.apache.jackrabbit.core.HierarchyManagerImpl",15,0.01,4.93,290,4.55,353161.52,20,5,15,84,18,46.21,112,381,2,1,88.51,0.00,0.00,0.21,5,0.00,14,13663.66,0,11,16,java.lang.Object,0.00,69,0,74,1,69,4,1,58,2327,1
"org.apache.jackrabbit.core.IllegalNameException",4,0.00,1.00,9,0.05,332.37,4,0,0,4,19,112.43,27,14,18,3,144.65,0.00,0.67,0.00,0,4.00,1,136.79,0,0,1,org.apache.jackrabbit.core.BaseException,0.00,0,2,4,0,0,4,0,5,46,1
"org.apache.jackrabbit.core.InternalValue",33,0.09,1.52,166,2.35,88656.60,35,2,9,81,49,118.06,132,261,38,1,117.83,0.00,0.00,0.41,1,86.00,7,7050.42,0,22,11,java.lang.Object,0.00,48,0,50,0,48,11,0,29,1425,1
"org.apache.jackrabbit.core.ItemId",2,0.50,1.00,6,0.04,572.65,4,2,1,2,37,101.63,13,8,37,1,133.86,0.00,0.00,0.25,0,2.00,1,127.08,0,0,0,java.lang.Object,0.00,0,0,2,3,0,2,1,2,35,2
"org.apache.jackrabbit.core.ItemImpl",43,0.06,3.79,584,8.40,724676.94,56,13,41,183,31,47.38,456,778,6,1,95.86,0.00,0.00,0.13,19,701.00,26,25187.80,1,14,30,java.lang.Object,0.00,140,0,163,4,140,29,3,212,4247,2
"org.apache.jackrabbit.core.ItemLifeCycleListener",3,0.00,1.00,4,0.03,127.07,3,0,0,3,7,114.06,35,5,6,1,158.19,0.00,0.00,0.00,0,3.00,1,84.71,0,0,2,,0.00,0,0,3,0,0,3,0,4,29,1
"org.apache.jackrabbit.core.ItemManager",29,0.09,3.03,288,4.11,148092.25,37,8,29,110,39,57.84,239,395,18,1,105.95,0.00,0.00,0.22,11,11.00,8,12333.89,0,16,28,java.lang.Object,0.00,81,0,88,0,81,13,2,85,2285,1
"org.apache.jackrabbit.core.LazyItemIterator",9,0.04,1.67,36,0.33,7534.34,12,3,4,18,3,175.41,16,53,2,1,125.41,0.00,0.00,0.30,1,12.00,5,981.87,0,3,2,java.lang.Object,0.00,9,0,15,0,9,6,2,8,232,1
"org.apache.jackrabbit.core.LocalNamespaceMappings",5,0.50,5.00,68,0.93,58498.21,9,4,6,31,4,59.48,62,94,1,1,97.04,0.00,0.00,0.65,0,0.00,13,2792.48,0,3,3,java.lang.Object,0.00,26,0,25,0,26,2,1,40,534,0
"org.apache.jackrabbit.core.MalformedPathException",4,0.00,1.00,9,0.05,332.37,4,0,0,4,21,112.43,27,14,20,3,144.65,0.00,0.67,0.00,0,4.00,1,136.79,0,0,1,org.apache.jackrabbit.core.BaseException,0.00,0,2,4,0,0,4,0,5,46,1
"org.apache.jackrabbit.core.NamespaceRegistryImpl",10,0.16,2.80,123,1.70,74996.50,17,7,14,46,12,51.89,80,170,8,1,99.99,0.00,0.00,0.29,2,0.00,10,5093.08,0,5,4,java.lang.Object,0.00,36,0,28,0,36,5,3,37,970,1
"org.apache.jackrabbit.core.NamespaceResolver",2,0.00,1.00,3,0.02,147.00,2,0,1,2,42,108.20,17,4,42,1,156.30,0.00,0.00,0.00,0,2.00,1,62.00,0,2,0,,0.00,0,0,2,0,0,0,0,3,22,1
"org.apache.jackrabbit.core.NoPrefixDeclaredException",4,0.00,1.00,9,0.05,332.37,4,0,0,4,32,112.43,27,14,31,3,144.65,0.00,0.67,0.00,0,4.00,1,136.79,0,0,1,org.apache.jackrabbit.core.BaseException,0.00,0,2,4,0,0,4,0,5,46,1
"org.apache.jackrabbit.core.NodeId",7,0.25,1.71,28,0.20,4170.27,9,2,0,11,38,166.45,19,41,37,2,126.56,1.00,0.33,0.29,0,3.00,3,613.53,0,3,1,org.apache.jackrabbit.core.ItemId,0.22,4,1,12,1,4,4,0,4,156,1
"org.apache.jackrabbit.core.NodeImpl",115,0.07,3.70,1458,21.69,1175046.34,119,4,69,394,60,50.39,1169,2028,21,2,98.87,2.00,0.25,0.18,44,1907.00,24,65062.59,8,56,45,org.apache.jackrabbit.core.ItemImpl,0.08,279,1,425,2,279,59,1,520,11341,1
"org.apache.jackrabbit.core.Path",29,0.01,3.38,303,3.78,278082.06,39,10,9,87,31,81.92,433,375,26,1,102.06,0.00,0.00,0.09,8,272.00,18,11338.79,0,14,5,java.lang.Object,0.00,58,0,98,0,58,15,0,88,2104,2
"org.apache.jackrabbit.core.Path$CurrentElement",7,0.67,1.00,16,0.09,742.44,8,1,9,7,3,143.82,6,24,0,2,143.82,0.00,0.50,0.43,0,10.00,1,255.07,0,2,3,org.apache.jackrabbit.core.PathElement,0.00,0,1,7,0,0,5,0,6,78,2
"org.apache.jackrabbit.core.Path$ParentElement",7,0.67,1.00,16,0.09,742.44,8,1,9,7,3,143.82,6,24,0,2,143.82,0.00,0.50,0.43,0,10.00,1,255.07,0,2,3,org.apache.jackrabbit.core.PathElement,0.00,0,1,7,0,0,5,0,6,78,2
"org.apache.jackrabbit.core.Path$PathBuilder",12,0.06,1.25,46,0.41,10317.08,15,3,9,25,3,112.17,66,58,0,1,130.04,0.00,0.00,0.28,3,32.00,2,1230.96,0,1,3,java.lang.Object,0.00,13,0,15,0,13,11,1,16,309,2
"org.apache.jackrabbit.core.Path$PathElement",15,0.25,2.00,84,0.95,38222.48,17,2,9,34,3,138.56,54,115,0,1,117.94,0.00,0.00,0.27,2,85.00,9,2846.36,0,4,3,java.lang.Object,0.00,19,0,30,0,19,11,0,15,600,2
"org.apache.jackrabbit.core.Path$RootElement",7,1.00,1.00,16,0.09,742.44,8,1,9,7,3,193.82,7,24,0,2,143.82,0.00,0.50,0.14,0,12.00,1,255.07,0,2,3,org.apache.jackrabbit.core.PathElement,0.00,0,1,7,0,0,5,0,7,78,2
"org.apache.jackrabbit.core.PathTest",7,0.17,5.71,189,3.11,197626.80,13,6,3,40,6,122.04,20,206,1,2,82.16,0.00,0.50,0.31,2,0.00,9,9337.75,0,2,5,junit.framework.TestCase,0.00,33,1,40,0,33,5,0,15,1611,1
"org.apache.jackrabbit.core.PathTest$NamespaceResolver",2,0.00,1.00,5,0.02,262.00,2,0,3,2,0,143.10,0,7,0,1,143.10,0.00,0.00,0.00,0,2.00,1,68.00,0,2,0,java.lang.Object,0.00,0,0,2,0,0,0,0,0,24,0
"org.apache.jackrabbit.core.PathTest$Test",7,0.11,1.71,29,0.28,6761.30,10,3,3,12,0,174.91,8,41,0,1,124.91,0.00,0.00,0.24,3,16.00,5,845.46,0,1,0,java.lang.Object,0.00,5,0,12,0,5,6,0,2,203,2
"org.apache.jackrabbit.core.PropertyId",8,0.00,1.88,43,0.41,13169.26,11,3,0,18,30,159.34,19,60,28,2,119.45,0.00,0.50,0.33,0,2.00,3,1227.53,0,4,2,org.apache.jackrabbit.core.ItemId,0.20,10,1,15,0,10,4,0,4,282,1
"org.apache.jackrabbit.core.PropertyImpl",36,0.03,4.53,519,7.20,349608.15,38,2,13,106,25,54.21,285,701,11,2,96.50,0.00,0.50,0.47,4,0.00,11,21599.60,3,13,17,org.apache.jackrabbit.core.ItemImpl,0.15,70,1,163,0,70,23,1,187,3859,1
"org.apache.jackrabbit.core.QName",13,0.01,2.54,99,1.14,50257.78,19,6,5,38,113,61.01,122,138,109,1,111.01,0.00,0.00,0.18,2,41.00,6,3427.49,1,8,4,java.lang.Object,0.00,25,0,33,0,25,5,3,33,704,1
"org.apache.jackrabbit.core.QNameTest",3,0.67,4.33,69,0.96,40998.47,6,3,2,16,4,107.92,11,73,1,2,87.30,0.00,0.50,0.78,0,0.00,7,2887.03,0,0,3,junit.framework.TestCase,0.00,13,1,13,0,13,3,0,6,525,1
"org.apache.jackrabbit.core.QNameTest$NamespaceResolver",2,0.00,1.00,5,0.02,262.00,2,0,2,2,0,143.10,0,7,0,1,143.10,0.00,0.00,0.00,0,2.00,1,68.00,0,2,0,java.lang.Object,0.00,0,0,2,0,0,0,0,0,24,0
"org.apache.jackrabbit.core.QNameTest$Test",4,0.22,1.25,17,0.12,2171.09,7,3,2,7,0,126.96,0,23,0,1,126.96,0.00,0.00,0.17,1,8.00,2,373.83,0,1,0,java.lang.Object,0.00,3,0,5,0,3,3,0,0,103,2
"org.apache.jackrabbit.core.RepositoryImpl",27,0.09,2.85,292,4.05,156467.67,48,21,46,139,35,61.53,212,417,9,1,103.82,0.00,0.00,0.13,7,90.00,11,12137.59,0,19,30,java.lang.Object,0.00,112,0,77,0,112,8,4,83,2167,1
"org.apache.jackrabbit.core.RepositoryImpl$Thread",1,0.00,1.00,3,0.01,56.92,1,0,46,2,0,139.38,0,4,0,1,139.38,0.00,0.00,0.00,0,1.00,1,30.46,0,0,0,java.lang.Object,0.00,1,0,1,0,1,1,0,0,12,0
"org.apache.jackrabbit.core.RepositoryImpl$WorkspaceInfo",10,0.15,2.50,66,0.64,18032.78,16,6,46,30,11,68.02,80,103,0,1,116.12,0.00,0.00,0.30,2,0.00,8,1918.76,0,8,11,java.lang.Object,0.00,20,0,25,0,20,2,0,25,415,0
"org.apache.jackrabbit.core.SearchManager",7,0.21,4.43,102,1.74,91855.37,18,11,25,53,23,57.91,90,156,5,1,95.48,0.00,0.00,0.27,2,0.00,16,5211.06,0,2,18,java.lang.Object,0.00,46,0,31,0,46,5,1,28,897,1
"org.apache.jackrabbit.core.SessionImpl",49,0.02,2.55,418,5.83,386825.89,68,19,61,182,50,64.12,344,600,29,1,106.41,0.00,0.00,0.07,7,1340.00,27,17481.30,0,22,32,java.lang.Object,0.00,133,0,125,2,133,27,2,143,3141,1
"org.apache.jackrabbit.core.SessionListener",1,0.00,1.00,2,0.01,41.48,1,0,0,1,2,109.47,12,3,2,1,147.03,0.00,0.00,0.00,0,1.00,1,27.65,0,0,1,,0.00,0,0,1,0,0,1,0,2,11,1
"org.apache.jackrabbit.core.SystemSession",3,1.00,1.00,12,0.15,2689.30,4,1,12,10,9,76.81,31,23,3,2,125.29,0.00,0.50,0.00,0,3.00,1,463.55,0,2,7,org.apache.jackrabbit.core.SessionImpl,0.00,7,1,3,0,7,1,0,8,108,0
"org.apache.jackrabbit.core.SystemSession$SystemAccessManager",5,0.00,1.00,7,0.06,409.33,5,0,12,5,3,176.55,17,16,0,1,155.93,0.00,0.00,0.00,0,5.00,1,177.74,0,0,3,java.lang.Object,0.00,0,0,5,0,0,5,1,9,54,1
"org.apache.jackrabbit.core.TestAll",1,0.00,1.00,7,0.06,1740.69,1,0,3,3,3,65.48,10,9,0,2,113.96,0.00,0.50,0.00,0,1.00,1,186.48,0,1,3,junit.framework.TestCase,0.00,2,1,1,0,2,0,0,2,47,1
"org.apache.jackrabbit.core.UnknownPrefixException",4,0.00,1.00,9,0.05,332.37,4,0,0,4,17,112.43,27,14,16,3,144.65,0.00,0.67,0.00,0,4.00,1,136.79,0,0,1,org.apache.jackrabbit.core.BaseException,0.00,0,2,4,0,0,4,0,5,46,1
"org.apache.jackrabbit.core.UserTransactionImpl",7,0.25,2.29,50,0.62,20735.10,11,4,11,18,1,79.73,42,77,1,1,111.95,0.00,0.00,0.46,0,0.00,4,1854.07,0,0,0,java.lang.Object,0.00,11,0,16,0,11,7,1,13,370,0
"org.apache.jackrabbit.core.UserTransactionImpl$XidImpl",4,1.00,1.00,10,0.06,808.47,5,1,11,4,0,162.23,15,15,0,1,141.61,0.00,0.00,0.25,0,6.00,1,193.11,0,0,0,java.lang.Object,0.00,0,0,4,0,0,4,1,5,57,0
"org.apache.jackrabbit.core.WorkspaceImpl",34,0.05,2.71,371,6.14,319540.10,42,8,53,148,35,54.08,294,590,4,1,102.18,0.00,0.00,0.18,13,270.00,10,18409.38,0,18,34,java.lang.Object,0.00,114,0,92,0,114,16,2,123,3180,1
"org.apache.jackrabbit.core.XASession",1,0.00,1.00,2,0.01,48.43,1,0,2,1,1,172.78,19,3,1,2,146.50,0.00,0.50,0.00,0,1.00,1,27.12,0,1,0,,0.00,0,1,1,0,0,0,0,2,11,1
"org.apache.jackrabbit.core.XASessionImpl",18,0.06,2.06,96,1.04,30777.96,22,4,14,32,9,87.08,119,133,2,2,119.30,0.00,0.50,0.19,4,130.00,8,3131.80,1,3,8,org.apache.jackrabbit.core.SessionImpl,0.00,14,1,37,0,14,15,2,26,677,1
"org.apache.jackrabbit.core.XASessionImpl$EventDispatcher",3,1.00,1.00,7,0.05,457.94,4,1,14,4,3,110.35,18,11,0,1,142.57,0.00,0.00,0.33,0,4.00,1,142.54,0,0,3,java.lang.Object,0.00,1,0,3,0,1,3,1,4,43,1
"org.apache.jackrabbit.core.XATest",8,0.00,2.62,112,1.31,32244.20,8,0,7,31,3,62.07,101,143,1,4,99.63,0.00,0.75,0.00,0,0.00,5,3926.83,1,0,2,org.apache.jackrabbit.test.AbstractJCRTest,0.00,23,3,21,0,23,8,0,66,758,1
"org.apache.jackrabbit.core.version.GenericVersionSelector",15,0.12,1.53,53,0.52,16963.40,19,4,5,23,2,86.77,108,78,1,1,129.06,0.00,0.00,0.13,0,64.00,5,1573.92,0,7,1,java.lang.Object,0.00,8,0,23,0,8,8,1,20,366,1
"org.apache.jackrabbit.core.version.HistoryRootNodeState",7,0.17,2.43,43,0.53,12816.14,9,2,10,17,8,83.85,46,67,1,4,116.08,0.00,0.75,0.36,1,4.00,4,1588.21,1,3,8,org.apache.jackrabbit.core.virtual.VirtualNodeState,0.04,10,3,17,0,10,4,0,16,332,1
"org.apache.jackrabbit.core.version.InternalFreeze",1,0.00,1.00,2,0.01,48.43,1,0,1,1,5,96.50,9,3,4,2,146.50,0.00,0.50,0.00,0,1.00,1,27.12,0,1,1,,0.00,0,1,1,0,0,0,0,2,11,1
"org.apache.jackrabbit.core.version.InternalFrozenNode",5,0.00,1.00,6,0.03,187.89,5,0,3,5,9,126.38,32,7,6,2,158.60,0.00,0.50,0.00,0,5.00,1,93.75,0,4,3,,0.00,0,1,5,0,0,1,0,6,36,1
"org.apache.jackrabbit.core.version.InternalFrozenVersionHistory",4,0.00,1.00,5,0.03,144.45,4,0,1,4,5,116.44,30,7,3,2,158.73,0.00,0.50,0.00,0,4.00,1,78.03,0,3,2,,0.00,0,1,4,0,0,1,0,5,30,1
"org.apache.jackrabbit.core.version.InternalVersion",10,0.00,1.00,11,0.05,270.10,10,0,3,10,21,127.51,61,12,19,2,159.73,0.00,0.50,0.00,0,10.00,1,159.39,0,7,3,,0.00,0,1,10,0,0,3,0,11,63,1
"org.apache.jackrabbit.core.version.InternalVersionHistory",13,0.00,1.00,14,0.10,525.64,13,0,4,13,16,116.06,93,16,15,2,158.35,0.00,0.50,0.00,0,13.00,1,288.26,0,3,2,,0.00,0,1,13,0,0,10,0,14,100,1
"org.apache.jackrabbit.core.version.InternalVersionItem",2,0.00,1.00,3,0.01,46.83,2,0,0,2,12,112.11,16,4,12,1,160.22,0.00,0.00,0.00,0,2.00,1,31.22,0,2,0,,0.00,0,0,2,0,0,0,0,3,14,1
"org.apache.jackrabbit.core.version.PersistentVersionManager",14,0.00,1.00,15,0.12,663.37,14,0,7,14,14,125.58,95,22,8,1,157.80,0.00,0.00,0.00,0,14.00,1,345.24,0,6,6,,0.00,0,0,14,0,0,8,0,15,116,1
"org.apache.jackrabbit.core.version.VersionHistoryImpl",16,0.27,2.31,94,1.34,41209.04,17,1,11,47,16,118.11,69,145,3,3,117.87,0.00,0.67,0.75,2,0.00,4,4014.07,0,8,15,org.apache.jackrabbit.core.NodeImpl,0.02,31,2,37,0,31,8,1,20,826,1
"org.apache.jackrabbit.core.version.VersionHistoryNodeState",7,0.17,2.57,39,0.55,13995.09,8,1,8,17,7,100.84,36,60,1,4,118.72,0.00,0.75,0.86,0,0.00,5,1662.17,5,3,7,org.apache.jackrabbit.core.virtual.VirtualNodeState,0.04,10,3,18,0,10,4,1,13,352,1
"org.apache.jackrabbit.core.version.VersionImpl",8,0.14,1.38,36,0.38,10782.70,9,1,8,15,10,105.95,47,45,4,3,123.82,0.00,0.67,0.88,0,0.00,2,1145.52,0,4,8,org.apache.jackrabbit.core.NodeImpl,0.02,7,2,11,0,7,4,1,13,262,1
"org.apache.jackrabbit.core.version.VersionItemStateProvider",22,0.02,2.27,178,2.81,136122.67,33,11,13,110,36,64.98,159,246,5,1,107.27,0.00,0.00,0.11,10,146.00,9,8417.69,0,12,35,java.lang.Object,0.00,88,0,50,0,88,10,2,66,1558,1
"org.apache.jackrabbit.core.version.VersionIteratorImpl",9,0.08,1.56,39,0.34,7838.57,12,3,7,22,2,107.42,50,52,1,1,125.29,0.00,0.00,0.26,2,16.00,3,1005.66,0,2,1,java.lang.Object,0.00,13,0,14,0,13,7,1,13,236,1
"org.apache.jackrabbit.core.version.VersionLabelsNodeState",8,0.29,2.38,55,0.69,24074.56,10,2,13,26,10,154.27,19,73,1,4,114.38,0.00,0.75,0.25,3,20.00,6,2055.58,5,5,10,org.apache.jackrabbit.core.virtual.VirtualNodeState,0.08,18,3,19,0,18,3,1,5,423,1
"org.apache.jackrabbit.core.version.VersionManager",12,0.00,1.00,13,0.09,498.08,12,0,8,12,11,115.97,87,14,5,1,158.26,0.00,0.00,0.00,0,12.00,1,279.54,0,7,7,,0.00,0,0,12,0,0,5,0,14,96,1
"org.apache.jackrabbit.core.version.VersionManagerImpl",13,0.07,1.31,48,0.55,10749.88,19,6,10,38,13,82.06,114,70,1,1,130.17,0.00,0.00,0.23,0,0.00,3,1643.11,0,6,12,java.lang.Object,0.00,25,0,17,0,25,7,1,24,377,1
"org.apache.jackrabbit.core.version.VersionNodeState",2,1.00,4.50,32,0.46,25153.10,3,1,7,13,8,44.98,21,37,1,4,93.45,0.00,0.75,0.50,0,2.00,7,1386.69,3,1,8,org.apache.jackrabbit.core.virtual.VirtualNodeState,0.00,11,3,9,0,11,1,0,6,261,1
"org.apache.jackrabbit.core.version.VersionSelector",1,0.00,1.00,2,0.01,69.06,1,0,3,1,2,107.72,12,3,2,1,145.29,0.00,0.00,0.00,0,1.00,1,36.53,0,1,0,,0.00,0,0,1,0,0,0,0,2,13,1
"org.apache.jackrabbit.rmi.client.ClientAdapterFactory",17,0.00,1.00,35,0.33,3592.68,17,0,34,34,37,123.59,100,56,2,1,141.46,0.00,0.00,0.00,0,17.00,1,988.82,0,17,35,java.lang.Object,0.00,17,0,17,0,17,0,1,18,269,1
"org.apache.jackrabbit.rmi.client.ClientItem",15,0.14,2.00,65,0.60,14960.89,17,2,8,32,8,125.00,65,105,3,1,124.77,0.00,0.00,0.37,2,0.00,6,1805.38,2,5,5,org.apache.jackrabbit.rmi.client.ClientObject,0.00,17,1,30,2,17,10,1,18,425,1
"org.apache.jackrabbit.rmi.client.ClientItemDef",7,0.17,1.86,29,0.24,4404.38,8,1,4,15,7,146.97,27,49,3,1,126.36,0.00,0.00,0.86,0,0.00,2,714.14,1,2,4,org.apache.jackrabbit.rmi.client.ClientObject,0.00,8,1,13,2,8,5,1,9,180,1
"org.apache.jackrabbit.rmi.client.ClientLock",7,0.08,1.71,28,0.21,3843.34,9,2,5,14,4,127.08,28,46,1,1,126.84,0.00,0.00,0.43,0,0.00,2,639.25,0,3,3,java.lang.Object,0.00,7,0,12,0,7,4,1,10,165,1
"org.apache.jackrabbit.rmi.client.ClientNamespaceRegistry",7,0.17,1.86,29,0.28,6048.57,8,1,4,14,5,145.89,24,52,1,1,125.27,0.00,0.00,0.86,0,0.00,2,841.90,0,4,4,org.apache.jackrabbit.rmi.client.ClientObject,0.00,7,1,13,0,7,3,1,9,202,1
"org.apache.jackrabbit.rmi.client.ClientNode",58,0.33,1.71,218,2.42,53947.23,59,1,29,109,8,179.70,95,373,1,2,129.70,0.00,0.50,0.67,1,0.00,2,7256.39,6,32,7,org.apache.jackrabbit.rmi.client.ClientItem,0.02,51,2,99,0,51,26,1,70,1671,1
"org.apache.jackrabbit.rmi.client.ClientNodeDef",4,0.33,1.75,17,0.15,2686.53,5,1,4,9,5,108.28,20,28,1,2,126.15,0.00,0.50,0.75,0,0.00,2,446.43,2,2,4,org.apache.jackrabbit.rmi.client.ClientItemDef,0.00,5,2,7,0,5,2,1,6,112,1
"org.apache.jackrabbit.rmi.client.ClientNodeType",17,0.06,1.94,72,0.68,14483.58,18,1,8,34,7,175.31,33,122,1,1,125.31,0.00,0.00,0.94,0,0.00,2,2038.00,3,8,6,org.apache.jackrabbit.rmi.client.ClientObject,0.00,17,1,33,0,17,9,1,19,486,1
"org.apache.jackrabbit.rmi.client.ClientNodeTypeManager",5,0.25,1.80,21,0.21,4051.67,6,1,6,11,5,125.74,22,37,1,1,125.50,0.00,0.00,0.80,0,0.00,2,619.38,2,4,4,org.apache.jackrabbit.rmi.client.ClientObject,0.00,6,1,9,0,6,1,1,7,149,1
"org.apache.jackrabbit.rmi.client.ClientObject",9,0.25,2.33,70,0.68,29251.43,10,1,19,18,21,63.15,98,78,11,1,111.63,0.00,0.00,0.78,1,0.00,3,2025.33,0,8,10,java.lang.Object,0.00,9,0,21,15,9,1,0,16,438,1
"org.apache.jackrabbit.rmi.client.ClientProperty",25,0.71,1.36,75,0.72,13571.39,26,1,19,51,6,131.83,124,117,1,2,131.60,0.00,0.50,0.32,3,97.00,2,2147.56,2,7,5,org.apache.jackrabbit.rmi.client.ClientItem,0.00,26,2,34,0,26,18,1,27,541,1
"org.apache.jackrabbit.rmi.client.ClientPropertyDef",5,0.25,1.80,21,0.17,3273.31,6,1,4,10,5,126.47,21,36,1,2,126.23,0.00,0.50,0.80,0,0.00,2,513.29,0,2,4,org.apache.jackrabbit.rmi.client.ClientItemDef,0.00,5,2,9,0,5,3,1,7,130,1
"org.apache.jackrabbit.rmi.client.ClientQuery",6,0.00,1.83,27,0.24,4515.03,8,2,6,14,6,125.99,24,45,1,1,125.75,0.00,0.00,0.50,0,0.00,2,730.03,1,4,5,org.apache.jackrabbit.rmi.client.ClientObject,0.00,8,1,11,0,8,2,1,9,178,1
"org.apache.jackrabbit.rmi.client.ClientQueryManager",4,0.17,1.75,21,0.23,4860.42,6,2,8,11,7,102.63,22,35,1,1,120.51,0.00,0.00,0.62,0,0.00,2,678.88,1,3,6,org.apache.jackrabbit.rmi.client.ClientObject,0.00,7,1,7,0,7,1,1,8,155,1
"org.apache.jackrabbit.rmi.client.ClientQueryResult",4,0.00,2.75,39,0.42,18961.97,6,2,13,12,9,88.35,22,50,1,1,106.23,0.00,0.00,0.50,0,0.00,4,1259.16,0,3,8,org.apache.jackrabbit.rmi.client.ClientObject,0.00,8,1,11,0,8,1,1,7,256,1
"org.apache.jackrabbit.rmi.client.ClientRepository",7,0.17,1.86,33,0.36,7866.13,8,1,7,13,7,144.99,23,55,1,1,124.38,0.00,0.00,0.86,0,0.00,2,1078.16,1,6,6,org.apache.jackrabbit.rmi.client.ClientObject,0.00,6,1,13,0,6,1,1,9,243,1
"org.apache.jackrabbit.rmi.client.ClientRepositoryFactory",5,0.17,2.00,28,0.33,7806.11,8,3,15,18,3,82.06,64,44,0,1,119.62,0.00,0.00,0.20,1,11.00,4,989.47,0,3,3,java.lang.Object,0.00,13,0,10,0,13,2,1,9,216,1
"org.apache.jackrabbit.rmi.client.ClientRow",3,0.50,1.67,12,0.11,2092.92,4,1,5,6,3,108.16,17,20,1,1,126.03,0.00,0.00,0.67,0,1.00,2,316.43,0,2,2,java.lang.Object,0.00,3,0,5,0,3,1,1,5,79,1
"org.apache.jackrabbit.rmi.client.ClientSession",30,0.02,2.13,145,1.70,42294.90,32,2,26,72,7,163.45,82,252,1,1,123.57,0.00,0.00,0.48,1,0.00,5,5109.50,1,14,6,org.apache.jackrabbit.rmi.client.ClientObject,0.00,42,1,64,0,42,16,1,33,1106,1
"org.apache.jackrabbit.rmi.client.ClientWorkspace",15,0.11,1.73,65,0.71,17628.97,17,2,19,34,10,164.12,40,109,1,1,124.24,0.00,0.00,0.40,0,0.00,3,2121.13,1,8,9,org.apache.jackrabbit.rmi.client.ClientObject,0.00,19,1,26,0,19,7,1,21,479,1
"org.apache.jackrabbit.rmi.client.LocalAdapterFactory",17,0.00,1.00,18,0.12,355.08,17,0,34,17,36,112.50,146,19,19,1,160.61,0.00,0.00,0.00,0,17.00,1,350.08,0,17,17,,0.00,0,0,17,0,0,0,0,18,125,1
"org.apache.jackrabbit.rmi.client.RemoteRepositoryException",1,0.00,1.00,3,0.02,106.02,1,0,2,1,13,126.90,15,5,13,2,137.25,0.00,0.50,0.00,0,1.00,1,45.51,0,0,0,javax.jcr.RepositoryException,0.00,0,1,1,0,0,1,0,2,16,1
"org.apache.jackrabbit.rmi.client.RemoteRuntimeException",1,0.00,1.00,3,0.02,106.02,1,0,1,1,11,126.90,15,5,11,2,137.25,0.00,0.50,0.00,0,1.00,1,45.51,0,0,0,java.lang.RuntimeException,0.00,0,1,1,0,0,1,0,2,16,1
"org.apache.jackrabbit.core.observation.ChangeLogBasedHierarchyMgr",1,0.00,1.00,5,0.06,532.41,1,0,14,3,12,170.73,23,13,1,2,123.46,0.00,0.50,0.00,0,1.00,1,169.19,0,0,11,org.apache.jackrabbit.core.HierarchyManagerImpl,0.00,2,1,1,0,2,1,0,4,45,0
"org.apache.jackrabbit.core.observation.ChangeLogBasedHierarchyMgr$AtticItemStateManager",4,0.33,1.50,19,0.17,3376.85,5,1,14,12,8,83.11,30,24,0,1,125.40,0.00,0.00,0.75,0,0.00,2,522.61,0,2,8,java.lang.Object,0.00,8,0,6,0,8,2,1,5,125,2
"org.apache.jackrabbit.core.observation.ChangeLogBasedHierarchyMgr$ChangeLogItemStateManager",4,0.00,2.00,20,0.19,3995.79,6,2,14,8,8,71.15,39,32,0,1,121.15,0.00,0.00,0.50,0,4.00,3,568.31,0,2,8,java.lang.Object,0.00,4,0,8,0,4,2,1,10,135,2
"org.apache.jackrabbit.core.observation.DispatchAction",3,0.25,1.00,10,0.05,504.44,5,2,1,3,2,85.68,27,14,1,1,135.68,0.00,0.00,0.33,0,5.00,1,154.86,0,1,1,java.lang.Object,0.00,0,0,3,0,0,2,0,6,48,0
"org.apache.jackrabbit.core.observation.EventConsumer",7,0.19,3.86,76,0.99,34522.49,13,6,17,36,13,74.93,92,106,4,1,104.31,0.00,0.00,0.33,0,0.00,9,2973.79,0,2,9,java.lang.Object,0.00,29,0,27,0,29,5,0,24,560,0
"org.apache.jackrabbit.core.observation.EventFilter",4,0.17,4.00,65,0.86,62993.93,14,10,8,23,10,139.98,95,84,4,1,92.71,0.00,0.00,0.22,0,6.00,13,2580.97,0,2,6,java.lang.Object,0.00,19,0,16,1,19,2,0,28,461,0
"org.apache.jackrabbit.core.observation.EventFilter$BlockAllFilter",2,0.00,1.00,5,0.03,264.06,2,0,8,2,2,143.31,8,8,0,2,143.07,0.00,0.50,0.00,0,2.00,1,97.53,0,0,2,org.apache.jackrabbit.core.observation.EventFilter,0.33,0,1,2,0,0,2,0,2,32,3
"org.apache.jackrabbit.core.observation.EventImpl",9,0.06,1.78,51,0.61,22432.99,13,4,7,31,8,75.76,70,71,3,1,118.05,0.00,0.00,0.31,4,0.00,4,1829.25,0,5,5,java.lang.Object,0.00,22,0,16,0,22,4,1,16,392,2
"org.apache.jackrabbit.core.observation.EventListenerIteratorImpl",9,0.06,1.78,44,0.35,7284.61,13,4,7,19,2,93.29,61,61,1,1,125.51,0.00,0.00,0.19,3,21.00,4,1048.79,0,2,1,java.lang.Object,0.00,10,0,16,0,10,7,1,15,251,0
"org.apache.jackrabbit.core.observation.EventState",18,0.00,1.67,90,1.04,32301.70,27,9,4,28,9,70.71,184,178,7,1,119.19,0.00,0.00,0.11,2,130.00,6,3122.80,0,14,2,java.lang.Object,0.00,10,0,30,0,10,4,0,29,688,0
"org.apache.jackrabbit.core.observation.EventStateCollection",5,0.06,8.00,203,3.93,924097.29,9,4,20,51,22,95.57,97,287,9,1,69.29,0.00,0.00,0.30,0,9.00,36,11780.43,0,1,15,java.lang.Object,0.00,46,0,40,0,46,4,0,64,1730,2
"org.apache.jackrabbit.core.observation.FilteredEventIterator",9,0.02,1.67,41,0.37,9757.59,15,6,7,19,5,92.30,62,61,1,1,124.52,0.00,0.00,0.19,2,24.00,5,1118.03,0,2,4,java.lang.Object,0.00,10,0,15,0,10,7,1,17,257,0
"org.apache.jackrabbit.core.observation.ObservationManagerFactory",10,0.17,2.20,87,0.92,20458.39,19,9,10,40,8,61.06,91,111,4,1,111.06,0.00,0.00,0.27,2,34.00,4,2751.56,0,3,6,java.lang.Object,0.00,30,0,22,0,30,7,1,32,570,2
"org.apache.jackrabbit.core.observation.ObservationManagerImpl",5,0.31,2.00,41,0.53,22358.24,9,4,11,21,14,60.30,40,72,4,1,108.41,0.00,0.00,0.50,0,0.00,4,1591.15,0,1,11,java.lang.Object,0.00,16,0,10,0,16,4,1,12,310,1
"org.apache.jackrabbit.core.observation.SynchronousEventListener",0,0.00,0.00,1,0.01,31.02,0,0,1,0,0,171.00,8,2,0,2,171.00,0.00,0.50,0.00,0,0.00,0,15.51,0,0,0,,0.00,0,1,0,0,0,0,0,1,6,1
"org.apache.jackrabbit.core.state.orm.ojb.OJBNodeState",13,0.17,1.00,35,0.25,3351.74,17,4,7,16,4,140.78,4,49,1,2,140.78,0.00,0.50,0.10,0,64.00,1,756.73,1,5,3,org.apache.jackrabbit.core.state.orm.ORMNodeState,0.22,3,1,13,0,3,8,1,1,212,1
"org.apache.jackrabbit.core.state.orm.ojb.OJBPersistenceManager",15,0.10,2.47,176,2.58,107172.14,18,3,27,89,17,122.21,47,240,0,2,101.60,0.00,0.50,0.42,0,0.00,8,7728.27,1,3,17,org.apache.jackrabbit.core.state.AbstractPersistenceManager,0.00,74,1,37,0,74,12,0,17,1397,1
"org.apache.jackrabbit.core.state.orm.ojb.ValuesToStringFieldConversion",4,1.00,1.75,23,0.26,9108.29,5,1,5,15,2,168.36,4,29,1,1,118.36,0.00,0.00,0.25,0,6.00,3,789.59,0,2,1,java.lang.Object,0.00,11,0,7,0,11,2,1,1,170,1
"org.apache.jackrabbit.core.state.orm.ORMBlobValue",15,0.06,1.33,48,0.37,9115.44,21,6,1,22,3,131.22,4,72,3,1,131.22,0.00,0.00,0.11,1,90.00,6,1102.76,0,5,0,java.lang.Object,0.00,7,0,20,0,7,10,1,2,278,1
"org.apache.jackrabbit.core.state.orm.ORMChildNodeEntry",17,0.08,1.18,53,0.46,9498.45,23,6,2,28,2,131.53,3,77,2,1,131.53,0.00,0.00,0.09,3,110.00,3,1384.87,0,5,1,java.lang.Object,0.00,11,0,20,0,11,12,2,1,352,1
"org.apache.jackrabbit.core.state.orm.ORMNodeMixinType",12,0.18,1.17,36,0.24,4056.85,16,4,1,15,2,133.25,3,52,2,1,133.25,0.00,0.00,0.08,1,52.00,3,724.78,0,3,1,java.lang.Object,0.00,3,0,14,0,3,9,1,1,199,1
"org.apache.jackrabbit.core.state.orm.ORMNodeParent",12,0.18,1.17,36,0.24,4229.28,16,4,1,15,2,133.11,3,52,2,1,133.11,0.00,0.00,0.08,1,52.00,3,721.61,0,3,1,java.lang.Object,0.00,3,0,14,0,3,9,1,1,199,1
"org.apache.jackrabbit.core.state.orm.ORMNodeReference",12,0.18,1.17,36,0.28,6193.15,16,4,1,17,3,131.80,4,54,3,1,131.80,0.00,0.00,0.08,1,52.00,3,849.40,0,4,0,java.lang.Object,0.00,5,0,14,0,5,8,1,1,226,1
"org.apache.jackrabbit.core.state.orm.ORMNodeState",23,0.11,1.52,102,1.39,44110.85,28,5,14,69,9,122.59,4,130,5,1,122.59,0.00,0.00,0.10,9,142.00,7,4183.23,0,8,8,java.lang.Object,0.00,46,0,35,2,46,15,1,1,812,2
"org.apache.jackrabbit.core.state.orm.ORMPropertyEntry",12,0.18,1.17,36,0.25,4213.71,16,4,2,17,2,133.12,5,52,2,1,133.12,0.00,0.00,0.08,1,52.00,3,760.14,0,3,1,java.lang.Object,0.00,5,0,14,0,5,9,1,1,206,1
"org.apache.jackrabbit.core.state.orm.ORMPropertyState",21,0.03,1.38,81,0.78,17991.00,28,7,10,49,10,130.03,3,113,3,1,130.03,0.00,0.00,0.12,5,182.00,5,2335.61,0,7,7,java.lang.Object,0.00,28,0,29,0,28,14,1,1,532,1
"org.apache.jackrabbit.core.version.persistence.InternalFreezeImpl",2,1.00,1.00,7,0.05,552.69,3,1,3,2,6,183.98,3,10,2,2,133.98,2.00,0.25,0.50,0,2.00,1,142.41,0,1,4,org.apache.jackrabbit.core.version.persistence.InternalVersionItemImpl,0.29,0,1,2,2,0,1,1,1,40,1
"org.apache.jackrabbit.core.version.persistence.InternalFrozenNodeImpl",10,0.04,3.90,111,1.86,129299.78,16,6,19,57,17,49.46,96,155,2,3,99.46,0.00,0.67,0.20,0,58.00,17,5578.39,1,8,16,org.apache.jackrabbit.core.version.persistence.InternalFreezeImpl,0.35,47,2,39,0,47,2,2,31,928,0
"org.apache.jackrabbit.core.version.persistence.InternalFrozenVHImpl",8,0.21,1.25,25,0.23,3463.77,10,2,5,15,10,153.00,28,40,1,3,132.39,0.00,0.67,0.31,1,14.00,2,678.00,1,7,9,org.apache.jackrabbit.core.version.persistence.InternalFreezeImpl,0.40,7,2,10,0,7,1,1,8,175,0
"org.apache.jackrabbit.core.version.persistence.InternalVersionHistoryImpl",22,0.06,2.09,186,2.68,109056.98,30,8,16,79,17,75.82,150,226,3,2,108.04,0.00,0.50,0.18,3,158.00,7,8029.34,1,14,16,org.apache.jackrabbit.core.version.persistence.InternalVersionItemImpl,0.22,57,1,46,0,57,8,2,55,1457,0
"org.apache.jackrabbit.core.version.persistence.InternalVersionImpl",25,0.03,1.76,133,1.37,31588.94,34,9,15,68,14,88.15,151,157,3,2,120.37,0.00,0.50,0.14,5,354.00,3,4115.74,1,12,13,org.apache.jackrabbit.core.version.persistence.InternalVersionItemImpl,0.20,43,1,44,0,43,13,2,42,888,0
"org.apache.jackrabbit.core.version.persistence.InternalVersionItemImpl",5,1.00,1.00,9,0.05,427.54,6,1,2,5,5,123.56,31,12,3,1,155.79,0.00,0.00,0.20,0,8.00,1,142.09,0,4,2,java.lang.Object,0.00,0,0,5,5,0,1,0,7,48,1
"org.apache.jackrabbit.core.version.persistence.NativePVM",22,0.01,2.32,175,2.88,149533.67,43,21,16,89,25,64.98,248,224,4,1,109.10,0.00,0.00,0.05,8,154.00,9,8640.93,0,11,24,java.lang.Object,0.00,67,0,51,0,67,11,2,63,1573,1
"org.apache.jackrabbit.core.version.persistence.NativePVM$PersistentId",5,0.22,1.80,36,0.40,8875.73,13,8,16,10,2,153.64,12,43,0,1,113.75,0.00,0.00,0.30,0,0.00,5,1195.41,0,0,2,java.lang.Object,0.00,5,0,9,0,5,5,0,6,261,3
"org.apache.jackrabbit.core.version.persistence.PersistentNode",26,0.07,2.19,186,2.56,93141.96,29,3,8,76,19,69.02,187,241,6,1,111.31,0.00,0.00,0.40,7,0.00,6,7670.32,0,13,13,java.lang.Object,0.00,50,0,57,0,50,13,0,43,1523,1
"org.apache.jackrabbit.core.state.orm.hibernate.HibernateNodeState",19,0.15,1.00,47,0.31,4012.74,23,4,6,22,4,141.46,4,67,1,2,141.46,0.00,0.50,0.11,0,139.00,1,938.25,1,8,3,org.apache.jackrabbit.core.state.orm.ORMNodeState,0.19,3,1,19,0,3,11,0,1,273,1
"org.apache.jackrabbit.core.state.orm.hibernate.HibernatePersistenceManager",15,0.36,6.67,331,5.27,267303.79,17,2,32,99,18,107.63,49,570,0,2,87.01,0.00,0.50,0.83,0,0.00,12,15812.27,0,3,18,org.apache.jackrabbit.core.state.AbstractPersistenceManager,0.00,84,1,100,0,84,12,0,19,2606,1
"org.apache.jackrabbit.core.jndi.provider.DummyContext",34,0.42,1.41,121,1.23,26112.70,36,2,4,57,2,151.02,113,169,2,2,130.40,0.00,0.50,0.09,14,198.00,3,3702.92,1,21,0,java.util.Hashtable,0.00,23,1,48,0,23,13,2,39,879,0
"org.apache.jackrabbit.core.jndi.provider.DummyContext$BindingEnum",2,0.00,1.00,6,0.05,692.27,2,0,4,5,0,133.21,0,9,0,2,133.21,0.00,0.50,0.00,0,2.00,1,143.20,0,1,0,org.apache.jackrabbit.core.jndi.provider.NamingEnum,0.00,3,1,2,0,3,1,0,0,41,0
"org.apache.jackrabbit.core.jndi.provider.DummyContext$FlatNameParser",1,0.00,1.00,7,0.06,832.71,2,1,4,3,0,137.09,3,10,0,1,116.48,0.00,0.00,1.00,0,0.00,1,180.99,0,1,0,java.lang.Object,0.00,2,0,1,0,2,0,1,1,49,1
"org.apache.jackrabbit.core.jndi.provider.DummyContext$NamingEnum",6,0.20,1.00,17,0.13,1732.88,8,2,4,13,0,140.39,0,24,0,1,140.39,0.00,0.00,0.33,2,6.00,1,398.94,0,2,0,java.lang.Object,0.00,7,0,6,0,7,4,1,0,110,0
"org.apache.jackrabbit.core.jndi.provider.DummyInitialContextFactory",1,0.00,3.00,12,0.15,6408.85,2,1,5,7,2,50.52,9,17,1,1,100.51,0.00,0.00,1.00,0,0.00,3,443.66,0,1,1,java.lang.Object,0.00,6,0,3,0,6,0,1,3,94,1
"org.apache.jackrabbit.core.xml.AbstractSAXEventGenerator",12,0.05,1.75,71,0.87,32451.80,18,6,7,30,7,67.77,108,96,2,1,117.77,0.00,0.00,0.12,7,46.00,8,2601.86,0,0,5,java.lang.Object,0.00,18,0,21,2,18,12,1,31,530,1
"org.apache.jackrabbit.core.xml.DocViewImportHandler",7,0.23,4.14,95,1.56,115756.92,12,5,18,44,9,45.90,67,136,1,2,95.90,0.00,0.50,0.40,1,0.00,16,4676.53,0,0,8,org.xml.sax.helpers.DefaultHandler,0.00,37,1,29,0,37,7,1,30,796,0
"org.apache.jackrabbit.core.xml.DocViewSAXEventGenerator",7,0.00,3.57,96,1.51,113868.63,10,3,17,48,9,45.99,64,134,1,2,95.99,0.00,0.50,0.33,0,4.00,16,4521.39,0,0,9,org.apache.jackrabbit.core.xml.AbstractSAXEventGenerator,0.21,41,1,25,0,41,7,0,39,729,1
"org.apache.jackrabbit.core.xml.ImportHandler",12,0.14,1.92,88,1.00,31729.52,22,10,16,41,10,70.09,89,123,2,2,112.38,0.00,0.50,0.22,0,12.00,6,3006.00,0,0,8,org.xml.sax.helpers.DefaultHandler,0.00,29,1,23,0,29,12,0,42,611,1
"org.apache.jackrabbit.core.xml.ImportHandler$NamespaceContext",7,0.29,1.86,29,0.29,8455.69,11,4,16,16,2,124.36,28,40,0,1,124.13,0.00,0.00,0.50,0,0.00,4,868.63,0,2,2,java.lang.Object,0.00,9,0,13,0,9,5,1,9,205,0
"org.apache.jackrabbit.core.xml.Importer",4,4.00,1.00,11,0.12,2529.50,8,4,6,4,7,119.84,20,13,5,1,137.71,0.00,0.00,0.00,0,4.00,1,357.79,0,0,2,,0.00,0,0,4,0,0,4,0,6,94,1
"org.apache.jackrabbit.core.xml.Importer$NodeInfo",10,0.17,1.00,27,0.18,2863.73,14,4,6,10,1,140.42,0,39,0,1,140.42,0.00,0.00,0.10,0,42.00,1,537.18,0,4,1,java.lang.Object,0.00,0,0,10,0,0,6,0,0,153,2
"org.apache.jackrabbit.core.xml.Importer$PropInfo",8,0.24,1.00,21,0.14,1914.23,11,3,6,8,1,141.04,0,30,0,1,141.04,0.00,0.00,0.12,0,26.00,1,417.92,0,2,1,java.lang.Object,0.00,0,0,8,0,0,6,0,0,119,2
"org.apache.jackrabbit.core.xml.SessionImporter",7,0.19,4.57,123,1.73,85496.21,14,7,21,52,6,50.28,51,164,1,1,92.57,0.00,0.00,0.31,0,0.00,11,5182.15,0,2,6,java.lang.Object,0.00,45,0,32,0,45,5,1,34,905,1
"org.apache.jackrabbit.core.xml.SysViewImportHandler",7,0.25,7.43,160,2.74,208487.47,15,8,22,58,11,37.13,62,215,1,2,85.23,0.00,0.50,0.34,1,5.00,20,8230.57,0,0,10,org.xml.sax.helpers.DefaultHandler,0.00,51,1,52,0,51,7,1,43,1318,0
"org.apache.jackrabbit.core.xml.SysViewImportHandler$ImportState",0,0.00,0.00,7,0.05,531.67,6,6,22,1,1,171.00,18,8,0,1,171.00,0.00,0.00,0.00,0,0.00,0,141.78,0,0,1,java.lang.Object,0.00,1,0,0,0,1,0,0,6,34,0
"org.apache.jackrabbit.core.xml.SysViewSAXEventGenerator",7,0.12,2.71,80,1.29,71672.06,15,8,12,34,8,52.24,57,112,2,2,100.34,0.00,0.50,0.23,0,3.00,10,3884.04,0,0,7,org.apache.jackrabbit.core.xml.AbstractSAXEventGenerator,0.21,27,1,19,0,27,7,0,30,659,1
"org.apache.jackrabbit.core.xml.SysViewSAXEventGenerator$Writer",3,0.00,1.33,7,0.07,1447.36,3,0,12,6,0,138.57,2,12,0,1,138.57,0.00,0.00,0.00,0,3.00,2,205.45,0,0,0,java.lang.Object,0.00,3,0,4,0,3,3,0,2,52,0
"org.apache.jackrabbit.init.NodeTestData",2,1.43,2.50,42,0.61,20541.29,9,7,9,23,2,41.40,20,48,1,4,89.88,0.00,0.75,0.86,0,0.00,4,1825.55,1,0,1,org.apache.jackrabbit.test.AbstractJCRTest,0.50,21,3,5,0,21,2,0,13,330,1
"org.apache.jackrabbit.init.PropertyTestData",1,0.00,4.00,23,0.36,12269.66,2,1,7,15,2,39.21,10,28,1,4,87.69,0.00,0.75,1.00,0,0.00,4,1079.00,0,0,1,org.apache.jackrabbit.test.AbstractJCRTest,0.00,14,3,4,0,14,1,0,5,188,1
"org.apache.jackrabbit.init.QueryTestData",1,0.00,4.00,27,0.41,20673.72,2,1,4,13,2,45.74,12,32,1,4,83.31,0.00,0.75,1.00,0,0.00,4,1231.03,0,0,1,org.apache.jackrabbit.test.AbstractJCRTest,0.00,12,3,4,0,12,1,0,5,223,1
"org.apache.jackrabbit.init.TestAll",1,0.00,1.00,7,0.06,1740.69,1,0,3,3,3,76.39,12,9,0,2,113.96,0.00,0.50,0.00,0,1.00,1,186.48,0,1,3,junit.framework.TestCase,0.00,2,1,1,0,2,0,0,2,47,1
"org.apache.jackrabbit.rmi.remote.RemoteItem",10,0.00,1.00,11,0.07,345.17,10,0,3,10,14,108.89,98,14,14,2,158.89,0.00,0.50,0.00,0,10.00,1,224.08,0,3,1,,0.00,0,1,10,0,0,7,0,11,79,1
"org.apache.jackrabbit.rmi.remote.RemoteItemDef",6,0.00,1.00,7,0.04,175.78,6,0,2,6,8,121.89,72,8,7,2,159.45,0.00,0.50,0.00,0,6.00,1,111.15,0,1,1,,0.00,0,1,6,0,0,5,0,7,43,1
"org.apache.jackrabbit.rmi.remote.RemoteLock",5,0.00,1.00,6,0.03,158.73,5,0,3,5,10,110.70,54,7,10,2,159.17,0.00,0.50,0.00,0,5.00,1,99.79,0,2,0,,0.00,0,1,5,0,0,3,0,6,38,1
"org.apache.jackrabbit.rmi.remote.RemoteNamespaceRegistry",6,0.00,1.00,7,0.06,334.83,6,0,3,6,10,119.68,77,10,10,2,157.25,0.00,0.50,0.00,0,6.00,1,185.17,0,4,0,,0.00,0,1,6,0,0,2,0,7,61,1
"org.apache.jackrabbit.rmi.remote.RemoteNode",39,0.00,1.00,40,0.37,1829.70,39,0,3,39,21,109.36,390,60,17,2,157.84,0.00,0.50,0.00,0,39.00,1,1106.46,0,18,5,,0.00,0,1,39,0,0,21,0,40,352,1
"org.apache.jackrabbit.rmi.remote.RemoteNodeDef",3,0.00,1.00,4,0.02,122.02,3,0,1,3,14,147.97,46,5,14,2,158.33,0.00,0.50,0.00,0,3.00,1,68.77,0,0,1,,0.00,0,1,3,0,0,3,0,4,26,1
"org.apache.jackrabbit.rmi.remote.RemoteNodeType",16,0.00,1.00,17,0.12,654.48,16,0,3,16,19,109.83,163,18,18,2,158.31,0.00,0.50,0.00,0,16.00,1,373.02,0,8,2,,0.00,0,1,16,0,0,8,0,17,128,1
"org.apache.jackrabbit.rmi.remote.RemoteNodeTypeManager",4,0.00,1.00,5,0.04,222.98,4,0,3,4,11,146.89,61,10,10,2,157.25,0.00,0.50,0.00,0,4.00,1,118.62,0,0,1,,0.00,0,1,4,0,0,4,0,5,40,1
"org.apache.jackrabbit.rmi.remote.RemoteProperty",8,0.00,1.00,9,0.07,359.33,8,0,3,8,13,120.43,99,11,12,2,157.99,0.00,0.50,0.00,0,8.00,1,206.45,0,2,1,,0.00,0,1,8,0,0,6,0,9,70,1
"org.apache.jackrabbit.rmi.remote.RemotePropertyDef",4,0.00,1.00,5,0.03,161.32,4,0,2,4,13,138.21,58,6,13,2,158.36,0.00,0.50,0.00,0,4.00,1,88.42,0,2,0,,0.00,0,1,4,0,0,2,0,5,33,1
"org.apache.jackrabbit.rmi.remote.RemoteQuery",5,0.00,1.00,6,0.04,184.47,5,0,3,5,11,108.66,46,7,10,2,158.66,0.00,0.50,0.00,0,5.00,1,116.95,0,4,1,,0.00,0,1,5,0,0,1,0,6,42,1
"org.apache.jackrabbit.rmi.remote.RemoteQueryManager",3,0.00,1.00,4,0.03,180.93,3,0,3,3,11,119.42,37,7,10,2,156.98,0.00,0.50,0.00,0,3.00,1,102.82,0,3,1,,0.00,0,1,3,0,0,0,0,4,34,1
"org.apache.jackrabbit.rmi.remote.RemoteQueryResult",3,0.00,1.00,4,0.03,180.19,3,0,3,3,11,112.87,34,5,9,2,156.99,0.00,0.50,0.00,0,3.00,1,90.09,0,1,2,,0.00,0,1,3,0,0,2,0,4,31,1
"org.apache.jackrabbit.rmi.remote.RemoteRepository",6,0.00,1.00,7,0.06,289.75,6,0,4,6,9,120.18,77,11,8,2,157.74,0.00,0.50,0.00,0,6.00,1,174.97,0,2,1,,0.00,0,1,6,0,0,4,0,7,58,1
"org.apache.jackrabbit.rmi.remote.RemoteRow",2,0.00,1.00,3,0.02,126.98,2,0,4,2,10,136.66,28,5,10,2,156.80,0.00,0.50,0.00,0,2.00,1,70.62,0,2,0,,0.00,0,1,2,0,0,0,0,3,24,1
"org.apache.jackrabbit.rmi.remote.RemoteSession",25,0.00,1.00,26,0.24,1268.82,25,0,6,25,14,109.09,270,38,11,2,157.57,0.00,0.50,0.00,0,25.00,1,722.95,0,9,3,,0.00,0,1,25,0,0,16,0,26,230,1
"org.apache.jackrabbit.rmi.remote.RemoteWorkspace",10,0.00,1.00,11,0.12,622.61,10,0,4,10,12,112.74,119,21,9,2,156.87,0.00,0.50,0.00,0,10.00,1,348.72,0,2,3,,0.00,0,1,10,0,0,8,0,11,107,1
"org.apache.jackrabbit.rmi.remote.SerialValue",11,0.10,2.91,85,1.17,55071.36,13,2,20,48,5,61.99,93,127,5,1,110.10,0.00,0.00,0.41,0,0.00,12,3504.93,0,4,0,java.lang.Object,0.00,37,0,32,0,37,7,2,14,652,1
"org.apache.jackrabbit.test.orm.BlobTest",2,0.00,3.00,33,0.48,23806.06,4,2,7,18,2,143.74,3,38,1,4,93.74,0.00,0.75,0.50,0,2.00,5,1429.02,0,0,1,org.apache.jackrabbit.test.AbstractJCRTest,0.00,16,3,6,0,16,2,0,1,243,1
"org.apache.jackrabbit.test.orm.TestAll",1,0.00,1.00,6,0.05,1283.53,1,0,3,3,2,73.37,11,8,0,2,117.50,0.00,0.50,0.00,0,1.00,1,150.40,0,1,2,junit.framework.TestCase,0.00,2,1,1,0,2,0,0,2,39,1
"org.apache.jackrabbit.test.orm.XMLImportSpeedTest",4,0.22,3.25,68,0.93,36955.05,10,6,12,31,2,143.60,5,87,1,4,93.60,0.00,0.75,0.33,2,2.00,5,2799.49,0,0,1,org.apache.jackrabbit.test.AbstractJCRTest,0.00,27,3,13,0,27,4,0,3,502,1
"org.apache.jackrabbit.core.state.obj.BLOBStore",3,0.00,1.00,4,0.04,243.32,3,0,3,3,3,107.86,24,5,1,1,155.97,0.00,0.00,0.00,0,3.00,1,123.66,0,2,2,,0.00,0,0,3,0,0,1,0,4,37,1
"org.apache.jackrabbit.core.state.obj.ObjectPersistenceManager",29,0.10,3.34,432,5.76,281189.81,37,8,13,150,23,54.28,220,540,1,2,96.58,0.00,0.50,0.22,7,129.00,9,17268.20,1,10,22,org.apache.jackrabbit.core.state.AbstractPersistenceManager,0.00,121,1,97,0,121,19,1,116,3130,1
"org.apache.jackrabbit.tck.j.RepositoryServlet",7,0.15,2.86,88,1.19,58263.95,18,11,11,31,3,67.41,44,115,1,2,99.63,0.00,0.50,0.22,2,13.00,11,3571.62,2,3,2,javax.servlet.http.HttpServlet,0.00,24,1,20,0,24,4,0,26,634,1
"org.apache.jackrabbit.core.search.lucene.AbstractIndex",12,0.13,2.25,78,0.72,19127.51,21,9,9,26,2,116.57,10,109,2,1,116.57,0.00,0.00,0.23,3,0.00,7,2164.29,0,4,0,java.lang.Object,0.00,14,0,27,2,14,8,0,2,489,1
"org.apache.jackrabbit.core.search.lucene.ChildAxisQuery",3,2.00,1.00,11,0.07,849.18,5,2,15,4,2,83.90,29,15,2,2,133.89,0.00,0.50,0.00,0,3.00,1,222.61,0,2,0,org.apache.lucene.search.Query,0.00,1,1,3,0,1,1,0,10,62,0
"org.apache.jackrabbit.core.search.lucene.ChildAxisQuery$ChildAxisScorer",8,0.04,1.62,46,0.50,12780.06,12,4,15,25,1,159.47,19,54,0,2,119.59,0.00,0.50,0.28,1,6.00,5,1504.46,0,1,1,org.apache.lucene.search.Scorer,0.00,17,1,13,0,17,7,0,10,316,1
"org.apache.jackrabbit.core.search.lucene.ChildAxisQuery$ChildAxisScorer$HitCollector",1,0.00,1.00,3,0.02,168.11,1,0,15,1,0,185.68,1,4,0,1,135.68,0.00,0.00,0.00,0,0.00,1,63.51,0,0,0,java.lang.Object,0.00,0,0,1,0,0,1,0,1,19,0
"org.apache.jackrabbit.core.search.lucene.ChildAxisQuery$ChildAxisWeight",7,1.00,1.00,16,0.13,1653.59,8,1,15,11,1,141.32,31,24,0,1,141.08,0.00,0.00,0.14,0,12.00,1,384.71,0,3,1,java.lang.Object,0.00,4,0,7,0,4,4,1,11,106,1
"org.apache.jackrabbit.core.search.lucene.DateField",5,0.12,1.80,34,0.43,14282.50,9,4,1,15,2,72.33,36,44,2,1,114.62,0.00,0.00,0.15,2,7.00,5,1285.31,0,3,0,java.lang.Object,0.00,10,0,9,0,10,2,0,11,274,0
"org.apache.jackrabbit.core.search.lucene.DescendantSelfAxisQuery",4,5.00,1.00,18,0.14,1875.98,9,5,14,5,2,89.94,48,23,2,2,127.51,0.00,0.50,0.00,0,4.00,1,423.73,0,2,0,org.apache.lucene.search.Query,0.00,1,1,4,0,1,2,0,14,110,0
"org.apache.jackrabbit.core.search.lucene.DescendantSelfAxisQuery$DescendantSelfAxisScorer",8,0.03,2.25,55,0.64,27508.48,13,5,14,26,1,134.55,24,71,0,2,113.94,0.00,0.50,0.22,3,16.00,8,1932.44,0,1,1,org.apache.lucene.search.Scorer,0.00,18,1,18,0,18,7,0,15,395,1
"org.apache.jackrabbit.core.search.lucene.DescendantSelfAxisQuery$DescendantSelfAxisScorer$HitCollector",1,0.00,1.00,3,0.02,168.11,1,0,14,1,0,185.68,1,4,0,1,135.68,0.00,0.00,0.00,0,0.00,1,63.51,0,0,0,java.lang.Object,0.00,0,0,1,0,0,1,0,1,19,0
"org.apache.jackrabbit.core.search.lucene.DescendantSelfAxisQuery$DescendantSelfAxisScorer$HitCollector_0",1,0.00,1.00,3,0.02,168.11,1,0,14,1,0,135.68,0,4,0,1,135.68,0.00,0.00,0.00,0,0.00,1,63.51,0,0,0,java.lang.Object,0.00,0,0,1,0,0,1,0,0,19,0
"org.apache.jackrabbit.core.search.lucene.DescendantSelfAxisQuery$DescendantSelfAxisWeight",7,1.00,1.00,17,0.15,2225.35,8,1,14,11,1,140.30,31,25,0,1,140.07,0.00,0.00,0.14,0,12.00,1,442.49,0,3,1,java.lang.Object,0.00,4,0,7,0,4,4,1,11,118,1
"org.apache.jackrabbit.core.search.lucene.DoubleField",3,0.25,2.67,30,0.43,23099.17,5,2,0,14,2,103.10,13,39,2,1,102.87,0.00,0.00,0.33,0,4.00,4,1299.83,0,1,0,java.lang.Object,0.00,11,0,8,0,11,2,0,9,256,0
"org.apache.jackrabbit.core.search.lucene.FieldNames",0,0.00,0.00,6,0.07,951.54,5,5,0,0,6,171.00,23,7,6,1,171.00,0.00,0.00,0.00,0,0.00,0,203.90,0,0,0,java.lang.Object,0.00,0,0,0,0,0,0,0,6,48,0
"org.apache.jackrabbit.core.search.lucene.FileSystemDirectory",13,0.22,2.62,78,0.95,26606.40,16,3,11,33,8,83.46,80,123,3,2,115.68,0.00,0.50,0.54,0,0.00,5,2845.78,0,5,5,org.apache.lucene.store.Directory,0.00,20,1,34,0,20,8,0,19,604,0
"org.apache.jackrabbit.core.search.lucene.FileSystemDirectory$Lock",4,0.00,2.00,22,0.20,3895.34,4,0,11,11,2,171.23,4,35,0,1,121.23,0.00,0.00,0.00,0,4.00,3,599.67,0,1,2,java.lang.Object,0.00,7,0,8,0,7,3,0,4,136,0
"org.apache.jackrabbit.core.search.lucene.FileSystemInputStream",6,0.13,3.00,56,0.59,28600.48,9,3,4,12,4,58.08,49,79,2,2,106.19,0.00,0.50,0.44,1,2.00,5,1756.11,1,1,2,org.apache.lucene.store.InputStream,0.00,6,1,18,0,6,5,0,13,365,0
"org.apache.jackrabbit.core.search.lucene.FileSystemOutputStream",5,0.12,1.40,21,0.20,3524.57,7,2,5,13,4,126.04,4,31,1,2,126.04,0.00,0.50,0.40,0,5.00,2,586.87,2,0,3,org.apache.lucene.store.OutputStream,0.00,8,1,7,0,8,5,0,1,147,0
"org.apache.jackrabbit.core.search.lucene.LongField",3,1.00,2.67,28,0.36,19368.12,4,1,0,12,2,105.41,14,38,2,1,105.18,0.00,0.00,0.33,0,4.00,4,1087.53,0,1,0,java.lang.Object,0.00,9,0,8,0,9,2,0,13,223,0
"org.apache.jackrabbit.core.search.lucene.LuceneQueryBuilder",15,0.04,7.53,406,6.71,782992.07,23,8,23,107,33,31.89,125,501,2,1,79.99,0.00,0.00,0.17,0,32.00,34,20121.13,0,14,31,java.lang.Object,0.00,92,0,113,0,92,1,1,70,3234,0
"org.apache.jackrabbit.core.search.lucene.MatchAllQuery",3,1.00,1.33,10,0.08,1056.56,4,1,3,6,2,90.79,23,15,1,2,133.08,0.00,0.50,0.33,0,4.00,2,230.02,0,2,1,org.apache.lucene.search.Query,0.00,3,1,4,0,3,1,0,4,62,0
"org.apache.jackrabbit.core.search.lucene.MatchAllScorer",8,0.02,1.62,45,0.48,14993.03,14,6,7,24,1,76.75,60,67,1,2,119.04,0.00,0.50,0.19,3,24.00,5,1427.41,0,1,0,org.apache.lucene.search.Scorer,0.00,16,1,13,0,16,7,0,16,313,0
"org.apache.jackrabbit.core.search.lucene.MatchAllWeight",7,0.06,1.00,26,0.24,3665.49,13,6,3,14,2,99.57,45,35,1,1,131.79,0.00,0.00,0.21,0,24.00,1,725.93,0,3,1,java.lang.Object,0.00,7,0,7,0,7,4,1,18,183,0
"org.apache.jackrabbit.core.search.lucene.NamespaceMappings",6,0.28,2.67,64,0.85,34190.01,11,5,17,36,10,66.33,76,89,3,1,103.90,0.00,0.00,0.43,2,0.00,4,2540.37,0,3,7,java.lang.Object,0.00,30,0,16,0,30,3,1,19,492,0
"org.apache.jackrabbit.core.search.lucene.NodeIndexer",4,0.00,7.25,98,1.86,143641.85,7,3,19,42,18,82.72,64,168,2,1,83.19,0.00,0.00,0.33,1,4.00,14,5581.85,0,2,16,java.lang.Object,0.00,38,0,29,0,38,2,0,24,904,0
"org.apache.jackrabbit.core.search.lucene.NodeIteratorImpl",10,0.00,1.50,39,0.36,7514.65,15,5,8,19,5,98.24,65,59,2,1,130.46,0.00,0.00,0.20,2,18.00,3,1089.21,0,3,3,java.lang.Object,0.00,9,0,15,0,9,7,1,16,258,0
"org.apache.jackrabbit.core.search.lucene.PersistentIndex",3,1.00,1.00,9,0.10,1141.47,4,1,5,6,4,182.88,4,18,1,2,132.88,0.00,0.50,0.33,0,4.00,1,297.42,1,1,3,org.apache.jackrabbit.core.search.lucene.AbstractIndex,0.13,3,1,3,0,3,2,0,1,76,0
"org.apache.jackrabbit.core.search.lucene.QueryImpl",2,0.67,5.50,66,1.20,84977.84,8,6,27,37,20,124.79,47,79,1,1,77.52,0.00,0.00,0.50,0,2.00,10,3590.63,0,1,20,java.lang.Object,0.00,35,0,11,0,35,1,1,17,565,0
"org.apache.jackrabbit.core.search.lucene.QueryImpl$DefaultQueryNodeVisitor",1,0.00,1.00,4,0.03,474.00,1,0,27,2,1,127.47,0,5,0,1,127.47,0.00,0.00,0.00,0,1.00,1,92.00,0,1,1,java.lang.Object,0.00,1,0,1,0,1,0,0,0,25,0
"org.apache.jackrabbit.core.search.lucene.QueryResultImpl",4,0.39,1.50,29,0.32,9428.14,10,6,9,10,7,80.60,26,38,1,1,112.83,0.00,0.00,0.46,0,2.00,3,965.97,0,3,6,java.lang.Object,0.00,6,0,6,0,6,1,1,11,210,0
"org.apache.jackrabbit.core.search.lucene.RowIteratorImpl",8,0.14,1.00,23,0.17,2073.20,11,3,17,16,9,92.66,66,32,1,1,140.76,0.00,0.00,0.21,1,0.00,1,503.08,0,2,8,java.lang.Object,0.00,8,0,8,0,8,6,1,14,141,0
"org.apache.jackrabbit.core.search.lucene.RowIteratorImpl$RowImpl",3,0.38,5.33,50,0.66,32051.02,7,4,17,22,5,49.85,34,63,0,1,93.97,0.00,0.00,0.50,0,1.00,8,1994.16,0,2,5,java.lang.Object,0.00,19,0,16,0,19,1,1,11,367,0
"org.apache.jackrabbit.core.search.lucene.SearchIndex",14,0.09,2.00,95,1.22,44271.35,21,7,28,53,18,71.96,105,138,1,2,114.25,0.00,0.50,0.22,2,0.00,7,3656.85,3,4,18,org.apache.jackrabbit.core.search.AbstractQueryHandler,0.10,39,1,28,0,39,10,0,33,716,1
"org.apache.jackrabbit.core.search.lucene.VolatileIndex",2,0.00,1.50,13,0.11,3042.86,2,0,4,5,1,166.82,2,14,0,2,116.82,0.00,0.50,0.00,0,2.00,2,320.89,1,0,1,org.apache.jackrabbit.core.search.lucene.AbstractIndex,0.00,3,1,3,0,3,2,0,1,75,0
"org.apache.jackrabbit.core.search.lucene.WildcardQuery",2,0.00,1.00,5,0.04,351.31,2,0,5,3,2,192.09,2,8,1,2,142.09,0.00,0.50,0.00,0,2.00,1,106.33,0,1,1,org.apache.lucene.search.MultiTermQuery,0.00,1,1,2,0,1,1,0,1,32,0
"org.apache.jackrabbit.core.search.lucene.WildcardTermEnum",5,0.08,3.20,54,0.61,38395.62,8,3,5,20,1,152.83,8,71,1,2,102.83,0.00,0.50,0.40,0,6.00,9,1831.94,0,1,0,org.apache.lucene.search.FilteredTermEnum,0.00,15,1,16,0,15,4,0,7,362,0
"org.apache.jackrabbit.core.util.uuid.Bytes",8,0.00,2.38,59,0.79,50837.57,8,0,0,9,1,67.04,61,78,1,1,109.33,0.00,0.00,0.00,1,8.00,9,2379.21,0,0,0,java.lang.Object,0.00,1,0,19,0,1,8,0,9,516,2
"org.apache.jackrabbit.core.util.uuid.Constants",0,0.00,0.00,33,0.42,8853.20,32,32,0,1,2,171.00,114,34,2,1,171.00,0.00,0.00,0.00,0,0.00,0,1267.81,0,0,0,,0.00,1,0,0,0,1,0,0,39,209,1
"org.apache.jackrabbit.core.util.uuid.UUID",21,0.01,2.14,141,1.74,69659.41,29,8,4,54,18,76.51,271,176,16,1,114.07,0.00,0.00,0.14,2,0.00,7,5209.89,0,4,3,java.lang.Object,0.00,33,0,45,0,33,17,3,75,1052,1
"org.apache.jackrabbit.core.util.uuid.VersionFourGenerator",6,0.10,2.17,38,0.38,15041.75,10,4,4,10,3,85.65,80,53,2,1,115.03,0.00,0.00,0.17,1,10.00,7,1127.04,0,4,2,java.lang.Object,0.00,4,0,13,0,4,2,1,23,239,2
"org.apache.jackrabbit.test.api.query.AbstractQueryLevel2Test",4,0.00,1.75,36,0.53,15212.79,4,0,8,18,4,58.98,34,47,2,5,107.08,0.50,0.57,0.00,0,0.00,3,1582.97,0,0,2,org.apache.jackrabbit.test.api.query.AbstractQueryTest,0.00,14,4,7,2,14,4,0,7,312,2
"org.apache.jackrabbit.test.api.query.AbstractQueryTest",9,0.10,2.22,73,0.92,33666.74,14,5,7,35,8,64.87,101,93,5,4,108.99,2.33,0.27,0.11,3,20.00,7,2762.55,2,4,3,org.apache.jackrabbit.test.AbstractJCRTest,0.27,26,3,20,7,26,5,0,18,546,2
"org.apache.jackrabbit.test.api.query.SQLOrderByTest",4,0.00,1.00,20,0.24,4452.21,5,1,1,9,3,70.94,37,25,1,5,120.94,0.00,0.80,1.00,0,0.00,1,732.37,3,0,2,org.apache.jackrabbit.test.api.query.AbstractQueryTest,0.26,5,4,4,0,5,4,0,7,164,1
"org.apache.jackrabbit.test.api.query.SQLQueryLevel2Test",8,0.00,1.75,68,0.76,16556.70,8,0,7,21,4,68.78,56,83,1,6,111.07,0.00,0.83,0.00,3,0.00,4,2294.77,7,0,3,org.apache.jackrabbit.test.api.query.AbstractQueryLevel2Test,0.00,13,5,14,0,13,8,0,19,481,1
"org.apache.jackrabbit.test.api.query.SaveTest",8,0.00,2.50,66,1.03,27605.70,9,1,12,31,3,61.14,66,94,1,4,109.24,0.00,0.75,1.00,0,0.00,5,3097.37,1,0,2,org.apache.jackrabbit.test.AbstractJCRTest,0.29,23,3,20,0,23,8,0,22,585,1
"org.apache.jackrabbit.test.api.query.Statement",3,0.25,1.33,12,0.08,2004.82,5,2,0,4,7,108.36,17,17,7,1,126.23,0.00,0.00,0.33,0,5.00,2,239.93,0,2,0,java.lang.Object,0.00,1,0,4,0,1,1,0,4,65,0
"org.apache.jackrabbit.test.api.query.TestAll",1,0.00,1.00,11,0.11,3828.97,1,0,3,3,7,66.38,12,13,0,2,103.94,0.00,0.50,0.00,0,1.00,1,341.05,0,1,7,junit.framework.TestCase,0.00,2,1,1,0,2,0,0,3,79,1
"org.apache.jackrabbit.test.api.query.XPathDocOrderTest",5,0.00,2.00,46,0.60,13797.34,5,0,6,17,4,60.04,40,50,1,5,108.15,0.00,0.80,0.00,1,0.00,4,1801.35,3,0,3,org.apache.jackrabbit.test.api.query.AbstractQueryTest,0.25,12,4,10,0,12,5,0,7,350,1
"org.apache.jackrabbit.test.api.query.XPathOrderByTest",4,0.00,1.00,21,0.25,4599.49,5,1,1,9,3,72.72,34,26,1,5,120.82,0.00,0.80,1.00,0,0.00,1,741.77,3,0,2,org.apache.jackrabbit.test.api.query.AbstractQueryTest,0.26,5,4,4,0,5,4,0,6,166,1
"org.apache.jackrabbit.test.api.query.XPathPosIndexTest",3,0.00,2.00,23,0.29,7356.34,3,0,6,13,4,64.15,31,29,1,5,112.62,0.00,0.80,0.00,1,2.00,4,859.79,3,0,3,org.apache.jackrabbit.test.api.query.AbstractQueryTest,0.28,10,4,6,0,10,3,0,5,170,1
"org.apache.jackrabbit.test.api.query.XPathQueryLevel2Test",8,0.00,1.75,64,0.80,17029.89,8,0,7,21,4,78.75,55,79,1,6,110.98,0.00,0.83,0.00,3,0.00,4,2394.83,7,0,3,org.apache.jackrabbit.test.api.query.AbstractQueryLevel2Test,0.00,13,5,14,0,13,8,0,19,497,1
"org.apache.jackrabbit.test.api.lock.TestAll",1,0.00,1.00,4,0.03,457.63,1,0,3,2,0,90.03,12,6,0,2,127.59,0.00,0.50,0.00,0,1.00,1,76.45,0,1,0,junit.framework.TestCase,0.00,1,1,1,0,1,0,0,3,23,1
