Name, No. Methods, LCOM, AVCC, NOS, HBUG, HEFF, UWCS, INST, PACK, RFC, CBO, MI, CCML, NLOC, F-IN, DIT, MINC, S-R, R-R, COH, LMC, LCOM2, MAXCC, HVOL, HIER, NQU, FOUT, Superclass, SIX, EXT, NSUP, TCC, NSUB, MPC, NCO, INTR, CCOM, HLTH, MOD
"org.apache.jackrabbit.webdav.version.ActivityResource",0,0.00,0.00,5,0.11,3438.72,4,4,1,1,4,171.00,66,6,2,2,171.00,0.00,0.50,0.00,0,0.00,0,320.95,0,0,2,,0.00,1,1,0,0,1,0,0,5,70,1
"org.apache.jackrabbit.webdav.version.BaselineResource",1,2.00,1.00,4,0.06,1353.17,3,2,3,2,5,74.93,51,5,1,2,123.88,0.00,0.50,0.00,0,1.00,1,183.88,0,1,4,,0.00,1,1,1,0,1,0,0,4,45,1
"org.apache.jackrabbit.webdav.version.DeltaVConstants",0,0.00,0.00,44,0.95,21563.97,43,43,3,1,33,171.00,275,45,30,1,171.00,0.00,0.00,0.00,0,0.00,0,2837.36,0,0,3,,0.00,1,0,0,0,1,0,0,38,428,1
"org.apache.jackrabbit.webdav.version.DeltaVResource",4,2.00,1.00,7,0.06,480.39,6,2,5,4,17,172.76,73,8,11,2,154.62,0.00,0.50,0.00,0,4.00,1,183.94,0,2,7,,0.00,0,1,4,0,0,2,0,8,55,1
"org.apache.jackrabbit.webdav.version.DeltaVServletRequest",6,0.00,1.00,7,0.04,244.95,6,0,3,6,8,110.21,48,8,1,2,158.31,0.00,0.50,0.00,0,6.00,1,125.38,0,5,7,,0.00,0,1,6,0,0,1,0,7,46,1
"org.apache.jackrabbit.webdav.version.LabelInfo",9,0.03,2.11,67,0.79,33295.91,17,8,9,20,18,78.98,61,84,12,1,111.21,0.00,0.00,0.15,0,38.00,5,2377.15,0,2,6,java.lang.Object,0.00,11,0,19,0,11,7,2,7,473,1
"org.apache.jackrabbit.webdav.version.LabelSetProperty",3,0.25,1.33,16,0.15,3326.12,5,2,6,6,6,121.12,12,18,2,2,120.88,0.00,0.50,0.33,0,1.00,2,463.19,1,2,4,org.apache.jackrabbit.webdav.property.AbstractDavProperty,0.00,3,1,4,0,3,1,0,3,106,1
"org.apache.jackrabbit.webdav.version.MergeInfo",8,0.05,2.12,51,0.63,19273.59,11,3,13,30,17,67.06,71,66,9,1,115.17,0.00,0.00,0.38,0,0.00,4,1899.91,0,5,8,java.lang.Object,0.00,22,0,17,0,22,3,2,10,391,1
"org.apache.jackrabbit.webdav.version.OptionsInfo",5,0.25,2.20,31,0.38,9261.60,7,2,13,21,15,67.58,51,39,8,1,116.06,0.00,0.00,0.30,0,10.00,3,1136.76,0,2,7,java.lang.Object,0.00,16,0,11,0,16,3,1,7,241,1
"org.apache.jackrabbit.webdav.version.OptionsResponse",4,0.17,2.50,38,0.59,18664.29,6,2,14,31,12,68.74,49,46,6,1,106.30,0.00,0.00,0.38,0,0.00,4,1763.22,0,3,6,java.lang.Object,0.00,27,0,10,0,27,1,2,5,344,1
"org.apache.jackrabbit.webdav.version.OptionsResponse$Entry",1,3.00,1.00,8,0.07,1245.95,4,3,14,1,1,112.94,0,10,0,1,112.94,0.00,0.00,0.00,0,1.00,1,199.22,0,0,1,java.lang.Object,0.00,0,0,1,0,0,1,0,0,53,2
"org.apache.jackrabbit.webdav.version.SupportedMethodSetProperty",3,0.25,1.33,17,0.18,4242.03,5,2,6,7,4,120.29,12,19,1,2,120.05,0.00,0.50,0.33,0,1.00,2,535.69,1,2,3,org.apache.jackrabbit.webdav.property.AbstractDavProperty,0.00,4,1,4,0,4,1,1,3,119,1
"org.apache.jackrabbit.webdav.version.UpdateInfo",9,0.25,3.33,89,1.29,69739.23,17,8,13,34,17,56.40,77,115,9,1,104.50,0.00,0.00,0.35,0,0.00,8,3868.36,0,7,8,java.lang.Object,0.00,25,0,30,0,25,2,2,13,706,1
"org.apache.jackrabbit.webdav.version.VersionControlledResource",7,16.00,1.00,24,0.51,19334.90,23,16,3,8,17,92.39,294,25,9,2,126.10,0.00,0.50,0.00,0,7.00,1,1526.92,0,3,8,,0.00,1,1,7,0,1,4,0,24,299,1
"org.apache.jackrabbit.webdav.version.VersionHistoryResource",1,3.00,1.00,5,0.08,1613.67,4,3,3,2,15,90.69,41,6,11,2,119.67,0.00,0.50,0.00,0,1.00,1,236.61,0,1,5,,0.00,1,1,1,0,1,0,0,5,55,1
"org.apache.jackrabbit.webdav.version.VersionResource",2,11.00,1.00,14,0.32,11920.17,13,11,2,3,16,159.64,164,15,12,2,109.75,0.00,0.50,0.00,0,2.00,1,962.56,0,0,5,,0.00,1,1,2,0,1,2,0,14,189,1
"org.apache.jackrabbit.webdav.version.VersionableResource",1,1.00,1.00,3,0.02,174.22,2,1,1,1,4,123.49,38,4,3,2,135.55,0.00,0.50,0.00,0,1.00,1,64.62,0,0,1,,0.00,0,1,1,0,0,1,0,3,20,1
"org.apache.jackrabbit.webdav.version.WorkspaceResource",0,0.00,0.00,4,0.08,2307.76,3,3,1,1,3,171.00,61,5,1,2,171.00,0.00,0.50,0.00,0,0.00,0,240.81,0,0,2,,0.00,1,1,0,0,1,0,0,4,54,1
"org.apache.jackrabbit.client.spi.RepositoryConfigImpl",6,0.11,2.33,57,0.67,26161.51,13,7,17,18,15,106.79,25,74,2,2,106.55,0.00,0.50,0.24,0,14.00,5,1997.05,0,4,13,org.apache.jackrabbit.client.AbstractRepositoryConfig,0.00,12,1,14,0,12,2,0,6,399,1
"org.apache.jackrabbit.spi.commons.conversion.CachingNameResolver",4,0.00,1.50,20,0.19,4650.67,6,2,2,9,5,72.22,43,28,1,1,120.69,0.00,0.00,0.50,0,4.00,2,573.35,0,2,4,java.lang.Object,0.00,5,0,6,0,5,2,1,8,140,1
"org.apache.jackrabbit.spi.commons.conversion.CachingPathResolver",5,0.12,1.60,26,0.27,8037.78,7,2,2,11,6,75.44,58,35,1,1,119.57,0.00,0.00,0.40,1,7.00,3,795.60,0,3,5,java.lang.Object,0.00,6,0,8,0,6,2,1,10,185,1
"org.apache.jackrabbit.spi.commons.conversion.DefaultNamePathResolver",11,0.30,1.18,33,0.35,5720.26,13,2,10,23,49,131.78,3,46,32,1,131.78,0.00,0.00,0.23,0,40.00,2,1052.48,0,5,17,java.lang.Object,0.00,12,0,13,1,12,6,1,1,260,1
"org.apache.jackrabbit.spi.commons.conversion.DummyIdentifierResolver",6,0.17,1.83,62,0.77,34334.26,12,6,8,20,8,103.97,5,71,2,1,103.97,0.00,0.00,0.31,0,0.00,4,2299.84,0,4,6,java.lang.Object,0.00,14,0,11,0,14,2,1,3,427,0
"org.apache.jackrabbit.spi.commons.conversion.DummyNamespaceResolver",2,0.00,1.00,5,0.03,335.40,2,0,2,2,7,94.15,17,8,6,1,142.25,0.00,0.00,0.00,0,2.00,1,85.37,0,2,1,java.lang.Object,0.00,0,0,2,0,0,0,1,3,28,1
"org.apache.jackrabbit.spi.commons.conversion.GenerationalCache",5,0.16,2.40,39,0.45,16199.18,13,8,3,16,2,91.49,71,52,2,1,111.63,0.00,0.00,0.25,1,13.00,6,1347.19,0,1,0,java.lang.Object,0.00,11,0,12,0,11,4,0,14,285,0
"org.apache.jackrabbit.spi.commons.conversion.IdentifierResolver",2,0.00,1.00,3,0.02,126.12,2,0,1,2,13,206.83,3,4,11,1,156.83,0.00,0.00,0.00,0,2.00,1,65.06,0,1,2,,0.00,0,0,2,0,0,1,0,1,22,1
"org.apache.jackrabbit.spi.commons.conversion.IllegalNameException",2,0.00,1.00,5,0.03,221.18,2,0,0,2,36,99.55,22,8,35,3,143.68,0.00,0.67,0.00,0,2.00,1,88.69,0,0,1,org.apache.jackrabbit.spi.commons.conversion.NameException,0.00,0,2,2,0,0,2,0,3,29,1
"org.apache.jackrabbit.spi.commons.conversion.MalformedPathException",2,0.00,1.00,5,0.03,221.18,2,0,0,2,49,95.20,21,8,48,3,143.68,0.00,0.67,0.00,0,2.00,1,88.69,0,0,1,org.apache.jackrabbit.spi.commons.conversion.NameException,0.00,0,2,2,0,0,2,0,3,29,1
"org.apache.jackrabbit.spi.commons.conversion.NameException",2,0.00,1.00,5,0.03,221.18,2,0,1,2,59,95.57,16,8,59,2,143.68,2.00,0.25,0.00,0,2.00,1,88.69,0,0,0,javax.jcr.RepositoryException,0.00,0,1,2,2,0,2,0,3,29,1
"org.apache.jackrabbit.spi.commons.conversion.NameParser",3,0.25,13.67,111,1.61,222327.31,9,6,5,15,15,91.69,56,135,9,1,73.55,0.00,0.00,0.33,1,4.00,37,4829.03,0,2,6,java.lang.Object,0.00,12,0,41,0,12,1,0,23,772,1
"org.apache.jackrabbit.spi.commons.conversion.NameParserTest",4,0.25,6.00,163,2.89,161391.57,8,4,10,21,8,24.56,37,170,0,2,74.56,0.00,0.50,0.44,0,2.00,9,8680.65,0,0,8,junit.framework.TestCase,0.00,17,1,24,0,17,4,0,30,1369,1
"org.apache.jackrabbit.spi.commons.conversion.NameParserTest$TestNamespaceResolver",2,0.00,2.00,11,0.16,6808.90,2,0,10,5,0,116.95,0,20,0,1,116.95,0.00,0.00,0.00,0,2.00,2,481.49,0,2,0,java.lang.Object,0.00,3,0,4,0,3,0,1,0,104,1
"org.apache.jackrabbit.spi.commons.conversion.NamePathResolver",0,0.00,0.00,1,0.01,39.30,0,0,0,0,153,171.00,5,2,153,3,171.00,0.00,0.67,0.00,0,0.00,0,19.65,0,0,0,,0.00,0,2,0,0,0,0,0,1,7,1
"org.apache.jackrabbit.spi.commons.conversion.NameResolver",2,0.00,1.00,3,0.02,93.79,2,0,2,2,52,109.36,20,4,50,1,157.84,0.00,0.00,0.00,0,2.00,1,62.53,0,2,2,,0.00,0,0,2,0,0,0,0,3,22,1
"org.apache.jackrabbit.spi.commons.conversion.ParsingNameResolver",3,0.00,1.33,14,0.15,2984.06,5,2,4,8,19,87.31,37,19,13,1,124.87,0.00,0.00,0.50,0,1.00,2,438.87,0,2,6,java.lang.Object,0.00,5,0,4,0,5,1,1,7,105,1
"org.apache.jackrabbit.spi.commons.conversion.ParsingNameResolverTest",4,0.67,2.00,40,0.35,5630.86,5,1,4,13,6,76.52,25,52,0,2,108.74,0.00,0.50,0.50,2,4.00,3,1051.48,0,0,6,junit.framework.TestCase,0.00,9,1,8,0,9,4,0,6,237,1
"org.apache.jackrabbit.spi.commons.conversion.ParsingPathResolver",5,0.17,2.40,38,0.51,26538.48,8,3,3,18,19,61.46,54,46,11,1,109.94,0.00,0.00,0.47,0,2.00,8,1527.05,0,3,8,java.lang.Object,0.00,13,0,12,0,13,2,1,10,303,1
"org.apache.jackrabbit.spi.commons.conversion.ParsingPathResolverTest",8,0.07,1.88,108,1.02,19226.48,12,4,8,28,11,123.29,26,123,0,2,102.68,0.00,0.50,0.31,2,0.00,3,3048.83,1,0,11,junit.framework.TestCase,0.00,20,1,15,0,20,8,0,10,620,1
"org.apache.jackrabbit.spi.commons.conversion.PathParser",7,0.06,10.00,173,2.98,551890.17,18,11,6,29,12,124.37,154,248,2,1,80.42,0.00,0.00,0.14,1,12.00,62,8939.57,0,6,10,java.lang.Object,0.00,22,0,70,0,22,1,0,29,1368,1
"org.apache.jackrabbit.spi.commons.conversion.PathParserTest",9,0.28,4.33,204,3.05,164909.45,14,5,10,42,13,126.90,19,211,0,2,87.02,0.00,0.50,0.44,0,0.00,9,9141.01,0,0,13,junit.framework.TestCase,0.00,33,1,39,0,33,9,0,17,1637,1
"org.apache.jackrabbit.spi.commons.conversion.PathResolver",3,0.00,1.00,4,0.04,165.36,3,0,2,3,36,107.29,29,5,33,1,157.29,0.00,0.00,0.00,0,3.00,1,110.24,0,3,3,,0.00,0,0,3,0,0,0,0,4,35,1
"org.apache.jackrabbit.spi.commons.query.xpath.QueryBuilder",4,0.00,1.00,9,0.10,1268.78,4,0,6,7,5,140.31,16,18,0,1,140.07,0.00,0.00,0.00,0,4.00,1,294.46,0,3,5,java.lang.Object,0.00,3,0,4,0,3,1,1,5,78,1
"org.apache.jackrabbit.spi.commons.query.xpath.QueryFormat",18,0.10,5.17,348,5.22,373032.50,21,3,30,90,27,128.82,43,407,4,1,88.93,0.00,0.00,0.43,2,0.00,25,15658.84,0,16,24,java.lang.Object,0.00,72,0,93,0,72,2,2,14,2652,0
"org.apache.jackrabbit.spi.commons.query.xpath.QueryFormat$DefaultQueryNodeVisitor",1,0.00,1.00,4,0.03,474.00,1,0,30,2,1,127.47,0,5,0,1,127.47,0.00,0.00,0.00,0,1.00,1,92.00,0,1,1,java.lang.Object,0.00,1,0,1,0,1,0,0,0,25,0
"org.apache.jackrabbit.spi.commons.query.xpath.QueryFormatTest",1,0.00,1.00,7,0.11,1636.44,3,2,11,7,8,134.78,3,10,0,2,114.17,0.00,0.50,1.00,0,0.00,1,318.86,0,0,8,junit.framework.TestCase,0.00,6,1,1,0,6,1,0,1,70,1
"org.apache.jackrabbit.spi.commons.query.xpath.SimpleNode",20,0.06,1.45,68,0.59,15165.52,25,5,0,27,2,130.44,17,90,2,1,130.44,0.00,0.00,0.14,3,204.00,4,1780.14,0,5,0,java.lang.Object,0.00,7,0,29,0,7,15,1,6,430,1
"org.apache.jackrabbit.spi.commons.query.xpath.XPathOrderByTest",6,0.40,1.00,45,0.77,13289.30,8,2,13,26,11,113.13,4,53,0,2,113.13,0.00,0.50,0.83,1,0.00,1,2296.14,0,0,11,junit.framework.TestCase,0.00,20,1,6,0,20,6,0,1,446,1
"org.apache.jackrabbit.spi.commons.query.xpath.XPathQueryBuilder",18,0.06,9.78,568,10.84,1149994.87,59,41,38,136,35,86.13,313,750,4,1,77.00,0.00,0.00,0.08,10,66.00,64,32532.51,0,11,32,java.lang.Object,0.00,118,0,176,0,118,7,2,116,4805,1
"org.apache.jackrabbit.spi.commons.query.xpath.XPathQueryBuilder$DefaultQueryNodeVisitor",1,0.00,2.00,7,0.11,2802.00,1,0,38,5,2,112.17,0,11,0,1,112.17,0.00,0.00,0.00,0,0.00,2,318.00,0,1,2,java.lang.Object,0.00,4,0,2,0,4,0,0,0,66,0
"org.apache.jackrabbit.commons.iterator.AccessControlPolicyIteratorAdapter",4,1.00,1.00,10,0.08,1359.33,5,1,6,6,4,97.55,29,17,2,2,139.84,0.00,0.50,0.00,0,4.00,1,249.48,1,1,2,org.apache.jackrabbit.commons.iterator.RangeIteratorDecorator,0.00,2,1,4,0,2,3,1,7,71,1
"org.apache.jackrabbit.commons.iterator.EventIteratorAdapter",6,1.00,1.00,18,0.14,1775.50,7,1,7,8,2,101.52,39,26,0,2,133.74,0.00,0.50,0.17,0,10.00,1,420.00,1,1,2,org.apache.jackrabbit.commons.iterator.RangeIteratorDecorator,0.00,2,1,6,0,2,5,1,9,114,1
"org.apache.jackrabbit.commons.iterator.EventListenerIteratorAdapter",4,1.00,1.00,10,0.08,1307.38,5,1,6,6,3,97.68,29,17,1,2,139.97,0.00,0.50,0.00,0,4.00,1,239.29,1,1,2,org.apache.jackrabbit.commons.iterator.RangeIteratorDecorator,0.00,2,1,4,0,2,3,1,7,69,1
"org.apache.jackrabbit.commons.iterator.FrozenNodeIteratorAdapter",2,0.00,1.50,7,0.07,1174.42,2,0,5,6,3,131.54,9,12,2,2,131.31,0.00,0.50,0.00,0,2.00,2,213.91,1,1,1,org.apache.jackrabbit.commons.iterator.RangeIteratorAdapter,0.00,4,1,3,0,4,1,1,2,55,1
"org.apache.jackrabbit.commons.iterator.NodeIterable",2,1.00,1.00,6,0.05,702.81,3,1,3,2,1,84.68,20,10,1,1,133.15,0.00,0.00,0.50,0,2.00,1,152.48,0,1,0,java.lang.Object,0.00,0,0,2,0,0,1,1,4,42,1
"org.apache.jackrabbit.commons.iterator.NodeIteratorAdapter",4,1.00,1.00,10,0.08,1359.33,5,1,6,6,11,97.55,29,17,9,2,139.84,0.00,0.50,0.00,0,4.00,1,249.48,1,1,2,org.apache.jackrabbit.commons.iterator.RangeIteratorDecorator,0.00,2,1,4,0,2,3,1,7,71,1
"org.apache.jackrabbit.commons.iterator.NodeTypeIteratorAdapter",4,1.00,1.00,10,0.09,1471.53,5,1,6,6,6,97.28,29,17,4,2,139.57,0.00,0.50,0.00,0,4.00,1,265.50,1,1,2,org.apache.jackrabbit.commons.iterator.RangeIteratorDecorator,0.00,2,1,4,0,2,3,1,7,74,1
"org.apache.jackrabbit.commons.iterator.PropertyIterable",2,1.00,1.00,6,0.05,702.81,3,1,3,2,1,84.68,20,10,1,1,133.15,0.00,0.00,0.50,0,2.00,1,152.48,0,1,0,java.lang.Object,0.00,0,0,2,0,0,1,1,4,42,1
"org.apache.jackrabbit.commons.iterator.PropertyIteratorAdapter",4,1.00,1.00,10,0.08,1307.38,5,1,6,6,4,97.68,29,17,2,2,139.97,0.00,0.50,0.00,0,4.00,1,239.29,1,1,2,org.apache.jackrabbit.commons.iterator.RangeIteratorDecorator,0.00,2,1,4,0,2,3,1,7,69,1
"org.apache.jackrabbit.commons.iterator.RangeIteratorAdapter",9,0.06,1.78,45,0.34,8853.83,13,4,5,16,15,73.12,75,63,15,1,121.23,0.00,0.00,0.31,1,8.00,3,1033.45,0,1,0,java.lang.Object,0.00,7,0,16,2,7,8,1,16,249,1
"org.apache.jackrabbit.commons.iterator.RangeIteratorDecorator",7,0.17,1.00,16,0.11,1357.60,8,1,2,13,10,109.53,48,25,10,1,141.76,0.00,0.00,0.86,0,0.00,1,328.05,0,1,0,java.lang.Object,0.00,6,0,7,10,6,6,1,11,98,1
"org.apache.jackrabbit.commons.iterator.RowIterable",2,1.00,1.00,6,0.05,702.81,3,1,3,2,1,84.68,20,10,1,1,133.15,0.00,0.00,0.50,0,2.00,1,152.48,0,1,0,java.lang.Object,0.00,0,0,2,0,0,1,1,4,42,1
"org.apache.jackrabbit.commons.iterator.RowIteratorAdapter",4,1.00,1.00,10,0.08,1307.38,5,1,6,6,3,97.68,29,17,1,2,139.97,1.00,0.33,0.00,0,4.00,1,239.29,1,1,2,org.apache.jackrabbit.commons.iterator.RangeIteratorDecorator,0.00,2,1,4,1,2,3,1,7,69,1
"org.apache.jackrabbit.commons.iterator.VersionIteratorAdapter",4,1.00,1.00,10,0.08,1307.38,5,1,6,6,3,97.68,29,17,1,2,139.97,0.00,0.50,0.00,0,4.00,1,239.29,1,1,2,org.apache.jackrabbit.commons.iterator.RangeIteratorDecorator,0.00,2,1,4,0,2,3,1,7,69,1
"org.apache.jackrabbit.webdav.jcr.lock.JcrActiveLock",12,0.23,1.50,39,0.42,9170.35,14,2,10,27,8,98.18,75,61,2,2,130.40,0.00,0.50,0.29,1,32.00,3,1254.62,0,4,6,org.apache.jackrabbit.webdav.lock.AbstractActiveLock,0.00,15,1,18,0,15,8,2,17,296,1
"org.apache.jackrabbit.webdav.jcr.lock.SessionScopedLockEntry",2,1.00,1.00,6,0.05,693.12,3,1,7,3,6,100.98,12,9,1,2,133.20,0.00,0.50,0.00,0,2.00,1,144.92,0,2,5,org.apache.jackrabbit.webdav.lock.AbstractLockEntry,0.00,1,1,2,0,1,0,0,3,40,1
"org.apache.jackrabbit.core.data.db.DatabaseHelper",3,0.00,3.00,17,0.17,3137.23,4,1,6,8,2,121.13,12,30,2,1,120.90,0.00,0.00,1.00,0,0.00,3,503.37,0,0,0,java.lang.Object,0.00,5,0,9,0,5,3,0,4,117,1
"org.apache.jackrabbit.core.data.db.DbDataRecord",4,0.22,1.00,17,0.14,2218.56,7,3,4,6,5,127.17,19,22,1,2,126.93,0.00,0.50,0.50,0,0.00,1,429.76,1,1,5,org.apache.jackrabbit.core.data.AbstractDataRecord,0.00,2,1,4,0,2,3,0,5,110,1
"org.apache.jackrabbit.core.data.db.DbDataStore",41,0.03,2.15,355,4.89,267892.42,75,34,31,118,17,58.99,357,480,7,1,107.09,0.00,0.00,0.06,10,941.00,15,14677.94,0,18,13,java.lang.Object,0.00,77,0,88,1,77,23,1,88,2540,1
"org.apache.jackrabbit.core.data.db.DbInputStream",13,0.04,2.38,85,0.70,15751.08,19,6,9,29,6,117.73,62,121,2,2,117.49,0.00,0.50,0.21,3,0.00,5,2099.01,0,0,5,org.apache.commons.io.input.AutoCloseInputStream,0.00,16,1,31,0,16,13,0,16,478,1
"org.apache.jackrabbit.core.data.db.DerbyDataStore",1,0.00,5.00,19,0.26,10585.92,2,1,7,13,4,109.37,18,27,0,2,91.24,0.00,0.50,1.00,0,0.00,5,785.48,3,0,4,org.apache.jackrabbit.core.data.db.DbDataStore,0.05,12,1,5,0,12,1,0,13,145,1
"org.apache.jackrabbit.core.data.db.Pool",4,0.17,1.75,22,0.24,5683.51,8,4,4,13,2,77.68,28,31,1,1,119.97,0.00,0.00,0.38,0,2.00,4,706.38,0,2,2,java.lang.Object,0.00,9,0,7,0,9,2,0,5,163,1
"org.apache.jackrabbit.core.data.db.TempFileInputStream",12,0.32,1.42,43,0.37,6556.52,14,2,10,27,2,181.56,18,61,2,2,131.57,0.00,0.50,0.21,2,28.00,2,1114.18,0,0,0,org.apache.commons.io.input.AutoCloseInputStream,0.00,15,1,17,0,15,12,0,3,279,1
"org.apache.jackrabbit.client.AbstractRepositoryConfig",6,0.11,2.33,51,0.56,27091.17,15,9,5,11,8,60.23,48,68,6,1,108.34,0.00,0.00,0.20,0,18.00,9,1666.28,0,1,2,java.lang.Object,0.00,5,0,14,4,5,5,1,11,340,2
"org.apache.jackrabbit.client.RepositoryFactoryImpl",1,0.00,7.00,23,0.36,22671.00,3,2,8,9,7,117.37,31,31,1,1,85.46,0.00,0.00,1.00,0,0.00,7,1093.93,0,1,6,java.lang.Object,0.00,8,0,7,0,8,0,1,3,211,1
"org.apache.jackrabbit.client.RepositoryFactoryImplTest",4,0.00,1.75,34,0.43,9643.97,6,2,57,19,29,150.44,11,41,0,2,110.55,0.00,0.50,0.50,0,0.00,3,1291.19,0,0,29,junit.framework.TestCase,0.00,15,1,7,0,15,4,0,7,265,1
"org.apache.jackrabbit.client.RepositoryFactoryImplTest$AbstractRepositoryConfig",1,0.00,1.00,3,0.01,111.66,1,0,57,1,1,137.08,0,4,0,1,137.08,0.00,0.00,0.00,0,0.00,1,41.22,0,1,1,java.lang.Object,0.00,0,0,1,0,0,0,0,0,14,0
"org.apache.jackrabbit.client.RepositoryFactoryImplTest$AbstractRepositoryConfig_0",1,0.00,1.00,3,0.01,111.66,1,0,57,1,1,137.08,0,4,0,1,137.08,0.00,0.00,0.00,0,0.00,1,41.22,0,1,1,java.lang.Object,0.00,0,0,1,0,0,0,0,0,14,0
"org.apache.jackrabbit.client.RepositoryFactoryImplTest$RepositoryServiceImpl",64,0.00,1.00,104,1.44,12951.69,64,0,57,64,22,152.84,0,169,0,1,152.84,0.00,0.00,0.00,0,64.00,1,4315.11,0,38,22,java.lang.Object,0.00,0,0,64,0,0,26,1,0,1069,3
"org.apache.jackrabbit.client.RepositoryFactoryTest",1,1.00,2.00,9,0.09,1928.73,2,1,6,7,0,77.15,6,12,0,2,109.37,0.00,0.50,0.00,0,1.00,2,284.87,0,0,0,junit.framework.TestCase,0.00,6,1,2,0,6,1,0,2,65,1
"org.apache.jackrabbit.test.api.util.TestAll",1,0.00,1.00,4,0.03,457.63,1,0,3,2,2,90.03,12,6,2,2,127.59,0.00,0.50,0.00,0,1.00,1,76.45,0,1,0,junit.framework.TestCase,0.00,1,1,1,0,1,0,0,3,23,1
"org.apache.jackrabbit.core.persistence.obj.ObjectPersistenceManager",19,0.21,3.32,245,3.17,131426.60,27,8,27,74,19,100.47,77,337,0,2,100.23,0.00,0.50,0.32,4,0.00,7,9505.07,1,7,19,org.apache.jackrabbit.core.persistence.AbstractPersistenceManager,0.00,55,1,63,0,55,12,0,33,1761,1
"org.apache.jackrabbit.webdav.transaction.TransactionConstants",0,0.00,0.00,13,0.24,5843.66,12,12,4,3,12,171.00,76,14,8,1,171.00,0.00,0.00,0.00,0,0.00,0,724.21,0,0,4,,0.00,3,0,0,0,3,0,0,16,138,1
"org.apache.jackrabbit.webdav.transaction.TransactionDavServletRequest",2,0.00,1.00,3,0.02,87.74,2,0,2,2,5,113.94,23,4,2,2,158.07,0.00,0.50,0.00,0,2.00,1,46.77,0,2,3,,0.00,0,1,2,0,0,0,0,3,18,1
"org.apache.jackrabbit.webdav.transaction.TransactionInfo",4,0.00,1.75,23,0.28,8103.38,6,2,8,13,14,70.28,41,30,9,1,118.76,0.00,0.00,0.50,0,0.00,3,836.00,0,1,5,java.lang.Object,0.00,9,0,7,0,9,3,2,7,178,1
"org.apache.jackrabbit.webdav.transaction.TransactionResource",3,1.00,1.00,5,0.04,358.34,4,1,2,3,16,104.64,28,6,13,2,154.64,0.00,0.50,0.00,0,3.00,1,133.70,0,1,4,,0.00,0,1,3,0,0,2,0,4,40,1
"org.apache.jackrabbit.webdav.transaction.TxActiveLock",4,0.17,2.00,23,0.23,6822.88,6,2,4,12,10,77.03,30,32,5,3,119.32,0.00,0.67,0.38,0,2.00,5,691.92,2,2,5,org.apache.jackrabbit.webdav.lock.DefaultActiveLock,0.45,8,2,8,0,8,2,1,7,150,1
"org.apache.jackrabbit.webdav.transaction.TxLockEntry",3,0.25,1.33,12,0.08,1314.56,5,2,5,4,5,79.57,26,17,1,2,127.67,0.00,0.50,0.33,0,2.00,2,249.39,0,2,4,org.apache.jackrabbit.webdav.lock.AbstractLockEntry,0.00,1,1,4,0,1,1,1,4,65,2
"org.apache.jackrabbit.webdav.transaction.TxLockManager",2,0.00,1.00,3,0.03,184.31,2,0,5,2,9,145.17,30,5,3,2,155.53,0.00,0.50,0.00,0,2.00,1,101.67,0,1,7,,0.00,0,1,2,0,0,1,0,3,30,1
"org.apache.jackrabbit.core.query.lucene.AbstractExcerpt",7,0.04,3.43,102,1.43,85557.95,11,4,23,57,10,45.78,66,138,4,1,95.78,0.00,0.00,0.29,3,7.00,9,4286.16,0,5,6,java.lang.Object,0.00,50,0,24,4,50,2,1,26,751,2
"org.apache.jackrabbit.core.query.lucene.AbstractExcerpt$TermPositionVector",8,0.43,1.50,34,0.34,10255.97,9,1,23,13,0,123.97,0,40,0,1,123.97,0.00,0.00,0.62,0,0.00,2,1005.34,0,3,0,java.lang.Object,0.00,5,0,12,0,5,5,0,0,240,0
"org.apache.jackrabbit.core.query.lucene.AbstractIndex",23,0.05,3.17,232,2.59,105708.15,39,16,17,91,12,54.59,208,307,2,1,104.59,0.00,0.00,0.11,11,199.00,9,7767.57,0,6,10,java.lang.Object,0.00,68,0,73,2,68,17,0,67,1527,1
"org.apache.jackrabbit.core.query.lucene.AbstractIndex$DynamicPooledExecutor.Command",1,0.00,1.00,5,0.05,925.46,1,0,17,4,0,121.57,0,6,0,1,121.57,0.00,0.00,0.00,0,1.00,1,156.06,0,1,0,java.lang.Object,0.00,3,0,1,0,3,0,0,0,38,0
"org.apache.jackrabbit.core.query.lucene.AbstractIndex$LoggingPrintStream",3,0.50,1.00,10,0.08,928.25,4,1,17,8,0,133.59,2,17,0,2,133.59,0.00,0.50,0.67,0,1.00,1,239.79,0,0,0,java.io.PrintStream,0.00,5,1,3,0,5,3,0,2,65,3
"org.apache.jackrabbit.core.query.lucene.AbstractIndex$LoggingPrintStream$OutputStream",1,0.00,1.00,2,0.01,41.48,1,0,17,1,0,147.03,0,0,0,1,147.03,0.00,0.00,0.00,0,1.00,1,27.65,0,0,0,java.lang.Object,0.00,0,0,1,0,0,1,0,0,11,0
"org.apache.jackrabbit.core.query.lucene.AbstractNamespaceMappings",3,0.50,1.67,12,0.12,2265.88,4,1,6,7,9,93.54,18,22,2,1,125.76,0.00,0.00,0.67,0,1.00,2,363.78,0,2,7,java.lang.Object,0.00,4,0,5,2,4,1,2,9,88,2
"org.apache.jackrabbit.core.query.lucene.AbstractQueryHits",3,0.00,1.67,8,0.06,831.12,3,0,1,4,6,90.42,27,14,5,1,140.42,0.00,0.00,0.00,0,3.00,3,174.03,0,0,1,java.lang.Object,0.00,1,0,5,4,1,3,1,4,48,2
"org.apache.jackrabbit.core.query.lucene.AbstractQueryImpl",8,0.04,1.12,29,0.31,6120.13,15,7,13,18,11,81.99,83,43,6,1,130.47,0.00,0.00,0.11,0,30.00,2,940.64,0,2,6,java.lang.Object,0.00,10,0,9,2,10,6,1,16,219,2
"org.apache.jackrabbit.core.query.lucene.AbstractScoreDocComparator",5,0.12,2.40,41,0.44,28285.23,7,2,7,12,6,65.27,36,51,4,1,107.56,0.00,0.00,0.40,1,7.00,5,1331.91,0,0,2,java.lang.Object,0.00,7,0,12,4,7,5,1,6,286,1
"org.apache.jackrabbit.core.query.lucene.AbstractWeight",3,1.00,2.00,27,0.29,21786.43,4,1,5,7,6,54.84,27,28,4,1,104.84,0.00,0.00,0.33,1,4.00,4,870.41,0,2,2,java.lang.Object,0.00,4,0,6,4,4,1,1,5,177,1
"org.apache.jackrabbit.core.query.lucene.AggregateRule",3,0.00,1.00,4,0.03,214.15,3,0,4,3,7,118.84,37,8,4,1,156.40,0.00,0.00,0.00,0,3.00,1,97.22,0,3,3,,0.00,0,0,3,0,0,0,0,4,33,1
"org.apache.jackrabbit.core.query.lucene.AggregateRuleImpl",8,0.05,3.62,114,1.54,58625.10,14,6,25,41,18,68.13,106,132,1,1,97.51,0.00,0.00,0.21,1,20.00,6,4629.35,0,5,17,java.lang.Object,0.00,33,0,29,0,33,3,1,18,861,0
"org.apache.jackrabbit.core.query.lucene.AggregateRuleImpl$AbstractInclude",3,0.25,4.33,47,0.64,28868.35,5,2,25,18,6,85.07,47,61,0,1,95.42,0.00,0.00,0.67,1,1.00,6,1922.90,0,1,6,java.lang.Object,0.00,15,0,13,0,15,2,0,16,354,2
"org.apache.jackrabbit.core.query.lucene.AggregateRuleImpl$NodeInclude",2,0.00,1.00,7,0.07,1439.74,2,0,25,5,4,82.60,16,10,0,2,130.70,0.00,0.50,0.00,1,2.00,1,221.92,0,1,4,org.apache.jackrabbit.core.query.lucene.AbstractInclude,0.00,3,1,2,0,3,1,0,2,58,2
"org.apache.jackrabbit.core.query.lucene.AggregateRuleImpl$PropertyInclude",2,1.00,2.00,18,0.23,5504.89,3,1,25,14,6,108.39,8,23,0,2,108.16,0.00,0.50,0.50,0,2.00,3,689.98,0,1,6,org.apache.jackrabbit.core.query.lucene.AbstractInclude,0.00,12,1,4,0,12,1,0,1,142,2
"org.apache.jackrabbit.core.query.lucene.CachingIndexReader",7,0.09,3.86,100,1.37,62133.25,16,9,20,46,11,96.37,118,143,4,2,96.85,0.00,0.50,0.19,2,30.00,11,4123.29,2,2,8,org.apache.lucene.index.FilterIndexReader,0.00,39,1,27,0,39,5,0,39,748,0
"org.apache.jackrabbit.core.query.lucene.CachingIndexReader$CacheInitializer",5,0.08,3.80,71,0.95,47548.74,8,3,20,32,3,48.51,44,106,0,1,96.61,0.00,0.00,0.40,2,0.00,8,2847.76,0,0,3,java.lang.Object,0.00,27,0,19,0,27,5,1,14,503,1
"org.apache.jackrabbit.core.query.lucene.CachingIndexReader$CacheInitializer$TermDocsCollector",1,0.00,3.00,8,0.11,2777.71,1,0,20,7,1,159.94,1,11,0,1,109.94,0.00,0.00,0.00,0,0.00,3,338.00,0,0,1,java.lang.Object,0.00,6,0,3,0,6,1,0,1,70,0
"org.apache.jackrabbit.core.query.lucene.CachingIndexReader$CacheInitializer$TermDocsCollector_0",1,0.00,3.00,11,0.14,4238.98,1,0,20,8,1,153.34,1,14,0,1,103.34,0.00,0.00,0.00,0,1.00,3,423.47,0,0,1,java.lang.Object,0.00,7,0,3,0,7,1,0,1,85,0
"org.apache.jackrabbit.core.query.lucene.CachingIndexReader$NodeInfo",1,3.00,1.00,7,0.05,645.29,4,3,20,1,1,117.35,0,9,0,1,117.35,0.00,0.00,0.00,0,1.00,1,143.40,0,0,1,java.lang.Object,0.00,0,0,1,0,0,1,0,0,40,3
"org.apache.jackrabbit.core.query.lucene.CachingIndexReader$TermDocsCollector_1",1,0.00,1.00,2,0.01,64.83,1,0,20,1,0,103.21,7,3,0,1,145.50,0.00,0.00,0.00,0,1.00,1,43.22,0,0,0,,0.00,0,0,1,0,0,1,0,1,15,1
"org.apache.jackrabbit.core.query.lucene.CachingMultiIndexReader",11,0.10,2.36,97,1.20,60119.59,16,5,8,39,14,65.39,82,120,5,2,107.68,0.00,0.50,0.29,2,17.00,6,3603.12,1,2,9,org.apache.lucene.index.MultiReader,0.00,28,1,26,0,28,9,2,30,718,2
"org.apache.jackrabbit.core.query.lucene.CachingMultiIndexReader$OffsetReader",1,2.00,1.00,6,0.04,488.07,3,2,8,1,1,83.24,12,8,0,1,120.80,0.00,0.00,0.00,0,1.00,1,128.00,0,0,1,java.lang.Object,0.00,0,0,1,0,0,1,0,3,37,3
"org.apache.jackrabbit.core.query.lucene.CaseTermQuery",2,1.00,1.00,10,0.09,1352.89,3,1,11,3,3,104.77,11,13,2,2,122.64,2.00,0.25,0.00,0,2.00,1,265.13,0,1,1,org.apache.lucene.search.MultiTermQuery,0.00,1,1,2,2,1,1,1,3,67,1
"org.apache.jackrabbit.core.query.lucene.CaseTermQuery$CaseTermEnum",4,0.11,2.75,59,0.97,81932.38,7,3,11,40,3,114.68,15,77,0,2,94.06,0.00,0.50,0.25,0,6.00,8,2916.03,0,0,3,org.apache.lucene.search.FilteredTermEnum,0.00,36,1,11,0,36,4,0,15,480,2
"org.apache.jackrabbit.core.query.lucene.CaseTermQuery$CaseTermEnum$TermEnum",5,0.25,1.40,14,0.11,1552.38,6,1,11,9,0,140.07,1,21,0,1,140.07,0.00,0.00,0.80,1,0.00,2,324.73,0,1,0,java.lang.Object,0.00,4,0,7,0,4,4,0,1,88,0
"org.apache.jackrabbit.core.query.lucene.CaseTermQuery$Lower",1,0.00,1.00,3,0.02,110.15,1,0,11,1,1,137.12,0,5,0,3,137.12,0.00,0.67,0.00,0,0.00,1,52.46,0,0,1,org.apache.jackrabbit.core.query.lucene.CaseTermQuery,0.00,0,2,1,0,0,1,0,0,18,2
"org.apache.jackrabbit.core.query.lucene.CaseTermQuery$Upper",1,0.00,1.00,3,0.02,110.15,1,0,11,1,1,137.12,0,5,0,3,137.12,0.00,0.67,0.00,0,0.00,1,52.46,0,0,1,org.apache.jackrabbit.core.query.lucene.CaseTermQuery,0.00,0,2,1,0,0,1,0,0,18,2
"org.apache.jackrabbit.core.query.lucene.ChildAxisQuery",11,0.04,1.64,70,0.76,20258.22,21,10,34,29,24,67.67,116,103,3,2,116.15,0.00,0.50,0.14,1,18.00,6,2268.86,0,6,21,org.apache.lucene.search.Query,0.00,18,1,18,0,18,5,1,32,476,0
"org.apache.jackrabbit.core.query.lucene.ChildAxisQuery$ChildAxisScorer",8,0.04,2.75,72,0.95,51844.02,12,4,34,26,10,72.93,49,106,0,2,105.16,0.00,0.50,0.28,2,14.00,12,2842.61,0,1,10,org.apache.lucene.search.Scorer,0.00,18,1,22,0,18,7,0,22,536,1
"org.apache.jackrabbit.core.query.lucene.ChildAxisQuery$ChildAxisScorer$HitCollector",1,0.00,1.00,3,0.02,233.39,1,0,34,2,0,134.55,0,4,0,1,134.55,0.00,0.00,0.00,0,1.00,1,74.42,0,0,0,java.lang.Object,0.00,1,0,1,0,1,1,0,0,21,0
"org.apache.jackrabbit.core.query.lucene.ChildAxisQuery$ChildAxisScorer$HitCollector_0",1,0.00,4.00,14,0.17,4565.35,2,1,34,9,0,139.00,2,16,0,1,99.11,0.00,0.00,1.00,0,0.00,4,498.14,0,0,0,java.lang.Object,0.00,8,0,4,0,8,1,0,2,101,0
"org.apache.jackrabbit.core.query.lucene.ChildAxisQuery$ChildAxisWeight",7,1.00,1.14,18,0.18,3200.51,8,1,34,13,3,139.03,33,28,0,1,138.79,0.00,0.00,0.14,0,12.00,2,527.64,0,3,3,java.lang.Object,0.00,6,0,8,0,6,4,1,8,132,1
"org.apache.jackrabbit.core.query.lucene.ChildAxisQuery$ChildrenCalculator",3,2.00,1.00,8,0.06,715.65,5,2,34,3,2,98.76,22,11,0,1,141.05,0.00,0.00,0.00,0,3.00,1,180.64,0,1,2,java.lang.Object,0.00,0,0,3,0,0,2,0,5,53,2
"org.apache.jackrabbit.core.query.lucene.ChildAxisQuery$HierarchyResolvingChildrenCalculator",3,0.50,2.67,29,0.35,18383.00,4,1,34,13,4,87.48,16,34,0,2,105.36,0.00,0.50,0.67,0,1.00,6,1038.37,0,1,4,org.apache.jackrabbit.core.query.lucene.ChildrenCalculator,0.00,10,1,8,0,10,2,0,5,202,2
"org.apache.jackrabbit.core.query.lucene.ChildAxisQuery$SimpleChildrenCalculator",3,1.00,3.00,40,0.61,30399.31,4,1,34,26,10,65.43,19,48,0,2,97.65,0.00,0.50,0.33,0,5.00,7,1832.94,0,1,10,org.apache.jackrabbit.core.query.lucene.ChildrenCalculator,0.00,23,1,9,0,23,2,0,8,308,2
"org.apache.jackrabbit.core.query.lucene.ChildNodesQueryHits",4,0.22,2.50,31,0.27,7090.84,7,3,4,10,8,65.58,33,44,2,2,113.68,0.00,0.50,0.50,1,0.00,4,811.64,0,1,6,org.apache.jackrabbit.core.query.lucene.AbstractQueryHits,0.29,6,1,10,0,6,3,0,9,182,1
"org.apache.jackrabbit.core.query.lucene.CloseableHits",3,0.00,1.00,4,0.02,82.26,3,0,1,3,0,127.45,19,5,0,1,159.68,0.00,0.00,0.00,0,3.00,1,57.51,0,0,0,,0.00,0,0,3,0,0,3,0,4,23,1
"org.apache.jackrabbit.core.query.lucene.CommittableIndexReader",3,0.00,1.00,10,0.06,658.19,4,1,4,4,3,86.66,24,14,3,2,134.77,0.00,0.50,1.00,0,0.00,1,185.77,1,0,0,org.apache.lucene.index.FilterIndexReader,0.00,1,1,3,0,1,3,0,7,53,0
"org.apache.jackrabbit.core.query.lucene.ConsistencyCheck",6,0.12,5.00,114,1.73,151666.20,11,5,15,52,13,58.88,80,141,2,1,88.26,0.00,0.00,0.30,0,6.00,13,5187.55,0,3,11,java.lang.Object,0.00,46,0,30,0,46,3,0,23,887,0
"org.apache.jackrabbit.core.query.lucene.ConsistencyCheck$MissingAncestor",3,1.00,2.00,19,0.27,9320.94,4,1,15,9,5,154.20,8,27,0,2,114.31,0.00,0.50,0.33,0,4.00,4,802.27,0,0,5,org.apache.jackrabbit.core.query.lucene.ConsistencyCheckError,0.57,6,1,6,0,6,3,0,2,161,1
"org.apache.jackrabbit.core.query.lucene.ConsistencyCheck$MultipleEntries",3,0.00,1.67,15,0.19,4729.35,3,0,15,8,5,140.24,11,22,0,2,119.63,0.00,0.50,0.00,0,4.00,3,576.96,0,0,5,org.apache.jackrabbit.core.query.lucene.ConsistencyCheckError,0.57,5,1,5,0,5,3,0,4,121,1
"org.apache.jackrabbit.core.query.lucene.ConsistencyCheck$NodeDeleted",3,0.00,1.00,8,0.06,546.87,3,0,15,3,2,181.85,8,12,0,2,141.97,0.00,0.50,0.00,0,4.00,1,172.60,0,0,2,org.apache.jackrabbit.core.query.lucene.ConsistencyCheckError,0.57,0,1,3,0,0,3,0,2,50,1
"org.apache.jackrabbit.core.query.lucene.ConsistencyCheck$UnknownParent",3,0.00,1.00,7,0.06,591.07,3,0,15,3,2,181.59,7,11,0,2,141.70,0.00,0.50,0.00,0,4.00,1,174.04,0,0,2,org.apache.jackrabbit.core.query.lucene.ConsistencyCheckError,0.57,0,1,3,0,0,3,0,2,50,1
"org.apache.jackrabbit.core.query.lucene.ConsistencyCheckError",4,0.50,1.00,10,0.06,584.03,6,2,2,4,7,124.85,21,13,6,1,142.73,0.00,0.00,0.12,0,6.00,1,176.34,0,1,1,java.lang.Object,0.00,0,0,4,4,0,3,0,6,55,1
"org.apache.jackrabbit.core.query.lucene.DateField",5,0.12,1.80,34,0.43,14324.50,9,4,1,15,3,72.32,38,44,3,1,114.61,0.00,0.00,0.15,2,7.00,5,1290.31,0,3,0,java.lang.Object,0.00,10,0,9,0,10,2,0,11,275,1
"org.apache.jackrabbit.core.query.lucene.DecimalConvertTest",3,0.00,4.00,75,0.99,51696.59,3,0,6,23,3,105.79,11,74,1,3,85.17,0.00,0.67,0.00,1,3.00,6,2979.81,0,0,2,org.apache.jackrabbit.test.JUnitTest,0.00,20,2,12,0,20,3,0,9,561,1
"org.apache.jackrabbit.core.query.lucene.DecimalField",4,0.00,3.50,52,0.80,51157.70,4,0,2,23,4,59.26,49,65,4,1,96.82,0.00,0.00,0.00,2,4.00,7,2411.17,0,4,0,java.lang.Object,0.00,19,0,14,0,19,0,0,8,452,1
"org.apache.jackrabbit.core.query.lucene.DefaultHTMLExcerpt",1,0.00,1.00,3,0.06,906.92,1,0,2,2,3,100.53,13,10,1,2,129.91,0.00,0.50,0.00,0,1.00,1,181.93,0,1,2,org.apache.jackrabbit.core.query.lucene.AbstractExcerpt,0.00,1,1,1,0,1,0,0,2,41,1
"org.apache.jackrabbit.core.query.lucene.DefaultHighlighter",6,0.00,7.67,194,3.10,617075.01,14,8,12,52,5,45.54,82,265,4,1,74.92,0.00,0.00,0.12,3,10.00,35,9302.76,0,5,1,java.lang.Object,0.00,46,0,46,1,46,1,0,24,1473,1
"org.apache.jackrabbit.core.query.lucene.DefaultHighlighter$FragmentInfo",7,0.27,1.43,35,0.28,5012.68,12,5,12,14,0,122.36,0,46,0,1,122.36,0.00,0.00,0.43,0,0.00,3,842.82,0,1,0,java.lang.Object,0.00,7,0,10,0,7,6,0,0,200,2
"org.apache.jackrabbit.core.query.lucene.DefaultHighlighter$FragmentInfoPositionSorter",2,0.00,2.00,9,0.10,3308.36,2,0,12,3,0,123.04,0,14,0,1,123.04,0.00,0.00,0.00,0,2.00,3,299.01,0,0,0,java.lang.Object,0.00,1,0,4,0,1,2,1,0,71,2
"org.apache.jackrabbit.core.query.lucene.DefaultHighlighter$FragmentInfoScoreSorter",2,0.00,2.50,9,0.13,6309.90,2,0,12,4,0,120.78,0,14,0,1,120.78,0.00,0.00,0.00,0,2.00,4,390.19,0,0,0,java.lang.Object,0.00,2,0,5,0,2,2,1,0,90,2
"org.apache.jackrabbit.core.query.lucene.DefaultHighlighter$TermVectorOffsetInfoSorter",2,0.00,2.00,9,0.10,3308.36,2,0,12,3,0,123.04,0,14,0,1,123.04,0.00,0.00,0.00,0,2.00,3,299.01,0,0,0,java.lang.Object,0.00,1,0,4,0,1,2,1,0,71,2
"org.apache.jackrabbit.core.query.lucene.DefaultQueryHits",3,0.25,1.33,13,0.09,1391.20,5,2,3,7,2,85.19,22,18,0,2,127.48,0.00,0.50,0.33,0,5.00,2,284.65,0,0,2,org.apache.jackrabbit.core.query.lucene.AbstractQueryHits,0.33,4,1,4,0,4,3,0,6,77,1
"org.apache.jackrabbit.core.query.lucene.DefaultXMLExcerpt",1,0.00,1.00,3,0.05,775.69,1,0,2,2,2,120.09,15,10,0,2,130.45,0.00,0.50,0.00,0,1.00,1,142.89,0,1,2,org.apache.jackrabbit.core.query.lucene.AbstractExcerpt,0.00,1,1,1,0,1,0,0,2,35,1
"org.apache.jackrabbit.core.query.lucene.DerefQuery",5,0.00,1.20,27,0.24,3851.29,12,7,17,8,6,84.59,64,35,3,2,122.15,0.00,0.50,0.14,0,8.00,2,718.08,0,3,3,org.apache.lucene.search.Query,0.00,3,1,6,0,3,2,0,18,169,0
"org.apache.jackrabbit.core.query.lucene.DerefQuery$DerefScorer",7,0.04,2.29,56,0.65,31934.02,11,4,17,30,1,76.09,43,66,0,2,108.31,0.00,0.50,0.29,1,7.00,10,1951.66,0,1,1,org.apache.lucene.search.Scorer,0.00,23,1,16,0,23,6,0,17,368,1
"org.apache.jackrabbit.core.query.lucene.DerefQuery$DerefScorer$HitCollector",1,0.00,1.00,3,0.02,168.11,1,0,17,1,0,135.68,0,4,0,1,135.68,0.00,0.00,0.00,0,0.00,1,63.51,0,0,0,java.lang.Object,0.00,0,0,1,0,0,1,0,0,19,0
"org.apache.jackrabbit.core.query.lucene.DerefQuery$DerefScorer$HitCollector_0",1,0.00,1.00,3,0.02,168.11,1,0,17,2,0,135.68,0,4,0,1,135.68,0.00,0.00,0.00,0,1.00,1,63.51,0,0,0,java.lang.Object,0.00,1,0,1,0,1,1,0,0,19,0
"org.apache.jackrabbit.core.query.lucene.DerefQuery$DerefWeight",7,1.00,1.14,18,0.17,3015.11,8,1,17,13,2,139.23,33,27,0,1,139.00,0.00,0.00,0.14,0,12.00,2,510.33,0,3,2,java.lang.Object,0.00,6,0,8,0,6,4,1,8,129,1
"org.apache.jackrabbit.core.query.lucene.DescendantSelfAxisQuery",12,0.02,1.83,82,0.92,39701.37,18,6,21,41,15,64.12,119,104,5,2,114.12,0.00,0.50,0.15,1,28.00,7,2769.92,0,4,10,org.apache.lucene.search.Query,0.00,29,1,22,0,29,8,1,31,554,0
"org.apache.jackrabbit.core.query.lucene.DescendantSelfAxisQuery$AbstractQueryHits",3,0.00,3.00,26,0.24,6895.92,5,2,21,12,4,110.59,1,39,0,1,110.59,0.00,0.00,0.50,1,0.00,4,727.23,0,1,4,java.lang.Object,0.00,9,0,9,0,9,2,0,1,157,0
"org.apache.jackrabbit.core.query.lucene.DescendantSelfAxisQuery$DescendantSelfAxisScorer",9,0.00,3.11,92,1.06,84918.01,15,6,21,22,2,54.03,73,118,0,2,102.14,0.00,0.50,0.17,2,18.00,11,3191.73,0,1,2,org.apache.lucene.search.Scorer,0.00,13,1,28,0,13,8,0,28,640,1
"org.apache.jackrabbit.core.query.lucene.DescendantSelfAxisQuery$DescendantSelfAxisScorer$HitCollector",1,0.00,1.00,3,0.02,168.11,1,0,21,1,0,135.68,0,4,0,1,135.68,0.00,0.00,0.00,0,0.00,1,63.51,0,0,0,java.lang.Object,0.00,0,0,1,0,0,1,0,0,19,0
"org.apache.jackrabbit.core.query.lucene.DescendantSelfAxisQuery$DescendantSelfAxisWeight",7,1.00,1.00,18,0.16,2655.34,8,1,21,11,2,139.70,34,26,0,1,139.46,0.00,0.00,0.14,0,12.00,1,484.57,0,3,2,java.lang.Object,0.00,4,0,7,0,4,4,1,9,126,1
"org.apache.jackrabbit.core.query.lucene.DocId",7,1.00,1.00,18,0.17,3268.55,8,1,3,12,14,90.27,74,24,12,1,138.75,0.00,0.00,0.00,1,7.00,1,502.19,0,5,2,java.lang.Object,0.00,5,0,7,4,5,2,0,13,134,1
"org.apache.jackrabbit.core.query.lucene.DocId$DocId",3,0.00,1.00,7,0.04,353.76,3,0,3,3,2,125.58,16,11,0,1,143.46,0.00,0.00,0.00,0,4.00,1,124.63,0,1,2,java.lang.Object,0.00,0,0,3,0,0,2,0,3,38,0
"org.apache.jackrabbit.core.query.lucene.DocId$MultiUUIDDocId",5,0.50,1.60,34,0.33,11075.93,6,1,3,12,3,97.65,27,35,0,2,115.52,0.00,0.50,0.60,0,2.00,2,981.43,0,2,3,org.apache.jackrabbit.core.query.lucene.DocId,0.33,7,1,8,0,7,3,0,6,219,3
"org.apache.jackrabbit.core.query.lucene.DocId$PlainDocId",5,0.25,1.20,16,0.13,2202.37,6,1,3,7,2,132.58,22,23,0,2,132.34,0.00,0.50,0.80,0,0.00,2,380.78,0,2,2,org.apache.jackrabbit.core.query.lucene.DocId,0.33,2,1,6,0,2,3,0,6,101,3
"org.apache.jackrabbit.core.query.lucene.DocId$UUIDDocId",5,0.00,1.80,28,0.27,9177.86,8,3,3,10,4,76.80,35,39,0,2,119.09,0.00,0.50,0.33,0,7.00,5,802.71,0,2,4,org.apache.jackrabbit.core.query.lucene.DocId,0.33,5,1,9,0,5,3,0,9,182,3
"org.apache.jackrabbit.core.query.lucene.DocNumberCache",4,0.33,4.25,71,0.97,56044.36,12,8,4,24,6,71.97,58,87,5,1,92.12,0.00,0.00,0.38,0,0.00,7,2900.80,0,0,2,java.lang.Object,0.00,20,0,17,0,20,4,0,19,522,1
"org.apache.jackrabbit.core.query.lucene.DocNumberCache$Entry",1,2.00,1.00,6,0.04,467.31,3,2,4,1,0,88.73,6,8,0,1,120.95,0.00,0.00,0.00,0,1.00,1,121.08,0,0,0,java.lang.Object,0.00,0,0,1,0,0,1,0,2,35,3
"org.apache.jackrabbit.core.query.lucene.DocOrderScoreNodeIterator",9,0.02,1.78,55,0.61,29517.57,14,5,12,29,7,81.93,61,72,1,1,114.15,0.00,0.00,0.22,2,0.00,7,1842.58,0,1,6,java.lang.Object,0.00,20,0,16,0,20,8,1,20,374,0
"org.apache.jackrabbit.core.query.lucene.DocOrderScoreNodeIterator$Comparator",1,0.00,14.00,59,0.92,110949.37,1,0,12,13,2,64.14,16,70,0,1,64.61,0.00,0.00,0.00,0,0.00,14,2756.45,0,0,2,java.lang.Object,0.00,12,0,14,0,12,1,0,16,440,0
"org.apache.jackrabbit.core.query.lucene.DocOrderScoreNodeIterator$SortFailedException",0,0.00,0.00,1,0.01,72.00,0,0,12,0,0,171.00,0,2,0,2,171.00,0.00,0.50,0.00,0,0.00,0,24.00,0,0,0,java.lang.RuntimeException,0.00,0,1,0,0,0,0,0,0,8,3
"org.apache.jackrabbit.core.query.lucene.DoubleField",3,0.25,2.67,30,0.44,23224.30,5,2,0,14,3,103.08,13,39,3,1,102.85,0.00,0.00,0.33,0,4.00,4,1306.56,0,1,0,java.lang.Object,0.00,11,0,8,0,11,2,0,9,257,1
"org.apache.jackrabbit.core.query.lucene.DynamicPooledExecutor",4,0.44,4.50,72,0.70,48059.15,7,3,4,23,1,47.58,44,83,1,1,91.70,0.00,0.00,0.67,1,0.00,11,2107.96,0,0,0,java.lang.Object,0.00,19,0,18,0,19,4,0,15,398,1
"org.apache.jackrabbit.core.query.lucene.DynamicPooledExecutor$Callable",1,0.00,1.00,3,0.02,208.76,1,0,4,2,0,134.94,0,4,0,1,134.94,0.00,0.00,0.00,0,1.00,1,52.97,0,1,0,java.lang.Object,0.00,1,0,1,0,1,0,0,0,17,0
"org.apache.jackrabbit.core.query.lucene.DynamicPooledExecutor$Command",1,0.00,1.00,2,0.01,38.26,1,0,4,1,0,167.92,3,3,0,1,147.31,0.00,0.00,0.00,0,1.00,1,25.51,0,1,0,,0.00,0,0,1,0,0,0,0,1,11,1
"org.apache.jackrabbit.core.query.lucene.DynamicPooledExecutor$Result",3,0.25,1.00,10,0.06,727.65,5,2,4,3,0,134.66,14,14,0,1,134.42,0.00,0.00,0.33,0,5.00,1,180.64,0,2,0,java.lang.Object,0.00,0,0,3,0,0,1,0,4,53,2
"org.apache.jackrabbit.core.query.lucene.EmptyTermDocs",9,1.00,1.00,16,0.09,1099.40,10,1,3,10,3,154.57,6,26,3,1,154.57,0.00,0.00,0.00,0,9.00,1,280.83,0,0,0,java.lang.Object,0.00,1,0,9,0,1,9,1,2,89,0
"org.apache.jackrabbit.core.query.lucene.ExcerptProvider",2,1.00,1.00,4,0.05,442.93,3,1,5,4,9,103.74,25,7,6,1,141.30,0.00,0.00,0.00,0,2.00,1,156.78,0,1,4,,0.00,2,0,2,0,2,1,0,4,43,1
"org.apache.jackrabbit.core.query.lucene.FieldNames",4,15.00,1.00,23,0.40,9147.10,19,15,0,7,46,162.42,90,28,45,1,118.47,0.00,0.00,0.00,0,4.00,1,1195.37,0,2,1,java.lang.Object,0.00,3,0,4,0,3,2,0,20,240,1
"org.apache.jackrabbit.core.query.lucene.FieldSelectors",1,0.00,1.00,6,0.04,827.95,1,0,2,3,8,86.77,6,8,8,1,118.99,0.00,0.00,0.00,0,1.00,1,111.61,0,0,0,java.lang.Object,0.00,2,0,1,0,2,1,0,2,32,1
"org.apache.jackrabbit.core.query.lucene.FieldSelectors$FieldSelector",1,0.00,2.00,6,0.04,694.86,1,0,2,1,1,87.21,6,8,0,1,119.43,0.00,0.00,0.00,0,1.00,2,118.36,0,1,1,java.lang.Object,0.00,0,0,2,0,0,0,0,1,31,0
"org.apache.jackrabbit.core.query.lucene.FieldSelectors$FieldSelector_0",1,0.00,3.00,8,0.06,1379.74,1,0,2,1,1,80.11,6,10,0,1,112.33,0.00,0.00,0.00,0,1.00,3,178.97,0,1,1,java.lang.Object,0.00,0,0,3,0,0,0,0,1,45,0
"org.apache.jackrabbit.core.query.lucene.FileBasedNamespaceMappings",5,0.40,2.40,55,0.71,27582.85,10,5,15,29,4,73.11,66,73,1,2,102.49,0.00,0.50,0.52,2,0.00,4,2117.16,0,2,3,org.apache.jackrabbit.core.query.lucene.AbstractNamespaceMappings,0.00,24,1,12,0,24,3,0,16,415,1
"org.apache.jackrabbit.core.query.lucene.FilterMultiColumnQuery",2,3.00,1.50,12,0.14,3300.22,5,3,5,6,8,72.42,23,20,1,1,116.54,0.00,0.00,0.00,0,2.00,2,414.03,0,0,7,java.lang.Object,0.00,4,0,3,0,4,2,1,6,95,1
"org.apache.jackrabbit.core.query.lucene.FilterMultiColumnQuery$FilterMultiColumnQueryHits",3,0.00,2.00,16,0.18,4675.65,3,0,5,5,1,119.63,0,25,0,1,119.63,0.00,0.00,0.00,1,4.00,3,536.01,1,1,1,java.lang.Object,0.00,2,0,6,0,2,2,0,0,120,0
"org.apache.jackrabbit.core.query.lucene.FilterMultiColumnQueryHits",6,0.20,1.00,14,0.10,1306.45,7,1,2,11,6,141.60,29,21,3,1,141.36,0.00,0.00,0.83,0,0.00,1,298.29,0,2,3,java.lang.Object,0.00,5,0,6,1,5,4,1,8,88,1
"org.apache.jackrabbit.core.query.lucene.ForeignSegmentDocId",6,0.27,1.33,25,0.19,4603.75,9,3,2,7,6,83.47,45,34,5,2,125.76,0.00,0.50,0.11,0,18.00,3,564.51,0,1,2,org.apache.jackrabbit.core.query.lucene.DocId,0.31,1,1,8,0,1,5,0,10,140,1
"org.apache.jackrabbit.core.query.lucene.HierarchyResolver",1,0.00,1.00,2,0.02,121.51,1,0,1,1,18,176.74,20,3,18,1,143.36,0.00,0.00,0.00,0,1.00,1,48.04,0,0,0,,0.00,0,0,1,0,0,1,0,2,17,1
"org.apache.jackrabbit.core.query.lucene.HighlightingExcerptProvider",1,0.00,1.00,2,0.01,78.30,1,0,1,1,2,107.30,12,3,2,2,144.86,0.00,0.50,0.00,0,1.00,1,40.55,0,1,0,,0.00,0,1,1,0,0,0,0,2,15,1
"org.apache.jackrabbit.core.query.lucene.IndexFormatVersion",5,0.25,1.40,21,0.23,5345.91,9,4,2,11,17,80.48,55,29,16,1,124.61,0.00,0.00,0.05,1,8.00,3,689.22,0,2,1,java.lang.Object,0.00,6,0,7,0,6,3,0,10,162,1
"org.apache.jackrabbit.core.query.lucene.IndexInfos",12,0.22,1.42,66,0.63,16266.16,17,5,12,38,3,87.96,82,82,1,1,120.18,0.00,0.00,0.40,1,0.00,4,1896.16,0,3,2,java.lang.Object,0.00,26,0,17,0,26,9,0,20,412,0
"org.apache.jackrabbit.core.query.lucene.IndexListener",1,0.00,1.00,2,0.01,30.51,1,0,1,1,3,99.60,10,3,3,1,148.08,0.00,0.00,0.00,0,1.00,1,25.51,0,0,0,,0.00,0,0,1,0,0,1,0,2,11,1
"org.apache.jackrabbit.core.query.lucene.IndexMerger",9,0.14,4.00,158,2.15,141133.64,21,12,14,60,5,62.36,122,190,1,2,91.75,0.00,0.50,0.20,0,15.00,13,6450.27,0,0,5,java.lang.Thread,0.00,51,1,36,0,51,9,1,59,1080,0
"org.apache.jackrabbit.core.query.lucene.IndexMerger$Index",3,0.25,2.00,15,0.15,5434.41,5,2,14,4,0,71.01,24,20,0,1,119.11,0.00,0.00,0.67,0,1.00,4,449.18,0,1,0,java.lang.Object,0.00,1,0,6,0,1,2,1,5,108,3
"org.apache.jackrabbit.core.query.lucene.IndexMerger$IndexBucket",3,0.00,1.00,12,0.09,1247.41,6,3,14,3,0,77.92,28,16,0,2,127.92,0.00,0.50,0.33,0,5.00,1,270.94,0,0,0,java.util.ArrayList,0.00,0,1,3,0,0,3,0,6,75,3
"org.apache.jackrabbit.core.query.lucene.IndexMerger$Merge",1,1.00,1.00,5,0.05,1051.93,2,1,14,2,0,88.91,6,7,0,1,121.13,0.00,0.00,0.00,0,1.00,1,164.30,0,0,0,java.lang.Object,0.00,1,0,1,0,1,1,0,1,44,3
"org.apache.jackrabbit.core.query.lucene.IndexMigration",1,0.00,5.00,39,0.63,37176.91,2,1,16,31,6,116.77,29,60,1,1,75.29,0.00,0.00,1.00,0,0.00,5,1887.19,0,0,6,java.lang.Object,0.00,30,0,5,0,30,1,0,10,309,1
"org.apache.jackrabbit.core.query.lucene.IndexMigration$MigrationIndexReader",4,0.00,1.50,22,0.27,8698.64,4,0,16,14,1,118.55,0,29,0,2,118.55,0.00,0.50,0.00,0,4.00,3,820.96,1,3,1,org.apache.lucene.index.FilterIndexReader,0.00,10,1,6,0,10,1,0,0,171,2
"org.apache.jackrabbit.core.query.lucene.IndexMigration$MigrationIndexReader$MigrationTermEnum",3,0.00,1.67,14,0.12,2485.36,3,0,16,8,1,125.44,0,20,0,2,125.44,0.00,0.50,0.00,0,3.00,3,347.93,1,2,1,FilterTermEnum,0.00,5,1,5,0,5,1,0,0,84,2
"org.apache.jackrabbit.core.query.lucene.IndexMigration$MigrationIndexReader$MigrationTermPositions",3,0.00,1.67,15,0.17,4359.35,3,0,16,11,1,119.91,0,21,0,2,119.91,0.00,0.50,0.00,0,3.00,2,523.06,1,0,1,FilterTermPositions,0.00,8,1,5,0,8,3,0,0,120,2
"org.apache.jackrabbit.core.query.lucene.IndexingConfiguration",8,1.00,1.00,10,0.07,296.14,9,1,5,8,9,108.65,79,11,4,1,158.65,0.00,0.00,0.00,0,8.00,1,216.52,0,2,5,,0.00,0,0,8,0,0,6,0,10,72,1
"org.apache.jackrabbit.core.query.lucene.IndexingConfigurationEntityResolver",1,0.00,3.00,15,0.15,3446.32,2,1,8,5,1,50.54,10,27,1,1,99.02,0.00,0.00,1.00,0,0.00,3,464.66,0,1,0,java.lang.Object,0.00,4,0,3,0,4,0,1,3,105,1
"org.apache.jackrabbit.core.query.lucene.IndexingConfigurationImpl",13,0.01,4.77,227,3.61,219641.07,21,8,44,94,31,47.32,155,293,1,1,91.45,0.00,0.00,0.12,3,73.00,16,10838.68,0,4,30,java.lang.Object,0.00,81,0,62,0,81,9,1,41,1790,1
"org.apache.jackrabbit.core.query.lucene.IndexingConfigurationImpl$IndexingRule",12,0.07,1.92,73,0.68,13540.55,17,5,44,28,5,69.68,105,95,0,1,117.79,0.00,0.00,0.13,1,64.00,5,2036.79,0,2,5,java.lang.Object,0.00,16,0,23,0,16,10,0,20,460,1
"org.apache.jackrabbit.core.query.lucene.IndexingConfigurationImpl$NamePattern",3,0.25,1.33,16,0.20,4749.51,5,2,44,10,5,69.67,27,24,0,1,119.67,0.00,0.00,0.33,0,5.00,2,587.29,0,0,5,java.lang.Object,0.00,7,0,4,0,7,3,0,6,127,3
"org.apache.jackrabbit.core.query.lucene.IndexingConfigurationImpl$PathExpression",2,0.78,8.50,55,0.75,47245.27,11,9,44,16,6,40.38,14,75,0,1,82.68,0.00,0.00,0.50,0,2.00,16,2253.71,0,0,6,java.lang.Object,0.00,14,0,17,0,14,2,0,6,398,1
"org.apache.jackrabbit.core.query.lucene.IndexingConfigurationImpl$PathExpression$AbstractIteratorDecorator",1,0.00,2.00,8,0.10,2622.23,1,0,44,4,2,110.23,0,13,0,1,110.23,0.00,0.00,0.00,0,0.00,2,299.27,1,1,2,java.lang.Object,0.00,3,0,2,0,3,0,0,0,67,0
"org.apache.jackrabbit.core.query.lucene.IndexingConfigurationImpl$PathExpression$Iterator",3,0.50,1.67,15,0.12,3421.16,4,1,44,6,2,120.74,0,22,0,1,120.74,0.00,0.00,0.67,0,1.00,3,372.96,0,1,2,java.lang.Object,0.00,3,0,5,0,3,2,0,0,92,0
"org.apache.jackrabbit.core.query.lucene.IndexingConfigurationImpl$PropertyConfig",1,3.00,1.00,8,0.05,744.82,4,3,44,1,0,70.57,11,12,0,1,114.70,0.00,0.00,0.00,0,1.00,1,162.52,0,0,0,java.lang.Object,0.00,0,0,1,0,0,1,0,3,46,1
"org.apache.jackrabbit.core.query.lucene.IndexingQueue",8,0.25,2.38,71,0.93,30804.13,12,4,14,44,12,60.77,68,99,5,1,108.88,0.00,0.00,0.47,1,0.00,6,2798.49,0,3,8,java.lang.Object,0.00,36,0,19,0,36,5,0,19,533,0
"org.apache.jackrabbit.core.query.lucene.IndexingQueueStore",6,0.23,2.33,43,0.55,17709.54,13,7,10,25,3,61.96,59,61,2,1,111.96,0.00,0.00,0.33,1,0.00,6,1638.01,0,1,1,java.lang.Object,0.00,19,0,14,0,19,5,0,17,328,0
"org.apache.jackrabbit.core.query.lucene.IndexingQueueTest",4,0.22,2.75,88,1.35,52047.38,7,3,17,39,8,88.53,18,99,1,6,88.29,0.00,0.83,0.50,2,0.00,4,4040.47,1,0,7,org.apache.jackrabbit.core.query.AbstractIndexingTest,0.00,35,5,11,0,35,4,0,14,669,1
"org.apache.jackrabbit.core.query.lucene.IndexingQueueTest$Extractor",2,1.00,1.50,9,0.10,1781.49,3,1,17,5,1,125.22,0,15,0,1,125.22,0.00,0.00,0.50,0,2.00,2,286.07,0,2,1,java.lang.Object,0.00,3,0,3,0,3,0,1,0,68,3
"org.apache.jackrabbit.core.query.lucene.IndexingQueueTest$FilenameFilter",1,0.00,1.00,3,0.02,217.60,1,0,17,2,0,134.79,0,4,0,1,134.79,0.00,0.00,0.00,0,1.00,1,68.92,0,0,0,java.lang.Object,0.00,1,0,1,0,1,1,0,0,20,0
"org.apache.jackrabbit.core.query.lucene.IndexingQueueTest$Runnable",1,0.00,2.00,5,0.04,625.59,1,0,17,3,0,122.75,0,8,0,1,122.75,0.00,0.00,0.00,0,1.00,2,118.45,0,0,0,java.lang.Object,0.00,2,0,2,0,2,1,0,0,30,0
"org.apache.jackrabbit.core.query.lucene.JackrabbitAnalyzer",3,0.00,1.67,13,0.13,2601.73,5,2,4,6,4,75.29,27,19,3,2,125.29,0.00,0.50,0.50,0,1.00,3,381.66,0,1,1,org.apache.lucene.analysis.Analyzer,0.00,3,1,5,0,3,2,0,6,94,1
"org.apache.jackrabbit.core.query.lucene.JackrabbitIndexReader",7,0.08,1.29,23,0.22,4396.84,9,2,4,13,5,98.89,47,35,1,2,131.11,0.00,0.50,0.43,0,0.00,3,647.64,0,2,4,org.apache.lucene.index.FilterIndexReader,0.00,6,1,9,0,6,5,2,13,165,2
"org.apache.jackrabbit.core.query.lucene.JackrabbitIndexSearcher",6,0.13,1.50,28,0.31,7902.73,9,3,9,13,19,75.78,53,49,11,2,123.88,0.00,0.50,0.22,1,14.00,4,923.69,0,2,10,org.apache.lucene.search.IndexSearcher,0.00,7,1,9,0,7,4,1,11,207,1
"org.apache.jackrabbit.core.query.lucene.JackrabbitQuery",1,0.00,1.00,2,0.02,108.21,1,0,4,1,7,191.02,23,6,5,1,143.75,0.00,0.00,0.00,0,1.00,1,56.11,0,0,3,,0.00,0,0,1,0,0,1,0,2,17,1
"org.apache.jackrabbit.core.query.lucene.JackrabbitQueryParser",7,1.00,4.14,95,1.11,69783.36,8,1,7,30,5,55.34,50,119,2,2,97.63,0.00,0.50,0.14,3,12.00,10,3339.77,2,6,3,org.apache.lucene.queryParser.QueryParser,0.00,23,1,29,0,23,1,0,15,646,1
"org.apache.jackrabbit.core.query.lucene.JackrabbitTermQuery",2,1.00,1.00,7,0.06,950.69,3,1,9,3,8,152.74,7,10,8,2,132.12,0.00,0.50,0.00,0,2.00,1,193.97,1,1,0,org.apache.lucene.search.TermQuery,0.00,1,1,2,0,1,1,0,2,51,1
"org.apache.jackrabbit.core.query.lucene.JackrabbitTermQuery$JackrabbitTermWeight",7,0.17,1.00,18,0.15,1923.03,9,2,9,12,2,161.18,21,27,0,2,140.57,0.00,0.50,0.36,0,0.00,1,447.93,0,3,2,org.apache.jackrabbit.core.query.lucene.AbstractWeight,0.00,5,1,7,0,5,4,0,7,122,1
"org.apache.jackrabbit.core.query.lucene.JackrabbitTextExtractor",3,0.67,3.67,31,0.49,16827.60,6,3,13,21,5,151.70,82,48,1,1,103.88,0.00,0.00,0.78,0,0.00,8,1459.04,0,2,4,java.lang.Object,0.00,18,0,11,0,18,1,1,9,278,1
"org.apache.jackrabbit.core.query.lucene.JoinQuery",2,0.67,1.00,18,0.22,4259.46,8,6,7,5,10,118.33,34,31,1,1,109.19,0.00,0.00,0.50,0,2.00,1,671.79,0,0,9,java.lang.Object,0.00,3,0,2,0,3,2,1,9,149,1
"org.apache.jackrabbit.core.query.lucene.LazyTextExtractorField",7,0.08,1.86,33,0.39,10981.54,11,4,8,17,3,80.94,52,54,2,2,123.24,0.00,0.50,0.18,0,10.00,4,1169.04,0,3,1,org.apache.lucene.document.AbstractField,0.00,10,1,13,0,10,4,0,12,250,1
"org.apache.jackrabbit.core.query.lucene.LengthSortComparator",2,0.50,1.50,11,0.13,2501.28,4,2,8,7,7,72.34,17,19,2,1,120.44,0.00,0.00,0.25,0,2.00,2,396.61,0,1,5,java.lang.Object,0.00,5,0,3,0,5,1,1,3,88,1
"org.apache.jackrabbit.core.query.lucene.LengthSortComparator$Comparator",2,0.00,1.50,15,0.21,5473.36,3,1,8,7,4,162.32,3,19,0,2,112.32,0.00,0.50,1.00,0,0.00,2,630.48,1,1,4,org.apache.jackrabbit.core.query.lucene.AbstractScoreDocComparator,0.00,5,1,3,0,5,1,0,1,130,2
"org.apache.jackrabbit.core.query.lucene.LocalNameQuery",4,0.17,1.25,14,0.13,2196.73,6,2,5,9,3,99.35,25,20,0,2,131.58,0.00,0.50,0.38,0,4.00,2,403.93,0,2,3,org.apache.lucene.search.Query,0.00,5,1,5,0,5,2,0,7,100,1
"org.apache.jackrabbit.core.query.lucene.LocalNameRangeQuery",3,0.00,1.67,17,0.14,3618.12,3,0,1,4,2,72.44,24,25,0,3,120.54,0.00,0.67,0.00,1,3.00,2,405.77,0,2,2,org.apache.jackrabbit.core.query.lucene.RangeQuery,0.00,1,2,5,0,1,1,0,4,98,1
"org.apache.jackrabbit.core.query.lucene.LongField",3,1.00,2.67,28,0.37,21108.14,4,1,0,12,4,105.12,14,38,4,1,104.88,0.00,0.00,0.33,0,4.00,4,1112.35,0,1,0,java.lang.Object,0.00,9,0,8,0,9,2,0,13,226,1
"org.apache.jackrabbit.core.query.lucene.LowerCaseSortComparator",2,0.50,1.00,8,0.08,1259.07,4,2,6,4,1,84.21,15,13,1,1,126.50,0.00,0.00,0.25,0,2.00,1,248.32,0,1,0,java.lang.Object,0.00,2,0,2,0,2,1,1,4,63,1
"org.apache.jackrabbit.core.query.lucene.LowerCaseSortComparator$Comparator",4,1.00,1.25,14,0.12,2154.60,5,1,6,8,1,131.64,3,20,0,1,131.64,0.00,0.00,0.25,1,6.00,2,346.90,0,1,1,java.lang.Object,0.00,4,0,5,0,4,3,1,1,92,3
"org.apache.jackrabbit.core.query.lucene.LuceneQueryBuilder",18,0.08,8.39,561,10.49,1559638.83,30,12,57,146,60,31.87,212,730,2,1,76.00,0.00,0.00,0.16,0,62.00,56,31483.40,0,17,58,java.lang.Object,0.00,128,0,151,0,128,1,1,126,4738,1
"org.apache.jackrabbit.core.query.lucene.LuceneQueryBuilder$DefaultQueryNodeVisitor",1,0.00,3.00,7,0.09,2263.54,1,0,57,3,2,112.81,0,9,0,1,112.81,0.00,0.00,0.00,0,1.00,3,260.17,0,1,2,java.lang.Object,0.00,2,0,3,0,2,0,0,0,59,0
"org.apache.jackrabbit.core.query.lucene.LuceneQueryFactory",5,0.00,1.00,6,0.05,297.29,5,0,7,5,13,114.74,39,7,7,1,157.03,0.00,0.00,0.00,0,5.00,1,150.65,0,3,6,,0.00,0,0,5,0,0,2,0,6,49,1
"org.apache.jackrabbit.core.query.lucene.LuceneQueryFactoryImpl",6,0.10,3.17,90,1.39,68277.47,14,8,30,56,24,46.45,62,125,1,1,94.92,0.00,0.00,0.21,1,14.00,9,4170.52,0,5,23,java.lang.Object,0.00,50,0,19,0,50,1,1,24,734,1
"org.apache.jackrabbit.core.query.lucene.LuceneQueryFactoryImpl$DefaultQOMTreeVisitor",2,0.00,1.00,5,0.06,686.72,2,0,30,5,3,139.80,0,8,0,1,139.80,0.00,0.00,0.00,0,2.00,1,165.31,0,2,3,java.lang.Object,0.00,3,0,2,0,3,0,0,0,44,0
"org.apache.jackrabbit.core.query.lucene.LuceneQueryHits",5,0.25,1.60,21,0.23,4542.86,7,2,7,16,6,125.37,24,33,1,1,125.14,0.00,0.00,0.30,1,7.00,3,704.32,0,0,5,java.lang.Object,0.00,11,0,8,0,11,5,1,8,163,1
"org.apache.jackrabbit.core.query.lucene.MatchAllDocsQuery",1,0.00,3.00,8,0.11,2371.32,1,0,4,5,9,68.19,7,18,3,2,110.48,0.00,0.50,0.00,0,1.00,3,326.99,0,1,6,org.apache.lucene.search.MatchAllDocsQuery,0.00,4,1,3,0,4,0,1,2,69,1
"org.apache.jackrabbit.core.query.lucene.MatchAllQuery",4,1.00,1.25,11,0.09,1304.15,5,1,4,7,2,107.71,26,17,1,2,139.93,0.00,0.50,0.25,0,6.00,2,260.16,0,2,1,org.apache.lucene.search.Query,0.00,3,1,5,0,3,2,0,5,71,0
"org.apache.jackrabbit.core.query.lucene.MatchAllScorer",8,0.03,1.62,50,0.63,25092.18,13,5,12,31,4,72.04,58,74,2,2,114.33,0.00,0.50,0.22,3,24.00,5,1880.22,0,1,2,org.apache.lucene.search.Scorer,0.00,23,1,13,0,23,7,0,19,377,0
"org.apache.jackrabbit.core.query.lucene.MatchAllWeight",7,0.03,1.00,25,0.23,3450.88,12,5,7,14,3,89.71,49,34,1,2,132.00,0.00,0.50,0.23,0,24.00,1,685.25,0,3,2,org.apache.jackrabbit.core.query.lucene.AbstractWeight,0.00,7,1,7,0,7,4,0,18,174,0
"org.apache.jackrabbit.core.query.lucene.MoreLikeThis",39,0.00,1.82,249,3.02,133599.69,61,22,28,88,2,69.87,429,309,1,1,114.00,0.00,0.00,0.05,6,698.00,8,9069.54,0,16,1,java.lang.Object,0.00,49,0,71,0,49,23,0,88,1772,2
"org.apache.jackrabbit.core.query.lucene.MoreLikeThis$FreqQ",2,0.00,1.00,9,0.10,2686.20,2,0,28,4,0,123.91,0,12,0,2,123.91,0.00,0.50,0.00,0,2.00,1,293.69,0,0,0,org.apache.lucene.util.PriorityQueue,0.00,2,1,2,0,2,2,0,0,73,2
"org.apache.jackrabbit.core.query.lucene.MoreLikeThis$Int",1,0.00,1.00,4,0.02,114.30,2,1,28,1,0,132.34,0,6,0,1,132.34,0.00,0.00,1.00,0,0.00,1,49.65,0,0,0,java.lang.Object,0.00,0,0,1,0,0,1,0,0,17,2
"org.apache.jackrabbit.core.query.lucene.MultiColumnQuery",1,0.00,1.00,2,0.02,145.26,1,0,1,1,11,113.36,13,6,8,1,142.74,0.00,0.00,0.00,0,1.00,1,61.30,0,0,3,,0.00,0,0,1,0,0,1,0,2,18,1
"org.apache.jackrabbit.core.query.lucene.MultiColumnQueryAdapter",3,0.25,1.33,16,0.18,4587.82,5,2,5,7,7,71.68,26,21,2,1,119.78,0.00,0.00,0.33,0,4.00,2,528.03,0,1,5,java.lang.Object,0.00,4,0,4,0,4,2,1,6,120,1
"org.apache.jackrabbit.core.query.lucene.MultiColumnQueryHits",2,0.00,1.00,3,0.02,92.91,2,0,2,2,25,109.77,16,4,23,2,157.87,0.00,0.50,0.00,0,2.00,1,49.36,0,2,2,,0.00,0,1,2,0,0,0,0,3,19,1
"org.apache.jackrabbit.core.query.lucene.MultiColumnQueryResult",3,0.25,1.33,12,0.19,3861.64,5,2,7,6,14,91.77,18,29,1,2,123.99,0.00,0.50,0.33,0,5.00,2,584.99,1,1,13,org.apache.jackrabbit.core.query.lucene.QueryResultImpl,0.29,3,1,4,0,3,2,0,7,122,1
"org.apache.jackrabbit.core.query.lucene.MultiIndex",37,0.07,3.05,444,5.80,225696.62,63,26,33,198,41,71.30,485,597,14,1,100.68,0.00,0.00,0.11,15,408.00,8,17407.04,0,10,31,java.lang.Object,0.00,161,0,113,0,161,27,0,147,3098,1
"org.apache.jackrabbit.core.query.lucene.MultiIndex$Action",7,0.04,2.71,66,0.97,59485.37,27,20,33,21,1,93.88,107,78,0,1,104.23,0.00,0.00,0.01,0,17.00,13,2900.18,0,2,1,java.lang.Object,0.00,14,0,19,0,14,5,0,28,527,3
"org.apache.jackrabbit.core.query.lucene.MultiIndex$AddIndex",4,0.67,1.25,20,0.21,4373.07,5,1,33,15,2,78.66,29,26,0,2,120.95,0.00,0.50,0.50,0,4.00,2,631.67,0,2,2,org.apache.jackrabbit.core.query.lucene.Action,0.00,11,1,5,0,11,2,0,6,152,2
"org.apache.jackrabbit.core.query.lucene.MultiIndex$AddNode",5,0.08,1.80,29,0.38,8682.81,8,3,33,21,5,71.17,42,43,0,2,119.28,0.00,0.50,0.27,0,7.00,4,1136.98,0,2,5,org.apache.jackrabbit.core.query.lucene.Action,0.00,16,1,9,0,16,3,0,10,252,2
"org.apache.jackrabbit.core.query.lucene.MultiIndex$Commit",4,0.00,1.00,9,0.09,930.52,4,0,33,8,1,123.26,21,14,0,2,141.13,0.00,0.50,0.00,0,4.00,1,258.76,0,2,1,org.apache.jackrabbit.core.query.lucene.Action,0.00,4,1,4,0,4,2,0,4,72,2
"org.apache.jackrabbit.core.query.lucene.MultiIndex$CreateIndex",6,0.40,1.17,25,0.23,4219.21,7,1,33,17,2,93.86,38,33,0,2,126.09,0.00,0.50,0.67,0,0.00,2,688.76,0,3,2,org.apache.jackrabbit.core.query.lucene.Action,0.00,11,1,7,0,11,3,0,8,172,2
"org.apache.jackrabbit.core.query.lucene.MultiIndex$DeleteIndex",4,0.67,1.50,22,0.20,4070.81,5,1,33,14,1,78.86,28,28,0,2,121.15,0.00,0.50,0.50,0,4.00,3,597.00,0,2,1,org.apache.jackrabbit.core.query.lucene.Action,0.00,10,1,6,0,10,2,0,6,145,2
"org.apache.jackrabbit.core.query.lucene.MultiIndex$DeleteNode",4,0.17,2.50,35,0.48,16216.86,6,2,33,24,6,58.69,36,46,0,2,108.69,0.00,0.50,0.38,0,4.00,6,1430.59,0,2,6,org.apache.jackrabbit.core.query.lucene.Action,0.00,20,1,10,0,20,2,0,12,288,2
"org.apache.jackrabbit.core.query.lucene.MultiIndex$Start",4,0.00,1.00,9,0.08,897.29,4,0,33,7,1,123.39,21,14,0,2,141.26,0.00,0.50,0.00,0,4.00,1,249.35,0,2,1,org.apache.jackrabbit.core.query.lucene.Action,0.00,3,1,4,0,3,2,0,4,70,2
"org.apache.jackrabbit.core.query.lucene.MultiIndex$Timer.Task",1,0.00,1.00,4,0.02,97.02,1,0,33,3,0,172.78,2,5,0,1,132.90,0.00,0.00,0.00,0,1.00,1,48.51,0,0,0,java.lang.Object,0.00,2,0,1,0,2,1,0,2,17,0
"org.apache.jackrabbit.core.query.lucene.MultiIndex$VolatileCommit",4,0.67,1.00,20,0.19,3565.26,5,1,33,14,3,89.47,24,25,0,2,121.70,0.00,0.50,0.50,0,4.00,1,574.63,0,2,3,org.apache.jackrabbit.core.query.lucene.Action,0.00,10,1,4,0,10,2,0,5,141,2
"org.apache.jackrabbit.core.query.lucene.MultiIndexReader",3,0.00,1.00,4,0.03,125.60,3,0,3,3,12,110.12,25,5,11,2,158.23,0.00,0.50,0.00,0,3.00,1,77.70,0,2,2,,0.00,0,1,3,0,0,1,0,4,28,1
"org.apache.jackrabbit.core.query.lucene.MultiScorer",7,0.38,2.29,49,0.48,25055.01,11,4,4,12,1,63.20,56,64,1,2,111.30,0.00,0.50,0.57,1,0.00,5,1432.10,0,1,0,org.apache.lucene.search.Scorer,0.00,5,1,16,0,5,6,0,21,318,0
"org.apache.jackrabbit.core.query.lucene.NSRegistryBasedNamespaceMappings",3,0.50,1.67,13,0.14,3648.06,4,1,2,8,3,91.91,19,23,1,2,124.13,0.00,0.50,0.67,0,1.00,2,429.64,0,2,2,org.apache.jackrabbit.core.query.lucene.AbstractNamespaceMappings,0.00,5,1,5,0,5,1,0,6,100,1
"org.apache.jackrabbit.core.query.lucene.NamePathResolverImpl",2,0.33,1.00,11,0.14,2501.76,5,3,16,8,19,120.77,9,14,5,2,120.54,0.00,0.50,0.17,0,2.00,1,423.99,0,1,14,org.apache.jackrabbit.spi.commons.conversion.DefaultNamePathResolver,0.00,6,1,2,0,6,1,0,3,96,1
"org.apache.jackrabbit.core.query.lucene.NamePathResolverImpl$NameResolverImpl",3,0.50,1.33,12,0.13,3087.74,4,1,16,8,4,74.75,28,17,0,1,124.75,0.00,0.00,0.67,0,1.00,2,403.98,0,2,4,java.lang.Object,0.00,5,0,4,0,5,1,1,5,96,2
"org.apache.jackrabbit.core.query.lucene.NameQuery",5,0.00,1.40,23,0.30,8635.93,8,3,9,16,12,90.75,33,38,5,2,122.97,0.00,0.50,0.33,0,2.00,3,907.39,0,3,7,org.apache.lucene.search.Query,0.00,11,1,7,0,11,2,0,11,193,1
"org.apache.jackrabbit.core.query.lucene.NameRangeQuery",8,0.20,2.75,65,0.83,27487.23,13,5,9,30,7,66.94,56,92,0,2,109.23,0.00,0.50,0.38,2,0.00,5,2501.33,0,7,7,org.apache.lucene.search.Query,0.00,22,1,22,0,22,1,0,15,515,1
"org.apache.jackrabbit.core.query.lucene.NamespaceMappings",2,0.00,1.00,3,0.02,108.19,2,0,4,2,22,108.87,20,4,18,2,157.35,0.00,0.50,0.00,0,2.00,1,66.09,0,2,4,,0.00,0,1,2,0,0,0,0,3,23,1
"org.apache.jackrabbit.core.query.lucene.NodeIndexer",37,0.02,2.89,283,4.52,185515.15,48,11,32,112,28,61.62,380,465,1,1,110.09,0.00,0.00,0.11,23,604.00,28,13555.92,0,7,27,java.lang.Object,0.00,75,0,107,0,75,30,0,81,2527,1
"org.apache.jackrabbit.core.query.lucene.NodeIteratorImpl",10,0.08,1.70,56,0.48,10574.45,17,7,8,21,5,78.70,75,78,1,1,120.99,0.00,0.00,0.21,3,22.00,3,1452.12,0,2,4,java.lang.Object,0.00,11,0,17,0,11,8,1,21,332,0
"org.apache.jackrabbit.core.query.lucene.NodeTraversingQueryHits",3,0.50,1.67,15,0.14,2604.75,4,1,10,8,6,71.67,29,23,3,2,121.67,0.00,0.50,0.67,0,1.00,2,429.39,0,1,3,org.apache.jackrabbit.core.query.lucene.AbstractQueryHits,0.00,5,1,5,0,5,2,0,6,103,1
"org.apache.jackrabbit.core.query.lucene.NodeTraversingQueryHits$TraversingNodeIterator",5,0.08,2.40,33,0.32,8757.83,8,3,10,17,1,84.01,33,47,0,1,116.23,0.00,0.00,0.40,1,1.00,7,959.79,0,1,1,java.lang.Object,0.00,12,0,12,0,12,4,1,12,209,1
"org.apache.jackrabbit.core.query.lucene.NotQuery",5,0.38,1.20,19,0.14,2558.77,7,2,9,9,3,89.54,35,26,3,2,131.83,0.00,0.50,0.20,0,7.00,2,417.85,0,3,0,org.apache.lucene.search.Query,0.00,4,1,6,0,4,2,0,10,110,0
"org.apache.jackrabbit.core.query.lucene.NotQuery$NotQueryScorer",6,0.00,2.00,35,0.32,15909.81,9,3,9,10,0,99.94,31,48,0,2,117.81,0.00,0.50,0.33,1,6.00,5,969.11,0,1,0,org.apache.lucene.search.Scorer,0.00,4,1,12,0,4,5,0,12,221,1
"org.apache.jackrabbit.core.query.lucene.NotQuery$NotQueryWeight",7,1.00,1.00,16,0.12,1428.89,8,1,9,10,1,162.20,25,24,0,1,141.58,0.00,0.00,0.14,0,12.00,1,362.03,0,3,1,java.lang.Object,0.00,3,0,7,0,3,4,1,8,101,1
"org.apache.jackrabbit.core.query.lucene.OffsetCharSequence",8,0.14,2.00,53,0.53,17562.25,11,3,0,21,5,83.28,53,61,4,1,115.50,0.00,0.00,0.46,2,2.00,4,1586.48,0,2,1,java.lang.Object,0.00,13,0,16,0,13,6,3,14,356,1
"org.apache.jackrabbit.core.query.lucene.Ordering",4,0.33,1.25,17,0.17,4280.88,6,2,15,8,22,82.34,31,27,9,1,124.63,0.00,0.00,0.25,0,8.00,2,511.10,0,3,13,java.lang.Object,0.00,4,0,5,0,4,1,0,7,117,1
"org.apache.jackrabbit.core.query.lucene.Ordering$DefaultTraversingQOMTreeVisitor",8,0.00,1.00,27,0.54,11183.93,8,0,15,28,13,128.43,0,50,0,1,128.43,0.00,0.00,0.00,0,0.00,1,1619.97,0,8,13,java.lang.Object,0.00,20,0,8,0,20,0,0,0,342,0
"org.apache.jackrabbit.core.query.lucene.ParentAxisQuery",5,0.00,1.20,26,0.24,4452.52,11,6,16,10,8,77.53,58,34,3,2,121.66,0.00,0.50,0.17,0,7.00,2,712.91,0,3,5,org.apache.lucene.search.Query,0.00,5,1,6,0,5,2,0,16,167,0
"org.apache.jackrabbit.core.query.lucene.ParentAxisQuery$ParentAxisScorer",7,0.08,2.00,50,0.57,23417.83,13,6,16,23,4,69.27,53,65,0,2,111.56,0.00,0.50,0.24,1,0.00,7,1698.49,0,1,4,org.apache.lucene.search.Scorer,0.00,16,1,14,0,16,6,0,16,345,1
"org.apache.jackrabbit.core.query.lucene.ParentAxisQuery$ParentAxisScorer$HitCollector",1,0.00,6.00,18,0.23,12625.07,2,1,16,3,0,141.47,1,22,0,1,91.47,0.00,0.00,1.00,0,0.00,6,700.16,0,0,0,java.lang.Object,0.00,2,0,6,0,2,1,0,1,136,0
"org.apache.jackrabbit.core.query.lucene.ParentAxisQuery$ParentAxisWeight",7,1.00,1.00,17,0.14,2128.10,8,1,16,11,2,140.45,33,26,0,1,140.22,0.00,0.00,0.14,0,12.00,1,429.11,0,3,2,java.lang.Object,0.00,4,0,7,0,4,4,1,8,115,1
"org.apache.jackrabbit.core.query.lucene.PerQueryCache",5,0.12,1.20,17,0.15,3040.34,7,2,2,13,6,83.13,43,24,6,1,131.24,0.00,0.00,0.40,0,9.00,2,460.92,0,3,0,java.lang.Object,0.00,8,0,6,0,8,2,0,9,121,0
"org.apache.jackrabbit.core.query.lucene.PerQueryCache$Key",3,0.25,1.33,13,0.12,2678.31,5,2,2,6,0,93.02,18,18,0,1,125.24,0.00,0.00,0.67,0,1.00,2,353.55,0,0,0,java.lang.Object,0.00,3,0,4,0,3,3,0,5,92,3
"org.apache.jackrabbit.core.query.lucene.PersistentIndex",8,0.43,1.50,48,0.52,17786.69,10,2,9,25,13,67.42,65,68,7,2,115.52,0.00,0.50,0.12,1,20.00,3,1564.42,5,1,7,org.apache.jackrabbit.core.query.lucene.AbstractIndex,0.00,17,1,12,0,17,7,0,13,325,0
"org.apache.jackrabbit.core.query.lucene.PooledTextExtractor",4,0.08,1.50,31,0.30,6881.47,8,4,10,17,4,63.90,39,45,1,1,113.90,0.00,0.00,0.31,0,2.00,2,907.33,0,2,3,java.lang.Object,0.00,13,0,6,0,13,2,1,9,200,1
"org.apache.jackrabbit.core.query.lucene.PooledTextExtractor$PooledExecutor.BlockedExecutionHandler",1,0.00,1.00,5,0.04,496.72,1,0,10,3,0,173.70,1,7,0,1,123.70,0.00,0.00,0.00,0,0.00,1,128.10,0,0,0,java.lang.Object,0.00,2,0,1,0,2,1,0,1,33,0
"org.apache.jackrabbit.core.query.lucene.PropertiesSynonymProvider",5,0.25,2.80,61,0.77,27674.26,12,7,9,26,4,63.47,63,81,0,1,101.03,0.00,0.00,0.34,2,2.00,4,2310.38,0,2,4,java.lang.Object,0.00,21,0,14,0,21,3,1,16,457,1
"org.apache.jackrabbit.core.query.lucene.PropertyMetaData",4,0.67,1.00,10,0.07,986.94,5,1,0,5,3,108.71,26,15,3,1,140.93,0.00,0.00,0.50,0,4.00,1,211.47,0,1,0,java.lang.Object,0.00,1,0,4,0,1,3,0,6,63,2
"org.apache.jackrabbit.core.query.lucene.QueryHits",1,0.00,1.00,2,0.01,59.45,1,0,1,1,13,97.32,10,3,12,2,145.80,0.00,0.50,0.00,0,1.00,1,33.60,0,1,1,,0.00,0,1,1,0,0,0,0,2,13,1
"org.apache.jackrabbit.core.query.lucene.QueryHitsAdapter",6,0.10,1.17,20,0.15,2970.46,8,2,2,10,5,114.07,31,28,1,1,131.95,0.00,0.00,0.42,0,2.00,2,456.94,0,2,4,java.lang.Object,0.00,4,0,7,0,4,4,1,9,123,1
"org.apache.jackrabbit.core.query.lucene.QueryHitsQuery",5,1.00,1.20,16,0.14,1840.49,6,1,17,8,5,100.73,34,25,1,2,132.95,0.00,0.50,0.20,0,8.00,2,414.53,0,2,4,org.apache.lucene.search.Query,0.00,3,1,6,0,3,3,1,13,105,1
"org.apache.jackrabbit.core.query.lucene.QueryHitsQuery$QueryHitsQueryScorer",6,0.07,1.67,38,0.43,9978.45,9,3,17,28,2,98.62,33,55,0,2,116.49,0.00,0.50,0.39,0,2.00,3,1289.55,0,1,2,org.apache.lucene.search.Scorer,0.00,22,1,10,0,22,5,0,9,265,1
"org.apache.jackrabbit.core.query.lucene.QueryHitsQuery$QueryHitsQueryWeight",7,1.00,1.00,15,0.10,1100.81,8,1,17,9,1,163.09,26,23,0,1,142.47,0.00,0.00,0.14,0,12.00,1,313.30,0,3,1,java.lang.Object,0.00,2,0,7,0,2,4,1,8,91,1
"org.apache.jackrabbit.core.query.lucene.QueryImpl",5,0.00,3.00,59,1.18,62570.91,8,3,28,48,23,62.07,61,86,1,2,99.64,0.00,0.50,0.33,1,2.00,8,3537.02,0,3,23,org.apache.jackrabbit.core.query.lucene.AbstractQueryImpl,0.15,43,1,15,0,43,2,0,15,610,1
"org.apache.jackrabbit.core.query.lucene.QueryImpl$DefaultQueryNodeVisitor",2,0.00,1.00,6,0.06,831.24,2,0,28,4,2,132.58,0,8,0,1,132.58,0.00,0.00,0.00,0,2.00,1,166.23,0,2,2,java.lang.Object,0.00,2,0,2,0,2,0,0,0,44,0
"org.apache.jackrabbit.core.query.lucene.QueryObjectModelImpl",5,0.50,2.40,43,0.78,37555.43,6,1,21,43,21,56.59,47,70,1,2,106.59,0.00,0.50,0.60,2,2.00,6,2342.28,1,1,21,org.apache.jackrabbit.core.query.lucene.AbstractQueryImpl,0.15,38,1,12,0,38,4,0,13,392,1
"org.apache.jackrabbit.core.query.lucene.QueryObjectModelImpl$DefaultTraversingQOMTreeVisitor",1,0.00,1.00,4,0.03,313.32,1,0,21,3,1,128.89,0,5,0,1,128.89,0.00,0.00,0.00,0,1.00,1,78.31,0,1,1,java.lang.Object,0.00,2,0,1,0,2,0,0,0,23,0
"org.apache.jackrabbit.core.query.lucene.QueryObjectModelImpl$DefaultTraversingQOMTreeVisitor_0",1,0.00,2.00,6,0.08,2294.69,1,0,21,5,1,115.35,0,8,0,1,115.35,0.00,0.00,0.00,0,1.00,2,231.48,1,1,1,java.lang.Object,0.00,4,0,2,0,4,0,0,0,51,0
"org.apache.jackrabbit.core.query.lucene.QueryResultImpl",11,0.08,2.73,101,1.35,61462.60,27,16,18,42,18,85.52,161,153,3,1,105.67,0.00,0.00,0.13,3,47.00,8,4045.21,0,5,15,java.lang.Object,0.00,31,0,30,2,31,6,1,40,750,2
"org.apache.jackrabbit.core.query.lucene.QueryResultImpl$LazyScoreNodeIteratorImpl",9,0.08,2.56,67,0.58,22566.24,12,3,18,15,2,112.73,38,93,0,1,112.49,0.00,0.00,0.26,3,34.00,7,1748.41,0,2,2,java.lang.Object,0.00,6,0,23,0,6,7,1,17,369,2
"org.apache.jackrabbit.core.query.lucene.RangeQuery",8,0.04,2.38,47,0.59,22291.74,12,4,19,21,5,67.60,75,64,4,2,117.60,1.00,0.33,0.28,1,14.00,7,1767.75,0,4,1,org.apache.lucene.search.Query,0.00,13,1,19,1,13,4,1,21,379,1
"org.apache.jackrabbit.core.query.lucene.RangeQuery$RangeQueryScorer",8,0.14,3.38,109,1.58,129645.89,14,6,19,50,3,46.02,74,139,0,2,96.02,0.00,0.50,0.29,2,4.00,15,4743.11,0,1,3,org.apache.lucene.search.Scorer,0.00,42,1,27,0,42,7,0,32,807,2
"org.apache.jackrabbit.core.query.lucene.RangeQuery$RangeQueryWeight",7,0.00,1.00,14,0.09,890.16,7,0,19,10,2,143.44,29,22,0,2,143.20,0.00,0.50,0.00,0,12.00,1,282.90,0,3,2,org.apache.jackrabbit.core.query.lucene.AbstractWeight,0.00,3,1,7,0,3,4,0,7,85,1
"org.apache.jackrabbit.core.query.lucene.RangeScan",4,0.17,1.25,15,0.12,1762.46,6,2,4,7,2,172.22,9,21,2,2,132.33,0.00,0.50,0.38,0,4.00,2,351.15,0,0,0,org.apache.lucene.search.FilteredTermEnum,0.00,3,1,5,0,3,4,0,2,90,0
"org.apache.jackrabbit.core.query.lucene.ReadOnlyIndexReader",15,0.14,1.20,50,0.41,6786.72,18,3,5,29,12,84.14,121,69,7,3,132.25,0.00,0.67,0.20,1,71.00,3,1225.13,2,3,5,org.apache.jackrabbit.core.query.lucene.RefCountingIndexReader,0.00,14,2,18,0,14,12,0,26,314,0
"org.apache.jackrabbit.core.query.lucene.ReadOnlyIndexReader$FilteredTermDocs",4,0.00,1.75,22,0.20,6124.40,4,0,5,4,0,140.33,14,27,0,2,119.72,0.00,0.50,0.00,0,4.00,2,600.32,2,0,0,FilterTermDocs,0.00,0,1,7,0,0,4,0,4,142,1
"org.apache.jackrabbit.core.query.lucene.ReadOnlyIndexReader$FilteredTermPositions",5,0.00,1.00,11,0.10,1357.37,5,0,5,9,0,161.22,17,18,0,2,140.61,0.00,0.50,0.00,0,5.00,1,314.15,0,0,0,org.apache.jackrabbit.core.query.lucene.FilteredTermDocs,0.00,4,1,5,0,4,5,1,5,89,2
"org.apache.jackrabbit.core.query.lucene.Recovery",3,0.12,6.33,73,1.07,128692.19,7,4,7,26,3,100.75,55,80,2,1,82.61,0.00,0.00,0.33,0,5.00,16,3195.67,0,0,2,java.lang.Object,0.00,23,0,19,0,23,3,0,23,551,0
"org.apache.jackrabbit.core.query.lucene.RedoLog",9,0.15,1.89,52,0.54,13754.54,14,5,15,32,4,69.71,84,74,2,1,119.71,0.00,0.00,0.33,2,6.00,6,1615.90,0,1,2,java.lang.Object,0.00,23,0,17,0,23,8,0,18,343,0
"org.apache.jackrabbit.core.query.lucene.RedoLog$ActionCollector",1,0.00,1.00,3,0.02,141.06,1,0,15,1,0,136.28,0,4,0,1,136.28,0.00,0.00,0.00,0,0.00,1,51.02,0,0,0,java.lang.Object,0.00,0,0,1,0,0,1,0,0,16,0
"org.apache.jackrabbit.core.query.lucene.RedoLog$ActionCollector_0",1,0.00,1.00,3,0.02,165.64,1,0,15,2,0,135.73,0,4,0,1,135.73,0.00,0.00,0.00,0,1.00,1,61.77,0,0,0,java.lang.Object,0.00,1,0,1,0,1,1,0,0,19,0
"org.apache.jackrabbit.core.query.lucene.RedoLog$ActionCollector_1",1,0.00,1.00,2,0.01,42.34,1,0,15,1,0,196.96,1,3,0,1,146.96,0.00,0.00,0.00,0,1.00,1,30.34,0,0,0,,0.00,0,0,1,0,0,1,0,1,12,0
"org.apache.jackrabbit.core.query.lucene.RefCountingIndexReader",5,0.50,1.20,13,0.09,968.84,6,1,3,7,4,162.33,18,22,2,2,141.72,2.00,0.25,0.60,0,2.00,2,262.24,0,0,2,org.apache.lucene.index.FilterIndexReader,0.00,2,1,6,2,2,5,1,7,74,1
"org.apache.jackrabbit.core.query.lucene.ReleaseableIndexReader",1,0.00,1.00,2,0.01,51.30,1,0,1,1,2,102.18,11,3,2,1,146.30,0.00,0.00,0.00,0,1.00,1,27.65,0,0,0,,0.00,0,0,1,0,0,1,0,2,11,1
"org.apache.jackrabbit.core.query.lucene.RowIteratorImpl",8,0.03,1.12,43,0.57,15340.67,21,13,34,23,19,98.91,116,63,1,1,119.05,0.00,0.00,0.05,1,0.00,2,1715.70,0,2,18,java.lang.Object,0.00,15,0,9,0,15,6,1,24,338,0
"org.apache.jackrabbit.core.query.lucene.RowIteratorImpl$RowImpl",20,0.12,2.60,153,1.89,64204.19,24,4,34,58,9,63.17,208,215,0,1,111.64,0.00,0.00,0.14,10,186.00,13,5664.05,0,12,9,java.lang.Object,0.00,38,0,52,0,38,8,1,34,1108,0
"org.apache.jackrabbit.core.query.lucene.ScoreNode",7,0.06,1.43,36,0.32,9045.50,10,3,5,17,53,88.12,47,49,51,1,120.34,0.00,0.00,0.29,0,15.00,3,960.96,0,2,2,java.lang.Object,0.00,10,0,10,0,10,5,0,10,222,2
"org.apache.jackrabbit.core.query.lucene.ScoreNodeIterator",1,0.00,1.00,2,0.01,53.60,1,0,1,1,7,97.68,10,3,6,2,146.15,0.00,0.50,0.00,0,1.00,1,29.70,0,0,1,,0.00,0,1,1,0,0,1,0,2,12,1
"org.apache.jackrabbit.core.query.lucene.ScoreNodeIteratorImpl",2,0.00,1.00,5,0.04,425.59,2,0,2,3,4,162.05,7,10,1,2,141.44,0.00,0.50,0.00,0,2.00,1,122.57,1,1,3,org.apache.jackrabbit.commons.iterator.RangeIteratorAdapter,0.00,1,1,2,0,1,1,1,2,37,1
"org.apache.jackrabbit.core.query.lucene.SearchIndex",103,0.01,2.00,649,8.51,381060.79,161,58,68,293,79,71.42,796,961,21,2,113.72,1.00,0.33,0.02,12,7784.00,14,25527.63,1,36,65,org.apache.jackrabbit.core.query.AbstractQueryHandler,0.02,190,1,206,1,190,67,0,188,4678,1
"org.apache.jackrabbit.core.query.lucene.SearchIndex$CombinedIndexReader",9,0.06,2.33,71,0.70,35621.67,11,2,68,19,6,131.57,34,85,0,2,110.95,0.00,0.50,0.56,1,0.00,5,2091.14,0,2,6,org.apache.lucene.index.MultiReader,0.00,10,1,21,0,10,7,2,14,458,3
"org.apache.jackrabbit.core.query.lucene.SearchIndex$FilterMultiColumnQueryHits",1,0.00,1.00,6,0.06,650.81,1,0,68,4,2,119.82,0,11,0,1,119.82,0.00,0.00,0.00,0,1.00,1,175.29,1,0,2,java.lang.Object,0.00,3,0,1,0,3,1,0,0,44,0
"org.apache.jackrabbit.core.query.lucene.SearchIndex$FilterMultiColumnQueryHits_0",1,0.00,1.00,6,0.05,623.51,1,0,68,4,2,119.96,0,10,0,1,119.96,0.00,0.00,0.00,0,1.00,1,161.64,1,0,2,java.lang.Object,0.00,3,0,1,0,3,1,0,0,41,0
"org.apache.jackrabbit.core.query.lucene.SearchIndex$HitCollector",1,0.00,1.00,3,0.02,168.11,1,0,68,2,0,135.68,0,4,0,1,135.68,0.00,0.00,0.00,0,1.00,1,63.51,0,0,0,java.lang.Object,0.00,1,0,1,0,1,1,0,0,19,0
"org.apache.jackrabbit.core.query.lucene.SharedFieldCache",5,0.38,3.40,81,1.27,107134.57,7,2,11,46,9,43.22,53,116,2,1,91.70,0.00,0.00,0.20,2,7.00,11,3800.89,0,4,7,java.lang.Object,0.00,41,0,17,0,41,1,0,12,648,1
"org.apache.jackrabbit.core.query.lucene.SharedFieldCache$Key",3,0.50,1.33,15,0.16,3616.70,6,3,11,7,0,141.21,10,22,0,1,120.60,0.00,0.00,0.67,0,1.00,2,469.53,0,0,0,java.lang.Object,0.00,4,0,4,0,4,3,0,3,120,1
"org.apache.jackrabbit.core.query.lucene.SharedFieldCache$ValueIndex",4,0.00,2.75,36,0.37,14366.11,8,4,11,7,0,107.41,19,44,0,1,107.18,0.00,0.00,0.25,1,8.00,3,1100.72,0,2,0,java.lang.Object,0.00,3,0,11,0,3,2,0,7,238,2
"org.apache.jackrabbit.core.query.lucene.SharedFieldSortComparator",3,0.20,1.67,26,0.31,7885.89,8,5,18,12,16,119.40,52,44,2,2,110.27,0.00,0.50,0.07,0,4.00,3,929.04,0,2,14,org.apache.lucene.search.SortComparator,0.00,9,1,5,0,9,1,0,11,193,1
"org.apache.jackrabbit.core.query.lucene.SharedFieldSortComparator$CompoundScoreDocComparator",2,1.00,2.00,12,0.09,2110.57,3,1,18,3,1,168.01,3,19,0,2,118.01,0.00,0.50,0.00,0,2.00,3,283.70,0,1,1,org.apache.jackrabbit.core.query.lucene.AbstractScoreDocComparator,0.00,1,1,4,0,1,1,0,1,70,2
"org.apache.jackrabbit.core.query.lucene.SharedFieldSortComparator$RelPathScoreDocComparator",2,1.00,3.00,25,0.37,12827.20,3,1,18,13,11,121.13,7,35,0,2,100.51,0.00,0.50,0.50,0,2.00,5,1119.53,1,1,11,org.apache.jackrabbit.core.query.lucene.AbstractScoreDocComparator,0.00,11,1,6,0,11,1,0,1,200,2
"org.apache.jackrabbit.core.query.lucene.SharedFieldSortComparator$SimpleScoreDocComparator",2,0.00,1.50,15,0.21,5271.11,3,1,18,7,4,112.68,9,19,0,2,112.44,0.00,0.50,1.00,0,0.00,2,619.98,1,1,4,org.apache.jackrabbit.core.query.lucene.AbstractScoreDocComparator,0.00,5,1,3,0,5,1,0,2,128,2
"org.apache.jackrabbit.core.query.lucene.SharedIndexReader",5,0.00,1.00,11,0.08,954.75,5,0,4,8,5,93.70,41,17,2,3,141.81,0.00,0.67,0.00,1,5.00,1,241.95,0,3,3,org.apache.jackrabbit.core.query.lucene.RefCountingIndexReader,0.00,3,2,5,0,3,2,0,6,72,0
"org.apache.jackrabbit.core.query.lucene.SimilarityQuery",3,0.00,1.67,23,0.26,8023.94,5,2,7,15,3,94.50,17,31,1,2,112.37,0.00,0.50,0.50,0,1.00,3,774.53,0,2,2,org.apache.lucene.search.Query,0.00,12,1,5,0,12,1,0,6,160,1
"org.apache.jackrabbit.core.query.lucene.SimpleExcerptProvider",2,0.00,4.00,30,0.47,30105.78,3,1,12,18,11,45.81,17,38,1,1,93.91,0.00,0.00,1.00,0,0.00,7,1397.48,0,1,10,java.lang.Object,0.00,16,0,8,0,16,1,1,5,238,1
"org.apache.jackrabbit.core.query.lucene.SingleColumnQueryResult",3,0.17,1.33,14,0.22,4558.58,6,3,8,6,12,91.20,20,33,1,2,123.42,0.00,0.50,0.44,0,2.00,2,672.71,1,0,11,org.apache.jackrabbit.core.query.lucene.QueryResultImpl,0.29,3,1,4,0,3,3,0,7,140,1
"org.apache.jackrabbit.core.query.lucene.SingleTermDocs",9,0.31,1.11,27,0.19,3693.09,11,2,4,10,2,132.84,39,38,2,1,132.60,0.00,0.00,0.22,0,22.00,2,567.23,0,0,0,java.lang.Object,0.00,1,0,10,0,1,9,1,12,152,0
"org.apache.jackrabbit.core.query.lucene.SingletonTokenStream",3,0.25,1.33,19,0.18,3617.64,5,2,4,14,3,69.54,26,24,2,2,117.64,0.00,0.50,0.33,0,4.00,2,537.86,0,1,1,org.apache.lucene.analysis.TokenStream,0.00,11,1,4,0,11,2,0,6,128,2
"org.apache.jackrabbit.core.query.lucene.SlowQueryHandler",1,0.00,2.00,7,0.08,1524.13,1,0,3,6,3,71.96,7,11,0,3,114.25,0.00,0.67,0.00,0,1.00,2,246.26,2,0,3,org.apache.jackrabbit.core.query.lucene.SearchIndex,0.03,5,2,2,0,5,1,0,4,54,1
"org.apache.jackrabbit.core.query.lucene.SortedLuceneQueryHits",5,0.20,1.60,44,0.63,17593.92,16,11,12,22,6,71.72,64,55,1,2,109.28,0.00,0.50,0.25,1,8.00,3,1883.39,0,0,6,org.apache.jackrabbit.core.query.lucene.AbstractQueryHits,0.50,17,1,8,0,17,5,0,20,362,2
"org.apache.jackrabbit.core.query.lucene.SortedMultiColumnQueryHits",3,1.00,2.33,21,0.27,7645.93,4,1,12,11,7,64.35,25,35,1,2,112.46,0.00,0.50,0.33,1,4.00,3,801.71,0,1,6,org.apache.jackrabbit.core.query.lucene.FilterMultiColumnQueryHits,0.44,8,1,7,0,8,2,0,7,165,1
"org.apache.jackrabbit.core.query.lucene.SortedMultiColumnQueryHits$ScoreNodeComparator",2,1.00,6.00,54,0.76,47371.17,9,7,12,18,3,91.88,35,63,0,1,82.75,0.00,0.00,0.64,0,0.00,9,2276.57,0,0,3,java.lang.Object,0.00,16,0,12,0,16,2,1,10,413,3
"org.apache.jackrabbit.core.query.lucene.SpellChecker",3,0.00,1.00,4,0.02,95.00,3,0,3,3,4,109.18,27,5,2,1,159.18,0.00,0.00,0.00,0,3.00,1,66.00,0,1,2,,0.00,0,0,3,0,0,2,0,4,25,1
"org.apache.jackrabbit.core.query.lucene.SpellSuggestion",2,0.00,1.50,11,0.07,1082.74,4,2,2,3,7,85.75,24,15,5,1,123.31,0.00,0.00,0.50,0,2.00,2,217.74,0,1,2,java.lang.Object,0.00,1,0,3,0,1,1,0,5,59,0
"org.apache.jackrabbit.core.query.lucene.SynonymProvider",2,0.00,1.00,3,0.02,87.19,2,0,2,2,6,113.96,23,4,5,1,158.09,0.00,0.00,0.00,0,2.00,1,52.09,0,1,1,,0.00,0,0,2,0,0,1,0,3,20,1
"org.apache.jackrabbit.core.query.lucene.TermDocsCache",2,0.67,8.00,63,1.03,95075.11,8,6,14,32,2,127.34,49,85,1,1,78.06,0.00,0.00,0.50,0,2.00,15,3099.53,0,1,1,java.lang.Object,0.00,30,0,16,0,30,1,0,19,507,1
"org.apache.jackrabbit.core.query.lucene.TermDocsCache$CacheEntry",1,1.00,3.00,6,0.08,2188.07,3,2,14,1,0,115.42,0,8,0,1,115.42,0.00,0.00,0.50,0,0.00,3,246.12,0,0,0,java.lang.Object,0.00,0,0,3,0,0,1,1,0,58,3
"org.apache.jackrabbit.core.query.lucene.TermDocsCache$CachedTermDocs",9,0.08,1.33,34,0.28,6726.12,12,3,14,11,0,151.12,33,44,0,1,130.51,0.00,0.00,0.26,0,18.00,2,833.71,0,0,0,java.lang.Object,0.00,2,0,12,0,2,9,1,11,204,3
"org.apache.jackrabbit.core.query.lucene.TestAll",1,0.00,1.00,6,0.05,1283.53,1,0,3,3,2,69.02,10,8,0,2,117.50,0.00,0.50,0.00,0,1.00,1,150.40,0,1,2,junit.framework.TestCase,0.00,2,1,1,0,2,0,0,2,39,1
"org.apache.jackrabbit.core.query.lucene.TextExtractorJob",6,0.07,2.67,55,0.61,20024.01,12,6,18,28,4,69.87,74,84,2,2,107.43,0.00,0.50,0.22,0,18.00,6,1829.28,0,3,2,EDU.oswego.cs.dl.util.concurrent.FutureResult,0.00,22,1,16,0,22,3,1,25,371,1
"org.apache.jackrabbit.core.query.lucene.TextExtractorJob$Callable",1,0.00,4.00,10,0.08,1945.76,1,0,18,3,0,157.48,1,13,0,1,107.48,0.00,0.00,0.00,0,0.00,4,247.72,0,1,0,java.lang.Object,0.00,2,0,4,0,2,0,0,1,55,0
"org.apache.jackrabbit.core.query.lucene.TextExtractorJob$InputStreamReader",1,0.00,2.00,5,0.04,525.58,1,0,18,3,0,173.34,1,7,0,1,123.34,0.00,0.00,0.00,0,1.00,2,113.18,1,0,0,java.lang.Object,0.00,2,0,2,0,2,1,0,1,31,0
"org.apache.jackrabbit.core.query.lucene.TextExtractorReader",4,0.44,3.25,39,0.40,12256.45,10,6,5,12,3,87.54,56,55,2,2,107.68,0.00,0.50,0.50,0,0.00,5,1194.04,0,0,1,java.io.Reader,0.00,8,1,13,0,8,4,0,21,251,0
"org.apache.jackrabbit.core.query.lucene.TransformConstants",0,0.00,0.00,4,0.03,265.97,3,3,0,0,5,171.00,12,5,5,1,171.00,0.00,0.00,0.00,0,0.00,0,85.11,0,0,0,,0.00,0,0,0,0,0,0,0,4,23,1
"org.apache.jackrabbit.core.query.lucene.Transformable",1,0.00,1.00,2,0.01,51.70,1,0,0,1,2,116.90,13,3,2,2,146.28,0.00,0.50,0.00,0,1.00,1,33.60,0,0,0,,0.00,0,1,1,0,0,1,0,2,13,1
"org.apache.jackrabbit.core.query.lucene.UpperCaseSortComparator",2,0.50,1.00,8,0.08,1259.07,4,2,6,4,1,84.21,15,13,1,1,126.50,0.00,0.00,0.25,0,2.00,1,248.32,0,1,0,java.lang.Object,0.00,2,0,2,0,2,1,1,4,63,1
"org.apache.jackrabbit.core.query.lucene.UpperCaseSortComparator$Comparator",4,1.00,1.25,14,0.12,2154.60,5,1,6,8,1,131.64,3,20,0,1,131.64,0.00,0.00,0.25,1,6.00,2,346.90,0,1,1,java.lang.Object,0.00,4,0,5,0,4,3,1,1,92,3
"org.apache.jackrabbit.core.query.lucene.Util",11,0.90,4.00,138,1.94,99804.05,12,1,16,63,39,50.78,110,217,32,1,99.26,0.00,0.00,0.18,2,25.00,11,5823.49,0,5,7,java.lang.Object,0.00,52,0,44,0,52,6,0,19,1102,1
"org.apache.jackrabbit.core.query.lucene.VolatileIndex",9,0.03,1.56,46,0.46,10039.34,13,4,8,23,7,72.72,73,61,2,2,120.83,0.00,0.50,0.22,1,20.00,4,1394.78,6,0,5,org.apache.jackrabbit.core.query.lucene.AbstractIndex,0.19,14,1,14,0,14,9,0,16,312,0
"org.apache.jackrabbit.core.query.lucene.WeightedHTMLExcerpt",1,0.00,1.00,3,0.06,906.92,1,0,2,2,2,156.19,19,10,0,2,129.91,0.00,0.50,0.00,0,1.00,1,181.93,0,1,2,org.apache.jackrabbit.core.query.lucene.AbstractExcerpt,0.00,1,1,1,0,1,0,0,2,41,1
"org.apache.jackrabbit.core.query.lucene.WeightedHighlighter",6,1.00,4.83,107,1.75,208807.09,7,1,12,40,4,51.41,76,155,3,2,88.98,0.00,0.50,0.17,3,14.00,17,5237.96,1,3,1,org.apache.jackrabbit.core.query.lucene.DefaultHighlighter,0.00,34,1,29,0,34,3,0,20,891,1
"org.apache.jackrabbit.core.query.lucene.WeightedHighlighter$FragmentInfo",6,0.28,1.83,42,0.33,12391.60,11,5,12,13,0,113.23,2,51,0,1,113.23,0.00,0.00,0.43,0,0.00,6,992.45,0,1,0,java.lang.Object,0.00,7,0,11,0,7,5,0,2,215,2
"org.apache.jackrabbit.core.query.lucene.WeightedHighlighter$FragmentInfoPriorityQueue",2,0.00,1.50,9,0.10,3704.31,2,0,12,5,0,143.33,7,13,0,2,122.72,0.00,0.50,0.00,0,2.00,2,300.01,0,0,0,org.apache.lucene.util.PriorityQueue,0.00,3,1,3,0,3,2,0,1,74,2
"org.apache.jackrabbit.core.query.lucene.WeightedXMLExcerpt",1,0.00,1.00,3,0.05,775.69,1,0,2,2,2,169.75,21,10,0,2,130.45,0.00,0.50,0.00,0,1.00,1,142.89,0,1,2,org.apache.jackrabbit.core.query.lucene.AbstractExcerpt,0.00,1,1,1,0,1,0,0,2,35,1
"org.apache.jackrabbit.core.query.lucene.WildcardQuery",7,0.06,1.29,32,0.32,6114.84,13,6,20,15,4,81.19,80,43,3,2,125.32,0.00,0.50,0.12,0,18.00,2,961.75,0,3,1,org.apache.lucene.search.Query,0.00,8,1,9,0,8,4,1,17,226,1
"org.apache.jackrabbit.core.query.lucene.WildcardQuery$Term",1,0.00,1.00,3,0.03,322.26,1,0,20,2,1,133.45,0,4,0,1,133.45,0.00,0.00,0.00,0,0.00,1,93.17,0,1,1,java.lang.Object,0.00,1,0,1,0,1,0,0,0,25,0
"org.apache.jackrabbit.core.query.lucene.WildcardQuery$WildcardQueryScorer",7,0.19,1.86,54,0.57,16150.48,13,6,20,25,2,80.63,47,72,0,2,112.85,0.00,0.50,0.33,1,0.00,5,1719.12,0,1,2,org.apache.lucene.search.Scorer,0.00,18,1,13,0,18,6,0,16,349,2
"org.apache.jackrabbit.core.query.lucene.WildcardQuery$WildcardQueryWeight",7,0.00,1.00,14,0.09,897.38,7,0,20,10,2,143.41,29,22,0,2,143.17,0.00,0.50,0.00,0,12.00,1,281.24,0,3,2,org.apache.jackrabbit.core.query.lucene.AbstractWeight,0.00,3,1,7,0,3,4,0,7,84,1
"org.apache.jackrabbit.core.query.lucene.WildcardTermEnum",4,0.28,2.75,42,0.54,26090.12,10,6,11,21,7,74.05,55,59,3,2,103.43,0.00,0.50,0.38,0,2.00,6,1610.87,0,0,4,org.apache.lucene.search.FilteredTermEnum,0.00,17,1,11,0,17,4,1,17,307,0
"org.apache.jackrabbit.core.query.lucene.WildcardTermEnum$LowerUpperCaseTermEnum",6,0.07,3.33,71,1.22,118219.93,9,3,11,43,3,80.19,34,94,0,2,98.06,0.00,0.50,0.39,1,0.00,13,3663.07,0,1,3,org.apache.lucene.index.TermEnum,0.00,37,1,20,0,37,5,0,17,597,1
"org.apache.jackrabbit.value.AbstractValueFactory",15,0.00,1.93,62,0.66,24773.11,15,0,11,37,14,123.29,61,95,1,1,123.05,0.00,0.00,0.00,1,15.00,13,1988.99,0,12,13,java.lang.Object,0.00,22,0,29,1,22,3,1,17,424,2
"org.apache.jackrabbit.value.BaseValue",13,0.04,1.77,62,0.62,13196.81,20,7,11,25,14,92.51,82,108,12,1,124.73,0.00,0.00,0.11,3,60.00,3,1856.29,0,6,2,java.lang.Object,0.00,12,0,23,13,12,7,1,17,418,2
"org.apache.jackrabbit.value.BinaryImpl",6,0.35,3.00,72,0.76,42372.62,10,4,12,24,4,50.18,57,95,3,1,100.18,0.00,0.00,0.54,0,0.00,5,2294.30,0,1,1,java.lang.Object,0.00,18,0,18,0,18,5,1,24,453,1
"org.apache.jackrabbit.value.BinaryValue",9,0.21,2.44,55,0.62,21825.07,12,3,8,20,7,82.89,59,91,5,2,115.11,1.00,0.33,0.52,0,0.00,4,1852.40,1,3,2,org.apache.jackrabbit.value.BaseValue,0.27,11,1,22,1,11,6,0,13,398,1
"org.apache.jackrabbit.value.BinaryValueTest",1,0.00,1.00,5,0.07,1102.26,2,1,1,6,1,91.59,13,7,0,2,120.97,0.00,0.50,1.00,0,0.00,1,203.23,0,0,1,junit.framework.TestCase,0.00,5,1,1,0,5,1,0,11,50,1
"org.apache.jackrabbit.value.BooleanValue",11,0.30,1.55,46,0.38,9244.39,13,2,5,17,4,107.54,60,73,3,2,125.41,0.00,0.50,0.23,0,40.00,5,1149.57,1,4,1,org.apache.jackrabbit.value.BaseValue,0.50,6,1,17,0,6,7,0,14,281,1
"org.apache.jackrabbit.value.DateValue",10,0.11,2.20,63,0.57,16017.20,12,2,6,19,6,74.27,72,95,4,2,116.56,0.00,0.50,0.40,0,0.00,5,1709.23,1,4,2,org.apache.jackrabbit.value.BaseValue,0.52,9,1,22,0,9,6,0,13,381,1
"org.apache.jackrabbit.value.DecimalValue",10,0.17,2.00,56,0.49,13178.45,12,2,6,20,3,102.33,58,87,2,2,120.20,0.00,0.50,0.35,0,6.00,5,1455.98,1,4,1,org.apache.jackrabbit.value.BaseValue,0.52,10,1,20,0,10,6,0,14,334,1
"org.apache.jackrabbit.value.DoubleValue",11,0.15,1.91,59,0.52,13998.56,13,2,6,23,3,102.46,63,91,2,2,120.33,0.00,0.50,0.36,0,19.00,5,1570.07,1,4,1,org.apache.jackrabbit.value.BaseValue,0.50,12,1,21,0,12,7,0,15,360,1
"org.apache.jackrabbit.value.LongValue",11,0.15,1.91,59,0.52,13998.56,13,2,6,23,3,102.46,63,91,2,2,120.33,0.00,0.50,0.36,0,19.00,5,1570.07,1,4,1,org.apache.jackrabbit.value.BaseValue,0.50,12,1,21,0,12,7,0,15,360,1
"org.apache.jackrabbit.value.NameValue",10,0.39,1.60,43,0.35,9154.91,12,2,5,13,3,92.89,62,69,2,2,125.11,0.00,0.50,0.15,0,30.00,5,1054.35,1,4,1,org.apache.jackrabbit.value.BaseValue,0.52,3,1,16,0,3,6,0,13,258,1
"org.apache.jackrabbit.value.PathValue",10,0.39,1.60,43,0.35,9154.91,12,2,5,13,3,92.89,63,69,2,2,125.11,0.00,0.50,0.15,0,30.00,5,1054.35,1,4,1,org.apache.jackrabbit.value.BaseValue,0.52,3,1,16,0,3,6,0,13,258,1
"org.apache.jackrabbit.value.ReferenceValue",11,0.35,1.73,51,0.44,12202.76,13,2,8,17,4,92.22,71,82,2,2,124.44,0.00,0.50,0.18,0,39.00,5,1323.95,1,4,2,org.apache.jackrabbit.value.BaseValue,0.50,6,1,19,0,6,7,0,14,313,1
"org.apache.jackrabbit.value.StringValue",4,0.17,2.25,23,0.19,6243.19,6,2,2,6,8,77.30,31,32,7,2,119.59,0.00,0.50,0.38,0,6.00,5,573.39,0,1,1,org.apache.jackrabbit.value.BaseValue,0.12,2,1,9,0,2,3,0,6,136,1
"org.apache.jackrabbit.value.URIValue",10,0.39,1.70,45,0.39,11011.43,12,2,7,16,3,92.24,61,73,2,2,124.47,0.00,0.50,0.15,0,30.00,5,1173.25,1,4,1,org.apache.jackrabbit.value.BaseValue,0.52,6,1,17,0,6,6,0,13,280,1
"org.apache.jackrabbit.value.ValueFactoryImpl",4,1.00,1.00,7,0.05,668.32,5,1,2,5,1,135.62,20,12,0,2,153.49,0.00,0.50,0.25,0,6.00,1,160.01,0,1,1,org.apache.jackrabbit.value.AbstractValueFactory,0.00,1,1,4,0,1,3,0,7,48,1
"org.apache.jackrabbit.value.ValueHelper",13,0.00,6.38,265,4.62,857124.64,13,0,21,54,19,93.22,225,485,15,1,84.09,0.00,0.00,0.00,2,13.00,36,13863.59,0,11,4,java.lang.Object,0.00,41,0,83,0,41,2,0,101,2336,1
"org.apache.jackrabbit.value.ValueHelper$FileInputStream",1,0.00,1.00,4,0.02,230.72,1,0,21,3,0,179.93,1,5,0,1,129.93,0.00,0.00,0.00,0,1.00,1,72.55,0,0,0,java.lang.Object,0.00,2,0,1,0,2,1,0,1,22,0
"org.apache.jackrabbit.value.WeakReferenceValue",11,0.35,1.73,51,0.44,12202.76,13,2,8,17,4,92.22,71,82,2,2,124.44,0.00,0.50,0.18,0,39.00,5,1323.95,1,4,2,org.apache.jackrabbit.value.BaseValue,0.50,6,1,19,0,6,7,0,14,313,1
"org.apache.jackrabbit.standalone.Main",11,0.08,2.36,139,2.00,69703.66,17,6,25,81,3,100.61,6,186,1,1,100.61,0.00,0.00,0.24,8,0.00,9,6012.79,0,0,2,java.lang.Object,0.00,70,0,26,0,70,11,0,2,1074,1
"org.apache.jackrabbit.standalone.Main$Thread",1,0.00,2.00,9,0.06,785.12,1,0,25,3,0,112.45,0,12,0,1,112.45,0.00,0.00,0.00,0,0.00,2,173.67,0,0,0,java.lang.Object,0.00,2,0,2,0,2,1,0,0,43,0
"org.apache.jackrabbit.core.config.AccessManagerConfig",1,0.00,1.00,3,0.02,106.02,1,0,0,1,8,126.90,15,5,7,2,137.25,0.00,0.50,0.00,0,1.00,1,45.51,0,0,1,org.apache.jackrabbit.core.config.BeanConfig,0.00,0,1,1,0,0,1,0,2,16,1
"org.apache.jackrabbit.core.config.BeanConfig",10,0.04,1.80,49,0.66,29281.87,16,6,5,29,21,76.98,111,80,20,1,121.11,0.00,0.00,0.13,1,50.00,9,1989.69,0,5,1,java.lang.Object,0.00,19,0,18,6,19,5,0,20,394,1
"org.apache.jackrabbit.core.config.ClusterConfig",4,0.11,1.00,14,0.09,1063.86,7,3,0,4,11,86.00,35,19,10,1,134.11,0.00,0.00,0.25,0,10.00,1,260.02,0,2,1,java.lang.Object,0.00,0,0,4,0,0,2,0,8,74,1
"org.apache.jackrabbit.core.config.ConfigurationEntityResolver",2,0.67,3.00,28,0.33,11387.58,5,3,7,9,2,148.42,50,57,2,1,98.42,0.00,0.00,0.67,0,0.00,5,995.63,0,1,0,java.lang.Object,0.00,7,0,6,0,7,1,1,11,216,0
"org.apache.jackrabbit.core.config.ConfigurationErrorHandler",4,1.00,1.00,11,0.13,1631.34,5,1,5,9,2,139.45,17,16,2,1,139.21,0.00,0.00,0.25,1,6.00,1,396.21,0,0,0,java.lang.Object,0.00,5,0,4,0,5,4,1,4,101,1
"org.apache.jackrabbit.core.config.ConfigurationException",2,0.00,1.00,5,0.03,221.18,2,0,1,2,11,101.39,14,8,11,2,143.68,0.00,0.50,0.00,0,2.00,1,88.69,0,0,0,javax.jcr.RepositoryException,0.00,0,1,2,0,0,2,0,3,29,1
"org.apache.jackrabbit.core.config.ConfigurationParser",12,0.09,2.33,86,1.17,42152.92,17,5,14,37,7,81.98,159,133,2,1,111.36,0.00,0.00,0.12,4,54.00,6,3522.17,0,11,5,java.lang.Object,0.00,25,0,28,1,25,1,0,23,695,1
"org.apache.jackrabbit.core.config.JournalConfig",1,0.00,1.00,3,0.02,106.02,1,0,0,1,7,99.69,12,5,6,2,137.25,0.00,0.50,0.00,0,1.00,1,45.51,0,0,1,org.apache.jackrabbit.core.config.BeanConfig,0.00,0,1,1,0,0,1,0,2,16,1
"org.apache.jackrabbit.core.config.LoginModuleConfig",2,3.00,1.50,13,0.12,2436.28,5,3,1,3,12,97.44,29,18,10,2,117.58,0.00,0.50,0.00,0,2.00,2,346.39,2,1,2,org.apache.jackrabbit.core.config.BeanConfig,0.00,1,1,3,0,1,1,0,6,84,1
"org.apache.jackrabbit.core.config.PersistenceManagerConfig",1,0.00,1.00,3,0.02,106.02,1,0,0,1,6,126.90,15,5,5,2,137.25,0.00,0.50,0.00,0,1.00,1,45.51,0,0,1,org.apache.jackrabbit.core.config.BeanConfig,0.00,0,1,1,0,0,1,0,2,16,1
"org.apache.jackrabbit.core.config.RepositoryConfig",32,0.01,2.12,239,3.15,145006.46,50,18,40,103,32,72.95,404,383,15,1,110.51,0.00,0.00,0.07,6,688.00,16,9441.86,0,25,19,java.lang.Object,0.00,71,0,68,0,71,7,2,77,1744,1
"org.apache.jackrabbit.core.config.RepositoryConfigTest",13,0.22,2.31,110,1.45,34985.44,16,3,11,62,9,160.11,25,181,1,2,110.11,0.00,0.50,0.54,0,0.00,4,4336.89,0,0,8,junit.framework.TestCase,0.00,49,1,30,0,49,13,0,10,880,1
"org.apache.jackrabbit.core.config.RepositoryConfigTest$InputStream",1,0.00,1.00,3,0.02,208.76,1,0,11,2,0,134.94,0,4,0,1,134.94,0.00,0.00,0.00,0,1.00,1,52.97,0,0,0,java.lang.Object,0.00,1,0,1,0,1,1,0,0,17,0
"org.apache.jackrabbit.core.config.RepositoryConfigurationParser",18,0.03,1.67,164,2.38,62188.52,50,32,18,57,29,151.37,405,228,4,2,107.42,0.00,0.50,0.06,14,186.00,4,7125.65,7,12,26,org.apache.jackrabbit.core.config.ConfigurationParser,0.00,39,1,30,0,39,6,0,81,1304,1
"org.apache.jackrabbit.core.config.RepositoryConfigurationParser$DataStoreFactory",1,0.00,3.00,14,0.17,5320.74,1,0,18,8,2,98.65,0,16,0,1,98.65,0.00,0.00,0.00,0,0.00,3,495.54,0,1,2,java.lang.Object,0.00,7,0,3,0,7,0,0,0,95,0
"org.apache.jackrabbit.core.config.RepositoryConfigurationParser$FileSystemFactory",1,0.00,3.00,8,0.09,3039.08,1,0,18,5,2,109.63,0,15,0,1,109.63,0.00,0.00,0.00,0,1.00,3,271.22,0,1,2,java.lang.Object,0.00,4,0,3,0,4,0,0,0,60,0
"org.apache.jackrabbit.core.config.RepositoryConfigurationParser$ISMLockingFactory",1,0.00,3.00,10,0.11,3549.59,1,0,18,7,3,105.49,0,16,0,1,105.49,0.00,0.00,0.00,0,0.00,3,331.14,0,1,3,java.lang.Object,0.00,6,0,3,0,6,0,0,0,67,0
"org.apache.jackrabbit.core.config.RepositoryConfigurationParser$RepositoryLockMechanismFactory",1,0.00,4.00,16,0.18,7312.37,1,0,18,8,3,95.34,0,19,0,1,95.34,0.00,0.00,0.00,0,0.00,4,547.23,0,1,3,java.lang.Object,0.00,7,0,4,0,7,0,0,0,104,0
"org.apache.jackrabbit.core.config.SearchConfig",2,1.00,1.50,10,0.08,1356.60,3,1,4,3,8,93.16,27,15,5,2,122.54,0.00,0.50,0.50,0,2.00,2,226.00,0,1,3,org.apache.jackrabbit.core.config.BeanConfig,0.00,1,1,3,0,1,1,1,4,59,1
"org.apache.jackrabbit.core.config.SecurityConfig",5,0.06,1.00,18,0.12,1475.38,9,4,0,5,7,83.75,46,27,4,1,133.75,0.00,0.00,0.20,0,17.00,1,349.39,0,4,3,java.lang.Object,0.00,0,0,5,0,0,1,0,10,96,1
"org.apache.jackrabbit.core.config.SecurityConfigTest",6,0.09,2.17,74,1.15,30379.55,13,7,22,43,14,101.39,2,112,0,4,101.39,0.00,0.75,0.21,1,0.00,6,3448.77,2,1,14,org.apache.jackrabbit.test.AbstractJCRTest,0.28,37,3,13,0,37,5,0,2,638,1
"org.apache.jackrabbit.core.config.SecurityManagerConfig",3,0.25,1.00,11,0.07,947.85,5,2,0,3,7,85.41,26,16,6,2,133.52,0.00,0.50,0.33,0,5.00,1,211.52,0,1,1,org.apache.jackrabbit.core.config.BeanConfig,0.00,0,1,3,0,0,2,0,4,60,1
"org.apache.jackrabbit.core.config.TestAll",1,0.00,1.00,6,0.05,1283.53,1,0,3,3,2,79.93,12,8,0,2,117.50,0.00,0.50,0.00,0,1.00,1,150.40,0,1,2,junit.framework.TestCase,0.00,2,1,1,0,2,0,0,2,39,1
"org.apache.jackrabbit.core.config.VersioningConfig",5,0.06,1.00,18,0.14,2030.63,9,4,6,8,9,84.18,52,27,4,1,132.66,0.00,0.00,0.20,0,17.00,1,416.81,0,3,5,java.lang.Object,0.00,3,0,5,0,3,2,2,10,112,1
"org.apache.jackrabbit.core.config.WorkspaceConfig",9,0.02,1.00,34,0.26,3937.96,17,8,5,11,19,82.41,88,47,12,1,132.40,0.00,0.00,0.11,0,65.00,1,772.25,0,5,7,java.lang.Object,0.00,2,0,9,0,2,4,2,18,193,1
"org.apache.jackrabbit.core.config.WorkspaceConfigTest",2,0.00,2.00,26,0.42,10123.39,3,1,5,26,8,100.35,9,37,1,2,100.12,0.00,0.50,1.00,0,0.00,3,1253.98,0,0,7,junit.framework.TestCase,0.00,24,1,4,0,24,2,0,2,224,1
"org.apache.jackrabbit.core.config.WorkspaceSecurityConfig",2,1.00,1.00,6,0.03,334.48,3,1,0,2,7,117.82,11,9,6,1,135.69,0.00,0.00,0.50,0,2.00,1,95.56,0,0,1,java.lang.Object,0.00,0,0,2,0,0,2,0,4,30,1
"org.apache.jackrabbit.webdav.client.TestAll",1,0.00,1.00,6,0.05,1283.53,1,0,4,3,2,117.50,0,8,0,2,117.50,0.00,0.50,0.00,0,1.00,1,150.40,0,1,2,junit.framework.TestCase,0.00,2,1,1,0,2,0,0,0,39,1
"org.apache.jackrabbit.webdav.client.XmlRequestEntityTest",1,0.00,1.00,13,0.19,3331.12,1,0,11,16,2,101.71,0,15,1,2,101.71,0.00,0.50,0.00,0,1.00,1,565.53,0,0,1,junit.framework.TestCase,0.00,15,1,1,0,15,1,0,0,108,1
"org.apache.jackrabbit.core.persistence.AbstractPersistenceManager",10,0.00,1.90,42,0.48,23092.66,10,0,9,22,12,89.69,60,57,3,1,121.91,0.00,0.00,0.00,2,10.00,10,1440.07,0,2,9,java.lang.Object,0.00,12,0,19,8,12,8,1,11,314,2
"org.apache.jackrabbit.core.persistence.IterablePersistenceManager",1,0.00,1.00,2,0.02,93.27,1,0,4,1,6,162.39,18,4,3,2,144.26,0.00,0.50,0.00,0,1.00,1,56.15,0,1,3,,0.00,0,1,1,0,0,0,0,2,18,1
"org.apache.jackrabbit.core.persistence.PMContext",7,0.03,1.00,26,0.18,2285.83,13,6,6,7,20,85.30,60,39,16,1,133.41,0.00,0.00,0.14,0,37.00,1,542.32,0,6,4,java.lang.Object,0.00,0,0,7,0,0,1,0,14,140,1
"org.apache.jackrabbit.core.persistence.PersistenceCopier",4,0.11,2.75,51,0.70,28431.54,7,3,12,40,12,62.62,51,61,1,1,100.18,0.00,0.00,0.42,1,2.00,6,2113.53,0,0,11,java.lang.Object,0.00,36,0,11,0,36,4,0,13,391,1
"org.apache.jackrabbit.core.persistence.PersistenceManager",12,0.00,1.00,13,0.10,440.31,12,0,9,12,24,114.55,143,17,14,1,158.68,0.00,0.00,0.00,0,12.00,1,298.66,0,5,10,,0.00,0,0,12,0,0,7,0,13,101,1
"org.apache.jackrabbit.spi.commons.AbstractReadableRepositoryService",61,0.14,1.18,170,2.46,48189.61,67,6,53,101,22,137.15,284,347,0,2,136.91,0.00,0.50,0.03,4,682.00,3,7385.62,0,32,22,org.apache.jackrabbit.spi.commons.AbstractRepositoryService,0.00,40,1,72,0,40,29,0,80,1645,2
"org.apache.jackrabbit.spi.commons.AbstractRepositoryService",4,0.00,1.00,9,0.07,701.59,4,0,10,8,10,109.88,27,14,1,1,142.10,0.00,0.00,0.00,0,4.00,1,206.07,0,4,9,java.lang.Object,0.00,4,0,4,1,4,0,1,5,59,2
"org.apache.jackrabbit.spi.commons.ChildInfoImpl",4,0.11,1.00,14,0.09,1169.64,7,3,3,4,5,91.49,29,19,3,1,133.78,0.00,0.00,0.25,0,10.00,1,278.61,0,2,2,java.lang.Object,0.00,0,0,4,1,0,2,2,8,77,1
"org.apache.jackrabbit.spi.commons.EventBundleImpl",3,0.25,1.00,10,0.07,841.38,5,2,4,4,3,91.63,21,14,2,1,133.93,0.00,0.00,0.33,0,5.00,1,203.04,0,1,1,java.lang.Object,0.00,1,0,3,0,1,2,2,6,58,1
"org.apache.jackrabbit.spi.commons.EventFilterImpl",9,0.17,2.44,61,0.79,26956.50,15,6,10,34,7,96.52,50,97,3,1,114.39,0.00,0.00,0.31,0,17.00,10,2382.25,0,4,4,java.lang.Object,0.00,25,0,22,0,25,5,2,18,481,1
"org.apache.jackrabbit.spi.commons.EventImpl",12,0.02,1.08,49,0.49,11434.15,22,10,12,15,8,107.19,63,68,2,1,125.06,0.00,0.00,0.08,0,112.00,2,1473.69,0,8,6,java.lang.Object,0.00,3,0,13,1,3,4,2,20,332,1
"org.apache.jackrabbit.spi.commons.ItemInfoImpl",4,0.33,1.00,12,0.09,982.24,6,2,5,4,6,86.28,33,17,2,1,134.38,0.00,0.00,0.25,0,8.00,1,262.56,0,1,4,java.lang.Object,0.00,0,0,4,4,0,3,2,7,73,2
"org.apache.jackrabbit.spi.commons.LockInfoImpl",9,0.04,1.00,32,0.25,4101.20,16,7,3,9,3,89.97,69,45,1,1,132.27,0.00,0.00,0.11,0,58.00,1,752.42,0,3,2,java.lang.Object,0.00,0,0,9,1,0,6,2,17,193,1
"org.apache.jackrabbit.spi.commons.NodeInfoImpl",10,0.05,1.70,63,0.83,37768.25,17,7,11,34,10,65.58,80,89,2,2,113.68,1.00,0.33,0.10,0,66.00,5,2498.80,0,7,8,org.apache.jackrabbit.spi.commons.ItemInfoImpl,0.00,24,1,17,1,24,3,1,19,506,1
"org.apache.jackrabbit.spi.commons.NodeInfoImpl$Iterator",3,0.00,1.00,10,0.09,1381.99,3,0,11,12,2,132.23,0,15,0,1,132.23,0.00,0.00,0.00,0,3.00,1,281.01,0,1,2,java.lang.Object,0.00,9,0,3,0,9,2,0,0,72,0
"org.apache.jackrabbit.spi.commons.NodeInfoImpl$Iterator_0",3,0.00,1.33,11,0.09,2012.51,3,0,11,8,2,130.88,0,15,0,1,130.88,0.00,0.00,0.00,0,1.00,2,263.44,0,1,2,java.lang.Object,0.00,5,0,4,0,5,2,0,0,68,0
"org.apache.jackrabbit.spi.commons.PropertyInfoImpl",7,0.12,1.14,31,0.36,8380.48,11,4,8,20,10,76.17,56,48,2,2,124.27,1.00,0.33,0.14,0,27.00,2,1087.46,0,3,8,org.apache.jackrabbit.spi.commons.ItemInfoImpl,0.00,13,1,8,1,13,4,1,12,245,1
"org.apache.jackrabbit.spi.commons.QItemDefinitionImpl",10,0.04,1.40,38,0.45,11974.86,18,8,6,23,8,86.59,78,59,3,1,128.88,0.00,0.00,0.16,0,42.00,5,1359.51,0,2,5,java.lang.Object,0.00,13,0,14,4,13,8,2,21,303,2
"org.apache.jackrabbit.spi.commons.QNodeDefinitionImpl",8,0.10,1.75,43,0.54,19412.93,11,3,4,28,7,75.85,63,72,4,2,118.14,1.00,0.33,0.25,1,26.00,4,1628.53,4,2,3,org.apache.jackrabbit.spi.commons.QItemDefinitionImpl,0.11,20,1,14,1,20,6,1,16,354,1
"org.apache.jackrabbit.spi.commons.QNodeTypeDefinitionImpl",19,0.03,2.21,147,2.15,99245.93,30,11,24,82,21,77.79,120,218,5,1,110.02,0.00,0.00,0.06,1,198.00,11,6446.27,0,12,16,java.lang.Object,0.00,63,0,42,1,63,7,2,35,1255,1
"org.apache.jackrabbit.spi.commons.QPropertyDefinitionImpl",12,0.08,1.67,68,0.89,36088.31,19,7,7,36,9,69.31,96,110,4,2,117.42,1.00,0.33,0.21,1,54.00,6,2673.15,4,3,5,org.apache.jackrabbit.spi.commons.QItemDefinitionImpl,0.09,24,1,20,1,24,9,1,23,549,1
"org.apache.jackrabbit.spi.commons.SerializableBatch",13,0.08,1.08,44,0.53,9308.69,15,2,20,25,6,180.70,24,64,0,1,130.70,0.00,0.00,0.42,0,0.00,2,1603.33,0,1,6,java.lang.Object,0.00,12,0,14,0,12,12,2,6,372,1
"org.apache.jackrabbit.spi.commons.SerializableBatch$AddNode",2,0.50,1.00,12,0.11,1497.16,6,4,20,3,3,169.34,3,15,0,1,119.34,0.00,0.00,0.50,0,2.00,1,329.26,0,0,3,java.lang.Object,0.00,1,0,2,0,1,2,1,1,84,2
"org.apache.jackrabbit.spi.commons.SerializableBatch$AddProperty",2,0.50,1.50,15,0.14,2432.83,6,4,20,3,4,165.09,3,20,0,1,115.09,0.00,0.00,0.50,0,2.00,2,420.06,0,0,4,java.lang.Object,0.00,1,0,3,0,1,2,1,1,101,2
"org.apache.jackrabbit.spi.commons.SerializableBatch$Move",2,0.33,1.00,10,0.09,1155.23,5,3,20,3,3,173.18,3,13,0,1,123.18,0.00,0.00,0.50,0,2.00,1,258.40,0,0,3,java.lang.Object,0.00,1,0,2,0,1,2,1,1,69,2
"org.apache.jackrabbit.spi.commons.SerializableBatch$Operation",1,0.00,1.00,2,0.01,88.08,1,0,20,1,1,102.16,7,3,0,2,144.46,0.00,0.50,0.00,0,1.00,1,44.04,0,0,1,,0.00,0,1,1,0,0,1,0,1,15,1
"org.apache.jackrabbit.spi.commons.SerializableBatch$Remove",2,1.00,1.00,6,0.05,478.47,3,1,20,3,2,184.47,3,9,0,1,134.47,0.00,0.00,0.50,0,2.00,1,135.35,0,0,2,java.lang.Object,0.00,1,0,2,0,1,2,1,1,39,2
"org.apache.jackrabbit.spi.commons.SerializableBatch$ReorderNodes",2,0.33,1.00,10,0.08,1275.81,5,3,20,3,2,172.84,3,13,0,1,122.84,0.00,0.00,0.50,0,2.00,1,252.33,0,0,2,java.lang.Object,0.00,1,0,2,0,1,2,1,1,69,2
"org.apache.jackrabbit.spi.commons.SerializableBatch$SetMixins",2,0.00,1.00,8,0.07,904.53,4,2,20,3,3,177.63,3,11,0,1,127.63,0.00,0.00,0.50,0,2.00,1,208.76,0,0,3,java.lang.Object,0.00,1,0,2,0,1,2,1,1,56,2
"org.apache.jackrabbit.spi.commons.SerializableBatch$SetPrimaryType",2,0.00,1.00,8,0.07,752.94,4,2,20,3,3,178.26,3,11,0,1,128.26,0.00,0.00,0.50,0,2.00,1,196.96,0,0,3,java.lang.Object,0.00,1,0,2,0,1,2,1,1,54,2
"org.apache.jackrabbit.spi.commons.SerializableBatch$SetValue",2,0.33,1.50,13,0.11,1944.51,5,3,20,3,3,168.35,3,17,0,1,118.35,0.00,0.00,0.50,0,2.00,2,342.29,0,0,3,java.lang.Object,0.00,1,0,3,0,1,2,1,1,85,2
"org.apache.jackrabbit.spi.commons.SessionInfoImpl",9,0.12,1.00,22,0.17,2263.27,13,4,5,14,3,122.99,50,32,2,1,140.87,0.00,0.00,0.14,0,32.00,1,504.49,0,3,1,java.lang.Object,0.00,5,0,9,1,5,6,2,15,140,1
"org.apache.jackrabbit.core.integration.random.task.ContentOperationsTask",2,0.00,1.00,5,0.06,815.97,2,0,3,3,4,189.21,3,11,1,2,139.21,0.00,0.50,0.00,0,2.00,1,189.26,0,1,3,org.apache.jackrabbit.core.integration.random.task.RandomOperationsTask,0.00,1,1,2,0,1,1,0,1,49,1
"org.apache.jackrabbit.core.integration.random.task.RandomOperationsTask",5,0.00,1.60,32,0.42,13947.60,11,6,7,18,5,164.73,5,48,2,1,114.73,0.00,0.00,0.17,1,11.00,4,1262.57,0,1,3,java.lang.Object,0.00,13,0,8,2,13,4,1,3,259,2
"org.apache.jackrabbit.core.integration.random.task.VersionOperationsTask",2,0.00,1.00,6,0.06,835.17,2,0,3,3,4,182.56,3,12,1,2,132.56,0.00,0.50,0.00,0,2.00,1,193.26,0,1,3,org.apache.jackrabbit.core.integration.random.task.RandomOperationsTask,0.00,1,1,2,0,1,1,0,1,50,1
"org.apache.jackrabbit.core.fs.AbstractFileSystemTest",8,0.07,1.25,189,2.73,386836.31,10,2,5,36,4,103.88,25,203,2,2,83.26,3.00,0.20,0.56,2,0.00,3,8178.19,0,1,2,junit.framework.TestCase,0.00,28,1,10,3,28,7,0,25,1455,2
"org.apache.jackrabbit.core.fs.BasedFileSystem",22,0.02,1.36,64,0.69,14640.18,24,2,2,46,7,158.08,72,96,4,1,137.47,0.00,0.00,0.48,1,0.00,6,2081.62,0,6,3,java.lang.Object,0.00,24,0,30,0,24,16,1,25,516,1
"org.apache.jackrabbit.core.fs.FileSystem",20,2.00,1.00,23,0.18,987.13,22,2,2,20,41,107.67,180,25,39,1,157.67,0.00,0.00,0.00,0,20.00,1,552.89,0,5,2,,0.00,0,0,20,0,0,15,0,23,181,1
"org.apache.jackrabbit.core.fs.FileSystemException",2,0.00,1.00,5,0.03,221.18,2,0,0,2,26,95.20,20,8,26,2,143.68,0.00,0.50,0.00,0,2.00,1,88.69,0,0,0,java.lang.Exception,0.00,0,1,2,0,0,2,0,3,29,1
"org.apache.jackrabbit.core.fs.FileSystemFactory",1,0.00,1.00,2,0.01,38.26,1,0,1,1,6,127.16,14,3,5,1,147.31,0.00,0.00,0.00,0,1.00,1,25.51,0,1,1,,0.00,0,0,1,0,0,0,0,2,11,1
"org.apache.jackrabbit.core.fs.FileSystemPathUtil",9,0.12,2.44,94,1.08,53821.33,13,4,2,32,8,53.75,84,104,6,1,103.75,0.00,0.00,0.14,1,33.00,7,3232.14,0,6,2,java.lang.Object,0.00,23,0,22,0,23,3,0,20,641,2
"org.apache.jackrabbit.core.fs.FileSystemResource",20,0.18,1.45,65,0.61,15239.81,22,2,4,38,25,130.66,98,100,21,1,130.42,0.00,0.00,0.68,3,0.00,5,1835.94,0,7,4,java.lang.Object,0.00,18,0,29,0,18,13,0,23,453,1
"org.apache.jackrabbit.core.fs.RandomAccessOutputStream",1,0.00,1.00,2,0.02,132.18,1,0,2,1,7,105.50,12,3,7,2,143.07,1.00,0.33,0.00,0,1.00,1,52.87,0,0,0,java.io.OutputStream,0.00,0,1,1,1,0,1,0,2,17,2
"org.apache.jackrabbit.core.fs.local.FileUtil",3,0.00,4.67,38,0.46,29992.15,3,0,3,17,2,50.79,25,47,2,1,98.89,0.00,0.00,0.00,2,3.00,9,1373.03,0,0,0,java.lang.Object,0.00,14,0,14,0,14,3,0,8,262,2
"org.apache.jackrabbit.core.fs.local.HandleMonitor",6,0.00,1.50,28,0.28,6106.33,8,2,9,17,3,82.47,43,36,2,1,124.76,0.00,0.00,0.50,1,0.00,2,837.63,0,1,1,java.lang.Object,0.00,11,0,9,0,11,5,0,10,200,1
"org.apache.jackrabbit.core.fs.local.HandleMonitor$Handle",5,0.12,1.60,24,0.24,5412.31,7,2,9,14,1,106.67,29,33,0,1,124.54,0.00,0.00,0.60,1,2.00,3,728.23,0,1,1,java.lang.Object,0.00,9,0,8,0,9,4,0,8,174,1
"org.apache.jackrabbit.core.fs.local.HandleMonitor$Handle$MonitoredInputStream",3,1.00,1.00,9,0.07,820.15,4,1,9,5,1,134.25,13,13,0,3,134.01,0.00,0.67,0.33,0,4.00,1,213.99,1,0,1,org.apache.jackrabbit.util.LazyFileInputStream,0.19,2,2,3,0,2,3,0,5,60,1
"org.apache.jackrabbit.core.fs.local.LocalFileSystem",30,0.11,2.27,208,2.54,100627.28,33,3,14,68,16,134.64,101,286,9,1,114.02,0.00,0.00,0.44,3,0.00,6,7617.83,0,9,7,java.lang.Object,0.00,38,0,68,0,38,21,1,32,1569,1
"org.apache.jackrabbit.core.fs.local.LocalFileSystem$FileFilter",1,0.00,1.00,3,0.02,173.90,1,0,14,2,0,135.56,0,4,0,1,135.56,0.00,0.00,0.00,0,1.00,1,52.97,0,0,0,java.lang.Object,0.00,1,0,1,0,1,1,0,0,17,0
"org.apache.jackrabbit.core.fs.local.LocalFileSystem$FileFilter_0",1,0.00,1.00,3,0.02,173.90,1,0,14,2,0,135.56,0,4,0,1,135.56,0.00,0.00,0.00,0,1.00,1,52.97,0,0,0,java.lang.Object,0.00,1,0,1,0,1,1,0,0,17,0
"org.apache.jackrabbit.core.fs.local.LocalFileSystemTest",4,0.33,1.25,21,0.17,4127.42,5,1,4,10,3,121.14,0,24,0,3,121.14,0.00,0.67,0.75,1,0.00,2,521.49,2,1,3,org.apache.jackrabbit.core.fs.AbstractFileSystemTest,0.75,6,2,5,0,6,3,0,0,126,1
"org.apache.jackrabbit.core.fs.local.RAFOutputStream",9,0.12,1.11,39,0.37,7311.79,15,6,3,14,2,93.38,59,50,1,3,125.60,0.00,0.67,0.28,2,17.00,2,1095.68,0,0,1,org.apache.jackrabbit.core.fs.RandomAccessOutputStream,0.30,5,2,10,0,5,9,0,17,260,0
"org.apache.jackrabbit.api.security.user.AbstractUserTest",11,1.00,2.00,58,0.70,22131.41,12,1,20,37,20,118.75,6,81,8,4,118.75,5.67,0.14,0.09,4,20.00,4,2114.74,1,10,12,org.apache.jackrabbit.test.AbstractJCRTest,0.12,26,3,22,17,26,1,0,4,459,2
"org.apache.jackrabbit.api.security.user.Authorizable",15,0.00,1.00,16,0.11,519.64,15,0,5,15,31,108.88,139,17,29,1,158.88,0.00,0.00,0.00,0,15.00,1,326.90,0,7,2,,0.00,0,0,15,0,0,8,0,16,114,1
"org.apache.jackrabbit.api.security.user.AuthorizableExistsException",1,0.00,1.00,3,0.02,106.02,1,0,1,1,8,157.87,3,5,8,2,137.25,0.00,0.50,0.00,0,1.00,1,45.51,0,0,0,javax.jcr.RepositoryException,0.00,0,1,1,0,0,1,0,1,16,1
"org.apache.jackrabbit.api.security.user.AuthorizableTest",23,1.00,1.96,200,2.33,66472.14,24,1,9,63,8,149.79,52,258,1,5,109.90,0.00,0.80,0.00,0,0.00,4,6991.11,3,0,7,org.apache.jackrabbit.api.security.user.AbstractUserTest,0.00,40,4,45,0,40,23,0,18,1392,1
"org.apache.jackrabbit.api.security.user.Group",5,0.00,1.00,6,0.04,190.72,5,0,2,5,20,116.26,36,7,19,2,158.55,0.00,0.50,0.00,0,5.00,1,121.11,0,2,1,,0.00,0,1,5,0,0,3,0,6,43,1
"org.apache.jackrabbit.api.security.user.GroupTest",19,1.00,2.05,176,2.17,60867.42,20,1,7,46,6,107.63,13,227,1,5,107.63,0.00,0.80,0.00,4,0.00,3,6498.14,3,0,5,org.apache.jackrabbit.api.security.user.AbstractUserTest,0.00,27,4,39,0,27,19,0,5,1318,1
"org.apache.jackrabbit.api.security.user.Impersonation",4,0.00,1.00,5,0.03,146.26,4,0,4,4,8,108.69,37,6,7,1,158.69,0.00,0.00,0.00,0,4.00,1,97.51,0,1,1,,0.00,0,0,4,0,0,3,0,5,35,1
"org.apache.jackrabbit.api.security.user.ImpersonationTest",18,0.04,1.22,106,1.17,22737.59,21,3,10,34,5,120.46,5,149,1,5,120.46,0.00,0.80,0.37,1,0.00,2,3514.92,7,2,4,org.apache.jackrabbit.api.security.user.AbstractUserTest,0.19,16,4,22,0,16,16,0,3,766,1
"org.apache.jackrabbit.api.security.user.NestedGroupTest",6,1.00,3.83,81,0.98,57135.80,7,1,7,19,7,97.81,5,105,1,5,97.81,0.00,0.80,0.00,0,0.00,8,2929.00,3,0,6,org.apache.jackrabbit.api.security.user.AbstractUserTest,0.25,13,4,23,0,13,6,0,3,587,1
"org.apache.jackrabbit.api.security.user.TestAll",1,0.00,1.00,12,0.13,4399.74,1,0,3,3,8,59.76,7,14,0,2,102.05,0.00,0.50,0.00,0,1.00,1,381.92,0,1,8,junit.framework.TestCase,0.00,2,1,1,0,2,0,0,1,87,1
"org.apache.jackrabbit.api.security.user.User",4,0.00,1.00,5,0.03,126.72,4,0,2,4,26,126.96,24,6,25,2,159.18,0.00,0.50,0.00,0,4.00,1,81.11,0,2,1,,0.00,0,1,4,0,0,2,0,5,31,1
"org.apache.jackrabbit.api.security.user.UserManager",8,3.00,1.00,12,0.12,725.92,11,3,3,8,24,135.44,118,14,20,1,155.58,0.00,0.00,0.00,0,8.00,1,364.95,0,6,4,,0.00,0,0,8,0,0,2,0,12,107,1
"org.apache.jackrabbit.api.security.user.UserManagerCreateGroupTest",5,0.00,2.00,44,0.52,9768.53,7,2,7,23,5,161.24,7,56,1,5,111.24,0.00,0.80,0.50,0,0.00,3,1551.15,2,0,4,org.apache.jackrabbit.api.security.user.AbstractUserTest,0.13,18,4,10,0,18,5,0,5,327,1
"org.apache.jackrabbit.api.security.user.UserManagerCreateUserTest",15,0.00,1.87,120,1.52,30297.25,17,2,7,31,5,161.14,15,158,1,5,111.14,0.00,0.80,0.50,0,0.00,3,4568.95,2,0,4,org.apache.jackrabbit.api.security.user.AbstractUserTest,0.10,16,4,28,0,16,15,0,13,945,1
"org.apache.jackrabbit.api.security.user.UserManagerTest",2,0.00,2.50,23,0.25,5811.56,2,0,5,7,4,144.56,5,23,1,5,104.67,0.00,0.80,0.00,0,0.00,3,757.86,1,0,3,org.apache.jackrabbit.api.security.user.AbstractUserTest,0.00,5,4,5,0,5,2,0,3,153,1
"org.apache.jackrabbit.api.security.user.UserTest",6,1.00,1.50,39,0.48,10909.42,7,1,8,24,4,166.21,7,55,1,5,116.21,0.00,0.80,0.00,0,0.00,3,1439.11,1,0,3,org.apache.jackrabbit.api.security.user.AbstractUserTest,0.00,18,4,9,0,18,6,0,5,297,1
"org.apache.jackrabbit.core.nodetype.BitsetENTCacheImpl",13,0.08,1.77,86,0.90,26587.80,19,6,7,42,5,83.55,90,107,2,1,115.77,0.00,0.00,0.24,5,5.00,4,2708.43,0,4,3,java.lang.Object,0.00,29,0,23,0,29,9,1,27,603,1
"org.apache.jackrabbit.core.nodetype.BitsetENTCacheImpl$BitsetKey",12,0.09,3.42,124,1.60,103573.30,15,3,7,20,2,70.20,79,149,0,1,102.42,0.00,0.00,0.42,1,0.00,8,4804.37,0,3,2,java.lang.Object,0.00,8,0,41,0,8,9,1,18,958,1
"org.apache.jackrabbit.core.nodetype.CyclicNodeTypeRegistrationTest",5,0.60,2.40,107,1.69,81577.73,10,5,11,34,12,58.92,69,123,0,4,88.30,0.00,0.75,0.68,0,0.00,3,5084.33,2,0,12,org.apache.jackrabbit.test.AbstractJCRTest,0.29,29,3,12,0,29,5,0,19,905,1
"org.apache.jackrabbit.core.nodetype.EffectiveNodeType",41,0.02,5.05,546,7.55,648056.28,49,8,15,131,25,53.72,289,764,17,1,96.01,0.00,0.00,0.15,9,444.00,24,22647.73,0,19,10,java.lang.Object,0.00,90,0,207,0,90,22,1,129,4140,1
"org.apache.jackrabbit.core.nodetype.EffectiveNodeTypeCache",8,0.00,1.00,10,0.06,224.51,8,0,2,8,6,127.37,53,11,4,3,159.60,0.00,0.67,0.00,0,8.00,1,168.83,0,1,3,,0.00,0,2,8,0,0,7,0,10,62,1
"org.apache.jackrabbit.core.nodetype.EffectiveNodeTypeCache$Key",3,0.00,1.00,4,0.02,72.40,3,0,2,3,1,117.82,22,5,0,2,160.11,0.00,0.50,0.00,0,3.00,1,54.98,0,2,1,,0.00,0,1,3,0,0,1,0,3,23,0
"org.apache.jackrabbit.core.nodetype.EffectiveNodeTypeCacheImpl",11,0.10,1.82,63,0.60,12933.92,13,2,10,32,4,72.51,91,81,1,1,120.61,0.00,0.00,0.59,4,0.00,4,1796.26,0,1,3,java.lang.Object,0.00,21,0,20,0,21,10,1,33,418,1
"org.apache.jackrabbit.core.nodetype.EffectiveNodeTypeCacheImpl$WeightedKey",11,0.05,1.82,68,0.68,24613.45,13,2,10,25,1,115.69,51,76,0,1,115.46,0.00,0.00,0.45,0,0.00,5,2032.43,0,2,1,java.lang.Object,0.00,14,0,20,0,14,9,1,19,450,2
"org.apache.jackrabbit.core.nodetype.InvalidNodeTypeDefException",2,0.00,1.00,5,0.03,221.18,2,0,0,2,10,93.68,18,8,10,2,143.68,0.00,0.50,0.00,0,2.00,1,88.69,0,0,0,java.lang.Exception,0.00,0,1,2,0,0,2,0,3,29,1
"org.apache.jackrabbit.core.nodetype.ItemDef",8,2.00,1.00,11,0.05,589.41,10,2,2,8,9,124.07,54,12,7,1,156.30,0.00,0.00,0.00,0,8.00,1,151.57,0,2,2,,0.00,0,0,8,0,0,6,0,10,55,1
"org.apache.jackrabbit.core.nodetype.ItemDefImpl",17,0.02,1.35,54,0.51,13619.19,23,6,3,25,6,98.05,105,83,3,1,130.27,0.00,0.00,0.19,0,88.00,5,1536.04,0,2,3,java.lang.Object,0.00,8,0,23,2,8,15,1,25,372,2
"org.apache.jackrabbit.core.nodetype.ItemDefinitionImpl",11,0.08,1.55,45,0.38,7132.45,16,5,8,25,7,94.08,69,67,3,1,126.30,0.00,0.00,0.27,0,0.00,3,1141.08,0,3,4,java.lang.Object,0.00,14,0,17,2,14,8,1,21,281,1
"org.apache.jackrabbit.core.nodetype.NodeDef",4,1.00,1.00,6,0.03,407.08,5,1,1,4,27,122.97,27,7,26,2,155.19,0.00,0.50,0.00,0,4.00,1,96.55,0,2,2,,0.00,0,1,4,0,0,2,0,5,34,1
"org.apache.jackrabbit.core.nodetype.NodeDefId",6,0.20,2.17,43,0.43,16773.45,8,2,3,20,18,64.05,50,54,17,1,112.16,0.00,0.00,0.33,0,0.00,5,1300.83,0,2,2,java.lang.Object,0.00,14,0,13,0,14,4,1,14,271,1
"org.apache.jackrabbit.core.nodetype.NodeDefImpl",19,0.07,1.32,72,0.65,13470.73,23,4,7,35,13,112.82,109,113,6,2,130.69,0.00,0.50,0.32,0,0.00,4,1945.00,8,3,7,org.apache.jackrabbit.core.nodetype.ItemDefImpl,0.28,16,1,25,0,16,16,1,36,472,1
"org.apache.jackrabbit.core.nodetype.NodeDefinitionImpl",7,0.50,2.71,58,0.64,28243.53,8,1,9,15,11,60.21,72,77,6,2,108.69,0.00,0.50,0.57,0,0.00,5,1931.97,0,4,6,org.apache.jackrabbit.core.nodetype.ItemDefinitionImpl,0.00,8,1,19,0,8,3,1,18,396,1
"org.apache.jackrabbit.core.nodetype.NodeTypeConflictException",2,0.00,1.00,5,0.03,221.18,2,0,0,2,10,93.68,18,8,10,2,143.68,0.00,0.50,0.00,0,2.00,1,88.69,0,0,0,java.lang.Exception,0.00,0,1,2,0,0,2,0,3,29,1
"org.apache.jackrabbit.core.nodetype.NodeTypeDef",26,0.11,1.88,154,1.77,61770.22,36,10,15,63,36,100.32,151,214,24,1,118.20,0.00,0.00,0.21,3,194.00,11,5319.47,0,6,12,java.lang.Object,0.00,37,0,49,0,37,20,1,37,1108,1
"org.apache.jackrabbit.core.nodetype.NodeTypeDefDiff",16,0.19,2.56,164,1.95,100314.95,25,9,9,48,8,53.58,145,195,2,1,103.58,0.00,0.00,0.28,3,0.00,7,5835.71,0,4,6,java.lang.Object,0.00,32,0,41,0,32,12,0,35,1129,1
"org.apache.jackrabbit.core.nodetype.NodeTypeDefDiff$ChildItemDefDiff",7,0.28,2.57,51,0.46,14393.06,10,3,9,15,1,153.05,14,71,0,1,113.17,0.00,0.00,0.57,5,0.00,8,1383.02,0,1,1,java.lang.Object,0.00,8,0,18,0,8,6,0,11,308,1
"org.apache.jackrabbit.core.nodetype.NodeTypeDefDiff$ChildNodeDefDiff",4,0.00,2.25,22,0.23,7277.90,4,0,9,10,1,158.95,10,32,0,2,119.07,0.00,0.50,0.00,2,10.00,6,693.70,1,0,1,org.apache.jackrabbit.core.nodetype.ChildItemDefDiff,0.00,6,1,9,0,6,4,0,5,152,1
"org.apache.jackrabbit.core.nodetype.NodeTypeDefDiff$PropDefDiff",4,0.00,3.50,43,0.48,30773.69,4,0,9,13,2,103.04,19,51,0,2,102.81,0.00,0.50,0.00,2,10.00,11,1448.00,1,0,2,org.apache.jackrabbit.core.nodetype.ChildItemDefDiff,0.00,9,1,14,0,9,4,0,11,273,1
"org.apache.jackrabbit.core.nodetype.NodeTypeDefStore",10,0.22,1.30,31,0.34,6059.48,11,1,16,26,9,131.47,48,48,1,1,131.23,0.00,0.00,0.80,1,0.00,3,1022.30,0,2,8,java.lang.Object,0.00,16,0,13,0,16,8,0,12,243,1
"org.apache.jackrabbit.core.nodetype.NodeTypeDefinitionImpl",10,0.22,1.70,61,0.60,16812.87,14,4,9,26,7,74.16,71,73,0,1,116.45,0.00,0.00,0.45,0,0.00,3,1802.97,0,5,7,java.lang.Object,0.00,16,0,17,0,16,5,1,15,401,1
"org.apache.jackrabbit.core.nodetype.NodeTypeImpl",31,0.16,2.77,281,3.23,139701.28,38,7,22,83,24,64.11,229,350,13,2,106.40,0.00,0.50,0.30,2,0.00,15,9675.24,0,15,12,org.apache.jackrabbit.spi.commons.nodetype.AbstractNodeType,0.00,52,1,86,0,52,16,2,84,1915,1
"org.apache.jackrabbit.core.nodetype.NodeTypeManagerImpl",22,0.08,4.55,342,5.34,444932.46,31,9,50,158,40,44.40,229,460,11,2,92.87,0.00,0.50,0.19,4,58.00,34,16015.67,0,13,33,org.apache.jackrabbit.spi.commons.nodetype.AbstractNodeTypeManager,0.00,136,1,100,0,136,9,3,68,2696,1
"org.apache.jackrabbit.core.nodetype.NodeTypeRegistry",48,0.03,4.38,728,11.18,1310729.48,63,15,37,231,52,62.47,658,1024,28,1,91.86,0.00,0.00,0.10,19,894.00,54,33530.92,0,3,25,java.lang.Object,0.00,183,0,210,0,183,45,2,208,5539,1
"org.apache.jackrabbit.core.nodetype.NodeTypeRegistryListener",3,0.00,1.00,4,0.02,61.53,3,0,1,3,3,118.38,22,5,2,1,160.67,0.00,0.00,0.00,0,3.00,1,56.53,0,0,1,,0.00,0,0,3,0,0,3,0,4,23,1
"org.apache.jackrabbit.core.nodetype.NodeTypesInContentTest",2,1.00,1.50,13,0.18,3099.59,3,1,12,15,7,98.88,11,17,1,4,116.76,0.00,0.75,0.50,0,0.00,2,551.27,1,0,6,org.apache.jackrabbit.test.AbstractJCRTest,0.16,13,3,3,0,13,2,0,3,116,1
"org.apache.jackrabbit.core.nodetype.NodeTypesInContentTest$TraversingItemVisitor.Default",1,0.00,3.00,10,0.12,3100.02,1,0,12,7,0,105.95,0,10,0,1,105.95,0.00,0.00,0.00,0,1.00,3,345.51,0,0,0,java.lang.Object,0.00,6,0,3,0,6,1,0,0,72,0
"org.apache.jackrabbit.core.nodetype.PropDef",8,1.00,1.00,10,0.05,457.91,9,1,2,8,29,139.29,47,11,27,2,157.16,0.00,0.50,0.00,0,8.00,1,135.77,0,4,3,,0.00,0,1,8,0,0,4,0,9,52,1
"org.apache.jackrabbit.core.nodetype.PropDefId",6,0.20,2.00,35,0.35,11217.10,8,2,1,20,16,70.90,51,47,16,1,119.00,0.00,0.00,0.33,0,0.00,4,1062.85,0,2,1,java.lang.Object,0.00,14,0,12,0,14,4,1,12,236,1
"org.apache.jackrabbit.core.nodetype.PropDefImpl",27,0.04,1.33,107,1.01,25488.34,35,8,10,40,15,111.84,157,163,5,2,129.71,0.00,0.50,0.16,0,178.00,4,3024.96,8,4,10,org.apache.jackrabbit.core.nodetype.ItemDefImpl,0.23,13,1,36,0,13,23,1,52,693,1
"org.apache.jackrabbit.core.nodetype.PropertyDefinitionImpl",9,0.38,1.78,48,0.58,24404.52,11,2,12,23,16,99.89,45,64,8,2,117.76,0.00,0.50,0.17,0,0.00,5,1738.59,1,3,9,org.apache.jackrabbit.core.nodetype.ItemDefinitionImpl,0.00,14,1,16,0,14,6,1,13,363,1
"org.apache.jackrabbit.core.nodetype.TestAll",1,0.00,1.00,5,0.04,864.35,1,0,3,3,1,73.32,10,7,0,2,121.80,0.00,0.50,0.00,0,1.00,1,115.51,0,1,1,junit.framework.TestCase,0.00,2,1,1,0,2,0,0,2,31,1
"org.apache.jackrabbit.test.api.lock.AbstractLockTest",30,0.16,1.67,196,2.53,78951.25,35,5,17,86,8,135.54,91,270,3,4,114.92,1.00,0.43,0.35,2,0.00,5,7601.62,5,2,5,org.apache.jackrabbit.test.AbstractJCRTest,0.15,56,3,50,3,56,28,0,43,1557,2
"org.apache.jackrabbit.test.api.lock.DeepLockTest",8,1.00,1.88,53,0.61,13127.04,9,1,7,28,3,166.51,9,81,1,5,116.51,0.00,0.80,0.00,0,0.00,5,1828.39,1,0,2,org.apache.jackrabbit.test.api.lock.AbstractLockTest,0.16,20,4,15,0,20,8,0,9,388,1
"org.apache.jackrabbit.test.api.lock.LockManagerTest",23,0.35,1.57,194,2.41,45718.03,27,4,14,58,3,161.24,24,265,1,4,111.24,0.00,0.75,0.59,3,0.00,3,7244.95,3,1,2,org.apache.jackrabbit.test.AbstractJCRTest,0.17,35,3,36,0,35,22,0,24,1422,1
"org.apache.jackrabbit.test.api.lock.LockTest",24,0.00,1.54,278,3.55,84112.41,24,0,9,72,3,56.04,211,369,1,4,104.14,0.00,0.75,0.00,1,0.00,3,10645.91,1,1,2,org.apache.jackrabbit.test.AbstractJCRTest,0.00,48,3,37,0,48,23,0,143,2060,1
"org.apache.jackrabbit.test.api.lock.OpenScopedLockTest",3,1.00,1.00,8,0.06,699.10,4,1,2,6,2,191.13,4,12,1,5,141.13,0.00,0.80,0.00,0,4.00,1,172.97,0,0,1,org.apache.jackrabbit.test.api.lock.AbstractLockTest,0.18,3,4,3,0,3,3,0,2,49,1
"org.apache.jackrabbit.test.api.lock.SessionScopedLockTest",5,1.00,1.60,39,0.51,12146.42,6,1,9,23,3,133.32,15,55,1,5,112.71,0.00,0.80,0.00,0,10.00,3,1538.23,2,0,2,org.apache.jackrabbit.test.api.lock.AbstractLockTest,0.17,18,4,8,0,18,5,0,8,295,1
"org.apache.jackrabbit.test.api.lock.SetValueLockExceptionTest",5,0.40,5.00,123,1.84,88746.02,26,21,13,29,3,37.58,41,159,1,4,85.68,0.00,0.75,0.37,1,0.00,15,5534.77,4,1,2,org.apache.jackrabbit.test.AbstractJCRTest,0.29,24,3,25,0,24,4,0,15,920,1
"org.apache.jackrabbit.test.api.lock.TestAll",1,0.00,1.00,10,0.10,3275.34,1,0,3,3,8,68.45,12,12,2,2,106.02,0.00,0.50,0.00,0,1.00,1,301.01,0,1,6,junit.framework.TestCase,0.00,2,1,1,0,2,0,0,3,71,1
"org.apache.jackrabbit.jcr.DocViewImportHandler",8,0.04,3.62,103,1.55,87251.45,12,4,17,40,9,61.09,97,145,1,3,98.65,0.00,0.67,0.22,2,14.00,10,4644.86,0,1,8,org.apache.jackrabbit.jcr2spi.xml.TargetImportHandler,0.00,32,2,29,0,32,7,0,39,818,0
"org.apache.jackrabbit.jcr.ImportHandler",12,0.14,1.75,83,0.97,23881.16,23,11,20,41,13,67.76,102,116,1,2,115.87,0.00,0.50,0.22,0,26.00,5,2902.68,0,1,12,org.xml.sax.helpers.DefaultHandler,0.00,29,1,21,0,29,11,0,43,604,1
"org.apache.jackrabbit.jcr.ImportHandler$NamespaceContext",7,0.25,1.86,32,0.28,7589.69,9,2,20,17,2,164.38,16,45,0,1,124.50,0.00,0.00,0.71,0,0.00,4,841.34,0,2,2,java.lang.Object,0.00,10,0,13,0,10,5,1,5,201,0
"org.apache.jackrabbit.jcr.Importer",4,0.00,1.00,8,0.05,273.86,4,0,6,4,8,113.10,25,10,6,1,145.32,0.00,0.00,0.00,0,4.00,1,148.76,0,0,2,,0.00,0,0,4,0,0,4,0,7,48,1
"org.apache.jackrabbit.jcr.Importer$NodeInfo",6,0.10,1.00,20,0.13,2262.30,10,4,6,6,1,132.91,0,27,0,1,132.91,0.00,0.00,0.17,0,22.00,1,396.66,0,4,1,java.lang.Object,0.00,0,0,6,0,0,2,0,0,111,1
"org.apache.jackrabbit.jcr.Importer$PropInfo",4,0.11,1.00,14,0.09,1305.18,7,3,6,4,1,133.41,0,19,0,1,133.41,0.00,0.00,0.25,0,10.00,1,277.40,0,1,1,java.lang.Object,0.00,0,0,4,0,0,3,0,0,77,1
"org.apache.jackrabbit.jcr.Importer$TextValue",3,0.00,1.00,4,0.02,76.13,3,0,6,3,0,127.72,18,5,0,1,159.94,0.00,0.00,0.00,0,3.00,1,52.87,0,2,0,,0.00,0,0,3,0,0,1,0,3,22,0
"org.apache.jackrabbit.jcr.SessionImportTest",7,0.00,1.86,82,1.61,76196.61,7,0,22,49,6,82.35,37,127,1,4,100.22,0.00,0.75,0.00,2,10.00,4,4844.34,2,2,5,org.apache.jackrabbit.test.AbstractJCRTest,0.27,42,3,13,0,42,5,0,14,806,1
"org.apache.jackrabbit.jcr.SessionImporter",16,0.10,4.25,259,4.25,252658.85,25,9,55,129,33,48.56,180,349,1,1,92.69,0.00,0.00,0.20,6,78.00,13,12761.91,0,4,33,java.lang.Object,0.00,113,0,68,0,113,12,2,95,2101,1
"org.apache.jackrabbit.jcr.SysViewImportHandler",6,0.28,7.67,130,2.19,144847.14,16,10,14,39,7,42.57,68,187,1,3,86.70,0.00,0.67,0.33,1,0.00,17,6571.22,1,0,6,org.apache.jackrabbit.jcr2spi.xml.TargetImportHandler,0.00,33,2,46,0,33,6,0,46,1101,0
"org.apache.jackrabbit.jcr.SysViewImportHandler$ImportState",0,0.00,0.00,7,0.05,531.67,6,6,14,1,1,171.00,18,8,0,1,171.00,0.00,0.00,0.00,0,0.00,0,141.78,0,0,1,java.lang.Object,0.00,1,0,0,0,1,0,0,6,34,0
"org.apache.jackrabbit.jcr.TargetImportHandler",4,0.11,2.25,28,0.29,8169.59,7,3,15,11,5,75.66,48,38,2,2,113.22,2.00,0.25,0.25,0,6.00,4,881.42,0,0,3,org.xml.sax.helpers.DefaultHandler,0.00,7,1,9,2,7,4,0,10,192,1
"org.apache.jackrabbit.jcr.TargetImportHandler$AppendableValue",3,0.00,1.00,4,0.03,218.89,3,0,15,3,0,114.04,21,6,0,2,156.33,0.00,0.50,0.00,0,3.00,1,104.62,0,0,0,,0.00,0,1,3,0,0,3,0,3,34,1
"org.apache.jackrabbit.jcr.TargetImportHandler$BufferedStringValue",7,0.61,3.29,85,0.90,41599.25,13,6,15,25,1,58.46,51,106,0,1,100.75,0.00,0.00,0.69,0,0.00,5,2691.00,0,2,1,java.lang.Object,0.00,18,0,23,0,18,5,1,23,533,1
"org.apache.jackrabbit.jcr.TargetImportHandler$BufferedStringValue$OutputStreamWriter",1,0.00,1.00,4,0.03,271.16,1,0,15,3,0,169.27,2,5,0,1,129.38,0.00,0.00,0.00,0,1.00,1,85.62,1,0,0,java.lang.Object,0.00,2,0,1,0,2,1,0,2,25,0
"org.apache.jackrabbit.jcr.TargetImportHandler$StringValue",4,0.33,1.00,10,0.06,695.71,5,1,15,6,0,142.36,16,15,0,1,142.13,0.00,0.00,0.75,0,0.00,1,187.08,0,2,0,java.lang.Object,0.00,2,0,4,0,2,2,1,5,56,1
"org.apache.jackrabbit.jcr.TestAll",1,0.00,1.00,5,0.04,864.35,1,0,3,3,2,142.42,3,7,1,2,121.80,0.00,0.50,0.00,0,1.00,1,115.51,0,1,1,junit.framework.TestCase,0.00,2,1,1,0,2,0,0,1,31,1
"org.apache.jackrabbit.jcr.WorkspaceContentHandler",12,0.06,1.42,45,0.56,12560.85,18,6,16,33,3,129.34,3,67,1,2,129.34,0.00,0.50,0.22,0,0.00,4,1685.23,0,0,2,org.xml.sax.helpers.DefaultHandler,0.00,21,1,17,0,21,12,0,1,384,1
"org.apache.jackrabbit.webdav.security.report.AbstractSecurityReport",3,1.00,2.67,20,0.26,9087.70,4,1,10,11,11,72.04,22,26,3,1,114.33,0.00,0.00,0.33,0,4.00,4,783.57,0,1,8,java.lang.Object,0.00,8,0,8,3,8,2,1,4,163,2
"org.apache.jackrabbit.webdav.security.report.AclPrincipalReport",2,0.50,2.50,22,0.45,17623.88,4,2,15,25,12,80.73,29,28,0,2,100.88,0.00,0.50,0.25,0,2.00,4,1347.77,1,1,12,org.apache.jackrabbit.webdav.security.report.AbstractSecurityReport,0.00,23,1,5,0,23,1,0,7,234,1
"org.apache.jackrabbit.webdav.security.report.PrincipalMatchReport",4,0.07,1.50,21,0.26,6077.65,9,5,11,10,11,82.22,49,27,0,2,119.78,0.00,0.50,0.25,0,6.00,3,783.64,1,2,11,org.apache.jackrabbit.webdav.security.report.AbstractSecurityReport,0.00,6,1,6,0,6,2,0,8,167,1
"org.apache.jackrabbit.webdav.security.report.PrincipalSearchReport",5,0.06,1.60,33,0.49,16025.98,13,8,17,19,13,84.88,69,42,0,2,114.26,0.00,0.50,0.18,0,9.00,4,1474.70,1,2,13,org.apache.jackrabbit.webdav.security.report.AbstractSecurityReport,0.00,14,1,8,0,14,3,0,12,282,1
"org.apache.jackrabbit.webdav.security.report.PrincipalSearchReport$SearchArgument",3,0.25,1.00,10,0.09,1016.28,5,2,17,6,4,173.17,7,14,0,1,133.28,0.00,0.00,0.67,0,0.00,1,257.08,0,2,4,java.lang.Object,0.00,3,0,3,0,3,1,0,2,67,1
"org.apache.jackrabbit.webdav.security.report.SearchablePropertyReport",5,0.06,1.80,26,0.39,10244.97,9,4,18,19,13,81.15,61,37,0,1,118.71,0.00,0.00,0.20,0,10.00,4,1165.88,0,2,13,java.lang.Object,0.00,14,0,9,0,14,3,1,13,246,1
"org.apache.jackrabbit.webdav.security.report.SearchablePropertyReport$PrincipalSearchProperty",4,0.24,2.25,34,0.36,8728.00,11,7,18,13,6,160.83,6,46,0,1,110.83,0.00,0.00,0.32,0,0.00,3,1081.03,0,1,6,java.lang.Object,0.00,9,0,9,0,9,3,1,4,234,1
"org.apache.jackrabbit.extractor.AbstractTextExtractor",2,1.00,1.00,7,0.07,1406.72,3,1,0,3,8,98.56,12,10,7,1,130.78,0.00,0.00,0.50,0,2.00,1,208.34,0,1,1,java.lang.Object,0.00,1,0,2,7,1,1,1,4,55,2
"org.apache.jackrabbit.extractor.CompositeTextExtractor",3,0.25,2.00,24,0.29,7921.75,5,2,9,16,3,66.08,35,31,2,1,110.21,0.00,0.00,0.67,0,0.00,3,855.80,0,2,1,java.lang.Object,0.00,13,0,6,0,13,1,1,7,181,1
"org.apache.jackrabbit.extractor.CompositeTextExtractorTest",5,0.00,1.00,25,0.32,4843.09,6,1,7,21,4,103.54,28,43,0,2,121.41,0.00,0.50,1.00,0,0.00,1,973.89,1,0,4,junit.framework.TestCase,0.00,16,1,5,0,16,5,0,7,215,1
"org.apache.jackrabbit.extractor.DefaultTextExtractor",2,0.00,1.50,24,0.31,9160.06,4,2,9,7,7,53.72,17,37,6,1,101.82,0.00,0.00,0.50,0,2.00,2,932.63,0,2,1,java.lang.Object,0.00,5,0,3,5,5,0,1,11,187,1
"org.apache.jackrabbit.extractor.DelegatingTextExtractor",1,0.00,1.00,2,0.01,51.70,1,0,0,1,2,172.56,19,3,1,2,146.28,0.00,0.50,0.00,0,1.00,1,33.60,0,0,1,,0.00,0,1,1,0,0,1,0,2,13,1
"org.apache.jackrabbit.extractor.EmptyTextExtractor",4,1.00,1.00,11,0.09,1199.34,5,1,4,6,3,92.16,34,17,2,1,140.27,0.00,0.00,0.25,0,6.00,1,268.56,0,2,1,java.lang.Object,0.00,2,0,4,0,2,2,1,7,73,1
"org.apache.jackrabbit.extractor.EmptyTextExtractorTest",3,0.00,1.00,14,0.16,2058.20,4,1,7,16,3,108.33,17,23,0,2,126.21,0.00,0.50,1.00,0,0.00,1,489.07,1,0,3,junit.framework.TestCase,0.00,13,1,3,0,13,3,0,5,111,1
"org.apache.jackrabbit.extractor.ExtractorHandler",6,0.20,1.83,32,0.32,11102.03,9,3,7,13,1,74.93,67,42,1,2,119.06,0.00,0.50,0.17,1,10.00,5,968.65,0,0,0,org.xml.sax.helpers.DefaultHandler,0.00,7,1,11,0,7,6,1,12,209,0
"org.apache.jackrabbit.extractor.ExtractorHelper",2,0.00,1.50,14,0.14,6855.48,2,0,3,9,5,79.32,13,22,5,1,111.55,0.00,0.00,0.00,0,2.00,2,432.52,0,1,0,java.lang.Object,0.00,7,0,3,0,7,1,0,3,92,0
"org.apache.jackrabbit.extractor.HTMLParser",5,0.50,2.00,38,0.35,14612.76,6,1,7,13,1,162.02,8,50,1,2,112.02,0.00,0.50,0.60,1,2.00,6,1063.82,2,2,0,org.apache.xerces.parsers.AbstractSAXParser,0.00,8,1,10,0,8,3,0,2,225,1
"org.apache.jackrabbit.extractor.HTMLTextExtractor",2,1.00,2.50,23,0.32,11979.77,3,1,15,16,2,69.98,13,34,0,2,102.20,0.00,0.50,0.50,0,2.00,4,948.20,0,1,2,org.apache.jackrabbit.extractor.AbstractTextExtractor,0.00,14,1,5,0,14,1,0,5,178,1
"org.apache.jackrabbit.extractor.MsExcelTextExtractor",1,0.00,1.00,4,0.04,576.08,2,1,0,1,1,147.42,3,10,0,2,126.80,0.00,0.50,1.00,0,0.00,1,114.37,0,1,1,org.apache.jackrabbit.extractor.DefaultTextExtractor,0.67,0,1,1,0,0,0,0,1,30,1
"org.apache.jackrabbit.extractor.MsOutlookTextExtractor",1,0.00,1.00,4,0.03,530.97,2,1,0,1,1,147.70,3,8,0,2,127.08,0.00,0.50,1.00,0,0.00,1,102.76,0,1,1,org.apache.jackrabbit.extractor.DefaultTextExtractor,0.67,0,1,1,0,0,0,0,1,28,1
"org.apache.jackrabbit.extractor.MsPowerPointTextExtractor",1,0.00,1.00,4,0.04,576.08,2,1,0,1,1,147.42,3,10,0,2,126.80,0.00,0.50,1.00,0,0.00,1,114.37,0,1,1,org.apache.jackrabbit.extractor.DefaultTextExtractor,0.67,0,1,1,0,0,0,0,1,30,1
"org.apache.jackrabbit.extractor.MsTextExtractor",1,0.00,1.00,4,0.05,713.62,2,1,0,1,1,146.69,3,15,0,2,126.07,0.00,0.50,1.00,0,0.00,1,144.47,0,1,1,org.apache.jackrabbit.extractor.DefaultTextExtractor,0.67,0,1,1,0,0,0,0,1,35,1
"org.apache.jackrabbit.extractor.MsWordTextExtractor",1,0.00,1.00,4,0.04,552.25,2,1,0,1,1,147.56,3,9,0,2,126.95,0.00,0.50,1.00,0,0.00,1,108.53,0,1,1,org.apache.jackrabbit.extractor.DefaultTextExtractor,0.67,0,1,1,0,0,0,0,1,29,1
"org.apache.jackrabbit.extractor.OpenOfficeTextExtractor",2,1.00,2.50,28,0.43,16346.36,3,1,16,19,1,54.94,14,51,0,2,97.23,0.00,0.50,0.50,0,2.00,4,1281.61,0,1,1,org.apache.jackrabbit.extractor.AbstractTextExtractor,0.00,17,1,5,0,17,1,0,6,229,1
"org.apache.jackrabbit.extractor.OpenOfficeTextExtractor$OpenOfficeContentHandler",5,0.25,1.40,16,0.17,2365.97,7,2,16,10,0,132.06,3,30,0,2,132.06,0.00,0.50,0.70,0,0.00,2,509.50,0,1,0,org.xml.sax.helpers.DefaultHandler,0.00,5,1,7,0,5,4,0,1,127,1
"org.apache.jackrabbit.extractor.PdfTextExtractor",2,1.00,2.50,24,0.29,9122.25,3,1,12,17,1,51.72,19,39,0,2,101.72,0.00,0.50,0.50,0,2.00,4,878.74,0,1,1,org.apache.jackrabbit.extractor.AbstractTextExtractor,0.00,15,1,5,0,15,1,0,9,172,1
"org.apache.jackrabbit.extractor.PlainTextExtractor",2,1.00,2.00,10,0.13,3116.43,3,1,7,6,3,75.50,23,19,2,2,119.63,0.00,0.50,0.50,0,2.00,3,400.70,0,1,1,org.apache.jackrabbit.extractor.AbstractTextExtractor,0.00,4,1,4,0,4,1,0,5,88,1
"org.apache.jackrabbit.extractor.PlainTextExtractorTest",5,0.00,1.20,23,0.29,4195.14,6,1,8,19,3,107.60,27,39,0,2,125.48,0.00,0.50,1.00,0,0.00,2,877.23,1,0,3,junit.framework.TestCase,0.00,14,1,6,0,14,5,0,7,192,1
"org.apache.jackrabbit.extractor.PngTextExtractor",4,0.06,2.50,59,0.86,53584.46,10,6,9,17,2,77.66,23,73,1,2,95.54,0.00,0.50,0.21,2,6.00,5,2588.25,0,1,1,org.apache.jackrabbit.extractor.AbstractTextExtractor,0.00,13,1,10,0,13,3,0,4,469,1
"org.apache.jackrabbit.extractor.PngTextExtractorTest",4,0.00,1.25,21,0.77,22125.20,5,1,7,17,3,115.64,18,43,0,2,115.40,0.00,0.50,1.00,0,0.00,2,2320.76,1,0,3,junit.framework.TestCase,0.00,13,1,5,0,13,4,0,5,388,1
"org.apache.jackrabbit.extractor.RTFTextExtractor",2,1.00,1.50,14,0.18,4635.30,3,1,8,11,2,80.66,13,23,1,2,112.88,0.00,0.50,0.50,0,2.00,2,552.78,0,1,1,org.apache.jackrabbit.extractor.AbstractTextExtractor,0.00,9,1,3,0,9,1,0,5,115,1
"org.apache.jackrabbit.extractor.RTFTextExtractorTest",1,0.00,3.00,15,0.19,5510.04,1,0,6,12,2,79.54,5,22,0,2,97.42,0.00,0.50,0.00,0,1.00,3,567.87,0,0,2,junit.framework.TestCase,0.00,11,1,3,0,11,1,0,2,106,1
"org.apache.jackrabbit.extractor.TextExtractor",2,0.00,1.00,3,0.02,102.47,2,0,3,2,17,190.92,41,5,17,1,157.54,0.00,0.00,0.00,0,2.00,1,63.12,0,2,0,,0.00,0,0,2,0,0,0,0,3,22,1
"org.apache.jackrabbit.extractor.XMLTextExtractor",2,1.00,3.00,26,0.38,13596.17,3,1,16,21,4,108.15,34,39,2,2,99.02,0.00,0.50,0.50,0,2.00,5,1154.93,0,1,2,org.apache.jackrabbit.extractor.AbstractTextExtractor,0.00,19,1,6,0,19,1,0,10,206,1
"org.apache.jackrabbit.extractor.XMLTextExtractor$FilterInputStream",1,0.00,1.00,2,0.01,34.83,1,0,16,1,0,147.63,0,3,0,1,147.63,0.00,0.00,0.00,0,1.00,1,23.22,0,0,0,java.lang.Object,0.00,0,0,1,0,0,1,0,0,10,0
"org.apache.jackrabbit.extractor.XMLTextExtractorTest",6,0.00,1.67,33,0.41,6091.01,7,1,8,20,3,121.37,27,58,0,2,121.13,0.00,0.50,1.00,0,0.00,3,1243.04,1,0,3,junit.framework.TestCase,0.00,14,1,10,0,14,6,0,8,264,1
"org.apache.jackrabbit.spi.AbstractSPITest",3,0.50,2.67,28,0.38,22817.36,5,2,2,13,7,56.14,32,40,4,2,104.62,12.00,0.07,0.83,0,0.00,5,1154.07,2,1,3,junit.framework.TestCase,0.00,10,1,8,12,10,2,0,8,240,1
"org.apache.jackrabbit.spi.Batch",10,0.00,1.00,11,0.18,1212.26,10,0,9,10,45,201.86,234,12,40,1,154.59,0.00,0.00,0.00,0,10.00,1,537.71,0,0,5,,0.00,0,0,10,0,0,10,0,11,143,1
"org.apache.jackrabbit.spi.ChildInfo",3,0.00,1.00,4,0.01,64.24,3,0,0,3,9,112.42,24,5,8,1,160.52,0.00,0.00,0.00,0,3.00,1,42.83,0,2,1,,0.00,0,0,3,0,0,1,0,4,19,1
"org.apache.jackrabbit.spi.Event",10,8.00,1.00,19,0.29,16403.56,18,8,2,10,15,95.68,97,22,11,1,145.68,0.00,0.00,0.00,0,10.00,1,859.07,0,5,4,,0.00,0,0,10,0,0,5,0,19,217,1
"org.apache.jackrabbit.spi.EventBundle",2,0.00,1.00,3,0.01,89.41,2,0,1,2,13,109.53,20,4,13,1,158.00,0.00,0.00,0.00,0,2.00,1,43.61,0,1,0,,0.00,0,0,2,0,0,1,0,3,17,1
"org.apache.jackrabbit.spi.EventFilter",1,0.00,1.00,2,0.01,79.62,1,0,1,1,13,178.18,20,3,12,2,144.80,0.00,0.50,0.00,0,1.00,1,42.51,0,0,1,,0.00,0,1,1,0,0,1,0,2,15,1
"org.apache.jackrabbit.spi.Helper",8,0.00,1.12,30,0.29,4828.05,11,3,6,17,4,131.51,39,40,1,1,131.28,0.00,0.00,0.33,3,0.00,2,868.92,0,6,3,java.lang.Object,0.00,9,0,9,0,9,2,0,12,210,1
"org.apache.jackrabbit.spi.IdFactory",6,0.00,1.00,7,0.05,234.62,6,0,0,6,40,108.46,57,8,36,1,158.46,0.00,0.00,0.00,0,6.00,1,151.01,0,2,4,,0.00,0,0,6,0,0,4,0,7,52,1
"org.apache.jackrabbit.spi.ItemId",3,0.00,1.00,4,0.01,64.24,3,0,0,3,43,150.16,45,5,42,1,160.52,0.00,0.00,0.00,0,3.00,1,42.83,0,1,1,,0.00,0,0,3,0,0,2,0,4,19,1
"org.apache.jackrabbit.spi.ItemInfo",2,0.00,1.00,3,0.01,46.83,2,0,0,2,5,112.11,16,4,4,1,160.22,0.00,0.00,0.00,0,2.00,1,31.22,0,1,1,,0.00,0,0,2,0,0,1,0,3,14,1
"org.apache.jackrabbit.spi.LockInfo",7,0.00,1.00,8,0.03,133.90,7,0,0,7,17,112.80,56,9,16,1,160.91,0.00,0.00,0.00,0,7.00,1,89.27,0,2,1,,0.00,0,0,7,0,0,5,0,8,39,1
"org.apache.jackrabbit.spi.Name",2,17.00,1.00,20,0.31,6824.97,19,17,1,2,440,115.01,34,21,440,4,105.88,0.00,0.75,0.00,0,2.00,1,944.74,0,2,0,,0.00,0,3,2,0,0,0,0,11,175,1
"org.apache.jackrabbit.spi.NameFactory",2,0.00,1.00,3,0.02,154.32,2,0,0,2,27,118.57,25,4,26,1,156.14,0.00,0.00,0.00,0,2.00,1,73.07,0,0,1,,0.00,0,0,2,0,0,2,0,3,24,1
"org.apache.jackrabbit.spi.NodeId",0,0.00,0.00,1,0.01,31.02,0,0,0,0,121,171.00,4,2,121,2,171.00,0.00,0.50,0.00,0,0.00,0,15.51,0,0,0,,0.00,0,1,0,0,0,0,0,1,6,1
"org.apache.jackrabbit.spi.NodeInfo",7,0.00,1.00,8,0.04,265.30,7,0,1,7,17,110.46,62,9,14,2,158.57,0.00,0.50,0.00,0,7.00,1,129.36,0,3,3,,0.00,0,1,7,0,0,4,0,8,49,1
"org.apache.jackrabbit.spi.Path",19,4.00,1.00,25,0.20,1849.88,23,4,3,19,236,164.47,329,26,236,2,155.34,0.00,0.50,0.00,0,19.00,1,592.63,0,6,0,,0.00,0,1,19,0,0,13,0,26,182,1
"org.apache.jackrabbit.spi.Path$Element",9,0.00,1.00,10,0.04,187.75,9,0,3,9,1,128.39,58,11,0,2,160.61,0.00,0.50,0.00,0,9.00,1,120.00,0,1,1,,0.00,0,1,9,0,0,8,0,9,51,1
"org.apache.jackrabbit.spi.PathFactory",14,0.00,1.00,15,0.17,1164.25,14,0,1,14,41,107.40,141,16,39,1,155.88,0.00,0.00,0.00,0,14.00,1,498.71,0,14,2,,0.00,0,0,14,0,0,0,0,15,149,1
"org.apache.jackrabbit.spi.PropertyId",2,0.00,1.00,3,0.01,65.85,2,0,0,2,58,126.83,13,4,56,2,159.05,0.00,0.50,0.00,0,2.00,1,38.73,0,0,2,,0.00,0,1,2,0,0,2,0,3,16,1
"org.apache.jackrabbit.spi.PropertyInfo",4,0.00,1.00,5,0.02,114.28,4,0,0,4,14,127.31,25,6,12,2,159.53,0.00,0.50,0.00,0,4.00,1,65.85,0,0,2,,0.00,0,1,4,0,0,4,0,5,27,1
"org.apache.jackrabbit.spi.QItemDefinition",8,1.00,1.00,10,0.05,596.40,9,1,1,8,12,124.03,53,11,11,1,156.25,0.00,0.00,0.00,0,8.00,1,153.82,0,0,1,,0.00,0,0,8,0,0,8,0,10,57,1
"org.apache.jackrabbit.spi.QNodeDefinition",3,1.00,1.00,5,0.04,608.40,4,1,1,3,44,104.73,25,6,43,2,152.83,0.00,0.50,0.00,0,3.00,1,111.07,0,0,1,,0.00,0,1,3,0,0,3,0,5,35,1
"org.apache.jackrabbit.spi.QNodeTypeDefinition",11,0.00,1.00,12,0.05,300.56,11,0,1,11,35,117.40,82,13,32,1,159.69,0.00,0.00,0.00,0,11.00,1,163.70,0,1,3,,0.00,0,0,11,0,0,10,0,12,66,1
"org.apache.jackrabbit.spi.QPropertyDefinition",7,1.00,1.00,9,0.06,705.26,8,1,1,7,51,112.93,50,10,49,2,155.22,0.00,0.50,0.00,0,7.00,1,165.31,0,1,2,,0.00,0,1,7,0,0,6,0,9,57,1
"org.apache.jackrabbit.spi.QValue",14,1.00,1.00,16,0.11,963.55,15,1,8,14,103,114.24,109,17,101,1,156.53,0.00,0.00,0.00,0,14.00,1,319.98,0,6,2,,0.00,0,0,14,0,0,8,0,15,111,1
"org.apache.jackrabbit.spi.QValueConstraint",2,1.00,1.00,4,0.03,507.88,3,1,3,2,27,120.69,28,5,26,1,140.83,0.00,0.00,0.00,0,2.00,1,97.47,0,1,1,,0.00,0,0,2,0,0,1,0,4,30,1
"org.apache.jackrabbit.spi.QValueFactory",13,0.00,1.00,14,0.14,853.48,13,0,8,13,47,114.40,101,15,43,1,156.69,0.00,0.00,0.00,0,13.00,1,412.13,0,13,4,,0.00,0,0,13,0,0,0,0,14,128,1
"org.apache.jackrabbit.spi.QValueFactoryTest",45,0.07,1.71,244,3.19,58235.85,51,6,13,91,7,170.30,55,346,1,3,120.30,0.50,0.50,0.23,2,0.00,7,9555.35,1,0,6,org.apache.jackrabbit.spi.AbstractSPITest,0.06,46,2,77,1,46,45,0,38,2051,1
"org.apache.jackrabbit.spi.QValueTest",44,0.07,1.52,240,3.11,56128.57,50,6,13,91,7,170.37,49,332,1,3,120.37,0.50,0.50,0.24,1,0.00,4,9315.21,1,0,6,org.apache.jackrabbit.spi.AbstractSPITest,0.06,47,2,67,1,47,44,0,30,1997,1
"org.apache.jackrabbit.spi.QueryInfo",2,0.00,1.00,3,0.01,60.43,2,0,2,2,11,110.87,20,4,11,1,159.34,0.00,0.00,0.00,0,2.00,1,35.12,0,2,0,,0.00,0,0,2,0,0,0,0,3,15,1
"org.apache.jackrabbit.spi.QueryResultRow",3,0.00,1.00,4,0.02,101.97,3,0,0,3,6,110.46,32,5,3,1,158.94,0.00,0.00,0.00,0,3.00,1,62.81,0,1,3,,0.00,0,0,3,0,0,2,0,4,24,1
"org.apache.jackrabbit.spi.RepositoryService",64,0.00,1.00,65,1.26,9519.02,64,0,26,64,52,143.54,1022,87,31,1,153.89,0.00,0.00,0.00,0,64.00,1,3789.90,0,15,21,,0.00,0,0,64,0,0,49,0,81,968,1
"org.apache.jackrabbit.spi.RepositoryServiceStub",6,0.08,3.33,55,0.92,59152.23,16,10,10,23,7,103.91,24,78,6,1,103.68,0.00,0.00,0.03,0,10.00,14,2748.05,0,5,1,java.lang.Object,0.00,17,0,20,3,17,1,0,5,488,2
"org.apache.jackrabbit.spi.RepositoryServiceTest",8,0.00,1.12,29,0.30,4608.84,9,1,3,24,5,131.44,2,41,1,3,131.44,0.00,0.67,1.00,0,0.00,2,887.39,2,0,4,org.apache.jackrabbit.spi.AbstractSPITest,0.27,16,2,9,0,16,8,0,2,209,1
"org.apache.jackrabbit.spi.SessionInfo",6,0.00,1.00,7,0.05,327.43,6,0,3,6,32,108.84,63,8,32,1,157.32,0.00,0.00,0.00,0,6.00,1,164.39,0,3,0,,0.00,0,0,6,0,0,3,0,7,54,1
"org.apache.jackrabbit.spi.SessionInfoTest",3,0.33,1.67,17,0.17,2520.28,6,3,2,11,4,121.78,2,23,1,3,121.78,0.00,0.67,0.56,0,0.00,2,503.29,2,0,3,org.apache.jackrabbit.spi.AbstractSPITest,1.00,8,2,5,0,8,3,0,2,120,1
"org.apache.jackrabbit.spi.Subscription",0,0.00,0.00,1,0.00,12.00,0,0,0,0,8,171.00,9,2,8,1,171.00,0.00,0.00,0.00,0,0.00,0,8.00,0,0,0,,0.00,0,0,0,0,0,0,0,1,4,1
"org.apache.jackrabbit.spi.TestAll",1,0.00,1.00,8,0.07,2228.14,1,0,3,3,7,160.95,1,10,3,2,110.95,0.00,0.50,0.00,0,1.00,1,223.66,0,1,4,junit.framework.TestCase,0.00,2,1,1,0,2,0,0,1,55,1
"org.apache.jackrabbit.spi.XASessionInfo",1,0.00,1.00,2,0.01,48.43,1,0,1,1,3,102.37,11,3,3,2,146.50,0.00,0.50,0.00,0,1.00,1,27.12,0,1,0,,0.00,0,1,1,0,0,0,0,2,11,1
"org.apache.jackrabbit.webdav.jcr.observation.SubscriptionImpl",20,0.05,2.50,149,1.76,57100.78,35,15,33,71,23,63.58,200,197,4,1,112.05,0.00,0.00,0.11,3,256.00,9,5285.46,0,9,19,java.lang.Object,0.00,51,0,50,0,51,11,3,43,1051,1
"org.apache.jackrabbit.webdav.jcr.observation.SubscriptionImpl$EventBundleImpl",3,0.25,4.00,48,0.88,48822.25,5,2,33,26,3,113.22,9,63,0,1,92.60,0.00,0.00,0.33,0,4.00,10,2649.44,0,1,3,java.lang.Object,0.00,23,0,12,0,23,2,1,9,428,1
"org.apache.jackrabbit.webdav.jcr.observation.SubscriptionImpl$TransactionEvent",3,0.00,1.00,4,0.03,141.35,3,0,33,3,1,207.82,3,9,0,1,157.82,0.00,0.00,0.00,0,3.00,1,94.23,0,0,1,java.lang.Object,0.00,0,0,3,0,0,3,0,3,31,0
"org.apache.jackrabbit.webdav.jcr.observation.SubscriptionImpl$TransactionEvent_0",3,0.50,2.67,22,0.28,4799.11,4,1,33,10,5,114.26,13,38,0,1,114.02,0.00,0.00,0.67,0,0.00,3,838.48,0,0,5,java.lang.Object,0.00,7,0,8,0,7,3,2,7,176,1
"org.apache.jackrabbit.webdav.jcr.observation.SubscriptionManagerImpl",10,0.07,1.90,80,1.04,27402.26,13,3,27,54,15,61.62,103,108,1,1,110.09,0.00,0.00,0.27,4,34.00,4,3106.35,0,5,14,java.lang.Object,0.00,44,0,19,0,44,5,2,22,628,1
"org.apache.jackrabbit.webdav.jcr.observation.SubscriptionManagerImpl$SubscriptionMap",6,0.30,1.67,35,0.41,12060.73,8,2,27,23,3,118.80,0,46,0,1,118.80,0.00,0.00,0.75,0,0.00,3,1240.36,0,3,3,java.lang.Object,0.00,17,0,10,0,17,3,0,0,272,1
"org.apache.jackrabbit.webdav.jcr.observation.SubscriptionManagerImpl$WrappedSubscription",3,1.00,1.00,8,0.05,565.02,4,1,27,4,1,141.86,2,12,0,1,141.86,0.00,0.00,0.33,0,4.00,1,151.98,0,2,1,java.lang.Object,0.00,1,0,3,0,1,1,1,2,46,1
"org.apache.jackrabbit.spi.BatchReadConfig",2,0.67,2.00,13,0.15,2823.87,5,3,3,9,5,72.88,23,18,4,1,117.01,0.00,0.00,0.67,0,0.00,2,438.20,0,0,1,java.lang.Object,0.00,7,0,4,0,7,2,0,3,101,1
"org.apache.jackrabbit.spi.ChildInfoImpl",2,0.00,1.50,8,0.11,1698.48,2,0,6,6,5,87.82,24,15,2,2,125.38,0.00,0.50,0.00,0,2.00,2,317.82,0,1,3,org.apache.jackrabbit.spi.commons.ChildInfoImpl,0.00,4,1,3,0,4,1,0,4,77,0
"org.apache.jackrabbit.spi.EventSubscription",9,0.06,3.33,135,2.26,136895.99,18,9,36,64,21,45.81,78,177,3,1,93.92,0.00,0.00,0.16,2,17.00,12,6790.66,0,3,19,java.lang.Object,0.00,55,0,30,0,55,6,2,25,1121,0
"org.apache.jackrabbit.spi.EventSubscription$EventListener",1,0.00,1.00,3,0.03,202.37,1,0,36,2,0,135.04,0,4,0,1,135.04,0.00,0.00,0.00,0,1.00,1,76.53,0,0,0,java.lang.Object,0.00,1,0,1,0,1,1,0,0,22,0
"org.apache.jackrabbit.spi.IdFactoryImpl",5,1.00,1.20,21,0.22,4879.57,6,1,13,14,16,125.19,21,31,6,2,124.96,0.00,0.50,0.20,2,8.00,2,650.08,0,4,10,org.apache.jackrabbit.spi.commons.identifier.AbstractIdFactory,0.17,9,1,6,0,9,1,0,3,145,0
"org.apache.jackrabbit.spi.LockInfoImpl",2,0.00,1.00,5,0.12,1589.55,2,0,4,11,8,92.80,22,11,4,2,136.93,0.00,0.50,0.00,0,2.00,1,358.70,0,1,4,org.apache.jackrabbit.spi.commons.LockInfoImpl,0.00,9,1,2,0,9,1,0,3,85,0
"org.apache.jackrabbit.spi.NodeInfoImpl",4,0.00,1.75,22,0.39,9688.31,4,0,12,23,7,70.04,34,42,1,3,118.15,0.00,0.67,0.00,0,4.00,2,1179.07,0,3,6,org.apache.jackrabbit.spi.commons.NodeInfoImpl,0.00,19,2,7,0,19,1,0,4,248,0
"org.apache.jackrabbit.spi.PropertyInfoImpl",2,0.00,2.00,17,0.27,10505.43,2,0,8,11,8,63.73,23,31,1,3,107.86,0.00,0.67,0.00,0,2.00,3,822.42,0,1,7,org.apache.jackrabbit.spi.commons.PropertyInfoImpl,0.00,9,2,4,0,9,1,0,3,167,0
"org.apache.jackrabbit.spi.QNodeDefinitionImpl",2,0.00,3.00,12,0.29,8843.91,2,0,6,16,6,75.45,25,24,2,3,113.01,0.00,0.67,0.00,0,2.00,4,877.43,0,1,4,org.apache.jackrabbit.spi.commons.QNodeDefinitionImpl,0.00,14,2,6,0,14,1,0,3,183,0
"org.apache.jackrabbit.spi.QNodeTypeDefinitionImpl",4,0.00,2.00,28,0.45,15343.32,4,0,12,17,11,81.71,52,43,1,2,111.09,0.00,0.50,0.00,0,4.00,2,1349.29,0,3,10,org.apache.jackrabbit.spi.commons.QNodeTypeDefinitionImpl,0.00,13,1,8,0,13,1,0,5,278,0
"org.apache.jackrabbit.spi.QPropertyDefinitionImpl",3,0.00,2.33,21,0.41,12982.87,3,0,14,22,12,66.52,33,41,2,3,110.65,0.00,0.67,0.00,0,4.00,3,1227.27,0,2,10,org.apache.jackrabbit.spi.commons.QPropertyDefinitionImpl,0.00,19,2,7,0,19,1,0,4,248,0
"org.apache.jackrabbit.spi.QueryInfoImpl",7,0.14,1.57,46,0.55,16260.38,14,7,20,20,8,83.14,44,64,1,1,115.36,0.00,0.00,0.02,1,12.00,3,1635.61,0,3,7,java.lang.Object,0.00,13,0,11,0,13,4,1,13,351,0
"org.apache.jackrabbit.spi.QueryInfoImpl$RangeIteratorDecorator",1,0.00,2.00,6,0.08,1444.71,1,0,20,4,1,116.93,0,12,0,1,116.93,0.00,0.00,0.00,0,0.00,2,238.79,1,1,1,java.lang.Object,0.00,3,0,2,0,3,0,0,0,53,0
"org.apache.jackrabbit.spi.QueryResultRowImpl",4,0.22,3.75,60,0.77,33916.40,7,3,16,26,9,53.60,29,77,1,1,95.89,0.00,0.00,0.50,0,0.00,7,2302.41,0,2,8,java.lang.Object,0.00,22,0,15,0,22,2,1,7,427,0
"org.apache.jackrabbit.spi.RMIRepositoryStub",4,0.33,1.50,23,0.23,4651.04,6,2,9,12,2,72.59,35,32,0,3,120.69,0.00,0.67,0.25,1,8.00,2,698.73,0,3,2,org.apache.jackrabbit.core.JackrabbitRepositoryStub,0.11,8,2,6,0,8,1,0,10,161,1
"org.apache.jackrabbit.spi.RMIRepositoryStub$ClientFactoryDelegater",1,0.00,1.00,2,0.02,146.32,1,0,9,1,0,142.72,0,4,0,1,142.72,0.00,0.00,0.00,0,1.00,1,58.53,0,1,0,java.lang.Object,0.00,0,0,1,0,0,0,0,0,18,3
"org.apache.jackrabbit.spi.RMIRepositoryStub$RMIClientFactoryDelegater",1,1.00,1.00,5,0.06,878.60,2,1,9,5,0,171.75,1,7,0,2,121.75,0.00,0.50,0.00,0,1.00,1,190.92,0,1,0,org.apache.jackrabbit.spi2jcr.ClientFactoryDelegater,0.00,4,1,1,0,4,0,0,1,46,2
"org.apache.jackrabbit.spi.RepositoryServiceImpl",82,0.15,1.85,529,7.50,220076.46,87,5,104,231,51,135.45,264,760,3,1,114.83,0.00,0.00,0.05,12,1234.00,6,22502.47,0,51,48,java.lang.Object,0.00,149,0,152,0,149,31,1,100,4477,1
"org.apache.jackrabbit.spi.RepositoryServiceImpl$BatchImpl",16,0.27,1.50,75,0.93,27207.33,19,3,104,38,10,123.01,6,118,0,1,123.01,0.00,0.00,0.08,1,54.00,5,2790.16,0,3,10,java.lang.Object,0.00,22,0,24,0,22,13,1,3,599,2
"org.apache.jackrabbit.spi.RepositoryServiceImpl$BatchImpl$Callable_22",1,0.00,4.00,18,0.22,8470.68,1,0,104,11,0,92.93,0,23,0,1,92.93,0.00,0.00,0.00,0,0.00,4,672.61,0,1,0,java.lang.Object,0.00,10,0,4,0,10,0,0,0,123,0
"org.apache.jackrabbit.spi.RepositoryServiceImpl$BatchImpl$Callable_23",1,0.00,1.00,7,0.09,1264.60,1,0,104,6,1,115.05,0,9,0,1,115.05,0.00,0.00,0.00,0,0.00,1,263.16,0,1,1,java.lang.Object,0.00,5,0,1,0,5,0,0,0,56,0
"org.apache.jackrabbit.spi.RepositoryServiceImpl$BatchImpl$Callable_24",1,0.00,2.00,12,0.15,4346.03,1,0,104,6,1,101.94,0,12,0,1,101.94,0.00,0.00,0.00,0,0.00,2,441.40,0,1,1,java.lang.Object,0.00,5,0,2,0,5,0,0,0,86,0
"org.apache.jackrabbit.spi.RepositoryServiceImpl$BatchImpl$Callable_25",1,0.00,1.00,6,0.07,1023.12,1,0,104,5,1,118.27,0,8,0,1,118.27,0.00,0.00,0.00,0,0.00,1,214.82,0,1,1,java.lang.Object,0.00,4,0,1,0,4,0,0,0,48,0
"org.apache.jackrabbit.spi.RepositoryServiceImpl$BatchImpl$Callable_26",1,0.00,2.00,11,0.13,3937.07,1,0,104,5,1,103.68,0,11,0,1,103.68,0.00,0.00,0.00,0,0.00,2,387.57,0,1,1,java.lang.Object,0.00,4,0,2,0,4,0,0,0,78,0
"org.apache.jackrabbit.spi.RepositoryServiceImpl$BatchImpl$Callable_27",1,0.00,4.00,11,0.12,3582.00,1,0,104,7,2,104.08,4,16,0,1,103.85,0.00,0.00,0.00,0,0.00,4,348.00,0,1,2,java.lang.Object,0.00,6,0,4,0,6,0,0,4,72,0
"org.apache.jackrabbit.spi.RepositoryServiceImpl$BatchImpl$Callable_28",1,0.00,5.00,17,0.20,9413.96,1,0,104,6,0,93.44,0,22,0,1,93.44,0.00,0.00,0.00,0,0.00,5,612.88,0,1,0,java.lang.Object,0.00,5,0,5,0,5,0,0,0,121,0
"org.apache.jackrabbit.spi.RepositoryServiceImpl$BatchImpl$Callable_29",1,0.00,5.00,30,0.31,13392.02,1,0,104,11,0,83.03,0,23,0,1,83.03,0.00,0.00,0.00,0,0.00,5,941.17,0,1,0,java.lang.Object,0.00,10,0,5,0,10,0,0,0,172,0
"org.apache.jackrabbit.spi.RepositoryServiceImpl$BatchImpl$Callable_30",1,0.00,1.00,5,0.04,498.94,1,0,104,4,0,123.68,0,6,0,1,123.68,0.00,0.00,0.00,0,0.00,1,120.37,0,1,0,java.lang.Object,0.00,3,0,1,0,3,0,0,0,30,0
"org.apache.jackrabbit.spi.RepositoryServiceImpl$BatchImpl$Callable_31",1,0.00,2.00,9,0.09,2216.31,1,0,104,4,0,108.90,0,11,0,1,108.90,0.00,0.00,0.00,0,0.00,2,275.19,0,1,0,java.lang.Object,0.00,3,0,2,0,3,0,0,0,59,0
"org.apache.jackrabbit.spi.RepositoryServiceImpl$BatchImpl$Callable_32",1,0.00,1.00,5,0.02,162.57,1,0,104,3,0,127.52,0,5,0,1,127.52,0.00,0.00,0.00,0,0.00,1,58.19,0,1,0,java.lang.Object,0.00,2,0,1,0,2,0,0,0,18,0
"org.apache.jackrabbit.spi.RepositoryServiceImpl$BatchImpl$Callable_32$Callable_33",1,0.00,1.00,4,0.03,251.86,1,0,104,2,0,129.63,0,5,0,1,129.63,0.00,0.00,0.00,0,0.00,1,76.53,0,1,0,java.lang.Object,0.00,1,0,1,0,1,0,0,0,22,0
"org.apache.jackrabbit.spi.RepositoryServiceImpl$Callable",1,0.00,2.00,7,0.08,1860.32,1,0,104,7,0,113.57,0,10,0,1,113.57,0.00,0.00,0.00,0,1.00,2,246.04,0,1,0,java.lang.Object,0.00,6,0,2,0,6,0,0,0,53,0
"org.apache.jackrabbit.spi.RepositoryServiceImpl$Callable_0",1,0.00,2.00,9,0.13,3031.52,1,0,104,11,0,107.83,0,11,0,1,107.83,0.00,0.00,0.00,0,1.00,2,379.38,0,1,0,java.lang.Object,0.00,10,0,2,0,10,0,0,0,77,0
"org.apache.jackrabbit.spi.RepositoryServiceImpl$Callable_1",1,0.00,2.00,14,0.16,5137.21,1,0,104,11,1,148.87,1,18,0,1,98.87,0.00,0.00,0.00,0,1.00,2,490.81,0,1,1,java.lang.Object,0.00,10,0,2,0,10,0,0,1,96,0
"org.apache.jackrabbit.spi.RepositoryServiceImpl$Callable_10",1,0.00,2.00,9,0.09,2503.49,1,0,104,5,0,108.48,0,11,0,1,108.48,0.00,0.00,0.00,0,1.00,2,257.98,0,1,0,java.lang.Object,0.00,4,0,2,0,4,0,0,0,56,0
"org.apache.jackrabbit.spi.RepositoryServiceImpl$Callable_11",1,0.00,7.00,27,0.40,28652.93,1,0,104,14,2,132.06,1,33,0,1,82.06,0.00,0.00,0.00,0,0.00,7,1196.29,0,1,2,java.lang.Object,0.00,13,0,7,0,13,0,0,1,206,0
"org.apache.jackrabbit.spi.RepositoryServiceImpl$Callable_12",1,0.00,3.00,14,0.16,7500.66,1,0,104,7,0,97.48,0,15,0,1,97.48,0.00,0.00,0.00,0,1.00,3,467.83,0,1,0,java.lang.Object,0.00,6,0,3,0,6,0,0,0,91,0
"org.apache.jackrabbit.spi.RepositoryServiceImpl$Callable_13",1,0.00,2.00,8,0.11,2147.67,1,0,104,9,0,110.91,0,11,0,1,110.91,0.00,0.00,0.00,0,0.00,2,338.69,0,1,0,java.lang.Object,0.00,8,0,2,0,8,0,0,0,69,0
"org.apache.jackrabbit.spi.RepositoryServiceImpl$Callable_14",1,0.00,2.00,8,0.12,2178.61,1,0,104,9,0,110.87,0,11,0,1,110.87,0.00,0.00,0.00,0,0.00,2,346.53,0,1,0,java.lang.Object,0.00,8,0,2,0,8,0,0,0,70,0
"org.apache.jackrabbit.spi.RepositoryServiceImpl$Callable_15",1,0.00,5.00,33,0.46,23028.90,1,0,104,17,3,79.63,0,32,0,1,79.63,0.00,0.00,0.00,0,0.00,5,1374.83,0,1,3,java.lang.Object,0.00,16,0,5,0,16,0,0,0,227,0
"org.apache.jackrabbit.spi.RepositoryServiceImpl$Callable_16",1,0.00,2.00,11,0.12,3438.53,1,0,104,7,0,104.15,0,14,0,1,104.15,0.00,0.00,0.00,0,1.00,2,353.95,0,1,0,java.lang.Object,0.00,6,0,2,0,6,0,0,0,72,0
"org.apache.jackrabbit.spi.RepositoryServiceImpl$Callable_17",1,0.00,2.00,10,0.09,2533.56,1,0,104,6,0,106.73,0,12,0,1,106.73,0.00,0.00,0.00,0,1.00,2,282.79,0,1,0,java.lang.Object,0.00,5,0,2,0,5,0,0,0,60,0
"org.apache.jackrabbit.spi.RepositoryServiceImpl$Callable_18",1,0.00,1.00,3,0.02,193.32,1,0,104,2,0,135.20,0,4,0,1,135.20,0.00,0.00,0.00,0,1.00,1,59.81,0,1,0,java.lang.Object,0.00,1,0,1,0,1,0,0,0,18,0
"org.apache.jackrabbit.spi.RepositoryServiceImpl$Callable_19",1,0.00,1.00,3,0.02,175.12,1,0,104,2,0,175.42,2,4,0,1,135.54,0.00,0.00,0.00,0,1.00,1,54.60,0,1,0,java.lang.Object,0.00,1,0,1,0,1,0,0,2,17,0
"org.apache.jackrabbit.spi.RepositoryServiceImpl$Callable_2",1,0.00,1.00,4,0.03,278.00,1,0,104,3,0,129.30,0,5,0,1,129.30,0.00,0.00,0.00,0,1.00,1,84.00,0,1,0,java.lang.Object,0.00,2,0,1,0,2,0,0,0,23,0
"org.apache.jackrabbit.spi.RepositoryServiceImpl$Callable_20",1,0.00,2.00,8,0.11,2088.14,1,0,104,9,0,111.01,0,11,0,1,111.01,0.00,0.00,0.00,0,0.00,2,323.00,0,1,0,java.lang.Object,0.00,8,0,2,0,8,0,0,0,67,0
"org.apache.jackrabbit.spi.RepositoryServiceImpl$Callable_21",1,0.00,1.00,3,0.03,378.20,1,0,104,4,0,132.90,0,4,0,1,132.90,0.00,0.00,0.00,0,1.00,1,103.91,0,1,0,java.lang.Object,0.00,3,0,1,0,3,0,0,0,27,0
"org.apache.jackrabbit.spi.RepositoryServiceImpl$Callable_3",1,0.00,1.00,10,0.11,2209.22,1,0,104,9,1,107.36,0,13,0,1,107.36,0.00,0.00,0.00,0,1.00,1,344.05,0,1,1,java.lang.Object,0.00,8,0,1,0,8,0,0,0,69,0
"org.apache.jackrabbit.spi.RepositoryServiceImpl$Callable_34",1,0.00,1.00,2,0.01,51.30,1,0,104,1,0,146.30,0,3,0,1,146.30,0.00,0.00,0.00,0,1.00,1,27.65,0,1,0,,0.00,0,0,1,0,0,0,0,0,11,1
"org.apache.jackrabbit.spi.RepositoryServiceImpl$Callable_4",1,0.00,1.00,5,0.06,860.22,1,0,104,5,1,121.82,0,6,0,1,121.82,0.00,0.00,0.00,0,0.00,1,177.64,0,1,1,java.lang.Object,0.00,4,0,1,0,4,0,0,0,41,0
"org.apache.jackrabbit.spi.RepositoryServiceImpl$Callable_5",1,0.00,2.00,10,0.17,4745.17,1,0,104,10,1,154.59,1,12,0,1,104.59,0.00,0.00,0.00,0,0.00,2,520.68,0,1,1,java.lang.Object,0.00,9,0,2,0,9,0,0,1,101,0
"org.apache.jackrabbit.spi.RepositoryServiceImpl$Callable_6",1,0.00,1.00,4,0.03,258.13,1,0,104,3,0,129.55,0,5,0,1,129.55,0.00,0.00,0.00,0,1.00,1,78.32,0,1,0,java.lang.Object,0.00,2,0,1,0,2,0,0,0,22,0
"org.apache.jackrabbit.spi.RepositoryServiceImpl$Callable_7",1,0.00,1.00,3,0.03,258.13,1,0,104,3,0,134.21,0,4,0,1,134.21,0.00,0.00,0.00,0,1.00,1,78.32,0,1,0,java.lang.Object,0.00,2,0,1,0,2,0,0,0,22,0
"org.apache.jackrabbit.spi.RepositoryServiceImpl$Callable_8",1,0.00,1.00,4,0.03,292.00,1,0,104,3,0,129.13,0,5,0,1,129.13,0.00,0.00,0.00,0,1.00,1,88.00,0,1,0,java.lang.Object,0.00,2,0,1,0,2,0,0,0,24,0
"org.apache.jackrabbit.spi.RepositoryServiceImpl$Callable_9",1,0.00,1.00,4,0.05,637.24,1,0,104,6,0,126.46,0,5,0,1,126.46,0.00,0.00,0.00,0,1.00,1,141.98,0,1,0,java.lang.Object,0.00,5,0,1,0,5,0,0,0,35,0
"org.apache.jackrabbit.spi.RepositoryServiceImpl$NodeTypeDefinitionImpl",0,0.00,0.00,1,0.02,184.37,0,0,104,0,0,171.00,0,1,0,1,171.00,0.00,0.00,0.00,0,0.00,0,64.53,0,0,0,java.lang.Object,0.00,0,0,0,0,0,0,0,0,18,0
"org.apache.jackrabbit.spi.RepositoryServiceImpl$TraversingItemVisitor",4,0.00,1.50,11,0.15,2284.01,4,0,104,9,3,137.97,2,19,0,1,137.97,0.00,0.00,0.00,0,4.00,2,437.05,0,0,3,java.lang.Object,0.00,5,0,6,0,5,4,0,2,102,0
"org.apache.jackrabbit.spi.RepositoryStubImpl",3,1.00,1.67,18,0.18,4506.13,4,1,9,11,8,68.73,24,25,0,3,116.84,0.00,0.67,0.33,1,4.00,3,527.18,1,2,8,org.apache.jackrabbit.core.JackrabbitRepositoryStub,0.11,8,2,5,0,8,1,0,6,118,1
"org.apache.jackrabbit.spi.RepositoryStubImpl$AbstractRepositoryConfig",1,0.00,1.00,3,0.01,72.00,1,0,9,1,1,138.58,0,4,0,1,138.58,0.00,0.00,0.00,0,1.00,1,32.00,0,1,1,java.lang.Object,0.00,0,0,1,0,0,0,0,0,12,0
"org.apache.jackrabbit.spi.ServiceStubImpl",4,0.11,1.75,19,0.20,4101.00,7,3,8,9,5,174.70,6,29,0,2,124.70,0.00,0.50,0.25,0,6.00,2,600.56,1,3,5,org.apache.jackrabbit.spi.RepositoryServiceStub,0.60,5,1,7,0,5,1,0,2,141,1
"org.apache.jackrabbit.spi.SessionInfoImpl",14,0.02,1.14,59,0.64,13734.87,19,5,29,43,16,107.08,77,83,2,1,124.95,0.00,0.00,0.21,1,62.00,3,1915.04,0,9,15,java.lang.Object,0.00,29,0,16,0,29,5,1,20,431,0
"org.apache.jackrabbit.spi.SessionInfoImpl$NamespaceResolver",2,0.00,2.00,9,0.09,2289.95,2,0,29,5,0,174.29,2,17,0,1,124.30,0.00,0.00,0.00,0,2.00,2,262.88,0,2,0,java.lang.Object,0.00,3,0,4,0,3,0,0,2,64,0
"org.apache.jackrabbit.server.remoting.davex.BatchReadConfig",8,0.02,2.12,51,0.57,13834.82,14,6,10,26,2,74.01,62,67,2,1,116.30,0.00,0.00,0.19,3,12.00,5,1697.41,0,0,0,java.lang.Object,0.00,18,0,17,0,18,8,0,11,356,0
"org.apache.jackrabbit.server.remoting.davex.BatchReadConfigTest",3,0.00,1.67,38,0.49,18449.25,3,0,2,13,2,150.79,5,46,1,2,100.79,0.00,0.50,0.00,0,3.00,2,1480.02,0,0,1,junit.framework.TestCase,0.00,10,1,5,0,10,3,0,3,314,1
"org.apache.jackrabbit.server.remoting.davex.DiffException",2,0.00,1.00,5,0.03,207.57,2,0,0,2,14,193.89,3,8,14,2,143.89,0.00,0.50,0.00,0,2.00,1,84.79,0,0,0,java.lang.Exception,0.00,0,1,2,0,0,2,0,1,28,0
"org.apache.jackrabbit.server.remoting.davex.DiffHandler",4,0.00,1.00,5,0.04,228.23,4,0,0,4,5,157.17,3,6,4,1,157.17,0.00,0.00,0.00,0,4.00,1,133.14,0,0,1,,0.00,0,0,4,0,0,4,0,1,44,0
"org.apache.jackrabbit.server.remoting.davex.DiffParser",8,0.08,4.38,109,1.42,142835.44,19,11,6,26,4,77.75,45,144,2,1,95.63,0.00,0.00,0.16,4,22.00,21,4263.29,0,0,2,java.lang.Object,0.00,18,0,35,0,18,8,0,26,780,0
"org.apache.jackrabbit.server.remoting.davex.DiffParserTest",11,0.00,1.64,172,2.51,100114.44,11,0,5,26,3,135.72,27,180,1,2,95.84,0.00,0.50,0.00,0,11.00,3,7534.78,0,0,2,junit.framework.TestCase,0.00,15,1,18,0,15,11,0,27,1284,1
"org.apache.jackrabbit.server.remoting.davex.DiffParserTest$DummyDiffHandler",1,0.00,1.00,4,0.03,216.34,1,0,5,2,0,130.15,0,5,0,1,130.15,0.00,0.00,0.00,0,1.00,1,76.11,0,0,0,java.lang.Object,0.00,1,0,1,0,1,1,0,0,23,0
"org.apache.jackrabbit.server.remoting.davex.DiffParserTest$DummyDiffHandler_0",1,0.00,1.00,4,0.04,529.45,1,0,5,4,0,127.09,0,5,0,1,127.09,0.00,0.00,0.00,0,1.00,1,116.42,0,0,0,java.lang.Object,0.00,3,0,1,0,3,1,0,0,30,0
"org.apache.jackrabbit.server.remoting.davex.DiffParserTest$DummyDiffHandler_1",1,0.00,1.00,4,0.03,216.34,1,0,5,2,0,130.15,0,5,0,1,130.15,0.00,0.00,0.00,0,1.00,1,76.11,0,0,0,java.lang.Object,0.00,1,0,1,0,1,1,0,0,23,0
"org.apache.jackrabbit.server.remoting.davex.DiffParserTest$DummyDiffHandler_10",1,0.00,2.00,6,0.05,778.17,1,0,5,3,1,119.05,0,8,0,1,119.05,0.00,0.00,0.00,0,1.00,2,139.69,0,0,1,java.lang.Object,0.00,2,0,2,0,2,1,0,0,35,0
"org.apache.jackrabbit.server.remoting.davex.DiffParserTest$DummyDiffHandler_11",1,0.00,2.00,6,0.05,778.17,1,0,5,3,1,119.05,0,8,0,1,119.05,0.00,0.00,0.00,0,1.00,2,139.69,0,0,1,java.lang.Object,0.00,2,0,2,0,2,1,0,0,35,0
"org.apache.jackrabbit.server.remoting.davex.DiffParserTest$DummyDiffHandler_12",1,0.00,1.00,4,0.03,300.72,1,0,5,2,1,129.03,0,5,0,1,129.03,0.00,0.00,0.00,0,1.00,1,87.95,0,0,1,java.lang.Object,0.00,1,0,1,0,1,1,0,0,25,0
"org.apache.jackrabbit.server.remoting.davex.DiffParserTest$DummyDiffHandler_13",4,0.00,1.00,5,0.05,372.07,4,0,5,4,2,205.50,4,13,0,1,155.50,0.00,0.00,0.00,0,4.00,1,161.67,0,0,2,java.lang.Object,0.00,0,0,4,0,0,4,1,4,50,1
"org.apache.jackrabbit.server.remoting.davex.DiffParserTest$DummyDiffHandler_2",1,0.00,1.00,4,0.03,216.34,1,0,5,2,0,130.15,0,5,0,1,130.15,0.00,0.00,0.00,0,1.00,1,76.11,0,0,0,java.lang.Object,0.00,1,0,1,0,1,1,0,0,23,0
"org.apache.jackrabbit.server.remoting.davex.DiffParserTest$DummyDiffHandler_3",1,0.00,1.00,4,0.03,216.34,1,0,5,2,0,130.15,0,5,0,1,130.15,0.00,0.00,0.00,0,1.00,1,76.11,0,0,0,java.lang.Object,0.00,1,0,1,0,1,1,0,0,23,0
"org.apache.jackrabbit.server.remoting.davex.DiffParserTest$DummyDiffHandler_4",1,0.00,1.00,4,0.03,216.34,1,0,5,2,0,130.15,0,5,0,1,130.15,0.00,0.00,0.00,0,1.00,1,76.11,0,0,0,java.lang.Object,0.00,1,0,1,0,1,1,0,0,23,0
"org.apache.jackrabbit.server.remoting.davex.DiffParserTest$DummyDiffHandler_5",4,0.00,1.00,13,0.12,1377.59,4,0,5,8,1,133.22,0,19,0,1,133.22,0.00,0.00,0.00,0,4.00,1,362.31,0,0,1,java.lang.Object,0.00,4,0,4,0,4,4,0,0,95,0
"org.apache.jackrabbit.server.remoting.davex.DiffParserTest$DummyDiffHandler_6",1,0.00,1.00,4,0.04,462.00,1,0,5,2,1,127.56,0,6,0,1,127.56,0.00,0.00,0.00,0,1.00,1,108.00,0,0,1,java.lang.Object,0.00,1,0,1,0,1,1,0,0,29,0
"org.apache.jackrabbit.server.remoting.davex.DiffParserTest$DummyDiffHandler_7",1,0.00,1.00,3,0.02,254.72,1,0,5,2,1,134.26,0,4,0,1,134.26,0.00,0.00,0.00,0,1.00,1,72.73,0,0,1,java.lang.Object,0.00,1,0,1,0,1,1,0,0,21,0
"org.apache.jackrabbit.server.remoting.davex.DiffParserTest$DummyDiffHandler_8",1,0.00,2.00,6,0.05,778.17,1,0,5,3,1,119.05,0,8,0,1,119.05,0.00,0.00,0.00,0,1.00,2,139.69,0,0,1,java.lang.Object,0.00,2,0,2,0,2,1,0,0,35,0
"org.apache.jackrabbit.server.remoting.davex.DiffParserTest$DummyDiffHandler_9",1,0.00,1.00,3,0.02,197.02,1,0,5,2,1,135.13,0,4,0,1,135.13,0.00,0.00,0.00,0,1.00,1,67.21,0,0,1,java.lang.Object,0.00,1,0,1,0,1,1,0,0,20,0
"org.apache.jackrabbit.server.remoting.davex.JcrRemotingServlet",14,0.00,3.50,207,3.16,142022.16,23,9,36,102,26,76.27,206,262,1,4,96.41,0.33,0.60,0.11,5,74.00,9,9485.76,4,7,25,org.apache.jackrabbit.webdav.jcr.JCRWebdavServerServlet,0.11,88,3,49,1,88,7,0,30,1664,2
"org.apache.jackrabbit.server.remoting.davex.JcrRemotingServlet$DavLocatorFactoryImpl",4,0.00,1.50,15,0.17,4263.78,4,0,36,6,2,129.27,0,22,0,3,129.27,0.00,0.67,0.00,1,4.00,2,505.00,1,2,2,org.apache.jackrabbit.webdav.jcr.DavLocatorFactoryImpl,0.00,2,2,6,0,2,2,0,0,125,2
"org.apache.jackrabbit.server.remoting.davex.JcrRemotingServlet$ResourceFactoryImpl",2,0.00,2.50,10,0.16,4424.54,2,0,36,5,5,76.09,14,17,0,2,118.38,0.00,0.50,0.00,0,2.00,4,471.09,1,1,5,org.apache.jackrabbit.webdav.jcr.DavResourceFactoryImpl,0.00,3,1,5,0,3,1,0,9,103,2
"org.apache.jackrabbit.server.remoting.davex.JcrRemotingServlet$WrappingLocator",13,0.10,1.46,49,0.40,8103.99,17,4,36,25,2,131.11,1,70,0,1,131.11,0.00,0.00,0.35,1,0.00,3,1185.07,0,7,2,java.lang.Object,0.00,12,0,19,0,12,6,1,1,292,2
"org.apache.jackrabbit.server.remoting.davex.JsonDiffHandler",15,0.00,4.87,277,4.23,296307.09,24,9,29,101,10,110.60,53,330,2,1,89.98,0.00,0.00,0.11,9,75.00,15,12681.76,0,7,8,java.lang.Object,0.00,86,0,73,0,86,8,1,33,2219,0
"org.apache.jackrabbit.server.remoting.davex.JsonDiffHandler$ImportItem",2,1.00,1.50,7,0.06,1089.20,3,1,29,3,0,131.56,0,10,0,1,131.56,0.00,0.00,0.00,0,2.00,2,168.65,0,0,0,java.lang.Object,0.00,1,0,3,0,1,2,0,0,45,2
"org.apache.jackrabbit.server.remoting.davex.JsonDiffHandler$ImportMvProp",2,1.00,1.50,10,0.11,2139.53,3,1,29,8,0,120.98,0,14,0,2,120.98,0.00,0.50,0.50,0,2.00,2,335.09,0,0,0,org.apache.jackrabbit.server.remoting.davex.ImportItem,0.00,6,1,3,0,6,2,0,0,78,1
"org.apache.jackrabbit.server.remoting.davex.JsonDiffHandler$ImportNode",5,0.12,3.00,40,0.45,16541.75,9,4,29,13,1,159.34,5,48,0,2,109.34,0.00,0.50,0.35,0,9.00,7,1363.29,0,0,1,org.apache.jackrabbit.server.remoting.davex.ImportItem,0.00,8,1,15,0,8,5,0,5,289,1
"org.apache.jackrabbit.server.remoting.davex.JsonDiffHandler$ImportProp",2,1.00,1.00,7,0.06,617.92,3,1,29,3,0,133.59,0,10,0,2,133.59,0.00,0.50,0.50,0,2.00,1,175.37,0,0,0,org.apache.jackrabbit.server.remoting.davex.ImportItem,0.00,1,1,2,0,1,2,0,0,47,1
"org.apache.jackrabbit.server.remoting.davex.JsonDiffHandler$NodeHandler",11,0.03,1.82,55,0.60,14670.89,14,3,29,25,1,120.18,5,76,0,1,120.18,0.00,0.00,0.30,1,25.00,4,1797.42,0,0,1,java.lang.Object,0.00,14,0,20,0,14,11,1,5,404,1
"org.apache.jackrabbit.server.remoting.davex.JsonDiffHandler$ValueHandler",10,0.56,1.10,17,0.15,1996.26,11,1,29,10,1,152.86,5,28,0,1,152.86,0.00,0.00,0.50,0,10.00,2,458.73,0,1,1,java.lang.Object,0.00,0,0,11,0,0,9,1,5,131,1
"org.apache.jackrabbit.server.remoting.davex.JsonDiffHandler$ValuesHandler",10,0.56,1.10,20,0.20,2596.91,11,1,29,14,1,140.74,5,32,0,1,140.74,0.00,0.00,0.50,0,10.00,2,604.49,0,1,1,java.lang.Object,0.00,4,0,11,0,4,9,1,5,164,1
"org.apache.jackrabbit.server.remoting.davex.JsonDiffHandlerTest",1,0.00,2.00,32,0.44,14032.97,1,0,34,10,2,102.65,3,32,1,2,82.04,0.00,0.50,0.00,0,1.00,2,1305.17,0,0,1,junit.framework.TestCase,0.00,9,1,2,0,9,1,0,1,230,1
"org.apache.jackrabbit.server.remoting.davex.JsonDiffHandlerTest$DummySession",41,0.00,1.00,69,0.62,5135.70,41,0,34,41,0,154.48,10,122,0,1,154.48,0.00,0.00,0.00,0,41.00,1,1845.98,0,20,0,java.lang.Object,0.00,0,0,41,0,0,21,1,10,511,2
"org.apache.jackrabbit.server.remoting.davex.JsonWriter",12,1.00,2.33,94,1.32,51196.80,13,1,11,36,3,68.40,89,126,1,1,110.70,0.00,0.00,0.08,7,22.00,7,3969.61,0,1,2,java.lang.Object,0.00,24,0,28,0,24,11,0,27,769,0
"org.apache.jackrabbit.server.remoting.davex.TestAll",1,0.00,1.00,7,0.06,1740.69,1,0,3,3,3,71.66,7,9,0,2,113.96,0.00,0.50,0.00,0,1.00,1,186.48,0,1,3,junit.framework.TestCase,0.00,2,1,1,0,2,0,0,2,47,1
"org.apache.jackrabbit.spi.commons.namespace.AbstractNamespaceResolver",7,0.17,2.71,70,0.64,24542.45,8,1,3,16,11,57.08,70,79,9,1,105.55,0.00,0.00,0.86,0,0.00,4,1915.29,0,0,2,java.lang.Object,0.00,9,0,19,2,9,7,1,15,392,2
"org.apache.jackrabbit.spi.commons.namespace.NamespaceAdder",3,0.00,1.33,16,0.18,2992.84,4,1,6,8,1,121.24,0,20,0,1,121.24,0.00,0.00,1.00,0,0.00,2,541.91,0,0,1,java.lang.Object,0.00,5,0,4,0,5,3,0,0,119,1
"org.apache.jackrabbit.spi.commons.namespace.NamespaceExtractor",2,0.00,1.50,16,0.18,3978.77,6,4,12,12,1,73.68,24,21,0,1,111.24,0.00,0.00,0.25,0,2.00,2,553.64,0,1,1,java.lang.Object,0.00,10,0,3,0,10,1,0,4,118,1
"org.apache.jackrabbit.spi.commons.namespace.NamespaceExtractor$NamespaceHandler",1,0.00,6.00,19,0.25,12230.03,1,0,12,5,0,130.59,2,26,0,2,90.70,0.00,0.50,0.00,0,0.00,6,752.53,0,0,0,org.xml.sax.helpers.DefaultHandler,0.00,4,1,6,0,4,1,0,2,141,1
"org.apache.jackrabbit.spi.commons.namespace.NamespaceListener",3,0.00,1.00,4,0.03,159.82,3,0,0,3,1,109.30,26,5,1,1,157.40,0.00,0.00,0.00,0,3.00,1,89.52,0,0,0,,0.00,0,0,3,0,0,3,0,4,31,1
"org.apache.jackrabbit.spi.commons.namespace.NamespaceMapping",10,0.04,2.10,54,0.62,21089.67,13,3,3,23,8,100.71,50,74,7,1,118.58,0.00,0.00,0.30,2,18.00,5,1850.65,0,5,1,java.lang.Object,0.00,13,0,21,0,13,5,1,15,421,1
"org.apache.jackrabbit.spi.commons.namespace.NamespaceResolver",2,0.00,1.00,3,0.02,99.22,2,0,1,2,56,113.52,22,4,56,1,157.65,0.00,0.00,0.00,0,2.00,1,54.92,0,2,0,,0.00,0,0,2,0,0,0,0,3,21,1
"org.apache.jackrabbit.spi.commons.namespace.RegistryNamespaceResolver",3,0.50,2.33,16,0.17,8339.19,4,1,3,6,5,117.85,12,28,4,1,117.61,0.00,0.00,0.67,0,1.00,3,503.19,0,2,1,java.lang.Object,0.00,3,0,7,0,3,1,1,3,116,1
"org.apache.jackrabbit.spi.commons.namespace.SessionNamespaceResolver",3,0.50,1.67,12,0.11,2384.80,4,1,3,6,3,93.36,19,20,2,1,125.58,0.00,0.00,0.67,0,1.00,2,340.69,0,2,1,java.lang.Object,0.00,3,0,5,0,3,1,1,7,84,1
"org.apache.jackrabbit.jca.test.AbstractTestCase",1,4.00,4.00,27,0.39,15983.02,7,6,9,14,4,134.18,25,41,2,2,84.19,2.00,0.25,0.33,0,0.00,4,1179.00,0,0,2,junit.framework.TestCase,0.00,13,1,4,2,13,1,0,9,217,2
"org.apache.jackrabbit.jca.test.ConnectionFactoryTest",5,0.00,1.20,45,0.54,18587.02,5,0,11,16,5,75.03,32,54,0,3,107.25,0.00,0.67,0.00,0,0.00,2,1623.61,0,0,5,org.apache.jackrabbit.jca.test.AbstractTestCase,0.00,11,2,6,0,11,5,0,20,335,2
"org.apache.jackrabbit.jca.test.ConnectionRequestInfoTest",3,0.42,1.00,19,0.28,7357.64,9,6,3,14,2,115.52,12,24,0,3,115.28,0.00,0.67,0.44,0,0.00,1,833.84,0,0,2,org.apache.jackrabbit.jca.test.AbstractTestCase,0.00,11,2,3,0,11,3,0,4,187,2
"org.apache.jackrabbit.test.api.observation.AbstractObservationTest",14,0.23,1.79,85,1.11,36578.20,17,3,14,42,25,64.93,126,116,22,4,114.93,7.33,0.12,0.12,3,62.00,6,3321.04,2,3,3,org.apache.jackrabbit.test.AbstractJCRTest,0.22,28,3,25,22,28,11,0,19,684,2
"org.apache.jackrabbit.test.api.observation.AbstractObservationTest$Callable",1,0.00,1.00,2,0.01,51.30,1,0,14,1,0,146.30,0,3,0,1,146.30,0.00,0.00,0.00,0,1.00,1,27.65,0,0,0,,0.00,0,0,1,0,0,1,0,0,11,1
"org.apache.jackrabbit.test.api.observation.AddEventListenerTest",7,0.00,1.14,84,1.22,35171.16,7,0,5,21,4,59.28,54,110,1,5,101.57,0.00,0.80,0.00,0,0.00,2,3653.15,4,1,3,org.apache.jackrabbit.test.api.observation.AbstractObservationTest,0.00,14,4,8,0,14,6,0,10,677,1
"org.apache.jackrabbit.test.api.observation.EventIteratorTest",3,0.00,1.67,47,0.59,15877.45,3,0,5,15,4,53.56,34,54,1,5,97.69,0.00,0.80,0.00,0,0.00,2,1770.04,2,0,3,org.apache.jackrabbit.test.api.observation.AbstractObservationTest,0.00,12,4,5,0,12,3,0,8,328,1
"org.apache.jackrabbit.test.api.observation.EventJournalTest",14,0.08,1.29,106,1.42,28247.63,15,1,9,44,3,163.39,18,122,1,5,113.39,0.00,0.80,0.93,1,0.00,3,4257.37,3,1,2,org.apache.jackrabbit.test.api.observation.AbstractObservationTest,0.10,30,4,18,0,30,13,0,9,861,1
"org.apache.jackrabbit.test.api.observation.EventResult",5,0.00,2.00,30,0.28,5463.78,8,3,8,16,20,73.76,56,43,20,1,117.89,0.00,0.00,0.33,2,2.00,3,845.75,0,3,0,java.lang.Object,0.00,11,0,10,0,11,2,1,11,195,1
"org.apache.jackrabbit.test.api.observation.EventTest",3,0.00,1.00,33,0.42,8149.26,3,0,3,13,3,62.82,23,37,1,5,105.11,0.00,0.80,0.00,0,0.00,1,1256.61,2,0,2,org.apache.jackrabbit.test.api.observation.AbstractObservationTest,0.00,10,4,3,0,10,3,0,4,243,1
"org.apache.jackrabbit.test.api.observation.GetDateTest",1,0.00,4.00,21,0.25,8247.23,1,0,7,11,2,58.30,6,20,1,5,90.52,0.00,0.80,0.00,0,0.00,4,752.14,0,0,1,org.apache.jackrabbit.test.api.observation.AbstractObservationTest,0.00,10,4,4,0,10,1,0,3,134,1
"org.apache.jackrabbit.test.api.observation.GetDateTest$Callable",1,0.00,1.00,4,0.03,256.15,1,0,7,3,0,129.58,0,5,0,1,129.58,0.00,0.00,0.00,0,1.00,1,80.34,0,0,0,java.lang.Object,0.00,2,0,1,0,2,1,0,0,23,0
"org.apache.jackrabbit.test.api.observation.GetIdentifierTest",6,0.00,1.00,42,0.56,9717.64,6,0,4,18,2,114.20,3,43,1,5,114.20,0.00,0.80,0.00,0,0.00,1,1680.04,0,0,1,org.apache.jackrabbit.test.api.observation.AbstractObservationTest,0.00,12,4,6,0,12,6,0,1,345,1
"org.apache.jackrabbit.test.api.observation.GetIdentifierTest$Callable",1,0.00,1.00,4,0.03,256.15,1,0,4,3,0,129.58,0,5,0,1,129.58,0.00,0.00,0.00,0,1.00,1,80.34,0,0,0,java.lang.Object,0.00,2,0,1,0,2,1,0,0,23,0
"org.apache.jackrabbit.test.api.observation.GetIdentifierTest$Callable_0",1,0.00,1.00,3,0.04,362.27,1,0,4,4,0,133.05,0,4,0,1,133.05,0.00,0.00,0.00,0,1.00,1,108.08,0,0,0,java.lang.Object,0.00,3,0,1,0,3,1,0,0,28,0
"org.apache.jackrabbit.test.api.observation.GetIdentifierTest$Callable_1",1,0.00,1.00,4,0.02,200.72,1,0,4,3,0,130.41,0,5,0,1,130.41,0.00,0.00,0.00,0,1.00,1,70.91,0,0,0,java.lang.Object,0.00,2,0,1,0,2,1,0,0,21,0
"org.apache.jackrabbit.test.api.observation.GetIdentifierTest$Callable_2",1,0.00,1.00,4,0.04,333.05,1,0,4,4,0,128.68,0,5,0,1,128.68,0.00,0.00,0.00,0,1.00,1,106.10,0,0,0,java.lang.Object,0.00,3,0,1,0,3,1,0,0,28,0
"org.apache.jackrabbit.test.api.observation.GetIdentifierTest$Callable_3",1,0.00,1.00,4,0.03,217.60,1,0,4,3,0,130.13,0,5,0,1,130.13,0.00,0.00,0.00,0,1.00,1,76.53,0,0,0,java.lang.Object,0.00,2,0,1,0,2,1,0,0,22,0
"org.apache.jackrabbit.test.api.observation.GetIdentifierTest$Callable_4",1,0.00,1.00,4,0.02,200.72,1,0,4,3,0,130.41,0,5,0,1,130.41,0.00,0.00,0.00,0,1.00,1,70.91,0,0,0,java.lang.Object,0.00,2,0,1,0,2,1,0,0,21,0
"org.apache.jackrabbit.test.api.observation.GetInfoTest",5,0.00,2.00,49,0.52,12390.91,5,0,4,12,2,158.52,6,40,1,5,108.52,0.00,0.80,0.00,0,2.00,2,1549.53,0,0,1,org.apache.jackrabbit.test.api.observation.AbstractObservationTest,0.00,7,4,10,0,7,5,0,1,309,1
"org.apache.jackrabbit.test.api.observation.GetInfoTest$Callable",1,0.00,1.00,4,0.03,256.15,1,0,4,3,0,129.58,0,5,0,1,129.58,0.00,0.00,0.00,0,1.00,1,80.34,0,0,0,java.lang.Object,0.00,2,0,1,0,2,1,0,0,23,0
"org.apache.jackrabbit.test.api.observation.GetInfoTest$Callable_0",1,0.00,1.00,4,0.02,200.72,1,0,4,3,0,130.41,0,5,0,1,130.41,0.00,0.00,0.00,0,1.00,1,70.91,0,0,0,java.lang.Object,0.00,2,0,1,0,2,1,0,0,21,0
"org.apache.jackrabbit.test.api.observation.GetInfoTest$Callable_1",1,0.00,1.00,4,0.04,333.05,1,0,4,4,0,128.68,0,5,0,1,128.68,0.00,0.00,0.00,0,1.00,1,106.10,0,0,0,java.lang.Object,0.00,3,0,1,0,3,1,0,0,28,0
"org.apache.jackrabbit.test.api.observation.GetInfoTest$Callable_2",1,0.00,1.00,3,0.02,151.81,1,0,4,2,0,136.03,0,4,0,1,136.03,0.00,0.00,0.00,0,1.00,1,54.60,0,0,0,java.lang.Object,0.00,1,0,1,0,1,1,0,0,17,0
"org.apache.jackrabbit.test.api.observation.GetInfoTest$Callable_3",1,0.00,1.00,3,0.02,136.54,1,0,4,2,0,136.39,0,4,0,1,136.39,0.00,0.00,0.00,0,1.00,1,49.51,0,0,0,java.lang.Object,0.00,1,0,1,0,1,1,0,0,16,0
"org.apache.jackrabbit.test.api.observation.GetRegisteredEventListenersTest",2,0.00,1.00,21,0.24,6030.45,2,0,2,5,3,74.08,12,24,1,5,106.30,0.00,0.80,0.00,0,0.00,1,725.25,3,0,2,org.apache.jackrabbit.test.api.observation.AbstractObservationTest,0.00,3,4,2,0,3,2,0,2,152,1
"org.apache.jackrabbit.test.api.observation.GetUserDataTest",4,0.00,1.25,26,0.22,4445.18,4,0,5,10,3,167.94,5,27,1,5,117.94,0.00,0.80,0.00,1,2.00,2,654.29,3,0,2,org.apache.jackrabbit.test.api.observation.AbstractObservationTest,0.00,6,4,5,0,6,4,0,2,143,1
"org.apache.jackrabbit.test.api.observation.GetUserDataTest$Callable",1,0.00,1.00,4,0.03,256.15,1,0,5,3,0,129.58,0,5,0,1,129.58,0.00,0.00,0.00,0,1.00,1,80.34,0,0,0,java.lang.Object,0.00,2,0,1,0,2,1,0,0,23,0
"org.apache.jackrabbit.test.api.observation.GetUserDataTest$Callable_0",1,0.00,1.00,5,0.05,863.43,1,0,5,3,0,121.80,0,6,0,1,121.80,0.00,0.00,0.00,0,1.00,1,161.73,0,0,0,java.lang.Object,0.00,2,0,1,0,2,1,0,0,39,0
"org.apache.jackrabbit.test.api.observation.GetUserDataTest$Callable_1",1,0.00,1.00,3,0.02,136.54,1,0,5,2,0,136.39,0,4,0,1,136.39,0.00,0.00,0.00,0,1.00,1,49.51,0,0,0,java.lang.Object,0.00,1,0,1,0,1,1,0,0,16,0
"org.apache.jackrabbit.test.api.observation.GetUserDataTest$Callable_2",1,0.00,1.00,4,0.02,240.37,1,0,5,3,0,129.79,0,5,0,1,129.79,0.00,0.00,0.00,0,1.00,1,74.61,0,0,0,java.lang.Object,0.00,2,0,1,0,2,1,0,0,22,0
"org.apache.jackrabbit.test.api.observation.LockingTest",3,0.00,2.33,55,0.75,25565.66,3,0,6,16,4,48.90,34,54,1,5,93.03,0.00,0.80,0.00,1,0.00,3,2261.12,3,1,3,org.apache.jackrabbit.test.api.observation.AbstractObservationTest,0.00,13,4,7,0,13,2,0,6,390,1
"org.apache.jackrabbit.test.api.observation.NodeAddedTest",4,0.00,1.00,41,0.46,9392.73,4,0,3,9,3,64.86,30,42,1,5,107.15,0.00,0.80,0.00,0,0.00,1,1372.91,3,0,2,org.apache.jackrabbit.test.api.observation.AbstractObservationTest,0.00,5,4,4,0,5,4,0,5,276,1
"org.apache.jackrabbit.test.api.observation.NodeMovedTest",5,0.38,1.00,85,1.22,41635.93,7,2,4,16,3,112.36,91,85,1,5,94.23,0.00,0.80,0.20,2,0.00,1,3653.50,5,0,2,org.apache.jackrabbit.test.api.observation.AbstractObservationTest,0.00,11,4,5,0,11,5,0,13,674,1
"org.apache.jackrabbit.test.api.observation.NodeRemovedTest",2,0.00,1.00,24,0.27,5847.23,2,0,3,7,3,59.32,23,25,1,5,103.45,0.00,0.80,0.00,0,0.00,1,802.77,3,0,2,org.apache.jackrabbit.test.api.observation.AbstractObservationTest,0.00,5,4,2,0,5,2,0,3,160,1
"org.apache.jackrabbit.test.api.observation.NodeReorderTest",5,0.38,3.80,143,2.02,136737.96,7,2,5,24,4,131.77,127,147,1,5,81.77,0.00,0.80,0.20,2,5.00,6,6058.89,5,0,3,org.apache.jackrabbit.test.api.observation.AbstractObservationTest,0.00,19,4,19,0,19,5,0,40,1013,1
"org.apache.jackrabbit.test.api.observation.PropertyAddedTest",3,0.00,1.33,37,0.48,12114.70,3,0,5,13,3,52.28,29,40,1,5,102.28,0.00,0.80,0.00,0,0.00,2,1451.08,3,0,2,org.apache.jackrabbit.test.api.observation.AbstractObservationTest,0.00,10,4,4,0,10,3,0,4,274,1
"org.apache.jackrabbit.test.api.observation.PropertyChangedTest",4,0.00,1.75,65,1.06,47696.82,4,0,7,24,4,49.73,44,72,1,5,93.85,0.00,0.80,0.00,0,0.00,4,3181.32,3,0,3,org.apache.jackrabbit.test.api.observation.AbstractObservationTest,0.00,20,4,7,0,20,4,0,7,548,1
"org.apache.jackrabbit.test.api.observation.PropertyRemovedTest",2,0.00,1.00,26,0.35,8292.36,2,0,4,8,3,63.40,24,30,1,5,100.96,0.00,0.80,0.00,0,0.00,1,1063.85,3,0,2,org.apache.jackrabbit.test.api.observation.AbstractObservationTest,0.00,6,4,2,0,6,2,0,3,201,1
"org.apache.jackrabbit.test.api.observation.TestAll",1,0.00,1.00,22,0.28,10800.80,1,0,3,3,20,45.03,11,24,2,2,89.16,0.00,0.50,0.00,0,1.00,1,827.66,0,1,18,junit.framework.TestCase,0.00,2,1,1,0,2,0,0,3,167,1
"org.apache.jackrabbit.test.api.observation.WorkspaceOperationTest",3,0.00,1.00,49,0.73,22769.39,3,0,3,11,3,45.53,28,48,1,5,95.53,0.00,0.80,0.00,0,0.00,1,2203.07,4,0,2,org.apache.jackrabbit.test.api.observation.AbstractObservationTest,0.00,8,4,3,0,8,3,0,4,408,1
"org.apache.jackrabbit.webdav.jcr.property.LengthsProperty",3,0.50,1.33,16,0.15,3065.42,4,1,5,6,4,88.94,19,18,1,2,121.16,0.00,0.50,0.67,0,2.00,2,436.03,1,2,3,org.apache.jackrabbit.webdav.property.AbstractDavProperty,0.00,3,1,4,0,3,1,1,4,99,1
"org.apache.jackrabbit.webdav.jcr.property.NamespacesProperty",6,0.10,2.17,46,0.66,18241.82,8,2,18,28,9,161.87,8,57,2,2,111.87,0.00,0.50,0.58,0,0.00,5,1971.00,1,3,7,org.apache.jackrabbit.webdav.property.AbstractDavProperty,0.00,22,1,13,0,22,3,1,4,382,1
"org.apache.jackrabbit.webdav.jcr.property.ValuesProperty",13,0.08,2.38,82,1.19,47415.44,15,2,20,42,15,81.50,89,105,7,2,113.72,0.00,0.50,0.42,2,0.00,8,3579.59,1,7,8,org.apache.jackrabbit.webdav.property.AbstractDavProperty,0.00,29,1,31,0,29,6,1,21,694,1
"org.apache.jackrabbit.server.BasicCredentialsProvider",2,1.00,4.00,30,0.47,31008.44,3,1,9,17,6,120.09,38,43,3,1,93.81,0.00,0.00,0.50,0,2.00,7,1423.23,0,1,3,java.lang.Object,0.00,15,0,8,0,15,1,1,4,246,1
"org.apache.jackrabbit.server.BasicCredentialsProviderTest",2,0.00,2.50,27,0.40,13797.38,2,0,19,18,3,138.89,4,31,1,2,99.01,0.00,0.50,0.00,0,2.00,3,1193.38,0,0,2,junit.framework.TestCase,0.00,16,1,5,0,16,2,0,2,219,1
"org.apache.jackrabbit.server.BasicCredentialsProviderTest$RequestImpl",51,1.00,1.00,101,0.48,3926.43,52,1,19,51,0,156.14,0,153,0,1,156.14,0.00,0.00,0.02,0,100.00,1,1430.80,0,37,0,java.lang.Object,0.00,0,0,51,0,0,14,1,0,459,1
"org.apache.jackrabbit.server.CredentialsProvider",1,0.00,1.00,2,0.01,78.44,1,0,4,1,5,100.72,11,4,5,1,144.85,0.00,0.00,0.00,0,1.00,1,41.22,0,1,0,,0.00,0,0,1,0,0,0,0,2,14,1
"org.apache.jackrabbit.server.SessionProvider",2,0.00,1.00,3,0.03,158.68,2,0,6,2,4,106.04,19,5,4,1,156.04,0.00,0.00,0.00,0,2.00,1,86.25,0,1,0,,0.00,0,0,2,0,0,1,0,3,26,1
"org.apache.jackrabbit.server.SessionProviderImpl",3,1.00,1.33,12,0.11,2236.10,4,1,7,6,4,107.98,16,19,2,1,125.86,0.00,0.00,0.33,0,4.00,2,342.21,0,1,2,java.lang.Object,0.00,3,0,4,0,3,2,1,5,82,1
"org.apache.jackrabbit.server.TestAll",1,0.00,1.00,5,0.04,864.35,1,0,3,3,1,79.51,7,7,0,2,121.80,0.00,0.50,0.00,0,1.00,1,115.51,0,1,1,junit.framework.TestCase,0.00,2,1,1,0,2,0,0,2,31,1
"org.apache.jackrabbit.test.api.AbstractImportXmlTest",13,0.10,2.46,218,2.84,81565.50,52,39,39,78,3,47.87,112,271,1,4,95.97,0.33,0.60,0.12,4,0.00,4,8524.22,2,5,2,org.apache.jackrabbit.test.AbstractJCRTest,0.22,65,3,32,1,65,8,0,34,1522,1
"org.apache.jackrabbit.test.api.AbstractPropertyTest",5,0.06,1.60,31,0.33,7536.97,9,4,6,15,12,117.07,21,40,9,4,116.84,3.00,0.23,0.30,2,2.00,3,981.97,3,1,3,org.apache.jackrabbit.test.AbstractJCRTest,0.43,10,3,8,9,10,4,0,9,205,1
"org.apache.jackrabbit.test.api.AbstractWorkspaceCopyBetweenTest",4,0.50,2.50,49,0.50,14066.36,10,6,6,23,7,60.32,29,59,5,5,102.61,4.25,0.18,0.54,2,0.00,4,1505.62,3,1,2,org.apache.jackrabbit.test.api.AbstractWorkspaceCopyTest,0.33,19,4,10,17,19,3,0,13,315,1
"org.apache.jackrabbit.test.api.AbstractWorkspaceCopyTest",3,0.50,1.67,21,0.18,3080.92,6,3,4,8,4,83.42,18,29,3,4,115.64,6.67,0.12,0.67,1,0.00,3,532.36,2,0,1,org.apache.jackrabbit.test.AbstractJCRTest,0.31,5,3,5,20,5,3,0,7,126,1
"org.apache.jackrabbit.test.api.AbstractWorkspaceReferenceableTest",2,0.00,2.00,13,0.14,3764.38,2,0,6,7,6,83.80,12,20,4,6,116.03,0.80,0.50,0.00,0,0.00,3,433.25,2,1,2,org.apache.jackrabbit.test.api.AbstractWorkspaceCopyBetweenTest,0.19,5,5,4,4,5,1,0,4,94,1
"org.apache.jackrabbit.test.api.AbstractWorkspaceSameNameSibsTest",2,1.00,5.00,40,0.45,25070.03,6,4,5,10,6,45.70,22,47,4,6,89.83,0.80,0.50,0.75,0,0.00,9,1353.63,3,0,2,org.apache.jackrabbit.test.api.AbstractWorkspaceCopyBetweenTest,0.38,8,5,10,4,8,2,0,10,249,1
"org.apache.jackrabbit.test.api.AbstractWorkspaceVersionableTest",2,0.00,2.00,13,0.15,3837.06,2,0,6,7,6,98.09,10,20,4,6,115.96,0.80,0.50,0.00,0,0.00,3,443.40,2,1,2,org.apache.jackrabbit.test.api.AbstractWorkspaceCopyBetweenTest,0.19,5,5,4,4,5,1,0,4,96,1
"org.apache.jackrabbit.test.api.AddNodeTest",13,0.00,2.00,90,1.07,21856.69,13,0,12,38,3,84.19,82,132,1,4,116.41,0.00,0.75,0.00,0,0.00,4,3198.50,0,0,2,org.apache.jackrabbit.test.AbstractJCRTest,0.00,25,3,26,0,25,13,0,34,670,1
"org.apache.jackrabbit.test.api.Base64",11,0.12,2.27,108,1.78,229742.97,15,4,7,18,2,58.91,86,135,2,1,101.20,0.00,0.00,0.14,2,39.00,8,5351.38,0,0,0,java.lang.Object,0.00,7,0,25,0,7,11,0,23,993,1
"org.apache.jackrabbit.test.api.BinaryPropertyTest",19,0.00,3.26,207,2.56,121904.63,19,0,9,62,4,85.57,108,316,1,5,103.44,0.00,0.80,0.00,0,0.00,6,7666.40,0,1,3,org.apache.jackrabbit.test.api.AbstractPropertyTest,0.21,43,4,62,0,43,18,0,40,1455,1
"org.apache.jackrabbit.test.api.BooleanPropertyTest",13,0.00,2.77,98,1.09,36347.55,13,0,7,40,3,94.23,72,164,1,5,112.10,0.00,0.80,0.00,0,0.00,6,3264.03,0,1,2,org.apache.jackrabbit.test.api.AbstractPropertyTest,0.24,27,4,36,0,27,12,0,28,654,1
"org.apache.jackrabbit.test.api.CheckPermissionTest",3,0.00,2.67,27,0.33,9623.48,3,0,3,10,2,59.46,26,39,1,4,107.57,0.00,0.75,0.00,2,0.00,5,998.73,0,0,1,org.apache.jackrabbit.test.AbstractJCRTest,0.00,7,3,8,0,7,3,0,7,203,1
"org.apache.jackrabbit.test.api.DatePropertyTest",13,0.00,2.62,99,1.12,36626.24,13,0,8,41,3,94.22,73,160,1,5,112.09,0.00,0.80,0.00,0,0.00,6,3371.86,0,1,2,org.apache.jackrabbit.test.api.AbstractPropertyTest,0.24,28,4,34,0,28,12,0,30,676,1
"org.apache.jackrabbit.test.api.DocumentViewImportTest",21,0.01,2.05,149,1.83,51028.62,25,4,13,47,3,94.78,120,229,1,5,112.65,0.00,0.80,0.26,11,136.00,6,5480.17,6,0,2,org.apache.jackrabbit.test.api.AbstractImportXmlTest,0.18,26,4,43,0,26,21,0,47,1066,1
"org.apache.jackrabbit.test.api.DoublePropertyTest",13,0.00,2.62,98,1.12,37231.14,13,0,8,43,3,94.16,70,157,1,5,112.03,0.00,0.80,0.00,0,0.00,6,3353.62,0,1,2,org.apache.jackrabbit.test.api.AbstractPropertyTest,0.24,30,4,34,0,30,12,0,26,672,1
"org.apache.jackrabbit.test.api.EscapeJCRUtil",7,0.22,2.57,73,0.80,43331.10,10,3,1,18,2,124.24,27,89,1,1,103.62,0.00,0.00,0.14,5,17.00,7,2403.89,0,6,1,java.lang.Object,0.00,11,0,18,0,11,1,0,8,491,1
"org.apache.jackrabbit.test.api.ExportDocViewTest",39,0.04,3.05,437,5.96,255290.46,59,20,40,145,5,51.85,361,599,1,4,101.85,0.00,0.75,0.09,23,696.00,10,17876.80,3,11,4,org.apache.jackrabbit.test.AbstractJCRTest,0.13,106,3,119,0,106,28,0,100,3315,1
"org.apache.jackrabbit.test.api.ExportDocViewTest$AttributeSeparator",4,0.33,1.75,30,0.26,5803.98,10,6,40,13,0,114.45,1,35,0,1,114.45,0.00,0.00,0.42,1,0.00,4,786.84,0,2,0,java.lang.Object,0.00,9,0,7,0,9,2,0,1,174,1
"org.apache.jackrabbit.test.api.ExportDocViewTest$StackEntry",0,0.00,0.00,3,0.02,129.73,2,2,40,0,0,171.00,2,4,0,1,171.00,0.00,0.00,0.00,0,0.00,0,51.89,0,0,0,java.lang.Object,0.00,0,0,0,0,0,0,0,2,15,1
"org.apache.jackrabbit.test.api.ExportSysViewTest",12,0.19,1.17,46,0.50,8106.35,19,7,16,25,3,170.77,24,73,1,4,130.88,0.00,0.75,0.32,2,4.00,2,1485.44,2,0,2,org.apache.jackrabbit.test.AbstractJCRTest,0.23,13,3,14,0,13,12,0,4,339,1
"org.apache.jackrabbit.test.api.ExportSysViewTest$SysViewParser",2,0.20,2.00,19,0.20,4460.31,7,5,16,10,1,158.88,3,27,0,1,108.88,0.00,0.00,0.30,0,0.00,2,610.34,0,0,1,java.lang.Object,0.00,8,0,4,0,8,2,0,3,131,1
"org.apache.jackrabbit.test.api.GetWeakReferencesTest",6,0.40,1.50,59,0.79,15262.93,8,2,7,22,3,108.49,5,69,1,4,108.49,0.00,0.75,0.83,0,0.00,4,2359.00,2,0,2,org.apache.jackrabbit.test.AbstractJCRTest,0.14,16,3,9,0,16,6,0,2,465,1
"org.apache.jackrabbit.test.api.HasPermissionTest",3,0.00,1.00,36,0.58,16088.85,4,1,3,12,2,59.08,23,44,1,4,101.38,0.00,0.75,1.00,0,0.00,1,1735.16,0,0,1,org.apache.jackrabbit.test.AbstractJCRTest,0.00,9,3,3,0,9,3,0,4,341,1
"org.apache.jackrabbit.test.api.ImpersonateTest",1,0.00,7.00,25,0.37,17717.28,1,0,9,12,3,103.08,18,39,1,4,84.95,0.00,0.75,0.00,0,0.00,7,1120.10,0,0,2,org.apache.jackrabbit.test.AbstractJCRTest,0.00,11,3,7,0,11,1,0,8,193,1
"org.apache.jackrabbit.test.api.LongPropertyTest",13,0.00,2.62,96,1.09,34613.00,13,0,8,42,3,94.41,69,157,1,5,112.28,0.00,0.80,0.00,0,0.00,6,3274.34,0,1,2,org.apache.jackrabbit.test.api.AbstractPropertyTest,0.24,29,4,34,0,29,12,0,26,658,1
"org.apache.jackrabbit.test.api.NamePropertyTest",10,0.00,2.20,58,0.61,12746.50,10,0,7,30,3,88.07,69,97,1,5,120.29,0.00,0.80,0.00,0,0.00,5,1819.93,0,1,2,org.apache.jackrabbit.test.api.AbstractPropertyTest,0.26,20,4,22,0,20,9,0,19,385,1
"org.apache.jackrabbit.test.api.NameTest",5,0.00,1.40,34,0.52,12329.11,5,0,9,24,3,97.31,27,41,1,4,115.18,0.00,0.75,0.00,1,0.00,3,1554.75,0,1,2,org.apache.jackrabbit.test.AbstractJCRTest,0.00,19,3,7,0,19,4,0,5,326,1
"org.apache.jackrabbit.test.api.NamespaceRegistryReadMethodsTest",6,0.30,2.17,61,0.72,18646.69,10,4,10,21,3,73.80,37,73,1,4,106.02,0.00,0.75,0.50,0,0.00,3,2174.37,2,0,2,org.apache.jackrabbit.test.AbstractJCRTest,0.28,15,3,13,0,15,6,0,12,429,1
"org.apache.jackrabbit.test.api.NamespaceRegistryTest",8,0.24,2.75,77,0.88,21919.86,14,6,8,33,2,65.81,58,109,1,4,108.10,0.00,0.75,0.38,0,0.00,5,2633.26,2,2,1,org.apache.jackrabbit.test.AbstractJCRTest,0.26,25,3,22,0,25,6,0,28,544,1
"org.apache.jackrabbit.test.api.NamespaceRemappingTest",13,0.12,1.62,107,1.36,32585.46,15,2,10,47,2,72.87,163,157,1,4,110.44,0.00,0.75,0.62,2,0.00,3,4077.93,2,1,1,org.apache.jackrabbit.test.AbstractJCRTest,0.22,34,3,21,0,34,12,0,35,822,1
"org.apache.jackrabbit.test.api.NodeAddMixinTest",8,0.00,3.25,113,1.46,51556.07,8,0,12,46,4,49.50,85,145,1,4,97.98,0.00,0.75,0.00,1,0.00,6,4389.97,1,0,3,org.apache.jackrabbit.test.AbstractJCRTest,0.00,38,3,26,0,38,8,0,35,789,1
"org.apache.jackrabbit.test.api.NodeCanAddMixinTest",5,0.00,2.60,63,0.84,23668.53,5,0,9,31,4,51.58,45,84,1,4,101.58,0.00,0.75,0.00,0,0.00,3,2533.41,1,0,3,org.apache.jackrabbit.test.AbstractJCRTest,0.00,26,3,13,0,26,5,0,16,466,1
"org.apache.jackrabbit.test.api.NodeDiscoveringNodeTypesTest",6,0.00,2.83,65,0.84,28117.40,8,2,9,29,3,56.45,49,102,1,4,104.55,0.00,0.75,0.50,1,0.00,5,2532.33,2,1,2,org.apache.jackrabbit.test.AbstractJCRTest,0.28,23,3,17,0,23,5,0,14,484,1
"org.apache.jackrabbit.test.api.NodeItemIsModifiedTest",4,0.00,1.00,23,0.29,3640.74,4,0,4,12,2,84.06,50,28,1,4,121.62,0.00,0.75,0.00,0,0.00,1,875.35,0,0,1,org.apache.jackrabbit.test.AbstractJCRTest,0.00,8,3,4,0,8,4,0,11,188,1
"org.apache.jackrabbit.test.api.NodeItemIsNewTest",2,0.00,1.00,10,0.13,1491.05,2,0,4,9,2,92.93,27,13,1,4,122.31,0.00,0.75,0.00,0,0.00,1,380.20,0,0,1,org.apache.jackrabbit.test.AbstractJCRTest,0.00,7,3,2,0,7,2,0,5,85,1
"org.apache.jackrabbit.test.api.NodeIteratorTest",5,0.00,2.80,45,0.45,14239.92,5,0,5,13,3,75.74,30,63,1,4,107.96,0.00,0.75,0.00,0,0.00,5,1336.28,1,0,2,org.apache.jackrabbit.test.AbstractJCRTest,0.14,8,3,14,0,8,5,0,11,280,1
"org.apache.jackrabbit.test.api.NodeMixinUtil",3,0.00,2.67,25,0.35,8091.28,3,0,8,17,4,130.68,10,36,4,1,110.07,0.00,0.00,0.00,0,3.00,3,1056.89,0,3,0,java.lang.Object,0.00,14,0,8,0,14,0,0,3,210,1
"org.apache.jackrabbit.test.api.NodeOrderableChildNodesTest",10,0.48,1.40,84,1.06,18041.90,13,3,9,27,3,63.12,105,113,1,4,111.59,0.00,0.75,0.77,2,0.00,2,3165.39,2,0,2,org.apache.jackrabbit.test.AbstractJCRTest,0.12,17,3,14,0,17,10,0,42,645,1
"org.apache.jackrabbit.test.api.NodeReadMethodsTest",38,0.38,4.13,580,9.00,795338.71,40,2,17,119,3,50.49,274,845,1,4,92.78,0.00,0.75,0.13,6,0.00,17,27013.90,3,6,2,org.apache.jackrabbit.test.AbstractJCRTest,0.13,81,3,157,0,81,32,0,125,4611,1
"org.apache.jackrabbit.test.api.NodeReadMethodsTest$ItemVisitor",2,0.00,1.00,5,0.04,319.50,2,0,17,5,0,142.42,0,8,0,1,142.42,0.00,0.00,0.00,0,2.00,1,114.87,0,0,0,java.lang.Object,0.00,3,0,2,0,3,2,0,0,33,0
"org.apache.jackrabbit.test.api.NodeRemoveMixinTest",4,0.00,4.00,70,0.97,32804.50,4,0,12,26,4,83.61,60,105,1,4,93.96,0.00,0.75,0.00,0,0.00,4,2898.45,1,0,3,org.apache.jackrabbit.test.AbstractJCRTest,0.00,22,3,16,0,22,4,0,26,508,1
"org.apache.jackrabbit.test.api.NodeSetPrimaryTypeTest",9,0.00,3.11,113,1.58,47905.62,9,0,13,44,4,58.85,67,154,1,4,101.14,0.00,0.75,0.00,1,0.00,5,4742.17,1,1,3,org.apache.jackrabbit.test.AbstractJCRTest,0.00,35,3,28,0,35,8,0,35,860,1
"org.apache.jackrabbit.test.api.NodeTest",37,0.89,1.68,338,4.59,100924.05,38,1,15,83,3,70.67,461,452,1,4,108.23,0.00,0.75,0.14,0,0.00,3,13773.69,7,0,2,org.apache.jackrabbit.test.AbstractJCRTest,0.13,46,3,62,0,46,37,0,234,2707,1
"org.apache.jackrabbit.test.api.NodeUUIDTest",3,0.00,2.00,33,0.46,11040.72,3,0,8,21,3,151.18,71,45,1,4,103.91,0.00,0.75,0.00,1,0.00,2,1381.18,1,0,2,org.apache.jackrabbit.test.AbstractJCRTest,0.00,18,3,6,0,18,3,0,26,264,1
"org.apache.jackrabbit.test.api.PathPropertyTest",10,0.00,2.20,78,1.00,41900.92,10,0,7,32,3,78.55,64,117,1,5,110.77,0.00,0.80,0.00,0,0.00,5,3011.42,0,1,2,org.apache.jackrabbit.test.api.AbstractPropertyTest,0.26,22,4,22,0,22,9,0,25,581,1
"org.apache.jackrabbit.test.api.PathTest",8,0.29,1.00,52,0.83,16402.60,9,1,8,27,2,115.89,3,62,1,4,115.89,0.00,0.75,0.75,0,0.00,1,2483.08,1,0,1,org.apache.jackrabbit.test.AbstractJCRTest,0.13,19,3,8,0,19,8,0,1,511,1
"org.apache.jackrabbit.test.api.PropertyItemIsModifiedTest",6,0.00,1.17,33,0.38,5086.89,7,1,5,17,2,79.54,47,42,1,4,121.83,0.00,0.75,1.00,0,0.00,2,1135.72,2,0,1,org.apache.jackrabbit.test.AbstractJCRTest,0.28,11,3,7,0,11,6,0,10,249,1
"org.apache.jackrabbit.test.api.PropertyItemIsNewTest",4,0.00,1.25,20,0.22,2981.66,5,1,5,14,2,79.96,31,27,1,4,122.26,0.00,0.75,1.00,0,0.00,2,655.48,2,0,1,org.apache.jackrabbit.test.AbstractJCRTest,0.30,10,3,5,0,10,4,0,6,148,1
"org.apache.jackrabbit.test.api.PropertyReadMethodsTest",20,0.08,1.75,104,1.17,26323.65,22,2,12,58,4,102.36,101,172,1,4,120.23,0.00,0.75,0.42,0,0.00,4,3504.78,2,0,3,org.apache.jackrabbit.test.AbstractJCRTest,0.19,38,3,35,0,38,20,0,32,755,1
"org.apache.jackrabbit.test.api.PropertyReadMethodsTest$ItemVisitor",2,0.00,1.00,5,0.04,319.50,2,0,12,5,0,142.42,0,9,0,1,142.42,0.00,0.00,0.00,0,2.00,1,114.87,0,0,0,java.lang.Object,0.00,3,0,2,0,3,2,0,0,33,0
"org.apache.jackrabbit.test.api.PropertyTest",1,0.00,1.00,11,0.14,2732.04,1,0,5,11,2,152.92,27,17,1,4,105.09,0.00,0.75,0.00,0,0.00,1,427.77,0,0,1,org.apache.jackrabbit.test.AbstractJCRTest,0.00,10,3,1,0,10,1,0,5,84,1
"org.apache.jackrabbit.test.api.PropertyTypeTest",3,0.00,2.67,31,0.40,15808.15,3,0,8,20,2,71.94,18,49,1,4,104.16,0.00,0.75,0.00,1,5.00,6,1206.42,1,0,1,org.apache.jackrabbit.test.AbstractJCRTest,0.15,17,3,8,0,17,3,0,3,225,1
"org.apache.jackrabbit.test.api.PropertyUtil",13,0.05,4.15,189,2.58,110779.16,29,16,16,42,16,54.68,101,280,16,1,96.97,0.00,0.00,0.01,1,46.00,8,7735.36,0,5,0,java.lang.Object,0.00,29,0,54,0,29,8,0,23,1397,1
"org.apache.jackrabbit.test.api.ReferencePropertyTest",14,0.69,1.57,59,0.64,10999.99,15,1,7,39,3,125.87,65,97,1,5,125.64,0.00,0.80,0.36,0,0.00,4,1933.97,2,1,2,org.apache.jackrabbit.test.api.AbstractPropertyTest,0.48,25,4,22,0,25,13,0,22,427,1
"org.apache.jackrabbit.test.api.ReferenceableRootNodesTest",3,0.75,3.00,29,0.30,8234.82,5,2,5,14,3,59.97,26,41,1,4,108.07,0.00,0.75,1.00,0,0.00,3,902.09,2,0,2,org.apache.jackrabbit.test.AbstractJCRTest,0.31,11,3,9,0,11,3,0,8,193,1
"org.apache.jackrabbit.test.api.ReferencesTest",4,0.00,5.50,108,1.72,97192.24,4,0,7,37,3,32.68,38,130,1,4,82.68,0.00,0.75,0.00,0,0.00,10,5154.36,2,0,2,org.apache.jackrabbit.test.AbstractJCRTest,0.00,33,3,22,0,33,4,0,25,899,1
"org.apache.jackrabbit.test.api.RepositoryDescriptorTest",4,0.00,1.75,43,0.44,8500.02,6,2,8,15,2,89.49,22,48,1,4,107.37,0.00,0.75,0.50,0,0.00,2,1309.39,2,0,1,org.apache.jackrabbit.test.AbstractJCRTest,0.30,11,3,7,0,11,4,0,6,294,1
"org.apache.jackrabbit.test.api.RepositoryFactoryTest",3,0.00,1.67,14,0.15,3544.21,3,0,5,8,3,164.12,6,22,1,4,124.23,0.00,0.75,0.00,1,3.00,3,439.91,1,1,2,org.apache.jackrabbit.test.AbstractJCRTest,0.00,5,3,5,0,5,2,0,3,99,1
"org.apache.jackrabbit.test.api.RepositoryLoginTest",4,0.56,1.50,32,0.31,6452.74,7,3,6,14,2,79.74,25,55,1,4,111.96,0.00,0.75,0.75,0,0.00,3,928.64,1,0,1,org.apache.jackrabbit.test.AbstractJCRTest,0.15,10,3,6,0,10,4,0,6,201,1
"org.apache.jackrabbit.test.api.RootNodeTest",6,0.20,1.33,24,0.20,2540.41,8,2,5,15,2,128.03,29,34,1,4,127.79,0.00,0.75,0.67,0,0.00,2,585.93,2,0,1,org.apache.jackrabbit.test.AbstractJCRTest,0.28,9,3,8,0,9,6,0,10,148,1
"org.apache.jackrabbit.test.api.SerializationContext",2,0.96,1.50,61,0.65,10501.89,29,27,2,4,3,126.40,5,65,2,1,86.51,0.00,0.00,0.52,0,0.00,2,1941.30,0,1,1,java.lang.Object,0.00,2,0,3,0,2,1,0,2,351,0
"org.apache.jackrabbit.test.api.SerializationTest",59,0.16,1.58,308,3.42,83026.48,71,12,29,104,5,159.91,163,461,1,4,120.03,0.00,0.75,0.24,12,260.00,5,10258.12,4,2,4,org.apache.jackrabbit.test.AbstractJCRTest,0.10,45,3,93,0,45,57,0,56,2146,1
"org.apache.jackrabbit.test.api.SessionReadMethodsTest",14,0.04,1.93,88,0.95,24893.69,16,2,9,44,3,98.36,72,129,1,4,116.23,0.00,0.75,0.46,2,0.00,4,2856.42,2,2,2,org.apache.jackrabbit.test.AbstractJCRTest,0.22,30,3,27,0,30,12,0,20,617,1
"org.apache.jackrabbit.test.api.SessionRemoveItemTest",9,0.34,2.00,81,0.84,18666.04,13,4,12,27,4,159.13,14,110,1,4,109.13,0.00,0.75,0.56,0,0.00,4,2530.80,4,0,3,org.apache.jackrabbit.test.AbstractJCRTest,0.25,18,3,18,0,18,9,0,14,512,1
"org.apache.jackrabbit.test.api.SessionTest",15,0.00,1.67,180,2.58,68604.70,15,0,12,39,3,128.09,296,230,1,4,101.80,0.00,0.75,0.00,0,0.00,3,7735.28,1,0,2,org.apache.jackrabbit.test.AbstractJCRTest,0.00,24,3,25,0,24,15,0,142,1484,1
"org.apache.jackrabbit.test.api.SessionUUIDTest",2,0.00,3.00,31,0.47,16744.54,2,0,7,18,3,109.77,68,42,1,4,95.99,0.00,0.75,0.00,0,0.00,3,1407.24,1,0,2,org.apache.jackrabbit.test.AbstractJCRTest,0.00,16,3,6,0,16,2,0,25,255,1
"org.apache.jackrabbit.test.api.SetPropertyAssumeTypeTest",12,0.37,1.50,193,3.19,117331.48,30,18,14,31,5,62.35,76,357,1,4,94.57,0.00,0.75,0.40,1,0.00,3,9557.06,3,0,4,org.apache.jackrabbit.test.AbstractJCRTest,0.23,19,3,18,0,19,12,0,22,1788,1
"org.apache.jackrabbit.test.api.SetPropertyBooleanTest",8,0.00,1.00,40,0.40,5108.54,9,1,3,17,2,123.07,35,59,1,4,122.84,0.00,0.75,1.00,0,0.00,1,1194.99,2,0,1,org.apache.jackrabbit.test.AbstractJCRTest,0.26,9,3,8,0,9,8,0,7,284,1
"org.apache.jackrabbit.test.api.SetPropertyCalendarTest",8,0.38,1.00,42,0.48,6294.08,11,3,4,19,2,122.36,35,61,1,4,122.12,0.00,0.75,0.67,0,0.00,1,1447.70,2,0,1,org.apache.jackrabbit.test.AbstractJCRTest,0.26,11,3,8,0,11,8,0,7,330,1
"org.apache.jackrabbit.test.api.SetPropertyConstraintViolationExceptionTest",6,0.00,6.67,148,2.25,111014.60,6,0,14,31,4,75.12,95,254,1,4,85.48,0.00,0.75,0.00,0,0.00,9,6761.57,1,0,3,org.apache.jackrabbit.test.AbstractJCRTest,0.00,25,3,40,0,25,6,0,56,1146,1
"org.apache.jackrabbit.test.api.SetPropertyDecimalTest",5,0.25,1.00,26,0.30,4164.46,8,3,4,18,2,122.16,24,37,1,4,121.93,0.00,0.75,0.53,0,0.00,1,889.46,3,0,1,org.apache.jackrabbit.test.AbstractJCRTest,0.29,13,3,5,0,13,5,0,6,207,1
"org.apache.jackrabbit.test.api.SetPropertyDoubleTest",8,0.38,1.00,43,0.49,6956.79,11,3,3,21,2,122.02,37,62,1,4,121.78,0.00,0.75,0.67,0,0.00,1,1467.01,3,0,1,org.apache.jackrabbit.test.AbstractJCRTest,0.26,13,3,8,0,13,8,0,9,338,1
"org.apache.jackrabbit.test.api.SetPropertyInputStreamTest",9,0.28,1.78,84,1.06,32107.67,14,5,6,30,3,107.53,43,118,1,4,107.30,0.00,0.75,0.44,0,0.00,5,3194.60,2,0,2,org.apache.jackrabbit.test.AbstractJCRTest,0.25,21,3,16,0,21,9,0,13,646,1
"org.apache.jackrabbit.test.api.SetPropertyLongTest",8,0.38,1.00,42,0.46,6673.90,11,3,3,18,2,122.16,35,61,1,4,121.92,0.00,0.75,0.67,0,0.00,1,1392.28,2,0,1,org.apache.jackrabbit.test.AbstractJCRTest,0.26,10,3,8,0,10,8,0,7,323,1
"org.apache.jackrabbit.test.api.SetPropertyNodeTest",8,0.57,1.25,52,0.60,11748.77,11,3,3,23,3,99.11,44,73,1,4,116.98,0.00,0.75,0.83,0,0.00,3,1799.71,3,0,2,org.apache.jackrabbit.test.AbstractJCRTest,0.26,15,3,10,0,15,8,0,10,399,1
"org.apache.jackrabbit.test.api.SetPropertyStringTest",30,0.23,1.20,190,2.37,41911.20,38,8,6,46,2,117.40,138,267,1,4,117.16,0.00,0.75,0.35,0,0.00,3,7098.91,2,0,1,org.apache.jackrabbit.test.AbstractJCRTest,0.15,16,3,36,0,16,30,0,35,1555,1
"org.apache.jackrabbit.test.api.SetPropertyValueTest",33,0.21,1.33,217,2.67,55145.84,41,8,6,49,2,116.76,160,297,1,4,116.53,0.00,0.75,0.33,0,0.00,6,8003.44,2,0,1,org.apache.jackrabbit.test.AbstractJCRTest,0.14,16,3,44,0,16,33,0,38,1745,1
"org.apache.jackrabbit.test.api.SetValueBinaryTest",9,0.50,1.78,84,1.00,24194.16,13,4,10,41,3,76.04,62,115,1,4,108.27,0.00,0.75,0.69,1,0.00,3,3002.25,2,0,2,org.apache.jackrabbit.test.AbstractJCRTest,0.25,32,3,16,0,32,9,0,19,607,1
"org.apache.jackrabbit.test.api.SetValueBooleanTest",6,0.60,1.33,35,0.34,4076.56,9,3,6,19,2,80.27,45,46,1,4,122.56,0.00,0.75,0.83,0,0.00,2,1014.68,2,0,1,org.apache.jackrabbit.test.AbstractJCRTest,0.28,13,3,8,0,13,6,0,13,234,1
"org.apache.jackrabbit.test.api.SetValueConstraintViolationExceptionTest",12,0.00,6.92,333,5.05,258478.55,12,0,15,38,4,62.90,179,528,1,4,83.04,0.00,0.75,0.00,0,0.00,9,15150.01,1,0,3,org.apache.jackrabbit.test.AbstractJCRTest,0.00,26,3,83,0,26,12,0,122,2518,1
"org.apache.jackrabbit.test.api.SetValueDateTest",6,0.60,1.33,38,0.38,4778.39,9,3,8,20,2,76.77,45,49,1,4,119.06,0.00,0.75,0.83,0,0.00,2,1136.55,2,0,1,org.apache.jackrabbit.test.AbstractJCRTest,0.28,14,3,8,0,14,6,0,13,254,1
"org.apache.jackrabbit.test.api.SetValueDecimalTest",5,0.33,1.20,27,0.31,4274.76,8,3,7,20,2,73.69,42,35,1,4,121.80,0.00,0.75,0.60,0,0.00,2,925.58,3,0,1,org.apache.jackrabbit.test.AbstractJCRTest,0.29,15,3,6,0,15,5,0,13,210,1
"org.apache.jackrabbit.test.api.SetValueDoubleTest",6,0.60,1.33,36,0.37,4723.96,9,3,6,21,2,76.81,47,47,1,4,119.10,0.00,0.75,0.83,0,0.00,2,1110.39,3,0,1,org.apache.jackrabbit.test.AbstractJCRTest,0.28,15,3,8,0,15,6,0,15,252,1
"org.apache.jackrabbit.test.api.SetValueLongTest",6,0.60,1.33,35,0.34,4076.56,9,3,6,19,2,80.27,45,46,1,4,122.56,0.00,0.75,0.83,0,0.00,2,1014.68,2,0,1,org.apache.jackrabbit.test.AbstractJCRTest,0.28,13,3,8,0,13,6,0,13,234,1
"org.apache.jackrabbit.test.api.SetValueReferenceTest",7,0.39,1.29,39,0.36,4422.61,10,3,7,21,3,72.82,64,51,1,4,122.82,0.00,0.75,0.67,1,0.00,2,1089.24,3,0,2,org.apache.jackrabbit.test.AbstractJCRTest,0.27,14,3,9,0,14,7,0,16,253,1
"org.apache.jackrabbit.test.api.SetValueStringTest",25,0.20,1.56,161,1.69,29488.26,34,9,10,42,2,99.81,132,207,1,4,117.68,0.00,0.75,0.30,0,0.00,2,5073.42,2,0,1,org.apache.jackrabbit.test.AbstractJCRTest,0.17,17,3,39,0,17,25,0,47,1089,1
"org.apache.jackrabbit.test.api.SetValueValueFormatExceptionTest",12,0.00,2.58,90,1.25,38465.78,12,0,12,30,4,79.43,79,163,1,4,111.65,0.00,0.75,0.00,1,38.00,7,3752.65,2,1,3,org.apache.jackrabbit.test.AbstractJCRTest,0.00,18,3,31,0,18,11,0,27,722,1
"org.apache.jackrabbit.test.api.SetValueVersionExceptionTest",12,0.30,2.08,98,1.08,24583.78,18,6,12,28,3,78.85,77,168,1,4,111.07,0.00,0.75,0.44,0,0.00,3,3251.18,5,0,2,org.apache.jackrabbit.test.AbstractJCRTest,0.23,16,3,25,0,16,12,0,31,655,1
"org.apache.jackrabbit.test.api.ShareableNodeTest",42,0.07,1.33,650,9.58,270127.18,43,1,20,108,2,47.07,403,772,1,4,97.07,0.00,0.75,0.93,2,0.00,4,28731.29,5,2,1,org.apache.jackrabbit.test.AbstractJCRTest,0.12,66,3,56,0,66,40,0,263,5202,1
"org.apache.jackrabbit.test.api.StringPropertyTest",13,0.00,2.69,99,1.14,32217.23,13,0,7,45,4,70.23,101,161,1,5,112.52,0.00,0.80,0.00,0,0.00,5,3412.80,0,1,3,org.apache.jackrabbit.test.api.AbstractPropertyTest,0.24,32,4,35,0,32,12,0,28,681,1
"org.apache.jackrabbit.test.api.SysViewContentHandler",13,0.12,4.92,290,4.68,289257.61,35,22,27,90,4,37.85,138,411,2,2,86.32,0.00,0.50,0.16,5,57.00,16,14052.08,0,1,2,org.xml.sax.helpers.DefaultHandler,0.00,77,1,64,0,77,12,0,90,2303,0
"org.apache.jackrabbit.test.api.SysViewContentHandler$ChildNodeElem",0,0.00,0.00,3,0.01,82.42,2,2,27,0,0,171.00,0,4,0,1,171.00,0.00,0.00,0.00,0,0.00,0,41.21,0,0,0,java.lang.Object,0.00,0,0,0,0,0,0,0,0,13,1
"org.apache.jackrabbit.test.api.SysViewContentHandler$ConditionException",1,0.00,1.00,3,0.02,106.02,1,0,27,1,0,137.25,0,5,0,2,137.25,0.00,0.50,0.00,0,1.00,1,45.51,0,0,0,org.xml.sax.SAXException,0.00,0,1,1,0,0,1,0,0,16,1
"org.apache.jackrabbit.test.api.SysViewContentHandler$NodeElemData",0,0.00,0.00,8,0.06,805.37,7,7,27,2,0,171.00,10,9,0,1,171.00,0.00,0.00,0.00,0,0.00,0,191.76,0,0,0,java.lang.Object,0.00,2,0,0,0,2,0,0,10,43,1
"org.apache.jackrabbit.test.api.SysViewContentHandler$PropElemData",0,0.00,0.00,5,0.03,169.39,4,4,27,0,0,171.00,0,6,0,1,171.00,0.00,0.00,0.00,0,0.00,0,75.28,0,0,0,java.lang.Object,0.00,0,0,0,0,0,0,0,0,21,1
"org.apache.jackrabbit.test.api.TestAll",1,0.00,1.00,97,1.72,75039.91,1,0,3,3,95,91.88,20,99,2,2,58.50,0.00,0.50,0.00,0,1.00,1,5155.98,0,1,93,junit.framework.TestCase,0.00,2,1,1,0,2,0,0,11,767,1
"org.apache.jackrabbit.test.api.TreeComparator",23,0.04,3.13,265,3.80,154605.37,37,14,17,69,3,69.53,158,358,1,4,101.75,0.00,0.75,0.11,11,131.00,11,11390.96,3,2,2,org.apache.jackrabbit.test.AbstractJCRTest,0.09,46,3,72,0,46,21,0,54,2016,0
"org.apache.jackrabbit.test.api.UndefinedPropertyTest",3,0.00,1.00,12,0.12,1661.57,3,0,6,9,4,94.72,19,18,1,4,126.94,0.00,0.75,0.00,0,5.00,1,347.13,1,1,3,org.apache.jackrabbit.test.AbstractJCRTest,0.15,6,3,3,0,6,2,0,4,81,1
"org.apache.jackrabbit.test.api.ValueFactoryTest",5,0.33,6.80,137,2.31,261362.52,24,19,15,32,3,37.72,37,216,1,4,80.01,0.00,0.75,0.32,0,0.00,14,6932.12,2,1,2,org.apache.jackrabbit.test.AbstractJCRTest,0.29,27,3,34,0,27,4,0,15,1183,1
"org.apache.jackrabbit.test.api.WorkspaceCloneReferenceableTest",4,0.00,1.75,35,0.55,12128.34,4,0,4,16,3,65.64,44,48,1,7,109.77,0.00,0.86,0.00,0,0.00,3,1650.08,1,0,2,org.apache.jackrabbit.test.api.AbstractWorkspaceReferenceableTest,0.00,12,6,7,0,12,4,0,20,334,1
"org.apache.jackrabbit.test.api.WorkspaceCloneSameNameSibsTest",2,0.00,2.50,22,0.33,8343.93,2,0,4,15,2,83.29,29,26,1,7,103.43,0.00,0.86,0.00,0,0.00,3,978.21,0,0,1,org.apache.jackrabbit.test.api.AbstractWorkspaceSameNameSibsTest,0.00,13,6,5,0,13,2,0,10,186,1
"org.apache.jackrabbit.test.api.WorkspaceCloneTest",8,0.00,1.88,59,0.92,19931.58,8,0,9,26,3,64.48,64,87,1,6,112.59,0.00,0.83,0.00,0,0.00,3,2764.04,2,0,2,org.apache.jackrabbit.test.api.AbstractWorkspaceCopyBetweenTest,0.00,18,5,15,0,18,8,0,30,551,1
"org.apache.jackrabbit.test.api.WorkspaceCloneVersionableTest",1,0.00,3.00,12,0.20,6456.99,1,0,3,8,3,144.43,22,19,1,7,100.49,0.00,0.86,0.00,0,0.00,3,610.51,1,0,2,org.apache.jackrabbit.test.api.AbstractWorkspaceVersionableTest,0.00,7,6,3,0,7,1,0,10,122,1
"org.apache.jackrabbit.test.api.WorkspaceCopyBetweenWorkspacesReferenceableTest",1,0.00,1.00,9,0.13,2552.06,1,0,3,9,3,108.10,16,12,1,7,108.58,0.00,0.86,0.00,0,0.00,1,396.98,1,0,2,org.apache.jackrabbit.test.api.AbstractWorkspaceReferenceableTest,0.00,8,6,1,0,8,1,0,5,83,1
"org.apache.jackrabbit.test.api.WorkspaceCopyBetweenWorkspacesSameNameSibsTest",2,0.00,2.50,22,0.32,8483.17,2,0,4,14,2,83.23,29,26,1,7,103.38,0.00,0.86,0.00,0,0.00,3,954.62,0,0,1,org.apache.jackrabbit.test.api.AbstractWorkspaceSameNameSibsTest,0.00,12,6,5,0,12,2,0,10,184,1
"org.apache.jackrabbit.test.api.WorkspaceCopyBetweenWorkspacesTest",7,0.00,2.14,53,0.81,19350.53,7,0,10,26,3,64.09,57,79,1,6,112.20,0.00,0.83,0.00,0,0.00,3,2435.17,2,0,2,org.apache.jackrabbit.test.api.AbstractWorkspaceCopyBetweenTest,0.00,19,5,15,0,19,7,0,26,482,1
"org.apache.jackrabbit.test.api.WorkspaceCopyBetweenWorkspacesVersionableTest",1,0.00,3.00,12,0.20,6531.71,1,0,3,7,3,144.39,22,19,1,7,100.45,0.00,0.86,0.00,0,0.00,3,590.57,1,0,2,org.apache.jackrabbit.test.api.AbstractWorkspaceVersionableTest,0.00,6,6,3,0,6,1,0,10,120,1
"org.apache.jackrabbit.test.api.WorkspaceCopyReferenceableTest",3,0.00,1.00,12,0.15,2578.04,3,0,3,11,3,107.56,17,17,1,7,125.44,0.00,0.86,0.00,0,1.00,1,439.97,1,1,2,org.apache.jackrabbit.test.api.AbstractWorkspaceReferenceableTest,0.40,8,6,3,0,8,2,0,6,99,1
"org.apache.jackrabbit.test.api.WorkspaceCopySameNameSibsTest",4,0.00,1.75,25,0.32,8164.08,4,0,5,16,3,73.49,30,31,1,7,115.78,0.00,0.86,0.00,0,0.00,3,972.37,0,1,2,org.apache.jackrabbit.test.api.AbstractWorkspaceSameNameSibsTest,0.39,12,6,7,0,12,3,0,11,196,1
"org.apache.jackrabbit.test.api.WorkspaceCopyTest",6,0.00,2.17,50,0.70,16214.94,6,0,8,24,3,62.01,53,75,1,5,110.11,0.00,0.80,0.00,0,0.00,3,2106.46,1,0,2,org.apache.jackrabbit.test.api.AbstractWorkspaceCopyTest,0.00,18,4,13,0,18,6,0,24,418,1
"org.apache.jackrabbit.test.api.WorkspaceCopyVersionableTest",3,0.00,2.00,17,0.24,8035.12,3,0,4,11,3,75.48,23,28,1,7,117.77,0.00,0.86,0.00,0,1.00,4,706.90,1,1,2,org.apache.jackrabbit.test.api.AbstractWorkspaceVersionableTest,0.40,8,6,6,0,8,2,0,11,146,1
"org.apache.jackrabbit.test.api.WorkspaceMoveReferenceableTest",3,0.00,1.00,12,0.15,2578.04,3,0,3,11,3,93.21,18,17,1,7,125.44,0.00,0.86,0.00,0,1.00,1,439.97,1,1,2,org.apache.jackrabbit.test.api.AbstractWorkspaceReferenceableTest,0.40,8,6,3,0,8,2,0,7,99,1
"org.apache.jackrabbit.test.api.WorkspaceMoveSameNameSibsTest",4,0.00,1.75,27,0.36,9089.75,4,0,5,17,3,73.12,31,33,1,7,115.41,0.00,0.86,0.00,0,0.00,3,1074.33,0,1,2,org.apache.jackrabbit.test.api.AbstractWorkspaceSameNameSibsTest,0.39,13,6,7,0,13,3,0,12,211,1
"org.apache.jackrabbit.test.api.WorkspaceMoveTest",6,0.00,2.17,50,0.70,16214.94,6,0,8,24,3,62.01,52,75,1,5,110.11,0.00,0.80,0.00,0,0.00,3,2106.46,1,0,2,org.apache.jackrabbit.test.api.AbstractWorkspaceCopyTest,0.00,18,4,13,0,18,6,0,23,418,1
"org.apache.jackrabbit.test.api.WorkspaceMoveVersionableTest",3,0.00,2.00,17,0.24,7790.45,3,0,4,12,3,75.59,23,28,1,7,117.88,0.00,0.86,0.00,0,1.00,4,711.52,1,1,2,org.apache.jackrabbit.test.api.AbstractWorkspaceVersionableTest,0.40,9,6,6,0,9,2,0,11,146,1
"org.apache.jackrabbit.test.api.WorkspaceReadMethodsTest",5,0.00,1.40,33,0.33,7639.24,5,0,4,18,2,98.95,29,48,1,4,116.82,0.00,0.75,0.00,0,0.00,2,988.92,1,0,1,org.apache.jackrabbit.test.AbstractJCRTest,0.14,13,3,7,0,13,5,0,7,217,1
"org.apache.jackrabbit.test.api.WorkspaceTest",2,0.00,2.00,12,0.10,1442.88,3,1,5,6,2,119.54,9,18,1,4,119.31,0.00,0.75,1.00,0,0.00,3,289.82,2,0,1,org.apache.jackrabbit.test.AbstractJCRTest,0.16,4,3,4,0,4,2,0,3,70,1
"org.apache.jackrabbit.spi.commons.lock.Locked",6,1.00,3.17,57,0.74,41867.30,7,1,15,28,5,144.17,130,83,1,1,104.87,0.00,0.00,0.17,4,10.00,13,2234.21,0,5,4,java.lang.Object,0.00,22,0,19,0,22,1,0,22,399,2
"org.apache.jackrabbit.spi.commons.lock.Locked$EventListener",1,0.00,1.00,4,0.02,212.76,1,0,15,2,0,130.21,0,6,0,1,130.21,0.00,0.00,0.00,0,1.00,1,65.36,0,0,0,java.lang.Object,0.00,1,0,1,0,1,1,0,0,20,0
"org.apache.jackrabbit.test.api.query.AbstractOrderByTest",13,0.17,2.15,119,1.43,45193.48,15,2,15,38,13,89.47,74,134,12,5,107.34,3.00,0.24,0.35,4,0.00,5,4283.09,1,4,1,org.apache.jackrabbit.test.api.query.AbstractQueryTest,0.10,25,4,28,12,25,9,0,16,853,0
"org.apache.jackrabbit.test.api.query.AbstractQueryLevel2Test",5,0.00,1.80,41,0.63,18024.37,5,0,8,23,4,61.06,44,57,2,5,109.17,0.50,0.57,0.00,0,2.00,3,1887.82,0,0,2,org.apache.jackrabbit.test.api.query.AbstractQueryTest,0.00,18,4,9,2,18,5,0,9,373,2
"org.apache.jackrabbit.test.api.query.AbstractQueryTest",15,0.05,2.33,129,1.59,55293.45,22,7,18,58,29,59.03,139,155,26,4,109.03,22.00,0.04,0.10,3,65.00,8,4778.06,3,6,3,org.apache.jackrabbit.test.AbstractJCRTest,0.21,43,3,35,66,43,9,0,29,948,2
"org.apache.jackrabbit.test.api.query.CreateQueryTest",1,0.00,2.00,10,0.10,2293.02,1,0,5,6,2,89.20,5,14,1,5,107.08,0.00,0.80,0.00,0,0.00,2,305.51,0,0,1,org.apache.jackrabbit.test.api.query.AbstractQueryTest,0.00,5,4,2,0,5,1,0,2,64,1
"org.apache.jackrabbit.test.api.query.DerefQueryLevel1Test",8,0.29,2.50,76,1.05,36088.53,9,1,10,33,4,74.20,54,96,1,5,106.42,0.00,0.80,0.75,2,0.00,6,3163.03,3,1,3,org.apache.jackrabbit.test.api.query.AbstractQueryTest,0.22,25,4,20,0,25,7,0,12,609,1
"org.apache.jackrabbit.test.api.query.ElementTest",8,0.00,1.12,61,0.96,24485.56,8,0,3,13,3,79.78,48,71,1,5,112.00,0.00,0.80,0.00,0,0.00,2,2887.95,1,0,2,org.apache.jackrabbit.test.api.query.AbstractQueryTest,0.00,5,4,9,0,5,8,0,9,568,1
"org.apache.jackrabbit.test.api.query.GetLanguageTest",6,0.20,1.33,30,0.39,6794.21,7,1,5,19,3,102.94,31,42,1,5,120.81,0.00,0.80,0.83,0,0.00,2,1161.02,3,0,2,org.apache.jackrabbit.test.api.query.AbstractQueryTest,0.23,13,4,8,0,13,6,0,8,255,1
"org.apache.jackrabbit.test.api.query.GetPersistentQueryPathLevel1Test",3,0.00,1.67,18,0.17,2816.78,4,1,4,12,2,86.23,20,25,1,5,118.45,0.00,0.80,1.00,0,0.00,2,524.67,2,0,1,org.apache.jackrabbit.test.api.query.AbstractQueryTest,0.24,9,4,5,0,9,3,0,6,120,1
"org.apache.jackrabbit.test.api.query.GetPersistentQueryPathTest",1,0.00,2.00,10,0.15,3678.06,1,0,4,10,3,138.84,20,16,1,5,105.46,0.00,0.80,0.00,0,0.00,2,451.91,0,0,2,org.apache.jackrabbit.test.api.query.AbstractQueryTest,0.00,9,4,2,0,9,1,0,3,88,1
"org.apache.jackrabbit.test.api.query.GetPropertyNamesTest",3,0.50,2.00,31,0.40,12453.59,4,1,8,23,2,56.94,25,35,1,5,105.05,0.00,0.80,0.67,0,2.00,3,1207.05,2,0,1,org.apache.jackrabbit.test.api.query.AbstractQueryTest,0.24,20,4,6,0,20,3,0,10,227,1
"org.apache.jackrabbit.test.api.query.GetStatementTest",3,0.00,1.33,16,0.16,2454.91,4,1,3,12,2,89.70,19,23,1,5,121.92,0.00,0.80,1.00,0,0.00,2,493.61,2,0,1,org.apache.jackrabbit.test.api.query.AbstractQueryTest,0.24,9,4,4,0,9,3,0,5,115,1
"org.apache.jackrabbit.test.api.query.GetSupportedQueryLanguagesTest",3,0.00,1.67,17,0.19,2789.99,4,1,7,13,2,79.14,22,25,1,5,121.43,0.00,0.80,1.00,0,0.00,2,558.68,3,0,1,org.apache.jackrabbit.test.api.query.AbstractQueryTest,0.24,10,4,5,0,10,3,0,7,127,1
"org.apache.jackrabbit.test.api.query.OrderByDateTest",4,0.00,1.00,46,0.78,25291.98,4,0,2,7,2,54.12,32,51,1,6,102.22,0.00,0.83,0.00,0,0.00,1,2328.29,2,0,1,org.apache.jackrabbit.test.api.query.AbstractOrderByTest,0.00,3,5,4,0,3,4,0,5,453,1
"org.apache.jackrabbit.test.api.query.OrderByDecimalTest",1,0.00,1.00,4,0.07,1047.77,1,0,2,2,2,145.37,3,6,1,6,124.76,0.00,0.83,0.00,0,0.00,1,202.81,2,0,1,org.apache.jackrabbit.test.api.query.AbstractOrderByTest,0.00,1,5,1,0,1,1,0,1,48,1
"org.apache.jackrabbit.test.api.query.OrderByDoubleTest",2,0.00,1.00,7,0.09,1050.04,2,0,0,2,2,87.65,23,10,1,6,131.78,0.00,0.83,0.00,0,0.00,1,270.26,2,0,1,org.apache.jackrabbit.test.api.query.AbstractOrderByTest,0.00,0,5,2,0,0,2,0,3,64,1
"org.apache.jackrabbit.test.api.query.OrderByLengthTest",4,0.00,1.00,10,0.09,960.63,4,0,5,6,2,191.02,6,16,1,6,141.03,0.00,0.83,0.00,0,8.00,1,274.34,2,3,1,org.apache.jackrabbit.test.api.query.AbstractOrderByTest,0.33,2,5,4,0,2,1,0,3,72,1
"org.apache.jackrabbit.test.api.query.OrderByLocalNameTest",4,0.00,1.00,12,0.10,1623.89,4,0,4,7,2,182.66,7,18,1,6,132.66,0.00,0.83,0.00,0,8.00,1,310.00,2,3,1,org.apache.jackrabbit.test.api.query.AbstractOrderByTest,0.33,3,5,4,0,3,1,0,4,79,1
"org.apache.jackrabbit.test.api.query.OrderByLocalNameTest$Comparator",1,0.00,1.00,5,0.05,936.18,1,0,4,3,0,121.53,0,6,0,1,121.53,0.00,0.00,0.00,0,1.00,1,146.97,0,0,0,java.lang.Object,0.00,2,0,1,0,2,1,0,0,38,0
"org.apache.jackrabbit.test.api.query.OrderByLongTest",1,0.00,1.00,4,0.05,604.38,1,0,0,1,2,160.02,20,6,1,6,126.64,0.00,0.83,0.00,0,0.00,1,149.29,2,0,1,org.apache.jackrabbit.test.api.query.AbstractOrderByTest,0.00,0,5,1,0,0,1,0,2,36,1
"org.apache.jackrabbit.test.api.query.OrderByLowerCaseTest",4,0.00,1.00,10,0.09,925.21,4,0,2,5,2,191.15,6,16,1,6,141.15,0.00,0.83,0.00,0,8.00,1,263.01,3,3,1,org.apache.jackrabbit.test.api.query.AbstractOrderByTest,0.33,1,5,4,0,1,1,0,3,70,1
"org.apache.jackrabbit.test.api.query.OrderByMultiTypeTest",1,0.00,4.00,41,0.95,64082.02,1,0,3,8,2,119.94,23,58,1,6,72.67,0.00,0.83,0.00,0,0.00,4,2852.27,1,0,1,org.apache.jackrabbit.test.api.query.AbstractOrderByTest,0.00,7,5,4,0,7,1,0,5,472,1
"org.apache.jackrabbit.test.api.query.OrderByNameTest",4,0.00,1.00,12,0.10,1623.89,4,0,3,6,2,182.66,7,18,1,6,132.66,0.00,0.83,0.00,0,8.00,1,310.00,2,3,1,org.apache.jackrabbit.test.api.query.AbstractOrderByTest,0.33,2,5,4,0,2,1,0,4,79,1
"org.apache.jackrabbit.test.api.query.OrderByStringTest",1,0.00,1.00,4,0.05,508.68,1,0,0,1,2,160.61,20,6,1,6,127.23,0.00,0.83,0.00,0,0.00,1,142.89,2,0,1,org.apache.jackrabbit.test.api.query.AbstractOrderByTest,0.00,0,5,1,0,0,1,0,2,35,1
"org.apache.jackrabbit.test.api.query.OrderByURITest",1,0.00,1.00,6,0.08,1302.15,2,1,2,1,2,138.06,3,7,1,6,117.45,0.00,0.83,1.00,0,0.00,1,245.13,2,0,1,org.apache.jackrabbit.test.api.query.AbstractOrderByTest,0.00,0,5,1,0,0,1,0,1,55,1
"org.apache.jackrabbit.test.api.query.OrderByUpperCaseTest",4,0.00,1.00,10,0.09,925.21,4,0,2,5,2,191.15,6,16,1,6,141.15,0.00,0.83,0.00,0,8.00,1,263.01,3,3,1,org.apache.jackrabbit.test.api.query.AbstractOrderByTest,0.33,1,5,4,0,1,1,0,3,70,1
"org.apache.jackrabbit.test.api.query.PredicatesTest",7,0.33,1.86,42,0.62,10471.18,10,3,5,17,2,74.54,50,61,1,5,116.83,0.00,0.80,0.62,0,0.00,2,1865.09,2,0,1,org.apache.jackrabbit.test.api.query.AbstractQueryTest,0.22,10,4,13,0,10,7,0,11,385,1
"org.apache.jackrabbit.test.api.query.QueryResultNodeIteratorTest",6,0.00,2.50,59,0.70,23122.88,6,0,6,20,3,64.66,44,78,1,5,106.96,0.00,0.80,0.00,0,0.00,5,2092.95,2,0,2,org.apache.jackrabbit.test.api.query.AbstractQueryTest,0.11,14,4,15,0,14,6,0,17,416,1
"org.apache.jackrabbit.test.api.query.SQLJcrPathTest",3,0.00,1.33,18,0.22,3302.10,4,1,6,17,3,85.73,19,24,1,5,117.95,0.00,0.80,1.00,0,0.00,2,658.55,2,0,2,org.apache.jackrabbit.test.api.query.AbstractQueryTest,0.24,14,4,4,0,14,3,0,6,143,1
"org.apache.jackrabbit.test.api.query.SQLJoinTest",4,0.00,2.25,76,1.32,53684.91,4,0,3,16,3,42.50,32,88,1,5,90.61,0.00,0.80,0.00,0,0.00,3,3966.84,3,0,2,org.apache.jackrabbit.test.api.query.AbstractQueryTest,0.00,12,4,9,0,12,4,0,5,707,1
"org.apache.jackrabbit.test.api.query.SQLOrderByTest",4,0.00,1.00,20,0.26,4935.77,5,1,1,9,3,70.58,37,25,1,5,120.58,0.00,0.80,1.00,0,0.00,1,774.28,4,0,2,org.apache.jackrabbit.test.api.query.AbstractQueryTest,0.12,5,4,4,0,5,4,0,7,172,1
"org.apache.jackrabbit.test.api.query.SQLPathTest",10,0.22,1.80,67,0.84,20751.19,11,1,7,27,2,97.84,54,80,1,5,115.72,0.00,0.80,0.80,1,0.00,4,2512.29,4,2,1,org.apache.jackrabbit.test.api.query.AbstractQueryTest,0.21,17,4,18,0,17,8,0,17,515,1
"org.apache.jackrabbit.test.api.query.SQLPathTest$TraversingItemVisitor.Default",1,0.00,2.00,4,0.06,896.15,1,0,7,5,0,125.13,0,6,0,1,125.13,0.00,0.00,0.00,0,1.00,2,173.83,0,0,0,java.lang.Object,0.00,4,0,2,0,4,1,0,0,41,0
"org.apache.jackrabbit.test.api.query.SQLPathTest$TraversingItemVisitor.Default_0",1,0.00,2.00,4,0.04,553.13,1,0,7,3,0,126.78,0,7,0,1,126.78,0.00,0.00,0.00,0,1.00,2,125.96,0,0,0,java.lang.Object,0.00,2,0,2,0,2,1,0,0,32,0
"org.apache.jackrabbit.test.api.query.SQLQueryLevel2Test",8,0.00,1.50,67,0.83,18095.68,8,0,5,20,3,68.51,56,80,1,6,110.80,0.00,0.83,0.00,3,0.00,4,2480.00,8,0,2,org.apache.jackrabbit.test.api.query.AbstractQueryLevel2Test,0.00,12,5,12,0,12,8,0,19,517,1
"org.apache.jackrabbit.test.api.query.SaveTest",9,0.12,2.22,76,1.11,26339.27,10,1,13,33,3,59.83,81,106,1,4,109.83,0.00,0.75,0.89,1,0.00,4,3339.58,2,0,2,org.apache.jackrabbit.test.AbstractJCRTest,0.12,24,3,20,0,24,9,0,26,637,1
"org.apache.jackrabbit.test.api.query.SetLimitTest",1,0.00,2.00,14,0.19,4147.56,1,0,2,11,2,120.21,3,20,1,5,99.60,0.00,0.80,0.00,0,0.00,2,559.20,0,0,1,org.apache.jackrabbit.test.api.query.AbstractQueryTest,0.00,10,4,2,0,10,1,0,1,105,1
"org.apache.jackrabbit.test.api.query.SetOffsetTest",1,0.00,2.00,14,0.19,4765.03,1,0,2,11,2,119.74,3,20,1,5,99.12,0.00,0.80,0.00,0,0.00,2,573.39,0,0,1,org.apache.jackrabbit.test.api.query.AbstractQueryTest,0.00,10,4,2,0,10,1,0,1,107,1
"org.apache.jackrabbit.test.api.query.SimpleSelectionTest",3,0.00,1.67,21,0.29,5913.95,4,1,6,22,3,65.31,26,29,1,5,113.41,0.00,0.80,1.00,0,0.00,2,881.42,2,0,2,org.apache.jackrabbit.test.api.query.AbstractQueryTest,0.24,19,4,5,0,19,3,0,7,176,1
"org.apache.jackrabbit.test.api.query.Statement",3,0.25,1.33,12,0.08,2004.82,5,2,0,4,7,108.36,17,17,7,1,126.23,0.00,0.00,0.33,0,5.00,2,239.93,0,2,0,java.lang.Object,0.00,1,0,4,0,1,1,0,4,65,0
"org.apache.jackrabbit.test.api.query.TestAll",1,0.00,1.00,42,0.62,25900.57,1,0,3,3,40,38.13,12,44,2,2,75.70,0.00,0.50,0.00,0,1.00,1,1854.17,0,1,38,junit.framework.TestCase,0.00,2,1,1,0,2,0,0,3,327,1
"org.apache.jackrabbit.test.api.query.TextNodeTest",5,0.62,1.40,48,0.71,22815.13,7,2,4,13,3,58.41,40,57,1,5,106.51,0.00,0.80,1.00,0,0.00,3,2127.48,2,0,2,org.apache.jackrabbit.test.api.query.AbstractQueryTest,0.12,8,4,7,0,8,5,0,6,413,1
"org.apache.jackrabbit.test.api.query.XPathDocOrderTest",6,0.00,2.00,57,0.75,17410.29,6,0,6,18,4,65.69,46,60,1,5,107.98,0.00,0.80,0.00,1,0.00,4,2261.18,3,0,3,org.apache.jackrabbit.test.api.query.AbstractQueryTest,0.11,12,4,12,0,12,6,0,8,437,1
"org.apache.jackrabbit.test.api.query.XPathJcrPathTest",3,0.00,1.33,18,0.22,3355.11,4,1,6,17,3,85.68,19,24,1,5,117.90,0.00,0.80,1.00,0,0.00,2,671.78,2,0,2,org.apache.jackrabbit.test.api.query.AbstractQueryTest,0.24,14,4,4,0,14,3,0,6,145,1
"org.apache.jackrabbit.test.api.query.XPathOrderByTest",4,0.00,1.00,21,0.23,4132.42,5,1,1,9,3,73.09,34,26,1,5,121.19,0.00,0.80,1.00,0,0.00,1,700.49,3,0,2,org.apache.jackrabbit.test.api.query.AbstractQueryTest,0.12,5,4,4,0,5,4,0,6,158,1
"org.apache.jackrabbit.test.api.query.XPathPosIndexTest",3,0.00,2.00,23,0.29,7356.34,3,0,6,13,4,64.15,31,29,1,5,112.62,0.00,0.80,0.00,1,2.00,4,859.79,3,0,3,org.apache.jackrabbit.test.api.query.AbstractQueryTest,0.12,10,4,6,0,10,3,0,5,170,1
"org.apache.jackrabbit.test.api.query.XPathQueryLevel2Test",8,0.00,1.50,56,0.65,12309.51,8,0,5,22,3,82.06,55,69,1,6,114.28,0.00,0.83,0.00,3,8.00,4,1952.21,7,0,2,org.apache.jackrabbit.test.api.query.AbstractQueryLevel2Test,0.00,14,5,12,0,14,8,0,19,419,1
"org.apache.jackrabbit.core.version.AbstractVersionManager",28,0.06,2.36,222,3.15,123698.90,34,6,23,108,29,62.10,293,327,8,1,110.57,0.00,0.00,0.11,11,254.00,8,9461.36,0,8,25,java.lang.Object,0.00,80,0,66,2,80,20,1,59,1762,1
"org.apache.jackrabbit.core.version.AbstractVersionManager$WriteOperation",3,0.00,1.33,13,0.09,1026.68,5,2,23,4,1,110.65,15,20,0,1,128.52,0.00,0.00,0.50,0,1.00,2,263.22,0,0,1,java.lang.Object,0.00,1,0,4,0,1,3,0,4,70,1
"org.apache.jackrabbit.core.version.CheckinRemoveVersionTest",1,0.00,2.00,14,0.17,3937.93,1,0,5,15,3,100.01,4,21,1,4,99.78,0.00,0.75,0.00,0,0.00,2,520.15,0,0,2,org.apache.jackrabbit.test.AbstractJCRTest,0.00,14,3,2,0,14,1,0,2,99,1
"org.apache.jackrabbit.core.version.DateVersionSelector",9,0.19,1.67,46,0.46,16923.93,11,2,5,19,4,69.03,82,62,3,1,119.03,0.00,0.00,0.33,0,17.00,5,1380.76,0,4,1,java.lang.Object,0.00,10,0,15,0,10,5,1,13,306,1
"org.apache.jackrabbit.core.version.InternalActivity",2,0.00,1.00,3,0.03,202.24,2,0,4,2,7,107.11,17,5,4,2,155.21,0.00,0.50,0.00,0,2.00,1,82.09,0,1,3,,0.00,0,1,2,0,0,1,0,3,26,1
"org.apache.jackrabbit.core.version.InternalActivityImpl",8,0.00,2.12,57,0.83,28689.18,8,0,13,35,17,79.09,51,76,6,2,111.31,0.00,0.50,0.00,0,0.00,4,2483.12,0,2,13,org.apache.jackrabbit.core.version.InternalVersionItemImpl,0.33,27,1,17,0,27,6,1,14,492,0
"org.apache.jackrabbit.core.version.InternalFreeze",1,0.00,1.00,2,0.01,44.19,1,0,1,1,5,96.82,9,3,4,2,146.81,0.00,0.50,0.00,0,1.00,1,26.09,0,1,1,,0.00,0,1,1,0,0,0,0,2,11,1
"org.apache.jackrabbit.core.version.InternalFreezeImpl",2,1.00,1.00,7,0.05,622.75,3,1,0,2,7,91.28,15,11,2,2,133.57,2.00,0.25,0.50,0,2.00,1,157.85,0,1,5,org.apache.jackrabbit.core.version.InternalVersionItemImpl,0.33,0,1,2,2,0,1,1,4,43,1
"org.apache.jackrabbit.core.version.InternalFrozenNode",6,0.00,1.00,7,0.03,141.83,6,0,4,6,10,127.96,38,8,6,2,160.18,0.00,0.50,0.00,0,6.00,1,92.48,0,4,4,,0.00,0,1,6,0,0,2,0,7,38,1
"org.apache.jackrabbit.core.version.InternalFrozenNodeImpl",11,0.01,3.82,132,2.13,155593.49,19,8,21,60,19,47.75,108,177,2,3,97.75,0.00,0.67,0.14,2,73.00,14,6395.11,0,6,18,org.apache.jackrabbit.core.version.InternalFreezeImpl,0.18,49,2,42,0,49,5,1,41,1074,0
"org.apache.jackrabbit.core.version.InternalFrozenVHImpl",7,0.00,1.29,20,0.20,3279.42,7,0,5,15,10,159.30,26,36,1,3,138.68,0.00,0.67,0.00,2,9.00,2,591.70,0,6,10,org.apache.jackrabbit.core.version.InternalFreezeImpl,0.23,8,2,9,0,8,1,1,8,151,0
"org.apache.jackrabbit.core.version.InternalFrozenVersionHistory",4,0.00,1.00,5,0.02,98.72,4,0,2,4,6,117.74,30,7,3,2,160.04,0.00,0.50,0.00,0,4.00,1,65.11,0,3,3,,0.00,0,1,4,0,0,1,0,5,27,1
"org.apache.jackrabbit.core.version.InternalVersion",13,0.00,1.00,14,0.05,194.03,13,0,4,13,23,129.53,83,15,20,2,161.76,0.00,0.50,0.00,0,13.00,1,153.87,0,10,4,,0.00,0,1,13,0,0,3,0,14,68,1
"org.apache.jackrabbit.core.version.InternalVersionHistory",10,0.00,1.00,11,0.05,185.55,10,0,4,10,19,128.79,64,12,16,2,161.01,0.00,0.50,0.00,0,10.00,1,143.84,0,4,4,,0.00,0,1,10,0,0,6,0,11,59,1
"org.apache.jackrabbit.core.version.InternalVersionHistoryImpl",22,0.09,3.14,255,3.82,193784.76,32,10,23,116,25,50.83,200,322,8,2,100.83,0.00,0.50,0.18,4,134.00,11,11470.66,0,7,19,org.apache.jackrabbit.core.version.InternalVersionItemImpl,0.15,94,1,69,0,94,15,1,76,2006,0
"org.apache.jackrabbit.core.version.InternalVersionHistoryImplTest",1,0.00,2.00,10,0.08,1845.61,1,0,2,4,2,59.71,8,11,1,2,107.82,0.00,0.50,0.00,0,1.00,2,250.73,0,0,1,junit.framework.TestCase,0.00,3,1,2,0,3,1,0,2,58,1
"org.apache.jackrabbit.core.version.InternalVersionImpl",32,0.10,1.78,168,1.85,52082.56,37,5,13,83,15,101.63,177,220,4,2,119.50,0.00,0.50,0.10,8,426.00,3,5564.48,0,14,13,org.apache.jackrabbit.core.version.InternalVersionItemImpl,0.11,51,1,57,0,51,18,1,50,1199,0
"org.apache.jackrabbit.core.version.InternalVersionItem",2,0.00,1.00,3,0.01,31.00,2,0,1,2,13,113.52,16,4,12,1,161.63,0.00,0.00,0.00,0,2.00,1,26.00,0,2,1,,0.00,0,0,2,0,0,0,0,3,13,1
"org.apache.jackrabbit.core.version.InternalVersionItemImpl",4,0.50,1.00,10,0.06,749.51,6,2,1,4,9,99.58,29,13,5,1,141.87,0.00,0.00,0.12,0,6.00,1,193.33,0,2,4,java.lang.Object,0.00,0,0,4,6,0,2,1,7,58,1
"org.apache.jackrabbit.core.version.JcrVersionManagerImpl",23,0.02,1.57,108,1.49,45746.01,26,3,19,71,10,122.70,99,166,1,1,122.46,0.00,0.00,0.35,2,0.00,5,4477.03,0,12,9,java.lang.Object,0.00,48,0,36,0,48,11,1,36,925,1
"org.apache.jackrabbit.core.version.JcrVersionManagerImpl$ChangeSetVersionSelector",2,1.00,1.50,10,0.11,2188.65,3,1,19,5,4,120.90,0,14,0,1,120.90,0.00,0.00,0.50,0,2.00,2,342.76,0,1,4,java.lang.Object,0.00,3,0,3,0,3,1,1,0,79,1
"org.apache.jackrabbit.core.version.LabelVersionSelector",6,0.60,1.17,21,0.17,2984.06,7,1,4,10,2,83.83,51,32,1,1,131.93,0.00,0.00,0.50,1,6.00,2,510.00,0,4,1,java.lang.Object,0.00,4,0,7,0,4,2,1,8,132,1
"org.apache.jackrabbit.core.version.NodeStateEx",29,0.08,2.24,230,3.07,101265.20,33,4,25,98,29,69.10,219,302,11,1,111.39,0.00,0.00,0.33,8,0.00,6,9218.44,0,13,18,java.lang.Object,0.00,69,0,65,0,69,16,0,52,1809,1
"org.apache.jackrabbit.core.version.RemoveAndAddVersionLabelXATest",1,0.00,1.00,20,0.25,6765.23,1,0,4,14,2,92.54,4,22,0,4,92.31,0.00,0.75,0.00,0,0.00,1,755.25,0,0,2,org.apache.jackrabbit.test.AbstractJCRTest,0.00,13,3,1,0,13,1,0,1,148,1
"org.apache.jackrabbit.core.version.RemoveOrphanVersionHistoryTest",4,0.00,2.25,85,1.15,33562.55,4,0,11,36,1,46.47,45,104,0,4,90.59,0.00,0.75,0.00,1,0.00,3,3437.17,0,0,1,org.apache.jackrabbit.test.AbstractJCRTest,0.00,32,3,9,0,32,4,0,27,601,1
"org.apache.jackrabbit.core.version.RemoveVersionLabelTest",1,0.00,1.00,13,0.16,2801.93,1,0,5,12,2,84.43,5,15,1,4,102.30,0.00,0.75,0.00,0,0.00,1,487.82,0,0,1,org.apache.jackrabbit.test.AbstractJCRTest,0.00,11,3,1,0,11,1,0,3,96,1
"org.apache.jackrabbit.core.version.RestoreTest",1,0.00,1.00,12,0.14,2401.89,1,0,4,13,3,124.74,3,14,1,4,104.12,0.00,0.75,0.00,0,0.00,1,425.85,0,0,2,org.apache.jackrabbit.test.AbstractJCRTest,0.00,12,3,1,0,12,1,0,1,86,1
"org.apache.jackrabbit.core.version.TestAll",1,0.00,1.00,9,0.09,2740.87,1,0,3,3,5,60.23,8,11,0,2,108.33,0.00,0.50,0.00,0,1.00,1,261.86,0,1,5,junit.framework.TestCase,0.00,2,1,1,0,2,0,0,2,63,1
"org.apache.jackrabbit.core.version.VersionHistoryImpl",24,0.91,1.71,114,1.53,38488.27,25,1,24,64,18,123.41,109,174,7,3,123.18,0.00,0.67,0.12,6,22.00,3,4595.30,2,14,13,org.apache.jackrabbit.core.NodeImpl,0.01,40,2,41,0,40,10,1,34,975,1
"org.apache.jackrabbit.core.version.VersionHistoryInfo",3,0.25,1.00,10,0.06,775.96,5,2,1,3,8,86.10,25,14,7,1,134.20,0.00,0.00,0.33,0,5.00,1,170.34,0,2,1,java.lang.Object,0.00,0,0,3,0,0,1,0,6,52,1
"org.apache.jackrabbit.core.version.VersionImpl",16,0.87,1.38,67,0.86,21611.68,17,1,16,43,13,105.94,87,87,7,3,123.82,0.00,0.67,0.19,2,70.00,3,2573.44,2,9,9,org.apache.jackrabbit.core.NodeImpl,0.01,27,2,22,0,27,7,1,24,569,1
"org.apache.jackrabbit.core.version.VersionItemStateManager",5,0.25,3.20,43,0.54,15551.41,7,2,16,29,14,91.67,25,67,2,2,109.54,0.00,0.50,0.30,0,2.00,6,1622.33,0,1,12,org.apache.jackrabbit.core.state.SharedItemStateManager,0.00,24,1,16,0,24,4,0,14,326,1
"org.apache.jackrabbit.core.version.VersionItemStateProvider",16,0.07,1.06,40,0.40,6479.86,19,3,15,30,15,139.46,65,66,1,1,139.22,0.00,0.00,0.27,0,62.00,2,1191.74,0,5,14,java.lang.Object,0.00,14,0,17,0,14,11,2,24,308,0
"org.apache.jackrabbit.core.version.VersionIteratorImpl",11,0.02,1.73,54,0.53,14208.39,15,4,10,30,5,91.69,74,76,2,1,123.92,0.00,0.00,0.23,3,26.00,3,1578.17,0,2,3,java.lang.Object,0.00,19,0,19,0,19,9,1,17,354,0
"org.apache.jackrabbit.core.version.VersionIteratorImplTest",1,0.00,3.00,16,0.19,6237.17,2,1,5,8,6,95.95,0,16,1,2,95.95,0.00,0.50,1.00,0,0.00,3,556.99,0,0,5,junit.framework.TestCase,0.00,7,1,3,0,7,1,0,0,111,1
"org.apache.jackrabbit.core.version.VersionIteratorImplTest$DummyInternalVersion",16,0.47,1.00,36,0.18,1846.63,18,2,5,16,6,143.53,0,27,0,1,143.53,0.00,0.00,0.06,0,44.00,1,545.55,0,12,6,java.lang.Object,0.00,0,0,16,0,0,4,1,0,169,2
"org.apache.jackrabbit.core.version.VersionManager",14,0.00,1.00,15,0.13,597.76,14,0,9,14,16,110.06,116,23,7,1,158.16,0.00,0.00,0.00,0,14.00,1,395.99,0,11,9,,0.00,0,0,14,0,0,3,0,15,127,1
"org.apache.jackrabbit.core.version.VersionManagerImpl",27,0.02,1.78,201,3.10,142667.27,36,9,46,116,49,77.80,182,312,5,2,110.03,0.00,0.50,0.09,3,390.00,8,9313.53,1,10,45,org.apache.jackrabbit.core.version.AbstractVersionManager,0.00,89,1,48,0,89,17,2,57,1717,1
"org.apache.jackrabbit.core.version.VersionManagerImpl$DynamicESCFactory",4,0.33,1.25,16,0.14,2648.81,6,2,46,7,4,78.17,34,26,0,1,126.28,0.00,0.00,0.25,1,8.00,2,415.98,0,3,4,java.lang.Object,0.00,3,0,5,0,3,1,1,6,104,3
"org.apache.jackrabbit.core.version.VersionManagerImpl$SourcedTarget",1,0.00,1.00,3,0.02,151.81,1,0,46,2,0,136.03,0,4,0,1,136.03,0.00,0.00,0.00,0,1.00,1,54.60,0,1,0,java.lang.Object,0.00,1,0,1,0,1,0,0,0,17,0
"org.apache.jackrabbit.core.version.VersionManagerImpl$SourcedTarget_0",1,0.00,1.00,3,0.02,136.54,1,0,46,2,0,136.39,0,4,0,1,136.39,0.00,0.00,0.00,0,1.00,1,49.51,0,1,0,java.lang.Object,0.00,1,0,1,0,1,0,0,0,16,0
"org.apache.jackrabbit.core.version.VersionManagerImpl$SourcedTarget_1",1,0.00,1.00,5,0.03,405.56,1,0,46,3,1,124.39,0,6,0,1,124.39,0.00,0.00,0.00,0,1.00,1,100.00,0,1,1,java.lang.Object,0.00,2,0,1,0,2,0,0,0,27,0
"org.apache.jackrabbit.core.version.VersionManagerImpl$SourcedTarget_2",1,0.00,2.00,10,0.13,2813.83,1,0,46,7,4,126.99,3,12,0,1,106.38,0.00,0.00,0.00,0,1.00,2,376.24,0,1,4,java.lang.Object,0.00,6,0,2,0,6,0,0,3,77,0
"org.apache.jackrabbit.core.version.VersionManagerImpl$SourcedTarget_3",1,0.00,1.00,5,0.04,512.39,1,0,46,3,1,123.59,0,7,0,1,123.59,0.00,0.00,0.00,0,1.00,1,112.25,0,1,1,java.lang.Object,0.00,2,0,1,0,2,0,0,0,29,0
"org.apache.jackrabbit.core.version.VersionManagerImpl$SourcedTarget_4",1,0.00,1.00,4,0.04,576.73,1,0,46,3,2,126.80,0,6,0,1,126.80,0.00,0.00,0.00,0,1.00,1,129.01,0,1,2,java.lang.Object,0.00,2,0,1,0,2,0,0,0,32,0
"org.apache.jackrabbit.core.version.VersionManagerImpl$SourcedTarget_5",1,0.00,1.00,2,0.01,83.22,1,0,46,1,0,144.65,0,3,0,1,144.65,0.00,0.00,0.00,0,1.00,1,35.61,0,1,0,java.lang.Object,0.00,0,0,1,0,0,0,0,0,13,2
"org.apache.jackrabbit.core.version.VersionSelector",1,0.00,1.00,2,0.01,51.00,1,0,3,1,5,140.55,37,3,5,1,146.32,0.00,0.00,0.00,0,1.00,1,34.00,0,1,0,,0.00,0,0,1,0,0,0,0,2,13,1
"org.apache.jackrabbit.core.version.XAVersionManager",44,0.04,1.80,220,2.73,67164.26,51,7,35,119,37,101.85,226,344,1,2,119.72,0.00,0.50,0.10,5,570.00,4,8182.30,8,18,36,org.apache.jackrabbit.core.version.AbstractVersionManager,0.06,75,1,79,0,75,26,3,62,1741,1
"org.apache.jackrabbit.core.version.XAVersionManager$InternalXAResource",6,0.00,1.00,9,0.06,370.36,6,0,35,6,1,156.90,0,15,0,1,156.90,0.00,0.00,0.00,0,10.00,1,176.58,0,0,1,java.lang.Object,0.00,0,0,6,0,0,6,0,0,57,0
"org.apache.jackrabbit.core.version.XAVersionManager$InternalXAResource_0",7,0.00,1.14,13,0.07,528.69,7,0,35,7,1,156.18,0,21,0,1,156.18,0.00,0.00,0.00,1,12.00,2,216.61,0,0,1,java.lang.Object,0.00,0,0,8,0,0,7,0,0,70,0
"org.apache.jackrabbit.webdav.server.AbstractWebdavServlet",47,2.00,3.23,446,6.53,228019.66,49,2,67,175,58,56.11,441,640,3,2,106.11,6.00,0.12,0.00,6,223.00,34,19576.01,1,6,55,javax.servlet.http.HttpServlet,0.00,128,1,152,6,128,41,1,86,3593,2
"org.apache.jackrabbit.webdav.server.BindTest",14,5.00,1.29,429,6.92,462426.46,19,5,39,76,21,80.49,59,460,1,2,80.26,0.00,0.50,0.00,3,14.00,3,20745.58,2,3,20,junit.framework.TestCase,0.00,62,1,18,0,62,11,0,50,3473,1
"org.apache.jackrabbit.webdav.server.RFC4918DestinationHeaderTest",3,5.00,1.33,48,0.85,53553.61,8,5,13,23,4,92.77,14,57,1,2,92.54,0.00,0.50,0.00,0,3.00,2,2547.55,2,0,3,junit.framework.TestCase,0.00,20,1,4,0,20,3,0,4,463,1
"org.apache.jackrabbit.webdav.server.RFC4918IfHeaderTest",4,5.00,1.50,78,1.46,102432.51,9,5,16,30,7,70.62,20,93,1,2,88.49,0.00,0.50,0.00,0,4.00,2,4379.65,2,0,6,junit.framework.TestCase,0.00,26,1,6,0,26,4,0,10,748,1
"org.apache.jackrabbit.webdav.server.RFC4918PropfindTest",4,0.20,1.25,44,0.73,25246.97,9,5,20,31,11,142.06,11,55,1,2,102.18,0.00,0.50,0.05,0,6.00,2,2186.80,2,0,10,junit.framework.TestCase,0.00,27,1,5,0,27,4,0,1,399,1
"org.apache.jackrabbit.webdav.server.WebdavServerTests",1,0.00,1.00,8,0.07,2228.14,1,0,3,3,4,110.95,0,10,0,2,110.95,0.00,0.50,0.00,0,1.00,1,223.66,0,1,4,junit.framework.TestCase,0.00,2,1,1,0,2,0,0,0,55,1
"org.apache.jackrabbit.webdav.AbstractLocatorFactory",6,0.50,2.67,41,0.57,34923.76,8,2,3,20,6,130.23,110,55,3,1,112.10,0.00,0.00,0.08,1,10.00,10,1698.49,0,5,3,java.lang.Object,0.00,14,0,16,3,14,1,1,18,338,2
"org.apache.jackrabbit.webdav.AbstractLocatorFactory$DavResourceLocatorImpl",13,0.07,1.69,52,0.55,17056.71,18,5,3,28,4,81.58,100,72,0,1,123.87,0.00,0.00,0.14,4,92.00,4,1656.22,0,6,4,java.lang.Object,0.00,15,0,22,0,15,7,1,16,377,1
"org.apache.jackrabbit.webdav.DavCompliance",1,19.00,3.00,30,0.44,11678.97,20,19,2,5,6,39.49,11,31,6,1,83.62,0.00,0.00,0.00,0,1.00,3,1307.56,0,1,0,java.lang.Object,0.00,4,0,3,0,4,0,0,8,239,2
"org.apache.jackrabbit.webdav.DavConstants",0,0.00,0.00,75,1.68,41851.13,74,74,3,2,72,171.00,41,76,70,1,171.00,0.00,0.00,0.00,0,0.00,0,5039.92,0,0,2,,0.00,2,0,0,0,2,0,0,19,685,1
"org.apache.jackrabbit.webdav.DavException",9,0.02,1.22,40,0.42,7800.64,14,5,8,18,130,83.07,71,55,127,2,125.36,1.00,0.33,0.18,2,46.00,3,1264.72,0,3,4,java.lang.Exception,0.00,9,1,11,1,9,6,1,10,295,1
"org.apache.jackrabbit.webdav.DavLocatorFactory",3,0.00,1.00,4,0.04,214.66,3,0,0,3,15,146.04,46,5,15,1,156.40,0.00,0.00,0.00,0,3.00,1,114.84,0,3,1,,0.00,0,0,3,0,0,0,0,4,37,1
"org.apache.jackrabbit.webdav.DavMethods",6,0.01,1.83,138,2.37,84926.15,76,70,3,14,38,132.50,170,152,37,1,87.38,0.00,0.00,0.02,2,22.00,3,7096.82,0,0,1,java.lang.Object,0.00,8,0,11,0,8,6,0,44,1115,1
"org.apache.jackrabbit.webdav.DavResource",32,1.00,1.00,34,0.24,1335.37,33,1,12,32,81,115.95,228,35,69,1,158.24,0.00,0.00,0.00,0,32.00,1,705.81,0,14,16,,0.00,0,0,32,0,0,18,0,34,241,1
"org.apache.jackrabbit.webdav.DavResourceFactory",2,0.00,1.00,3,0.03,184.32,2,0,0,2,26,111.40,22,4,21,1,155.53,0.00,0.00,0.00,0,2.00,1,94.16,0,2,6,,0.00,0,0,2,0,0,0,0,3,28,1
"org.apache.jackrabbit.webdav.DavResourceIterator",2,0.00,1.00,3,0.01,65.85,2,0,1,2,16,126.83,13,4,16,2,159.05,0.00,0.50,0.00,0,2.00,1,38.73,0,1,1,,0.00,0,1,2,0,0,1,0,3,16,1
"org.apache.jackrabbit.webdav.DavResourceIteratorImpl",6,0.07,1.00,17,0.12,1618.56,9,3,4,12,9,140.86,26,24,7,1,140.63,0.00,0.00,0.28,1,6.00,1,363.10,0,2,2,java.lang.Object,0.00,6,0,6,0,6,4,1,7,102,1
"org.apache.jackrabbit.webdav.DavResourceLocator",10,0.00,1.00,11,0.05,222.33,10,0,0,10,47,118.10,75,12,47,1,160.39,0.00,0.00,0.00,0,10.00,1,148.22,0,6,1,,0.00,0,0,10,0,0,4,0,11,60,1
"org.apache.jackrabbit.webdav.DavServletRequest",16,0.00,1.00,17,0.10,536.21,16,0,7,16,14,110.88,137,18,6,2,158.99,0.00,0.50,0.00,0,16.00,1,295.34,0,7,8,,0.00,0,1,16,0,0,9,0,17,110,1
"org.apache.jackrabbit.webdav.DavServletResponse",5,6.00,1.00,12,0.12,1085.81,11,6,4,5,112,140.90,83,13,109,2,141.37,0.00,0.50,0.00,0,5.00,1,345.73,0,0,4,,0.00,0,1,5,0,0,5,0,12,91,1
"org.apache.jackrabbit.webdav.DavSession",5,0.00,1.00,6,0.03,160.93,5,0,0,5,20,126.91,31,7,20,1,159.13,0.00,0.00,0.00,0,5.00,1,102.12,0,1,0,,0.00,0,0,5,0,0,4,0,6,38,1
"org.apache.jackrabbit.webdav.DavSessionProvider",2,0.00,1.00,3,0.02,98.54,2,0,0,2,7,120.11,24,4,5,1,157.67,0.00,0.00,0.00,0,2.00,1,56.18,0,0,2,,0.00,0,0,2,0,0,2,0,3,20,1
"org.apache.jackrabbit.webdav.MultiStatus",9,0.25,1.89,45,0.61,16236.90,11,2,9,34,34,69.14,81,65,26,1,119.14,0.00,0.00,0.28,3,31.00,3,1817.74,0,3,8,java.lang.Object,0.00,25,0,17,0,25,6,2,13,388,1
"org.apache.jackrabbit.webdav.MultiStatusResponse",21,0.00,2.38,178,2.23,96963.88,28,7,15,68,43,60.15,176,222,29,1,108.26,0.00,0.00,0.14,4,145.00,7,6679.31,0,8,15,java.lang.Object,0.00,47,0,50,0,47,13,2,39,1283,1
"org.apache.jackrabbit.webdav.Status",5,0.12,2.80,53,0.69,43470.93,9,4,6,19,7,123.06,18,70,3,1,102.44,0.00,0.00,0.35,0,9.00,10,2073.30,0,2,4,java.lang.Object,0.00,14,0,14,0,14,3,2,8,387,1
"org.apache.jackrabbit.webdav.WebdavRequest",0,0.00,0.00,1,0.01,76.11,0,0,5,0,15,171.00,7,5,10,7,171.00,0.00,0.86,0.00,0,0.00,0,38.05,0,0,5,,0.00,0,6,0,0,0,0,0,1,11,1
"org.apache.jackrabbit.webdav.WebdavRequestImpl",90,0.00,1.73,409,4.43,159146.53,101,11,58,221,41,162.73,248,567,1,1,122.84,0.00,0.00,0.09,12,0.00,13,13292.92,0,63,40,java.lang.Object,0.00,131,0,156,0,131,27,2,70,2825,1
"org.apache.jackrabbit.webdav.WebdavResponse",0,0.00,0.00,1,0.01,39.30,0,0,1,0,7,171.00,7,3,6,3,171.00,0.00,0.67,0.00,0,0.00,0,19.65,0,0,1,,0.00,0,2,0,0,0,0,0,1,7,1
"org.apache.jackrabbit.webdav.WebdavResponseImpl",39,0.05,1.18,117,1.27,27319.14,41,2,30,96,17,180.76,73,168,1,1,130.76,0.00,0.00,0.45,2,0.00,5,3807.24,0,8,16,java.lang.Object,0.00,57,0,46,0,57,31,1,16,888,1
"org.apache.jackrabbit.core.security.authorization.acl.ACLEditor",16,0.05,2.38,126,1.64,55277.46,21,5,31,49,15,69.12,117,154,2,2,111.41,0.00,0.50,0.15,6,94.00,6,4916.04,4,11,15,org.apache.jackrabbit.core.ProtectedItemModifier,0.00,33,1,38,0,33,5,2,33,957,1
"org.apache.jackrabbit.core.security.authorization.acl.ACLProvider",11,0.10,2.36,103,1.35,42821.58,15,4,46,60,25,58.46,116,126,3,2,106.93,0.00,0.50,0.16,5,55.00,4,4037.08,6,4,23,org.apache.jackrabbit.core.security.authorization.AbstractAccessControlProvider,0.00,49,1,26,0,49,7,1,32,780,1
"org.apache.jackrabbit.core.security.authorization.acl.ACLProvider$AclPermissions",7,0.11,5.57,140,2.29,139737.42,10,3,46,66,10,50.65,84,184,0,2,88.21,0.00,0.50,0.43,0,1.00,16,6873.67,3,0,10,org.apache.jackrabbit.core.security.authorization.AbstractCompiledPermissions,0.13,59,1,39,0,59,7,1,44,1131,1
"org.apache.jackrabbit.core.security.authorization.acl.ACLProvider$Entries",3,0.00,2.33,26,0.26,5283.27,4,1,46,15,3,161.56,4,29,0,1,111.56,0.00,0.00,1.00,1,0.00,3,778.95,0,1,3,java.lang.Object,0.00,12,0,7,0,12,2,0,4,172,1
"org.apache.jackrabbit.core.security.authorization.acl.ACLTemplate",19,0.04,2.63,166,2.48,132151.92,25,6,29,71,16,64.54,136,223,6,1,106.83,0.00,0.00,0.13,4,133.00,9,7450.84,0,5,10,java.lang.Object,0.00,52,0,50,0,52,14,1,51,1349,0
"org.apache.jackrabbit.core.security.authorization.acl.ACLTemplate$Entry",1,0.00,1.00,3,0.04,436.15,1,0,29,1,1,132.42,0,5,0,2,132.42,0.00,0.50,0.00,0,1.00,1,120.04,0,0,1,org.apache.jackrabbit.core.security.authorization.AccessControlEntryImpl,0.00,0,1,1,0,0,1,0,0,31,1
"org.apache.jackrabbit.core.security.authorization.acl.ACLTemplateTest",7,0.00,1.86,81,1.33,54932.98,7,0,15,31,10,141.23,20,100,1,6,101.34,0.00,0.83,0.00,2,9.00,4,3983.37,2,2,9,org.apache.jackrabbit.core.security.authorization.AbstractACLTemplateTest,0.11,24,5,13,0,24,5,0,18,738,1
"org.apache.jackrabbit.core.security.authorization.acl.EntryTest",1,0.00,1.00,3,0.05,722.57,1,0,5,3,3,151.30,3,6,1,6,130.69,0.00,0.83,0.00,0,0.00,1,140.37,0,1,2,org.apache.jackrabbit.core.security.authorization.AbstractEntryTest,0.00,2,5,1,0,2,0,0,1,34,1
"org.apache.jackrabbit.core.security.authorization.acl.EvaluationUtil",3,0.00,3.00,24,0.28,10681.22,3,0,11,7,7,148.98,6,33,4,1,109.09,0.00,0.00,0.00,0,3.00,5,825.08,0,2,3,java.lang.Object,0.00,4,0,9,0,4,1,0,4,164,1
"org.apache.jackrabbit.core.security.authorization.acl.LockTest",3,0.00,1.00,7,0.08,1011.58,3,0,8,6,5,189.86,3,12,1,7,139.86,0.00,0.86,0.00,0,4.00,1,231.28,0,2,4,org.apache.jackrabbit.core.security.authorization.AbstractLockManagementTest,0.12,3,6,3,0,3,1,0,1,61,1
"org.apache.jackrabbit.core.security.authorization.acl.NodeTypeTest",3,0.00,1.00,7,0.08,1011.58,3,0,8,6,5,189.86,3,12,1,7,139.86,0.00,0.86,0.00,0,4.00,1,231.28,0,2,4,org.apache.jackrabbit.core.security.authorization.AbstractNodeTypeManagementTest,0.11,3,6,3,0,3,1,0,1,61,1
"org.apache.jackrabbit.core.security.authorization.acl.TestAll",1,0.00,1.00,10,0.10,3275.34,1,0,3,3,6,57.54,10,12,0,2,106.02,0.00,0.50,0.00,0,1.00,1,301.01,0,1,6,junit.framework.TestCase,0.00,2,1,1,0,2,0,0,2,71,1
"org.apache.jackrabbit.core.security.authorization.acl.VersionTest",3,0.00,1.00,7,0.08,1011.58,3,0,8,6,5,189.86,3,12,1,7,139.86,0.00,0.86,0.00,0,4.00,1,231.28,0,2,4,org.apache.jackrabbit.core.security.authorization.AbstractVersionManagementTest,0.12,3,6,3,0,3,1,0,1,61,1
"org.apache.jackrabbit.core.security.authorization.acl.WriteTest",6,0.00,1.50,53,0.80,23626.99,6,0,17,27,10,66.62,46,70,2,7,108.91,0.17,0.75,0.00,0,6.00,4,2393.04,6,2,8,org.apache.jackrabbit.core.security.authorization.AbstractWriteTest,0.09,21,6,9,1,21,4,0,26,443,1
"org.apache.jackrabbit.webdav.observation.DefaultEventType",6,0.07,1.67,32,0.40,11744.41,9,3,10,24,10,70.78,50,43,4,1,118.89,0.00,0.00,0.28,1,14.00,3,1187.54,0,5,6,java.lang.Object,0.00,18,0,10,0,18,1,1,9,250,1
"org.apache.jackrabbit.webdav.observation.EventBundle",0,0.00,0.00,1,0.01,31.02,0,0,1,0,5,171.00,6,2,4,2,171.00,0.00,0.50,0.00,0,0.00,0,15.51,0,0,1,,0.00,0,1,0,0,0,0,0,1,6,1
"org.apache.jackrabbit.webdav.observation.EventDiscovery",4,0.17,1.50,17,0.18,3080.14,6,2,9,13,14,77.61,35,24,10,1,125.72,0.00,0.00,0.38,1,0.00,2,532.76,0,2,4,java.lang.Object,0.00,9,0,6,0,9,2,2,5,126,1
"org.apache.jackrabbit.webdav.observation.EventType",2,0.00,1.00,3,0.01,65.85,2,0,2,2,6,209.05,3,4,4,2,159.05,0.00,0.50,0.00,0,2.00,1,38.73,0,2,2,,0.00,0,1,2,0,0,0,0,1,16,1
"org.apache.jackrabbit.webdav.observation.Filter",7,0.17,1.29,26,0.25,5243.97,11,4,7,15,5,130.51,3,35,2,1,130.51,0.00,0.00,0.39,0,0.00,2,757.29,0,4,3,java.lang.Object,0.00,8,0,9,0,8,3,1,1,184,1
"org.apache.jackrabbit.webdav.observation.ObservationConstants",0,0.00,0.00,22,0.40,7644.67,21,21,2,2,15,171.00,31,23,13,1,171.00,0.00,0.00,0.00,0,0.00,0,1189.17,0,0,2,,0.00,2,0,0,0,2,0,0,10,203,1
"org.apache.jackrabbit.webdav.observation.ObservationDavServletRequest",3,0.00,1.00,4,0.02,105.15,3,0,2,3,3,110.73,25,5,0,2,158.84,0.00,0.50,0.00,0,3.00,1,58.38,0,2,3,,0.00,0,1,3,0,0,1,0,4,23,1
"org.apache.jackrabbit.webdav.observation.ObservationDavServletResponse",2,0.00,1.00,3,0.02,145.14,2,0,2,2,4,108.24,17,4,1,2,156.35,0.00,0.50,0.00,0,2.00,1,72.57,0,0,3,,0.00,0,1,2,0,0,2,0,3,24,1
"org.apache.jackrabbit.webdav.observation.ObservationResource",4,1.00,1.00,6,0.06,373.67,5,1,2,4,12,105.48,39,7,7,2,155.48,0.00,0.50,0.00,0,4.00,1,169.26,0,2,6,,0.00,0,1,4,0,0,2,0,5,51,1
"org.apache.jackrabbit.webdav.observation.Subscription",1,0.00,1.00,2,0.01,48.43,1,0,1,1,13,136.14,15,3,12,2,146.50,0.00,0.50,0.00,0,1.00,1,27.12,0,1,1,,0.00,0,1,1,0,0,0,0,2,11,1
"org.apache.jackrabbit.webdav.observation.SubscriptionDiscovery",5,0.75,2.00,34,0.39,12153.08,6,1,9,20,13,82.93,31,42,6,2,115.15,0.00,0.50,0.40,0,7.00,3,1182.11,1,3,7,org.apache.jackrabbit.webdav.property.AbstractDavProperty,0.00,15,1,10,0,15,2,0,7,248,1
"org.apache.jackrabbit.webdav.observation.SubscriptionDiscovery$Subscription",2,0.00,1.50,8,0.09,1537.07,2,0,9,5,3,146.34,6,11,0,1,125.72,0.00,0.00,0.00,0,2.00,2,260.90,0,2,3,java.lang.Object,0.00,3,0,3,0,3,0,0,2,63,0
"org.apache.jackrabbit.webdav.observation.SubscriptionInfo",10,0.02,2.30,81,1.00,42865.52,16,6,14,31,22,58.52,93,96,10,1,108.52,0.00,0.00,0.18,0,46.00,6,2990.99,0,1,12,java.lang.Object,0.00,21,0,23,0,21,9,2,11,581,1
"org.apache.jackrabbit.webdav.observation.SubscriptionManager",4,0.00,1.00,5,0.05,310.01,4,0,1,4,12,108.02,35,10,7,1,156.12,0.00,0.00,0.00,0,4.00,1,161.92,0,2,6,,0.00,0,0,4,0,0,2,0,5,48,1
"org.apache.jackrabbit.api.observation.JackrabbitEvent",1,0.00,1.00,2,0.01,44.19,1,0,1,1,1,102.69,11,3,1,2,146.81,0.00,0.50,0.00,0,1.00,1,26.09,0,0,0,,0.00,0,1,1,0,0,1,0,2,11,1
"org.apache.jackrabbit.core.persistence.db.DatabasePersistenceManager",37,0.08,3.35,486,6.19,280749.65,70,33,40,136,22,56.32,282,689,3,2,98.61,4.00,0.17,0.10,14,13.00,11,18569.60,2,8,19,org.apache.jackrabbit.core.persistence.AbstractPersistenceManager,0.00,99,1,124,4,99,29,0,131,3350,2
"org.apache.jackrabbit.core.persistence.db.DatabasePersistenceManager$DbBLOBStore",4,0.00,1.75,30,0.39,11695.04,4,0,40,18,2,94.18,20,39,0,1,112.05,0.00,0.00,0.00,0,10.00,3,1172.64,0,2,2,java.lang.Object,0.00,14,0,7,0,14,2,1,9,238,0
"org.apache.jackrabbit.core.persistence.db.DatabasePersistenceManager$DbBLOBStore$FilterInputStream",1,0.00,1.00,4,0.02,218.17,1,0,40,3,0,180.12,1,5,0,1,130.12,0.00,0.00,0.00,0,1.00,1,68.97,0,0,0,java.lang.Object,0.00,2,0,1,0,2,1,0,1,21,0
"org.apache.jackrabbit.core.persistence.db.DatabasePersistenceManager$SizedInputStream",7,0.08,1.00,22,0.17,2593.31,9,2,40,7,0,132.97,0,30,0,2,132.97,0.00,0.50,0.43,0,0.00,1,512.17,2,0,0,java.io.FilterInputStream,0.00,0,1,7,0,0,7,0,0,134,0
"org.apache.jackrabbit.core.persistence.db.DerbyPersistenceManager",4,0.00,2.00,28,0.27,7362.38,6,2,5,15,1,122.74,69,39,0,4,113.61,0.00,0.75,0.50,0,0.00,5,815.65,0,0,1,org.apache.jackrabbit.core.persistence.db.SimpleDbPersistenceManager,0.00,11,3,8,0,11,4,0,19,170,1
"org.apache.jackrabbit.core.persistence.db.JNDIDatabasePersistenceManager",3,0.50,1.00,10,0.08,1276.06,4,1,5,6,1,88.37,35,14,0,3,132.50,0.00,0.67,0.67,0,1.00,1,241.45,0,2,1,org.apache.jackrabbit.core.persistence.db.DatabasePersistenceManager,0.06,3,2,3,0,3,1,0,7,64,1
"org.apache.jackrabbit.core.persistence.db.OraclePersistenceManager",10,0.07,3.50,135,2.01,89416.21,16,6,25,64,9,68.66,134,192,0,4,98.04,0.00,0.75,0.23,1,14.00,8,6023.30,5,2,9,org.apache.jackrabbit.core.persistence.db.SimpleDbPersistenceManager,0.06,54,3,35,0,54,8,0,50,1054,1
"org.apache.jackrabbit.core.persistence.db.OraclePersistenceManager$OracleBLOBStore",1,0.00,4.00,14,0.19,7266.34,1,0,25,6,0,97.76,4,22,0,2,97.52,0.00,0.50,0.00,0,1.00,4,555.96,0,0,0,org.apache.jackrabbit.core.persistence.db.DbBLOBStore,0.00,5,1,4,0,5,1,0,2,103,0
"org.apache.jackrabbit.core.persistence.db.SimpleDbPersistenceManager",9,0.03,1.00,23,0.15,1687.87,13,4,4,10,4,97.74,104,33,2,3,141.87,1.00,0.40,0.22,0,28.00,1,444.10,0,5,2,org.apache.jackrabbit.core.persistence.db.DatabasePersistenceManager,0.05,1,2,9,2,1,4,0,4,128,1
"org.apache.jackrabbit.test.api.query.qom.AbstractJoinTest",4,0.00,1.75,22,0.32,10239.73,7,3,8,10,6,138.57,15,42,5,6,117.96,1.00,0.45,0.33,3,6.00,4,958.59,0,2,1,org.apache.jackrabbit.test.api.query.qom.AbstractQOMTest,0.00,6,5,7,5,6,2,0,6,207,2
"org.apache.jackrabbit.test.api.query.qom.AbstractQOMTest",8,0.00,2.50,104,1.31,54544.71,8,0,14,28,21,56.76,59,108,20,5,99.05,6.25,0.13,0.00,3,16.00,7,3942.95,0,1,1,org.apache.jackrabbit.test.api.query.AbstractQueryTest,0.00,20,4,20,25,20,7,0,10,739,2
"org.apache.jackrabbit.test.api.query.qom.AbstractQOMTest$Callable",1,0.00,1.00,2,0.01,69.06,1,0,14,1,0,145.29,0,3,0,1,145.29,0.00,0.00,0.00,0,1.00,1,36.53,0,1,0,,0.00,0,0,1,0,0,0,0,0,13,1
"org.apache.jackrabbit.test.api.query.qom.AndConstraintTest",1,0.00,1.00,13,0.32,9476.09,1,0,4,12,2,118.75,3,29,1,6,98.13,0.00,0.83,0.00,0,0.00,1,949.16,1,0,1,org.apache.jackrabbit.test.api.query.qom.AbstractQOMTest,0.00,11,5,1,0,11,1,0,1,169,1
"org.apache.jackrabbit.test.api.query.qom.BindVariableValueTest",14,0.19,1.14,122,1.80,39630.49,23,9,9,32,3,110.10,5,152,1,6,110.10,0.00,0.83,0.29,0,0.00,3,5398.17,5,0,2,org.apache.jackrabbit.test.api.query.qom.AbstractQOMTest,0.20,18,5,16,0,18,14,0,3,1079,1
"org.apache.jackrabbit.test.api.query.qom.ChildNodeJoinConditionTest",4,0.67,1.25,27,0.38,7442.00,6,2,7,12,2,166.17,4,33,1,7,116.17,0.00,0.86,1.00,0,0.00,2,1133.76,4,0,1,org.apache.jackrabbit.test.api.query.qom.AbstractJoinTest,0.13,8,6,5,0,8,4,0,1,234,1
"org.apache.jackrabbit.test.api.query.qom.ChildNodeTest",7,0.00,2.14,57,0.98,23847.57,7,0,9,24,3,159.32,11,94,1,6,109.32,0.00,0.83,0.00,0,0.00,3,2925.75,1,0,2,org.apache.jackrabbit.test.api.query.qom.AbstractQOMTest,0.00,17,5,15,0,17,7,0,8,557,1
"org.apache.jackrabbit.test.api.query.qom.ColumnTest",3,0.33,1.00,18,0.37,9390.15,6,3,16,13,2,82.22,20,43,1,6,114.45,0.00,0.83,0.56,0,0.00,1,1107.89,1,0,1,org.apache.jackrabbit.test.api.query.qom.AbstractQOMTest,0.00,10,5,3,0,10,3,0,3,222,1
"org.apache.jackrabbit.test.api.query.qom.ColumnTest$Callable",1,0.00,4.00,21,0.32,11360.74,1,0,16,16,0,89.42,0,20,0,1,89.42,0.00,0.00,0.00,0,0.00,4,948.24,0,1,0,java.lang.Object,0.00,15,0,4,0,15,0,0,0,159,0
"org.apache.jackrabbit.test.api.query.qom.ColumnTest$Callable_0",1,0.00,2.00,11,0.13,2593.99,1,0,16,9,0,105.11,0,10,0,1,105.11,0.00,0.00,0.00,0,1.00,2,377.87,0,1,0,java.lang.Object,0.00,8,0,2,0,8,0,0,0,75,0
"org.apache.jackrabbit.test.api.query.qom.ColumnTest$Callable_1",1,0.00,1.00,8,0.11,1860.13,1,0,16,9,0,111.57,0,9,0,1,111.57,0.00,0.00,0.00,0,0.00,1,330.02,0,1,0,java.lang.Object,0.00,8,0,1,0,8,0,0,0,69,0
"org.apache.jackrabbit.test.api.query.qom.DescendantNodeJoinConditionTest",4,0.67,2.00,37,0.48,13432.53,6,2,7,14,2,147.36,8,43,1,7,107.48,0.00,0.86,1.00,0,0.00,5,1426.49,4,0,1,org.apache.jackrabbit.test.api.query.qom.AbstractJoinTest,0.13,10,6,8,0,10,4,0,5,282,1
"org.apache.jackrabbit.test.api.query.qom.DescendantNodeTest",7,0.00,2.14,57,0.97,23944.58,7,0,9,24,3,159.31,11,92,1,6,109.31,0.00,0.83,0.00,0,0.00,3,2922.52,1,0,2,org.apache.jackrabbit.test.api.query.qom.AbstractQOMTest,0.00,17,5,15,0,17,7,0,8,557,1
"org.apache.jackrabbit.test.api.query.qom.EquiJoinConditionTest",7,0.58,1.00,37,0.57,9278.06,9,2,5,11,2,120.34,4,51,1,7,120.34,0.00,0.86,1.00,0,0.00,1,1701.95,5,0,1,org.apache.jackrabbit.test.api.query.qom.AbstractJoinTest,0.12,4,6,7,0,4,7,0,1,354,1
"org.apache.jackrabbit.test.api.query.qom.FullTextSearchScoreTest",3,1.00,1.00,18,0.36,7157.26,4,1,7,19,2,165.38,3,43,1,6,115.38,0.00,0.83,0.33,0,0.00,1,1067.28,2,0,1,org.apache.jackrabbit.test.api.query.qom.AbstractQOMTest,0.12,16,5,3,0,16,3,0,1,218,1
"org.apache.jackrabbit.test.api.query.qom.FullTextSearchScoreTest$Callable",1,0.00,3.00,10,0.12,3075.58,1,0,7,7,0,105.98,0,13,0,1,105.98,0.00,0.00,0.00,0,1.00,3,359.03,0,1,0,java.lang.Object,0.00,6,0,3,0,6,0,0,0,73,0
"org.apache.jackrabbit.test.api.query.qom.FullTextSearchScoreTest$Callable_0",1,0.00,3.00,8,0.10,2346.83,1,0,7,7,0,110.52,0,11,0,1,110.52,0.00,0.00,0.00,0,1.00,3,310.66,0,1,0,java.lang.Object,0.00,6,0,3,0,6,0,0,0,64,0
"org.apache.jackrabbit.test.api.query.qom.GetQueryTest",3,0.00,2.67,35,0.57,18496.95,3,0,11,24,3,102.32,13,48,1,6,102.08,0.00,0.83,0.00,1,0.00,4,1714.09,2,0,2,org.apache.jackrabbit.test.api.query.qom.AbstractQOMTest,0.00,21,5,8,0,21,3,0,4,299,1
"org.apache.jackrabbit.test.api.query.qom.LengthTest",29,0.18,1.28,156,2.06,42478.02,30,1,14,59,3,119.94,12,226,1,6,119.94,0.00,0.83,0.83,3,0.00,3,6174.99,4,2,2,org.apache.jackrabbit.test.api.query.qom.AbstractQOMTest,0.16,30,5,37,0,30,27,0,9,1328,1
"org.apache.jackrabbit.test.api.query.qom.NodeLocalNameTest",27,0.21,1.07,110,1.59,31030.54,29,2,10,49,3,124.43,5,162,1,6,124.43,0.00,0.83,0.30,5,0.00,2,4771.33,5,3,2,org.apache.jackrabbit.test.api.query.qom.AbstractQOMTest,0.16,22,5,29,0,22,24,0,2,1037,1
"org.apache.jackrabbit.test.api.query.qom.NodeNameTest",22,0.57,2.05,152,2.35,54845.49,23,1,11,44,3,165.06,36,249,1,6,115.06,0.00,0.83,0.45,5,0.00,5,7057.61,4,3,2,org.apache.jackrabbit.test.api.query.qom.AbstractQOMTest,0.18,22,5,45,0,22,19,0,25,1380,1
"org.apache.jackrabbit.test.api.query.qom.NotConstraintTest",1,0.00,1.00,9,0.17,3807.19,1,0,3,11,2,127.82,3,21,1,6,107.21,0.00,0.83,0.00,0,0.00,1,515.77,1,0,1,org.apache.jackrabbit.test.api.query.qom.AbstractQOMTest,0.00,10,5,1,0,10,1,0,1,100,1
"org.apache.jackrabbit.test.api.query.qom.OrConstraintTest",1,0.00,1.00,9,0.18,4478.52,1,0,3,11,2,127.27,3,22,1,6,106.65,0.00,0.83,0.00,0,0.00,1,553.02,1,0,1,org.apache.jackrabbit.test.api.query.qom.AbstractQOMTest,0.00,10,5,1,0,10,1,0,1,107,1
"org.apache.jackrabbit.test.api.query.qom.OrderingTest",3,0.25,1.00,24,0.35,7904.24,5,2,6,14,2,160.38,5,34,1,7,110.38,0.00,0.86,0.67,1,0.00,1,1041.64,2,1,1,org.apache.jackrabbit.test.api.query.qom.AbstractJoinTest,0.13,11,6,3,0,11,2,0,3,221,1
"org.apache.jackrabbit.test.api.query.qom.PropertyExistenceTest",1,0.00,1.00,11,0.23,7477.29,1,0,3,9,2,101.88,4,23,1,6,101.65,0.00,0.83,0.00,0,0.00,1,682.00,1,0,1,org.apache.jackrabbit.test.api.query.qom.AbstractQOMTest,0.00,8,5,1,0,8,1,0,1,133,1
"org.apache.jackrabbit.test.api.query.qom.PropertyValueTest",1,0.00,1.00,12,0.31,10301.57,2,1,4,12,2,99.38,4,32,1,6,99.14,0.00,0.83,1.00,0,0.00,1,925.16,1,0,1,org.apache.jackrabbit.test.api.query.qom.AbstractQOMTest,0.00,11,5,1,0,11,1,0,1,174,1
"org.apache.jackrabbit.test.api.query.qom.QueryObjectModelFactoryTest",50,0.03,1.04,288,4.21,79235.91,57,7,39,148,2,140.33,154,345,1,6,119.72,0.00,0.83,0.17,0,0.00,2,12635.90,0,0,1,org.apache.jackrabbit.test.api.query.qom.AbstractQOMTest,0.00,98,5,52,0,98,50,0,53,2636,1
"org.apache.jackrabbit.test.api.query.qom.RowTest",10,0.17,1.00,45,0.58,8765.25,12,2,7,33,2,125.37,5,60,1,6,125.37,0.00,0.83,0.35,1,2.00,1,1729.75,1,1,1,org.apache.jackrabbit.test.api.query.qom.AbstractQOMTest,0.11,23,5,10,0,23,9,0,3,383,1
"org.apache.jackrabbit.test.api.query.qom.SameNodeJoinConditionTest",8,0.43,1.12,34,0.61,12063.26,10,2,5,15,2,123.49,5,66,1,7,123.49,0.00,0.86,0.88,1,0.00,2,1844.65,4,1,1,org.apache.jackrabbit.test.api.query.qom.AbstractJoinTest,0.12,7,6,9,0,7,7,0,2,389,1
"org.apache.jackrabbit.test.api.query.qom.SameNodeTest",6,0.00,2.33,50,0.87,21648.57,6,0,9,23,3,159.11,10,84,1,6,109.11,0.00,0.83,0.00,0,0.00,3,2595.48,1,0,2,org.apache.jackrabbit.test.api.query.qom.AbstractQOMTest,0.00,17,5,14,0,17,6,0,8,490,1
"org.apache.jackrabbit.test.api.query.qom.SelectorTest",4,0.00,3.00,43,0.56,14297.26,4,0,8,18,2,145.35,10,69,1,6,105.46,0.00,0.83,0.00,0,0.00,5,1683.29,1,0,1,org.apache.jackrabbit.test.api.query.qom.AbstractQOMTest,0.00,14,5,12,0,14,4,0,8,327,1
"org.apache.jackrabbit.test.api.query.qom.SelectorTest$Callable",1,0.00,2.00,6,0.07,1054.26,1,0,8,6,0,118.01,0,8,0,1,118.01,0.00,0.00,0.00,0,1.00,2,203.04,0,1,0,java.lang.Object,0.00,5,0,2,0,5,0,0,0,46,0
"org.apache.jackrabbit.test.api.query.qom.TestAll",1,0.00,1.00,28,0.37,15077.10,1,0,3,3,25,84.35,4,30,1,2,84.11,0.00,0.50,0.00,0,1.00,1,1120.16,0,1,24,junit.framework.TestCase,0.00,2,1,1,0,2,0,0,1,215,1
"org.apache.jackrabbit.test.api.query.qom.UpperLowerCaseTest",12,0.55,1.25,63,1.29,35903.69,13,1,7,36,2,167.50,17,134,1,6,117.50,0.00,0.83,0.50,2,0.00,3,3859.86,4,1,1,org.apache.jackrabbit.test.api.query.qom.AbstractQOMTest,0.21,24,5,15,0,24,11,0,14,791,1
"org.apache.jackrabbit.api.security.principal.NoSuchPrincipalException",1,0.00,1.00,3,0.02,106.02,1,0,1,1,6,137.49,4,5,6,2,137.25,0.00,0.50,0.00,0,1.00,1,45.51,0,0,0,javax.jcr.RepositoryException,0.00,0,1,1,0,0,1,0,1,16,1
"org.apache.jackrabbit.api.security.principal.PrincipalIterator",1,0.00,1.00,2,0.01,44.19,1,0,2,1,19,98.71,8,3,19,2,146.81,0.00,0.50,0.00,0,1.00,1,26.09,0,1,0,,0.00,0,1,1,0,0,0,0,2,11,1
"org.apache.jackrabbit.api.security.principal.PrincipalManager",7,3.00,1.00,11,0.07,396.01,10,3,2,7,21,156.73,112,12,19,1,157.20,0.00,0.00,0.00,0,7.00,1,203.15,0,2,2,,0.00,0,0,7,0,0,5,0,11,67,1
"org.apache.jackrabbit.api.security.principal.PrincipalManagerTest",20,0.11,2.95,200,2.50,82039.77,22,2,12,53,8,105.00,13,234,1,4,105.00,0.00,0.75,0.60,3,0.00,7,7496.89,1,1,7,org.apache.jackrabbit.test.AbstractJCRTest,0.09,33,3,59,0,33,19,0,11,1501,1
"org.apache.jackrabbit.api.security.principal.TestAll",1,0.00,1.00,5,0.04,864.35,1,0,3,3,1,79.51,7,7,0,2,121.80,0.00,0.50,0.00,0,1.00,1,115.51,0,1,1,junit.framework.TestCase,0.00,2,1,1,0,2,0,0,1,31,1
"org.apache.jackrabbit.core.fs.db.DB2FileSystem",2,0.00,1.00,12,0.12,1751.23,2,0,0,2,1,145.09,39,29,0,3,118.80,0.00,0.67,0.00,0,0.00,1,371.78,1,0,1,org.apache.jackrabbit.core.fs.db.DbFileSystem,0.05,0,2,2,0,0,2,0,5,88,1
"org.apache.jackrabbit.core.fs.db.DatabaseFileSystem",44,0.07,3.50,606,7.99,369623.61,71,27,29,124,9,66.03,266,916,3,1,98.26,0.00,0.00,0.10,23,0.00,10,23978.21,0,10,6,java.lang.Object,0.00,80,0,154,5,80,34,1,98,4334,1
"org.apache.jackrabbit.core.fs.db.DatabaseFileSystem$FileOutputStream",2,0.00,2.50,25,0.36,19685.64,2,0,29,19,0,99.09,1,48,0,1,99.09,0.00,0.00,0.00,0,2.00,4,1092.93,0,0,0,java.lang.Object,0.00,17,0,5,0,17,2,0,1,203,0
"org.apache.jackrabbit.core.fs.db.DatabaseFileSystem$FilterInputStream",1,0.00,1.00,4,0.02,218.17,1,0,29,2,0,180.12,1,5,0,1,130.12,0.00,0.00,0.00,0,1.00,1,68.97,1,0,0,java.lang.Object,0.00,1,0,1,0,1,1,0,1,21,0
"org.apache.jackrabbit.core.fs.db.DatabaseFileSystem$RandomAccessOutputStream",6,0.20,1.50,31,0.40,19317.41,7,1,29,22,0,117.21,3,59,0,1,117.21,0.00,0.00,0.83,0,0.00,4,1207.49,0,0,0,java.lang.Object,0.00,16,0,9,0,16,6,0,3,249,0
"org.apache.jackrabbit.core.fs.db.DatabaseFileSystem$SizedInputStream",7,0.08,1.00,22,0.17,2525.52,9,2,29,7,0,133.06,0,30,0,2,133.06,0.00,0.50,0.43,0,0.00,1,501.00,2,0,0,org.apache.jackrabbit.core.fs.db.FilterInputStream,0.00,0,1,7,0,0,7,0,0,132,0
"org.apache.jackrabbit.core.fs.db.DbFileSystem",11,0.02,1.64,33,0.36,16805.67,15,4,4,13,6,78.02,104,52,4,2,128.02,3.00,0.20,0.27,0,29.00,8,1065.63,1,5,2,org.apache.jackrabbit.core.fs.db.DatabaseFileSystem,0.07,2,1,18,3,2,6,0,11,259,1
"org.apache.jackrabbit.core.fs.db.DerbyFileSystem",4,0.00,2.00,28,0.27,7362.38,6,2,5,15,2,103.25,61,39,1,3,113.61,0.00,0.67,0.50,0,0.00,5,815.65,0,0,1,org.apache.jackrabbit.core.fs.db.DbFileSystem,0.00,11,2,8,0,11,4,0,19,170,1
"org.apache.jackrabbit.core.fs.db.DerbyFileSystemTest",4,0.33,1.25,21,0.18,4292.16,5,1,4,10,3,121.01,0,24,0,3,121.01,0.00,0.67,0.75,1,0.00,2,544.48,2,1,3,org.apache.jackrabbit.core.fs.AbstractFileSystemTest,0.75,6,2,5,0,6,3,0,0,130,1
"org.apache.jackrabbit.core.fs.db.JNDIDatabaseFileSystem",3,0.50,1.00,10,0.08,1276.06,4,1,5,6,1,103.12,39,14,0,2,132.50,0.00,0.50,0.67,0,1.00,1,241.45,0,2,1,org.apache.jackrabbit.core.fs.db.DatabaseFileSystem,0.04,3,1,3,0,3,1,0,7,64,1
"org.apache.jackrabbit.core.fs.db.OracleFileSystem",10,0.07,2.90,142,2.21,86874.83,16,6,25,61,7,59.42,123,246,1,3,96.98,0.00,0.67,0.23,0,18.00,8,6620.07,5,4,6,org.apache.jackrabbit.core.fs.db.DbFileSystem,0.14,51,2,29,0,51,6,0,30,1158,1
"org.apache.jackrabbit.core.fs.db.OracleFileSystem$FileOutputStream",2,0.00,3.00,30,0.41,21690.77,2,0,25,19,0,95.10,1,55,0,1,95.10,0.00,0.00,0.00,0,2.00,5,1243.66,0,0,0,java.lang.Object,0.00,17,0,6,0,17,2,0,1,224,0
"org.apache.jackrabbit.core.fs.db.OracleFileSystem$RandomAccessOutputStream",6,0.20,1.67,36,0.45,21239.36,7,1,25,22,0,113.91,3,66,0,1,113.91,0.00,0.00,0.83,0,0.00,5,1355.50,0,0,0,java.lang.Object,0.00,16,0,10,0,16,6,0,3,270,0
"org.apache.jackrabbit.core.xml.BufferedStringValue",12,0.19,2.83,123,1.42,53846.27,21,9,27,47,9,56.59,102,167,2,1,104.70,0.00,0.00,0.29,5,18.00,5,4254.56,0,6,7,java.lang.Object,0.00,35,0,34,0,35,6,1,42,827,0
"org.apache.jackrabbit.core.xml.BufferedStringValue$Base64ReaderInputStream",3,0.71,2.00,29,0.27,5837.17,10,7,27,8,1,109.34,0,36,0,2,109.34,0.00,0.50,0.62,1,0.00,3,816.91,0,0,1,java.io.InputStream,0.00,5,1,6,0,5,3,0,0,176,2
"org.apache.jackrabbit.core.xml.ClonedInputSource",7,0.08,3.43,69,0.75,36907.08,9,2,9,34,6,145.70,17,101,6,2,105.81,0.00,0.50,0.43,0,7.00,7,2261.97,0,1,0,org.xml.sax.InputSource,0.00,27,1,24,0,27,6,0,3,450,1
"org.apache.jackrabbit.core.xml.DocViewImportHandler",9,0.08,3.56,111,1.63,86471.80,12,3,20,48,16,61.53,110,160,1,3,99.09,0.00,0.67,0.26,2,15.00,10,4897.45,0,2,15,org.apache.jackrabbit.core.xml.TargetImportHandler,0.00,39,2,32,0,39,7,0,47,869,0
"org.apache.jackrabbit.core.xml.DocumentViewTest",5,0.00,1.60,38,0.59,13107.29,7,2,18,34,5,64.34,41,61,1,2,112.45,0.00,0.50,0.50,0,0.00,2,1763.55,3,0,4,junit.framework.TestCase,0.00,29,1,8,0,29,5,0,11,335,1
"org.apache.jackrabbit.core.xml.ImportHandler",10,0.05,1.40,45,0.58,11493.46,17,7,13,33,8,82.07,71,71,2,2,124.36,0.00,0.50,0.19,0,38.00,3,1739.64,0,0,6,org.xml.sax.helpers.DefaultHandler,0.00,23,1,14,0,23,10,0,22,390,1
"org.apache.jackrabbit.core.xml.Importer",4,0.00,1.00,5,0.03,147.36,4,0,2,4,8,110.19,40,7,7,1,158.67,0.00,0.00,0.00,0,4.00,1,98.24,0,0,1,,0.00,0,0,4,0,0,4,0,5,35,1
"org.apache.jackrabbit.core.xml.NamespaceContext",4,0.11,2.25,31,0.35,11522.27,7,3,5,12,3,67.92,47,41,2,1,112.05,0.00,0.00,0.25,0,8.00,3,1052.64,0,3,1,java.lang.Object,0.00,8,0,9,0,8,1,1,9,231,0
"org.apache.jackrabbit.core.xml.NodeInfo",5,0.06,1.00,18,0.12,2090.55,9,4,2,5,7,82.56,49,25,5,1,132.56,0.00,0.00,0.20,0,17.00,1,355.50,0,4,2,java.lang.Object,0.00,0,0,5,0,0,1,0,10,99,1
"org.apache.jackrabbit.core.xml.PropInfo",6,0.35,4.00,84,1.24,75749.51,10,4,20,37,17,45.63,56,112,4,1,95.63,0.00,0.00,0.54,2,0.00,8,3705.50,0,1,13,java.lang.Object,0.00,31,0,24,0,31,5,0,31,649,1
"org.apache.jackrabbit.core.xml.SessionImporter",7,0.19,5.29,135,2.10,131230.52,13,6,23,65,11,39.27,67,185,1,1,89.27,0.00,0.00,0.33,0,0.00,14,6293.79,0,2,11,java.lang.Object,0.00,58,0,37,0,58,5,1,44,1067,1
"org.apache.jackrabbit.core.xml.StringValue",4,0.22,1.75,24,0.30,8089.87,7,3,12,12,7,83.59,25,38,1,1,115.81,0.00,0.00,0.50,0,4.00,3,904.01,0,2,6,java.lang.Object,0.00,8,0,7,0,8,2,1,16,191,0
"org.apache.jackrabbit.core.xml.SysViewImportHandler",7,0.17,6.71,131,2.23,144985.55,12,5,16,45,12,41.27,72,195,1,3,89.75,0.00,0.67,0.34,2,8.00,17,6681.90,0,1,11,org.apache.jackrabbit.core.xml.TargetImportHandler,0.00,38,2,47,0,38,6,0,42,1111,0
"org.apache.jackrabbit.core.xml.SysViewImportHandler$ImportState",0,0.00,0.00,7,0.04,499.41,6,6,16,1,1,171.00,18,8,0,1,171.00,0.00,0.00,0.00,0,0.00,0,130.80,0,0,1,java.lang.Object,0.00,1,0,0,0,1,0,0,6,32,0
"org.apache.jackrabbit.core.xml.TargetImportHandler",5,0.06,1.40,22,0.18,2923.57,9,4,7,11,7,84.38,39,32,3,2,126.68,2.00,0.25,0.30,0,1.00,2,548.50,0,0,4,org.xml.sax.helpers.DefaultHandler,0.00,6,1,7,2,6,5,0,6,138,1
"org.apache.jackrabbit.core.xml.TestAll",1,0.00,1.00,5,0.04,864.35,1,0,3,3,1,71.80,9,7,0,2,121.80,0.00,0.50,0.00,0,1.00,1,115.51,0,1,1,junit.framework.TestCase,0.00,2,1,1,0,2,0,0,2,31,1
"org.apache.jackrabbit.core.xml.TextValue",3,0.00,1.00,4,0.03,122.87,3,0,5,3,7,178.92,9,7,5,1,158.30,0.00,0.00,0.00,0,3.00,1,84.58,0,2,2,,0.00,0,0,3,0,0,1,0,2,29,1
"org.apache.jackrabbit.core.xml.WorkspaceImporter",8,0.35,6.38,242,4.03,313053.88,20,12,36,89,24,126.58,184,367,1,1,79.31,0.00,0.00,0.39,2,0.00,16,12103.35,0,1,24,java.lang.Object,0.00,81,0,51,0,81,7,1,114,1926,1
"org.apache.jackrabbit.core.xml.WorkspaceImporterTest",3,0.75,1.67,21,0.38,7743.45,5,2,9,22,2,133.11,9,54,0,2,112.49,0.00,0.50,1.00,0,0.00,3,1141.26,0,0,2,junit.framework.TestCase,0.00,19,1,5,0,19,3,0,2,216,1
"org.apache.jackrabbit.spi.commons.nodetype.AbstractItemDefinitionTemplate",13,0.05,1.00,35,0.22,2332.95,18,5,2,18,2,142.26,58,48,2,1,142.02,0.00,0.00,0.15,0,59.00,1,664.41,0,2,0,java.lang.Object,0.00,5,0,13,2,5,11,1,16,187,1
"org.apache.jackrabbit.spi.commons.nodetype.AbstractNodeType",4,0.33,2.75,33,0.36,17852.83,6,2,7,16,4,60.23,34,43,2,1,108.34,0.00,0.00,0.25,1,6.00,8,1083.34,0,3,2,java.lang.Object,0.00,12,0,11,2,12,1,1,12,211,2
"org.apache.jackrabbit.spi.commons.nodetype.AbstractNodeTypeManager",7,1.00,1.00,16,0.18,2880.31,8,1,12,14,10,139.42,33,29,6,1,139.18,0.00,0.00,0.00,1,7.00,1,554.97,0,6,4,java.lang.Object,0.00,7,0,7,2,7,1,1,10,141,2
"org.apache.jackrabbit.spi.commons.nodetype.InvalidConstraintException",2,0.00,1.00,5,0.03,221.18,2,0,1,2,20,93.68,18,8,20,2,143.68,0.00,0.50,0.00,0,2.00,1,88.69,0,0,0,javax.jcr.RepositoryException,0.00,0,1,2,0,0,2,0,3,29,1
"org.apache.jackrabbit.spi.commons.nodetype.ItemDefinitionImpl",10,0.07,1.60,44,0.37,7190.97,15,5,8,24,6,93.72,65,62,3,1,125.94,0.00,0.00,0.26,0,0.00,3,1124.53,0,2,3,java.lang.Object,0.00,14,0,16,2,14,8,1,21,274,1
"org.apache.jackrabbit.spi.commons.nodetype.NodeDefinitionImpl",7,0.50,2.71,58,0.65,28654.85,8,1,11,13,9,76.42,48,76,2,2,108.64,0.00,0.50,0.57,0,0.00,5,1951.83,0,4,7,org.apache.jackrabbit.spi.commons.nodetype.ItemDefinitionImpl,0.00,6,1,19,0,6,3,1,18,400,1
"org.apache.jackrabbit.spi.commons.nodetype.NodeDefinitionTemplateImpl",10,0.00,1.20,35,0.30,6899.88,14,4,4,15,3,131.04,41,46,2,2,130.81,0.00,0.50,0.25,0,30.00,3,890.24,0,4,1,org.apache.jackrabbit.spi.commons.nodetype.AbstractItemDefinitionTemplate,0.00,5,1,12,0,5,6,1,14,217,0
"org.apache.jackrabbit.spi.commons.nodetype.NodeTypeConflictException",2,0.00,1.00,5,0.03,221.18,2,0,1,2,0,93.68,18,8,0,2,143.68,0.00,0.50,0.00,0,2.00,1,88.69,0,0,0,javax.jcr.RepositoryException,0.00,0,1,2,0,0,2,0,3,29,1
"org.apache.jackrabbit.spi.commons.nodetype.NodeTypeDefDiff",15,0.17,2.93,152,1.77,88588.19,24,9,15,50,8,53.75,142,188,2,1,103.75,0.00,0.00,0.27,3,0.00,7,5318.62,0,4,6,java.lang.Object,0.00,35,0,44,0,35,11,0,32,1044,1
"org.apache.jackrabbit.spi.commons.nodetype.NodeTypeDefDiff$ChildItemDefDiff",7,0.28,2.57,51,0.46,14393.06,10,3,15,15,1,153.05,14,71,0,1,113.17,0.00,0.00,0.57,5,0.00,8,1383.02,0,1,1,java.lang.Object,0.00,8,0,18,0,8,6,0,11,308,1
"org.apache.jackrabbit.spi.commons.nodetype.NodeTypeDefDiff$ChildNodeDefDiff",4,0.00,2.25,22,0.25,9065.64,4,0,15,10,2,158.20,10,32,0,2,118.32,0.00,0.50,0.00,2,10.00,6,738.60,1,2,2,org.apache.jackrabbit.spi.commons.nodetype.ChildItemDefDiff,0.00,6,1,9,0,6,2,0,5,158,1
"org.apache.jackrabbit.spi.commons.nodetype.NodeTypeDefDiff$PropDefDiff",4,0.00,3.50,39,0.47,28682.68,4,0,15,14,2,104.99,17,51,0,2,104.75,0.00,0.50,0.00,2,10.00,11,1403.19,1,2,2,org.apache.jackrabbit.spi.commons.nodetype.ChildItemDefDiff,0.00,10,1,14,0,10,2,0,9,263,1
"org.apache.jackrabbit.spi.commons.nodetype.NodeTypeDefinitionFactory",9,0.12,2.11,90,1.18,35544.90,11,2,24,79,12,105.44,41,105,1,1,105.20,0.00,0.00,0.39,5,22.00,3,3529.13,0,8,11,java.lang.Object,0.00,70,0,19,0,70,1,0,6,696,1
"org.apache.jackrabbit.spi.commons.nodetype.NodeTypeDefinitionImpl",10,0.22,1.70,61,0.60,17619.57,14,4,12,26,8,116.53,43,74,1,1,116.29,0.00,0.00,0.45,0,0.00,3,1805.36,0,5,7,java.lang.Object,0.00,16,0,17,0,16,5,1,16,402,1
"org.apache.jackrabbit.spi.commons.nodetype.NodeTypeTemplateImpl",20,0.01,1.40,78,0.63,13424.83,29,9,8,35,3,151.48,64,106,1,1,130.86,0.00,0.00,0.12,2,240.00,5,1888.09,0,7,2,java.lang.Object,0.00,15,0,28,0,15,13,1,22,442,1
"org.apache.jackrabbit.spi.commons.nodetype.PropertyDefinitionImpl",9,0.38,1.78,50,0.61,25514.68,11,2,12,24,11,99.73,46,66,2,2,117.61,0.00,0.50,0.17,0,0.00,5,1822.78,1,3,9,org.apache.jackrabbit.spi.commons.nodetype.ItemDefinitionImpl,0.00,15,1,16,0,15,6,1,13,378,1
"org.apache.jackrabbit.spi.commons.nodetype.PropertyDefinitionTemplateImpl",16,0.05,1.00,50,0.35,3780.41,23,7,5,24,4,155.13,55,68,2,2,134.51,0.00,0.50,0.19,0,100.00,1,1040.29,0,3,2,org.apache.jackrabbit.spi.commons.nodetype.AbstractItemDefinitionTemplate,0.00,8,1,16,0,8,13,1,19,274,0
"org.apache.jackrabbit.core.util.CooperativeFileLock",14,0.10,2.93,132,1.41,43612.06,26,12,11,46,2,107.88,58,176,0,1,107.65,0.00,0.00,0.18,10,10.00,5,4221.49,0,3,2,java.lang.Object,0.00,32,0,41,0,32,11,1,15,832,1
"org.apache.jackrabbit.core.util.CooperativeFileLock$Runnable",1,0.00,5.00,12,0.13,4390.53,1,0,11,6,0,151.69,1,19,0,1,101.69,0.00,0.00,0.00,0,0.00,5,391.37,0,0,0,java.lang.Object,0.00,5,0,5,0,5,1,0,1,80,0
"org.apache.jackrabbit.core.util.DOMBuilder",8,0.11,1.25,36,0.38,7677.59,12,4,13,26,1,82.72,62,51,1,1,125.01,0.00,0.00,0.34,4,0.00,3,1142.07,0,0,0,java.lang.Object,0.00,18,0,10,0,18,8,0,13,270,2
"org.apache.jackrabbit.core.util.DOMWalker",8,0.10,2.75,71,0.79,26083.43,11,3,12,38,3,60.94,85,90,3,1,109.41,0.00,0.00,0.42,0,0.00,6,2366.57,0,4,0,java.lang.Object,0.00,30,0,22,0,30,4,0,12,489,2
"org.apache.jackrabbit.core.util.DOMWalkerTest",1,0.00,3.00,6,0.07,1426.35,1,0,2,5,1,68.78,8,13,0,2,116.88,0.00,0.50,0.00,0,1.00,3,222.23,0,0,1,junit.framework.TestCase,0.00,4,1,3,0,4,1,0,3,49,1
"org.apache.jackrabbit.core.util.Dumpable",1,0.00,1.00,2,0.01,30.51,1,0,1,1,6,110.52,12,3,6,1,148.08,0.00,0.00,0.00,0,1.00,1,25.51,0,0,0,,0.00,0,0,1,0,0,1,0,2,11,1
"org.apache.jackrabbit.core.util.EmptyLinkedMap",11,0.45,1.00,25,0.16,2052.94,13,2,5,13,1,142.12,48,37,1,2,141.89,0.00,0.50,0.09,0,25.00,1,481.36,0,8,0,org.apache.commons.collections.map.LinkedMap,0.00,2,1,11,0,2,3,0,14,140,1
"org.apache.jackrabbit.core.util.ReferenceChangeTracker",6,0.00,1.00,15,0.14,2555.50,8,2,4,14,5,96.77,45,22,4,1,139.07,0.00,0.00,0.50,0,2.00,1,416.58,0,2,1,java.lang.Object,0.00,8,0,6,0,8,4,0,9,114,1
"org.apache.jackrabbit.core.util.RepositoryLock",7,0.31,3.00,60,0.74,24258.85,14,7,9,30,5,71.62,86,105,4,1,109.19,0.00,0.00,0.41,3,0.00,6,2234.83,0,0,1,java.lang.Object,0.00,23,0,21,0,23,7,1,27,443,1
"org.apache.jackrabbit.core.util.RepositoryLockMechanism",3,0.00,1.00,4,0.02,97.53,3,0,1,3,7,110.99,24,5,7,1,159.09,0.00,0.00,0.00,0,3.00,1,65.02,0,0,0,,0.00,0,0,3,0,0,3,0,4,25,1
"org.apache.jackrabbit.core.util.RepositoryLockMechanismFactory",1,0.00,1.00,2,0.01,38.26,1,0,1,1,3,156.44,17,3,2,1,147.31,0.00,0.00,0.00,0,1.00,1,25.51,0,0,1,,0.00,0,0,1,0,0,1,0,2,11,1
"org.apache.jackrabbit.core.util.RepositoryLockTest",6,0.20,1.67,42,0.41,10991.71,7,1,4,19,2,95.79,34,56,1,2,113.66,0.00,0.50,0.83,1,0.00,3,1242.39,0,0,1,junit.framework.TestCase,0.00,13,1,10,0,13,6,0,8,279,1
"org.apache.jackrabbit.core.util.StringIndex",2,0.00,1.00,3,0.02,87.00,2,0,0,2,7,109.62,21,4,7,1,158.10,0.00,0.00,0.00,0,2.00,1,58.00,0,1,0,,0.00,0,0,2,0,0,1,0,3,21,1
"org.apache.jackrabbit.core.util.TestAll",1,0.00,1.00,5,0.04,864.35,1,0,3,3,1,73.70,8,7,0,2,121.80,0.00,0.50,0.00,0,1.00,1,115.51,0,1,1,junit.framework.TestCase,0.00,2,1,1,0,2,0,0,2,31,1
"org.apache.jackrabbit.client.spilogger.RepositoryConfigImpl",3,0.25,1.67,17,0.22,6915.31,5,2,7,11,8,100.46,15,23,3,2,118.33,0.00,0.50,0.67,0,0.00,2,673.44,0,2,5,org.apache.jackrabbit.client.AbstractRepositoryConfig,0.00,8,1,5,0,8,1,0,2,145,1
"org.apache.jackrabbit.core.nodetype.xml.AdditionalNamespaceResolver",5,0.12,1.80,31,0.32,8555.78,7,2,6,13,5,98.50,27,41,4,1,116.38,0.00,0.00,0.40,1,6.00,2,949.71,0,2,1,java.lang.Object,0.00,8,0,9,0,8,3,1,8,218,1
"org.apache.jackrabbit.core.nodetype.xml.Constants",0,0.00,0.00,37,0.46,5130.13,36,36,0,0,2,171.00,32,38,2,1,171.00,0.00,0.00,0.00,0,0.00,0,1393.14,0,0,0,,0.00,0,0,0,0,0,0,0,30,221,1
"org.apache.jackrabbit.core.nodetype.xml.NodeTypeReader",7,0.23,5.29,141,3.02,218474.90,12,5,34,91,29,42.57,80,213,5,1,86.69,0.00,0.00,0.40,3,4.00,18,9060.37,0,6,24,java.lang.Object,0.00,84,0,37,0,84,1,0,21,1421,1
"org.apache.jackrabbit.core.nodetype.xml.NodeTypeWriter",6,0.33,5.50,130,2.28,130868.67,9,3,25,70,19,49.56,72,193,3,1,87.12,0.00,0.00,0.61,2,0.00,16,6848.56,0,0,16,java.lang.Object,0.00,64,0,33,0,64,6,0,21,1118,2
"org.apache.jackrabbit.core.nodetype.xml.SimpleNamespaceRegistry",7,0.08,1.14,24,0.26,4175.73,9,2,3,15,3,171.20,15,33,2,1,131.31,0.00,0.00,0.57,1,0.00,2,772.48,0,4,1,java.lang.Object,0.00,8,0,8,0,8,3,1,10,201,1
"org.apache.jackrabbit.core.nodetype.xml.TestAll",41,0.07,1.32,247,3.50,65125.96,48,7,28,96,21,156.59,100,414,1,4,116.70,0.00,0.75,0.07,3,405.00,4,10494.59,1,4,20,org.apache.jackrabbit.test.AbstractJCRTest,0.06,55,3,54,0,55,37,0,51,2149,1
"org.apache.jackrabbit.webdav.jcr.version.report.AbstractJcrReport",3,0.25,2.67,21,0.32,12839.56,5,2,9,10,15,78.43,19,30,7,1,110.65,0.00,0.00,0.67,0,0.00,6,951.12,0,2,8,java.lang.Object,0.00,7,0,8,7,7,1,1,5,183,2
"org.apache.jackrabbit.webdav.jcr.version.report.ExportViewReport",4,0.00,3.00,39,0.67,24041.24,8,4,24,28,11,67.83,49,54,1,2,105.39,0.00,0.50,0.25,0,6.00,7,2008.53,3,2,10,org.apache.jackrabbit.webdav.jcr.version.report.AbstractJcrReport,0.00,24,1,12,0,24,2,0,13,364,1
"org.apache.jackrabbit.webdav.jcr.version.report.JcrPrivilegeReport",5,0.00,1.80,36,0.58,16461.57,10,5,22,31,17,79.42,34,48,2,2,111.64,0.00,0.50,0.20,1,10.00,4,1744.97,2,2,15,org.apache.jackrabbit.webdav.jcr.version.report.AbstractJcrReport,0.00,26,1,9,0,26,3,0,12,335,1
"org.apache.jackrabbit.webdav.jcr.version.report.LocateByUuidReport",4,0.08,1.50,25,0.42,11679.18,8,4,18,26,16,64.59,38,33,3,2,114.59,0.00,0.50,0.19,0,6.00,3,1264.01,2,2,13,org.apache.jackrabbit.webdav.jcr.version.report.AbstractJcrReport,0.00,22,1,6,0,22,2,0,9,238,1
"org.apache.jackrabbit.webdav.jcr.version.report.LocateCorrespondingNodeReport",5,0.19,1.80,34,0.56,16256.85,9,4,21,28,15,70.05,56,45,1,2,114.18,0.00,0.50,0.10,0,11.00,3,1675.53,1,3,14,org.apache.jackrabbit.webdav.jcr.version.report.AbstractJcrReport,0.00,23,1,9,0,23,2,0,10,323,1
"org.apache.jackrabbit.webdav.jcr.version.report.NodeTypesReport",5,0.17,4.00,71,1.12,50316.99,8,3,26,46,15,67.03,65,82,2,2,96.41,0.00,0.50,0.20,0,13.00,8,3372.07,2,3,13,org.apache.jackrabbit.webdav.jcr.version.report.AbstractJcrReport,0.00,41,1,20,0,41,2,1,23,586,1
"org.apache.jackrabbit.webdav.jcr.version.report.RegisteredNamespacesReport",4,0.00,1.75,26,0.33,9629.00,7,3,14,15,11,71.09,46,33,2,2,115.22,0.00,0.50,0.33,0,6.00,3,1003.83,1,2,9,org.apache.jackrabbit.webdav.jcr.version.report.AbstractJcrReport,0.00,11,1,7,0,11,2,1,8,205,1
"org.apache.jackrabbit.webdav.jcr.version.report.RepositoryDescriptorsReport",4,0.50,1.25,21,0.26,6975.76,6,2,12,11,10,75.22,45,24,2,2,119.35,0.00,0.50,0.12,0,8.00,2,783.79,2,2,8,org.apache.jackrabbit.webdav.jcr.version.report.AbstractJcrReport,0.00,7,1,5,0,7,2,1,7,167,1
"org.apache.jackrabbit.api.JackrabbitNodeTypeManager",3,2.00,1.00,6,0.06,429.53,5,2,7,3,6,122.65,42,9,6,2,142.79,0.00,0.50,0.00,0,3.00,1,170.55,0,2,0,,0.00,0,1,3,0,0,1,0,6,49,1
"org.apache.jackrabbit.api.JackrabbitRepository",1,0.00,1.00,2,0.01,44.19,1,0,1,1,7,126.67,14,3,7,2,146.81,0.00,0.50,0.00,0,1.00,1,26.09,0,0,0,,0.00,0,1,1,0,0,1,0,2,11,1
"org.apache.jackrabbit.api.JackrabbitSession",2,0.00,1.00,3,0.02,108.19,2,0,6,2,12,119.79,25,4,10,2,157.35,0.00,0.50,0.00,0,2.00,1,66.09,0,2,2,,0.00,0,1,2,0,0,0,0,3,23,1
"org.apache.jackrabbit.api.JackrabbitValue",1,0.00,1.00,2,0.01,48.43,1,0,1,1,2,178.41,31,3,2,2,146.50,0.00,0.50,0.00,0,1.00,1,27.12,0,1,0,,0.00,0,1,1,0,0,0,0,2,11,1
"org.apache.jackrabbit.api.JackrabbitWorkspace",2,0.00,1.00,3,0.03,136.06,2,0,4,2,2,127.19,26,6,2,2,156.57,0.00,0.50,0.00,0,2.00,1,84.68,0,0,0,,0.00,0,1,2,0,0,2,0,3,27,1
"org.apache.jackrabbit.api.XASession",1,0.00,1.00,2,0.01,44.19,1,0,2,1,6,180.20,20,3,6,2,146.81,0.00,0.50,0.00,0,1.00,1,26.09,0,1,0,,0.00,0,1,1,0,0,0,0,2,11,1
"org.apache.jackrabbit.server.io.AbstractExportContext",9,0.02,1.33,29,0.26,5015.01,15,6,3,12,9,131.51,4,42,4,1,131.51,0.00,0.00,0.15,0,53.00,3,768.97,0,2,5,java.lang.Object,0.00,3,0,12,3,3,7,1,1,188,2
"org.apache.jackrabbit.server.io.BoundedInputStream",14,0.14,1.50,54,0.52,15774.65,19,5,2,23,2,129.31,57,74,2,2,129.08,0.00,0.50,0.33,1,0.00,4,1553.34,0,1,0,java.io.InputStream,0.00,9,1,21,0,9,13,0,19,368,1
"org.apache.jackrabbit.server.io.DefaultHandler",34,0.16,2.91,274,3.96,164860.54,39,5,26,136,21,65.75,267,397,5,1,108.04,0.00,0.00,0.05,14,266.00,10,11894.33,0,10,16,java.lang.Object,0.00,102,0,99,3,102,24,2,79,2270,1
"org.apache.jackrabbit.server.io.DefaultIOListener",4,0.00,1.50,11,0.17,2386.13,6,2,2,8,8,138.06,16,16,5,1,137.82,0.00,0.00,0.50,0,0.00,2,498.31,0,0,3,java.lang.Object,0.00,4,0,6,0,4,4,1,5,119,1
"org.apache.jackrabbit.server.io.DefaultIOManager",2,1.00,1.00,11,0.09,1420.98,3,1,2,9,8,73.99,20,14,1,2,122.47,0.00,0.50,0.00,1,2.00,1,281.72,1,0,7,org.apache.jackrabbit.server.io.IOManagerImpl,0.00,7,1,2,0,7,2,0,3,74,1
"org.apache.jackrabbit.server.io.DirListingExportHandler",17,0.44,1.71,127,1.81,88561.37,19,2,15,51,11,110.32,82,159,1,1,110.08,0.00,0.00,0.09,2,58.00,7,5432.55,0,3,10,java.lang.Object,0.00,34,0,29,0,34,14,2,27,947,1
"org.apache.jackrabbit.server.io.ExportContext",10,0.00,1.00,11,0.07,327.85,10,0,2,10,13,141.19,57,12,12,2,159.06,0.00,0.50,0.00,0,10.00,1,202.60,0,2,1,,0.00,0,1,10,0,0,8,0,11,74,1
"org.apache.jackrabbit.server.io.ExportContextImpl",11,0.06,2.45,64,0.80,21836.39,16,5,15,37,7,100.88,61,95,1,2,118.75,0.00,0.50,0.25,0,0.00,11,2400.68,2,1,6,org.apache.jackrabbit.server.io.AbstractExportContext,0.10,26,1,27,0,26,10,0,22,486,1
"org.apache.jackrabbit.server.io.IOContext",4,0.00,1.00,5,0.02,93.72,4,0,0,4,2,142.34,23,6,2,1,160.21,0.00,0.00,0.00,0,4.00,1,62.48,0,1,1,,0.00,0,0,4,0,0,3,0,5,26,1
"org.apache.jackrabbit.server.io.IOHandler",11,0.00,1.00,12,0.10,581.83,11,0,2,11,12,119.87,136,13,9,1,157.43,0.00,0.00,0.00,0,11.00,1,311.12,0,2,4,,0.00,0,0,11,0,0,9,0,12,101,1
"org.apache.jackrabbit.server.io.IOListener",3,0.00,1.00,4,0.04,168.96,3,0,0,3,8,109.11,25,5,7,1,157.21,0.00,0.00,0.00,0,3.00,1,112.64,0,0,2,,0.00,0,0,3,0,0,3,0,4,35,1
"org.apache.jackrabbit.server.io.IOManager",6,0.00,1.00,7,0.06,395.24,6,0,2,6,13,112.55,67,8,10,1,156.68,0.00,0.00,0.00,0,6.00,1,192.35,0,0,4,,0.00,0,0,6,0,0,6,0,7,61,1
"org.apache.jackrabbit.server.io.IOManagerImpl",7,0.08,3.43,83,0.99,54846.69,9,2,6,25,8,101.44,30,96,1,1,101.21,0.00,0.00,0.43,1,9.00,5,2983.60,0,1,7,java.lang.Object,0.00,18,0,24,1,18,6,1,8,567,1
"org.apache.jackrabbit.server.io.IOUtil",8,4.00,2.50,62,0.77,29270.11,12,4,12,26,16,62.73,83,81,13,1,111.20,0.00,0.00,0.00,0,8.00,3,2298.55,0,7,3,java.lang.Object,0.00,18,0,20,0,18,1,0,20,481,1
"org.apache.jackrabbit.server.io.ImportContext",10,0.00,1.00,11,0.05,223.94,10,0,2,10,13,128.15,63,12,12,2,160.37,0.00,0.50,0.00,0,10.00,1,138.09,0,7,1,,0.00,0,1,10,0,0,3,0,11,58,1
"org.apache.jackrabbit.server.io.ImportContextImpl",20,0.01,1.85,77,0.79,19451.93,28,8,9,40,8,111.66,115,111,2,1,129.53,0.00,0.00,0.12,3,224.00,4,2356.19,0,8,6,java.lang.Object,0.00,20,0,37,1,20,12,1,22,553,1
"org.apache.jackrabbit.server.io.MimeResolver",5,0.00,1.80,22,0.23,4565.93,7,2,3,18,8,76.99,40,33,7,1,125.09,0.00,0.00,0.50,0,1.00,3,682.89,0,2,1,java.lang.Object,0.00,13,0,9,0,13,3,0,12,162,1
"org.apache.jackrabbit.server.io.PropertyExportContext",0,0.00,0.00,1,0.01,31.02,0,0,0,0,9,171.00,5,2,9,2,171.00,0.00,0.50,0.00,0,0.00,0,15.51,0,0,0,,0.00,0,1,0,0,0,0,0,1,6,1
"org.apache.jackrabbit.server.io.PropertyHandler",4,0.00,1.00,5,0.05,270.57,4,0,2,4,8,127.21,52,6,6,1,156.59,0.00,0.00,0.00,0,4.00,1,136.59,0,1,2,,0.00,0,0,4,0,0,3,0,5,44,1
"org.apache.jackrabbit.server.io.PropertyImportContext",2,0.00,1.00,3,0.01,65.85,2,0,2,2,9,110.94,17,4,9,2,159.05,0.00,0.50,0.00,0,2.00,1,38.73,0,2,0,,0.00,0,1,2,0,0,0,0,3,16,1
"org.apache.jackrabbit.server.io.PropertyManager",4,0.00,1.00,5,0.04,233.87,4,0,2,4,5,124.86,25,6,2,1,157.09,0.00,0.00,0.00,0,4.00,1,117.76,0,2,3,,0.00,0,0,4,0,0,2,0,5,39,1
"org.apache.jackrabbit.server.io.PropertyManagerImpl",6,0.20,2.17,45,0.49,19241.28,9,3,7,26,9,111.92,26,53,2,1,111.69,0.00,0.00,0.17,1,14.00,4,1473.17,0,2,7,java.lang.Object,0.00,20,0,13,0,20,4,1,7,309,1
"org.apache.jackrabbit.server.io.VersionHandler",12,1.00,1.42,40,0.40,8339.32,13,1,9,17,10,170.63,31,59,1,2,130.74,0.00,0.50,0.00,2,12.00,3,1188.62,0,2,9,org.apache.jackrabbit.server.io.DefaultHandler,0.22,5,1,17,0,5,10,1,15,282,1
"org.apache.jackrabbit.server.io.VersionHistoryHandler",18,0.50,1.28,54,0.48,7570.50,20,2,8,26,10,132.48,9,78,1,1,132.48,0.00,0.00,0.03,2,34.00,2,1425.86,0,3,9,java.lang.Object,0.00,8,0,23,0,8,15,2,7,357,1
"org.apache.jackrabbit.server.io.XmlHandler",10,0.44,2.00,50,0.70,16376.13,12,2,10,37,7,87.23,68,80,2,2,119.46,0.00,0.50,0.10,0,22.00,4,2110.22,5,0,5,org.apache.jackrabbit.server.io.DefaultHandler,0.05,27,1,20,0,27,10,0,20,445,1
"org.apache.jackrabbit.server.io.ZipHandler",11,0.20,2.64,95,1.32,47134.01,14,3,15,60,10,60.01,110,124,2,2,108.49,0.00,0.50,0.15,1,39.00,6,3955.44,5,1,8,org.apache.jackrabbit.server.io.DefaultHandler,0.04,49,1,29,0,49,10,0,27,761,1
"org.apache.jackrabbit.server.io.ZipHandler$ZipEntryExportContext",9,0.25,1.56,24,0.26,5038.34,11,2,15,18,2,188.03,11,39,0,2,138.03,0.00,0.50,0.28,0,20.00,3,767.11,0,1,2,org.apache.jackrabbit.server.io.AbstractExportContext,0.00,9,1,14,0,9,8,0,6,185,1
"org.apache.jackrabbit.server.io.ZipHandler$ZipEntryImportContext",4,0.00,1.00,14,0.18,2467.12,6,2,15,13,5,131.23,0,19,0,2,131.23,0.00,0.50,0.50,0,4.00,1,527.91,0,1,5,org.apache.jackrabbit.server.io.ImportContextImpl,0.25,9,1,4,0,9,3,0,0,120,1
"org.apache.jackrabbit.core.query.lucene.directory.DirectoryManager",7,0.00,1.00,8,0.05,212.76,7,0,3,7,12,111.22,57,9,12,1,159.32,0.00,0.00,0.00,0,7.00,1,147.62,0,2,1,,0.00,0,0,7,0,0,5,0,8,54,1
"org.apache.jackrabbit.core.query.lucene.directory.DirectoryManagerTest",6,0.10,1.17,30,0.31,5882.00,10,4,7,18,5,121.34,4,39,1,2,121.34,0.00,0.50,0.17,1,10.00,2,941.39,0,0,4,junit.framework.TestCase,0.00,12,1,7,0,12,6,0,1,216,1
"org.apache.jackrabbit.core.query.lucene.directory.DirectoryManagerTest$Callable",1,0.00,1.00,5,0.05,626.53,1,0,7,5,1,122.90,0,6,0,1,122.90,0.00,0.00,0.00,0,0.00,1,139.69,0,0,1,java.lang.Object,0.00,4,0,1,0,4,1,0,0,35,0
"org.apache.jackrabbit.core.query.lucene.directory.DirectoryManagerTest$Callable_0",1,0.00,1.00,5,0.05,582.76,1,0,7,6,1,123.15,0,6,0,1,123.15,0.00,0.00,0.00,0,0.00,1,138.80,0,0,1,java.lang.Object,0.00,5,0,1,0,5,1,0,0,36,0
"org.apache.jackrabbit.core.query.lucene.directory.DirectoryManagerTest$Callable_1",1,0.00,1.00,4,0.05,529.59,1,0,7,7,1,127.09,0,5,0,1,127.09,0.00,0.00,0.00,0,0.00,1,148.18,0,0,1,java.lang.Object,0.00,6,0,1,0,6,1,0,0,37,0
"org.apache.jackrabbit.core.query.lucene.directory.DirectoryManagerTest$Callable_2",1,0.00,1.00,6,0.06,856.03,1,0,7,7,1,118.88,0,7,0,1,118.88,0.00,0.00,0.00,0,0.00,1,182.17,0,0,1,java.lang.Object,0.00,6,0,1,0,6,1,0,0,45,0
"org.apache.jackrabbit.core.query.lucene.directory.DirectoryManagerTest$Callable_3",1,0.00,1.00,2,0.01,69.06,1,0,7,1,1,145.29,0,3,0,1,145.29,0.00,0.00,0.00,0,1.00,1,36.53,0,0,1,,0.00,0,0,1,0,0,1,0,0,13,1
"org.apache.jackrabbit.core.query.lucene.directory.FSDirectoryManager",7,0.17,1.71,36,0.36,9855.31,8,1,7,20,3,120.24,31,46,2,1,120.01,0.00,0.00,0.86,0,0.00,4,1065.70,0,2,2,java.lang.Object,0.00,13,0,12,0,13,5,1,12,245,1
"org.apache.jackrabbit.core.query.lucene.directory.FSDirectoryManager$FileFilter",1,0.00,1.00,3,0.02,173.90,1,0,7,2,0,135.56,0,4,0,1,135.56,0.00,0.00,0.00,0,1.00,1,52.97,0,0,0,java.lang.Object,0.00,1,0,1,0,1,1,0,0,17,0
"org.apache.jackrabbit.core.query.lucene.directory.IndexInputStream",4,0.11,1.50,22,0.22,7140.23,7,3,3,8,4,76.94,31,29,4,2,119.23,0.00,0.50,0.25,1,4.00,2,667.15,0,0,0,java.io.InputStream,0.00,4,1,6,0,4,4,0,9,155,1
"org.apache.jackrabbit.core.query.lucene.directory.IndexInputStreamTest",2,0.00,2.50,31,0.36,17615.65,2,0,8,13,2,135.74,4,34,1,2,95.85,0.00,0.50,0.00,1,2.00,4,1070.39,0,0,1,junit.framework.TestCase,0.00,11,1,5,0,11,2,0,2,205,1
"org.apache.jackrabbit.core.query.lucene.directory.IndexOutputStream",5,0.50,1.00,14,0.15,2257.88,6,1,3,10,3,106.64,32,21,3,2,138.87,0.00,0.50,0.60,1,2.00,1,436.27,0,0,0,java.io.OutputStream,0.00,5,1,5,0,5,5,0,7,113,1
"org.apache.jackrabbit.core.query.lucene.directory.IndexOutputStreamTest",2,0.00,3.00,37,0.40,21204.94,2,0,8,16,2,132.11,5,38,1,2,92.22,0.00,0.50,0.00,1,2.00,5,1189.26,0,0,1,junit.framework.TestCase,0.00,14,1,6,0,14,2,0,3,225,1
"org.apache.jackrabbit.core.query.lucene.directory.RAMDirectoryManager",7,0.33,1.43,30,0.28,6394.32,8,1,6,16,3,125.38,28,47,1,1,125.14,0.00,0.00,0.71,0,0.00,3,833.72,0,2,2,java.lang.Object,0.00,9,0,10,0,9,5,1,9,200,1
"org.apache.jackrabbit.core.query.lucene.directory.TestAll",1,0.00,1.00,7,0.06,1740.69,1,0,3,3,3,65.48,10,9,0,2,113.96,0.00,0.50,0.00,0,1.00,1,186.48,0,1,3,junit.framework.TestCase,0.00,2,1,1,0,2,0,0,2,47,1
"org.apache.jackrabbit.webdav.io.InputContext",7,0.00,1.00,8,0.03,152.68,7,0,1,7,11,128.24,42,9,11,1,160.46,0.00,0.00,0.00,0,7.00,1,95.75,0,4,0,,0.00,0,0,7,0,0,3,0,8,41,1
"org.apache.jackrabbit.webdav.io.InputContextImpl",8,0.10,1.12,24,0.21,3268.16,11,3,6,15,3,182.61,14,34,1,1,132.61,0.00,0.00,0.25,0,16.00,2,633.69,0,4,2,java.lang.Object,0.00,7,0,9,0,7,4,1,3,162,1
"org.apache.jackrabbit.webdav.io.OutputContext",8,0.00,1.00,9,0.05,242.82,8,0,1,8,11,141.46,44,10,11,1,159.33,0.00,0.00,0.00,0,8.00,1,156.48,0,1,0,,0.00,0,0,8,0,0,7,0,9,58,1
"org.apache.jackrabbit.webdav.io.OutputContextImpl",9,0.04,1.89,34,0.32,5648.77,12,3,5,17,4,131.02,4,52,2,1,131.02,0.00,0.00,0.30,0,1.00,3,971.05,0,1,2,java.lang.Object,0.00,8,0,17,0,8,8,1,2,237,1
"org.apache.jackrabbit.webdav.io.OutputContextImplTest",1,0.00,1.00,12,0.13,3427.25,1,0,7,4,3,123.52,3,14,1,2,102.91,0.00,0.50,0.00,0,1.00,1,388.10,0,0,2,junit.framework.TestCase,0.00,3,1,1,0,3,1,0,1,86,1
"org.apache.jackrabbit.webdav.io.OutputContextImplTest$DummyResponse",2,0.00,1.00,5,0.05,445.57,2,0,7,4,0,141.28,0,7,0,1,141.28,0.00,0.00,0.00,0,2.00,1,136.97,0,0,0,java.lang.Object,0.00,2,0,2,0,2,2,0,0,38,0
"org.apache.jackrabbit.webdav.io.OutputContextImplTest$DummyResponse_0",30,0.00,1.00,42,0.26,1720.12,30,0,7,30,0,157.15,0,73,0,1,157.15,0.00,0.00,0.00,0,30.00,1,794.65,0,8,0,java.lang.Object,0.00,0,0,30,0,0,22,1,0,260,2
"org.apache.jackrabbit.webdav.io.TestAll",1,0.00,1.00,5,0.04,864.35,1,0,3,3,1,121.80,0,7,0,2,121.80,0.00,0.50,0.00,0,1.00,1,115.51,0,1,1,junit.framework.TestCase,0.00,2,1,1,0,2,0,0,0,31,1
"org.apache.jackrabbit.core.query.lucene.hits.AdaptingHits",6,0.17,2.00,38,0.38,17865.63,12,6,3,15,6,96.59,34,53,3,1,114.46,0.00,0.00,0.31,0,0.00,7,1153.97,0,1,3,java.lang.Object,0.00,9,0,12,0,9,5,1,11,241,1
"org.apache.jackrabbit.core.query.lucene.hits.ArrayHits",6,0.40,2.00,41,0.33,9827.58,10,4,1,9,3,156.39,17,52,2,1,116.50,0.00,0.00,0.58,2,0.00,3,1001.97,0,0,1,java.lang.Object,0.00,3,0,12,0,3,6,1,4,228,1
"org.apache.jackrabbit.core.query.lucene.hits.ArrayHitsTest",1,0.00,1.00,6,0.06,1011.06,1,0,1,5,2,118.31,0,8,1,2,118.31,0.00,0.50,0.00,0,1.00,1,169.24,0,0,1,junit.framework.TestCase,0.00,4,1,1,0,4,1,0,0,41,1
"org.apache.jackrabbit.core.query.lucene.hits.BitSetHits",4,0.33,1.00,15,0.10,1251.29,6,2,1,7,2,154.17,14,20,1,1,133.55,0.00,0.00,0.75,1,0.00,1,290.73,0,0,1,java.lang.Object,0.00,3,0,4,0,3,4,1,4,81,1
"org.apache.jackrabbit.core.query.lucene.hits.Hits",3,0.00,1.00,4,0.02,95.88,3,0,1,3,12,141.28,17,5,12,1,159.15,0.00,0.00,0.00,0,3.00,1,63.48,0,0,0,,0.00,0,0,3,0,0,3,0,4,25,1
"org.apache.jackrabbit.core.query.lucene.hits.HitsIntersection",4,0.33,2.00,31,0.28,16792.68,8,4,1,7,1,131.40,12,40,0,1,110.79,0.00,0.00,0.50,1,4.00,4,850.41,0,0,1,java.lang.Object,0.00,3,0,8,0,3,4,1,4,195,1
"org.apache.jackrabbit.core.query.lucene.hits.ScorerHits",4,0.67,1.50,16,0.12,2073.91,5,1,2,8,5,147.69,12,23,4,1,127.07,0.00,0.00,0.50,0,4.00,2,345.43,0,0,1,java.lang.Object,0.00,4,0,6,0,4,4,1,4,91,1
"org.apache.jackrabbit.spi.commons.query.sql.ASTContainsExpression",7,0.42,1.00,17,0.11,1129.61,9,2,1,8,4,142.38,3,25,2,2,142.38,0.00,0.50,0.14,0,17.00,1,331.40,0,3,2,SimpleNode,0.00,1,1,7,0,1,4,0,1,98,1
"org.apache.jackrabbit.spi.commons.query.sql.ASTIdentifier",6,0.80,1.00,14,0.10,1044.12,7,1,1,7,8,142.13,1,21,6,2,142.13,0.00,0.50,0.33,0,10.00,1,295.38,1,3,2,SimpleNode,0.08,1,1,6,0,1,3,0,1,87,1
"org.apache.jackrabbit.spi.commons.query.sql.ASTLiteral",8,0.29,1.00,19,0.13,1418.97,10,2,0,9,4,142.06,3,28,3,2,142.06,0.00,0.50,0.25,0,18.00,1,403.74,1,3,1,SimpleNode,0.14,1,1,8,0,1,5,0,1,117,1
"org.apache.jackrabbit.spi.commons.query.sql.ASTPredicate",14,0.12,1.00,34,0.24,2461.65,19,5,1,15,4,142.09,1,49,2,2,142.09,0.00,0.50,0.09,0,70.00,1,709.22,1,5,2,SimpleNode,0.06,1,1,14,0,1,9,0,1,199,1
"org.apache.jackrabbit.spi.commons.query.sql.DefaultParserVisitor",20,0.00,1.00,41,0.27,2807.83,20,0,0,20,6,142.86,4,62,1,1,142.86,0.00,0.00,0.00,0,20.00,1,808.87,0,20,5,java.lang.Object,0.00,0,0,20,0,0,0,1,1,245,0
"org.apache.jackrabbit.spi.commons.query.sql.JCRSQLQueryBuilder",27,0.02,3.52,372,5.43,429324.69,37,10,40,154,34,63.85,163,471,2,1,96.07,0.00,0.00,0.09,3,149.00,16,16294.49,0,25,32,java.lang.Object,0.00,127,0,95,0,127,2,1,63,2814,1
"org.apache.jackrabbit.spi.commons.query.sql.JCRSQLQueryBuilder$DefaultParserVisitor",2,0.00,1.00,7,0.07,753.53,2,0,40,5,3,132.92,0,9,0,1,132.92,0.00,0.00,0.00,0,0.00,1,206.90,0,2,3,java.lang.Object,0.00,3,0,2,0,3,0,0,0,53,0
"org.apache.jackrabbit.spi.commons.query.sql.JCRSQLQueryBuilder$DefaultParserVisitor_0",1,0.00,2.00,5,0.05,958.23,1,0,40,3,2,171.29,1,7,0,1,121.29,0.00,0.00,0.00,0,0.00,2,148.18,0,1,2,java.lang.Object,0.00,2,0,2,0,2,0,0,1,37,0
"org.apache.jackrabbit.spi.commons.query.sql.JCRSQLQueryBuilder$DefaultParserVisitor_1",5,0.00,2.20,25,0.25,7597.13,5,0,40,8,3,119.69,0,34,0,1,119.69,0.00,0.00,0.00,1,5.00,5,740.78,0,4,3,java.lang.Object,0.00,3,0,11,0,3,1,0,0,174,0
"org.apache.jackrabbit.spi.commons.query.sql.JCRSQLQueryBuilder$DefaultParserVisitor_2",1,0.00,1.00,4,0.03,474.00,1,0,40,2,1,127.47,0,5,0,1,127.47,0.00,0.00,0.00,0,1.00,1,92.00,0,1,1,java.lang.Object,0.00,1,0,1,0,1,0,0,0,25,0
"org.apache.jackrabbit.spi.commons.query.sql.JCRSQLQueryBuilder$MergingPathQueryNode",5,0.75,6.00,101,1.46,155703.10,6,1,40,26,4,49.11,63,115,0,4,86.67,0.00,0.75,0.40,2,6.00,13,4389.43,0,3,4,org.apache.jackrabbit.spi.commons.query.PathQueryNode,0.00,21,3,30,0,21,2,0,15,766,2
"org.apache.jackrabbit.spi.commons.query.sql.QueryBuilder",4,0.00,1.00,9,0.10,1268.78,4,0,6,7,5,140.31,16,18,0,1,140.07,0.00,0.00,0.00,0,4.00,1,294.46,0,3,5,java.lang.Object,0.00,3,0,4,0,3,1,1,5,78,1
"org.apache.jackrabbit.spi.commons.query.sql.QueryFormat",20,0.01,5.00,373,5.38,445070.25,24,4,29,88,23,110.19,77,442,2,1,89.57,0.00,0.00,0.26,4,30.00,16,16127.67,0,15,21,java.lang.Object,0.00,68,0,100,0,68,5,2,27,2803,0
"org.apache.jackrabbit.commons.repository.EmptyRepository",6,0.00,1.00,13,0.09,857.88,6,0,5,7,1,100.51,42,21,0,2,142.80,0.00,0.50,0.00,0,6.00,1,257.98,0,5,1,org.apache.jackrabbit.commons.AbstractRepository,0.00,1,1,6,0,1,1,0,7,76,1
"org.apache.jackrabbit.commons.repository.JNDIRepository",1,0.00,1.00,3,0.02,215.39,1,0,1,2,2,124.47,15,5,0,3,134.83,0.00,0.67,0.00,0,1.00,1,72.87,0,0,2,org.apache.jackrabbit.commons.repository.ProxyRepository,0.00,1,2,1,0,1,1,0,2,22,1
"org.apache.jackrabbit.commons.repository.JNDIRepositoryFactory",2,0.00,2.50,16,0.19,6983.23,4,2,4,6,2,65.07,23,29,1,1,109.20,0.00,0.00,0.50,0,2.00,4,558.91,0,1,1,java.lang.Object,0.00,4,0,5,0,4,1,1,5,120,1
"org.apache.jackrabbit.commons.repository.ProxyRepository",7,0.17,1.71,26,0.24,3786.35,8,1,5,14,5,81.56,65,45,3,2,131.56,2.00,0.25,0.86,0,0.00,2,729.31,0,5,2,org.apache.jackrabbit.commons.AbstractRepository,0.00,7,1,12,2,7,2,0,9,183,1
"org.apache.jackrabbit.commons.repository.RepositoryFactory",1,0.00,1.00,2,0.01,38.26,1,0,2,1,7,103.18,11,3,7,1,147.31,0.00,0.00,0.00,0,1.00,1,25.51,0,1,0,,0.00,0,0,1,0,0,0,0,2,11,1
"org.apache.jackrabbit.commons.repository.SingletonRepositoryFactory",2,1.00,1.00,6,0.04,384.68,3,1,1,2,1,87.11,16,9,0,1,135.22,0.00,0.00,0.50,0,2.00,1,105.38,0,1,1,java.lang.Object,0.00,0,0,2,0,0,1,1,4,32,1
"org.apache.jackrabbit.uuid.Constants",0,0.00,0.00,33,0.42,8853.20,32,32,0,1,7,171.00,114,34,7,1,171.00,0.00,0.00,0.00,0,0.00,0,1267.81,0,0,0,,0.00,1,0,0,0,1,0,0,39,209,1
"org.apache.jackrabbit.uuid.UUID",13,0.17,2.38,117,1.70,104450.25,17,4,3,22,99,62.16,100,153,98,1,104.45,0.00,0.00,0.40,0,0.00,9,5114.45,0,3,2,java.lang.Object,0.00,9,0,31,0,9,10,3,20,998,1
"org.apache.jackrabbit.uuid.VersionFourGenerator",6,0.03,2.50,56,0.55,23765.71,12,6,2,17,4,96.51,92,71,3,1,106.86,0.00,0.00,0.19,2,10.00,8,1637.08,0,3,2,java.lang.Object,0.00,11,0,15,0,11,3,1,28,331,2
"org.apache.jackrabbit.uuid.VersionFourGenerator$Thread",1,0.00,1.00,5,0.04,441.18,1,0,2,1,0,163.99,2,6,0,1,124.10,0.00,0.00,0.00,0,0.00,1,110.19,0,0,0,java.lang.Object,0.00,0,0,1,0,0,1,0,2,29,0
"org.apache.jackrabbit.spi.CredentialsWrapper",3,0.00,1.67,19,0.18,4761.26,6,3,5,9,2,166.65,4,24,2,1,116.65,0.00,0.00,0.33,0,2.00,3,545.38,0,2,0,java.lang.Object,0.00,6,0,5,0,6,1,0,2,124,0
"org.apache.jackrabbit.spi.EventImpl",3,0.25,2.33,33,0.69,30300.36,5,2,22,20,16,140.31,6,62,1,2,100.43,0.00,0.50,0.33,1,5.00,5,2063.76,0,1,15,org.apache.jackrabbit.spi.commons.EventImpl,0.00,17,1,7,0,17,2,1,4,390,1
"org.apache.jackrabbit.spi.EventSubscriptionImpl",3,0.25,1.00,10,0.06,706.08,5,2,1,3,3,116.65,15,14,1,1,134.53,0.00,0.00,0.33,0,5.00,1,177.61,0,1,2,java.lang.Object,0.00,0,0,3,0,0,2,1,5,52,1
"org.apache.jackrabbit.spi.ExceptionConverter",3,1.00,4.67,36,0.73,61553.48,4,1,17,23,13,136.32,8,53,6,1,96.43,0.00,0.00,0.00,1,3.00,12,2183.87,0,2,7,java.lang.Object,0.00,20,0,14,0,20,1,0,6,357,1
"org.apache.jackrabbit.spi.IdURICache",9,0.16,1.44,38,0.42,8399.53,13,4,5,21,2,125.07,3,52,1,1,125.07,0.00,0.00,0.39,1,0.00,2,1266.31,0,3,1,java.lang.Object,0.00,12,0,13,0,12,6,0,1,294,0
"org.apache.jackrabbit.spi.ItemInfoImpl",3,0.25,1.00,11,0.12,1546.61,5,2,10,8,9,171.73,6,15,2,1,131.84,0.00,0.00,0.33,0,1.00,1,352.71,0,1,7,java.lang.Object,0.00,5,0,3,2,5,2,1,2,85,1
"org.apache.jackrabbit.spi.LockInfoImpl",9,0.04,1.22,24,0.21,3149.99,12,3,7,15,6,139.69,4,34,1,1,139.69,0.00,0.00,0.30,1,0.00,2,619.86,0,4,5,java.lang.Object,0.00,6,0,11,0,6,5,1,2,163,1
"org.apache.jackrabbit.spi.NamespaceResolverImpl",5,0.17,1.40,22,0.22,5695.68,8,3,8,12,4,164.28,11,30,2,2,124.39,0.00,0.50,0.47,0,0.00,2,674.51,0,3,2,org.apache.jackrabbit.spi.commons.namespace.AbstractNamespaceResolver,0.00,7,1,7,0,7,2,0,5,164,0
"org.apache.jackrabbit.spi.NodeInfoImpl",12,0.01,1.67,63,0.81,37197.14,20,8,19,33,15,117.32,8,85,2,2,117.32,0.00,0.50,0.14,0,98.00,7,2431.40,0,6,13,org.apache.jackrabbit.spi2dav.ItemInfoImpl,0.00,21,1,20,0,21,6,1,6,469,1
"org.apache.jackrabbit.spi.PropertyInfoImpl",7,0.00,1.71,51,0.64,27827.28,11,4,17,18,15,161.01,9,65,2,2,111.01,0.00,0.50,0.25,0,20.00,6,1923.83,0,2,13,org.apache.jackrabbit.spi2dav.ItemInfoImpl,0.00,11,1,12,0,11,5,1,7,358,1
"org.apache.jackrabbit.spi.QItemDefinitionImpl",11,0.12,2.27,68,0.90,45826.59,19,8,12,30,11,81.06,76,99,2,1,113.28,0.00,0.00,0.24,1,33.00,11,2700.76,0,2,9,java.lang.Object,0.00,19,0,25,2,19,9,2,23,513,2
"org.apache.jackrabbit.spi.QNodeDefinitionImpl",7,0.11,2.71,61,0.76,33398.02,10,3,13,34,10,60.01,56,84,2,2,108.11,0.00,0.50,0.43,1,9.00,6,2277.84,4,2,8,org.apache.jackrabbit.spi2dav.QItemDefinitionImpl,0.11,27,1,19,0,27,5,1,17,440,1
"org.apache.jackrabbit.spi.QNodeTypeDefinitionImpl",14,0.13,2.93,129,1.83,113757.21,25,11,24,54,16,104.60,62,167,1,1,104.37,0.00,0.00,0.21,1,58.00,12,5488.76,0,7,15,java.lang.Object,0.00,40,0,41,0,40,7,2,29,987,1
"org.apache.jackrabbit.spi.QPropertyDefinitionImpl",11,0.21,2.82,114,1.62,94392.88,18,7,20,50,14,70.26,70,149,2,2,102.48,0.00,0.50,0.34,0,13.00,13,4847.06,4,3,12,org.apache.jackrabbit.spi2dav.QItemDefinitionImpl,0.09,39,1,31,0,39,8,1,26,852,1
"org.apache.jackrabbit.spi.QueryInfoImpl",3,0.17,2.00,25,0.34,11932.39,6,3,16,13,11,109.04,12,32,1,1,108.81,0.00,0.00,0.44,0,0.00,4,1006.19,0,2,10,java.lang.Object,0.00,10,0,6,0,10,1,1,4,198,1
"org.apache.jackrabbit.spi.QueryResultRowImpl",4,0.27,4.25,59,0.97,49396.79,9,5,21,28,15,145.69,5,75,1,1,95.69,0.00,0.00,0.40,0,0.00,9,2918.11,0,2,14,java.lang.Object,0.00,24,0,17,0,24,2,1,2,512,1
"org.apache.jackrabbit.spi.RepositoryServiceImpl",100,0.01,3.13,1133,18.60,910034.73,122,22,174,388,138,121.33,321,1497,5,1,100.71,0.00,0.00,0.03,37,3254.00,13,55790.80,0,58,134,java.lang.Object,0.00,288,0,313,1,288,42,2,170,9640,1
"org.apache.jackrabbit.spi.RepositoryServiceImpl$BatchImpl",18,0.19,2.50,206,2.84,108080.34,24,6,174,77,34,122.80,54,254,0,1,102.19,0.00,0.00,0.34,3,0.00,5,8522.92,0,3,34,java.lang.Object,0.00,59,0,45,0,59,15,1,34,1553,1
"org.apache.jackrabbit.spi.RepositoryServiceImpl$IdentifierResolverImpl",5,0.75,1.60,22,0.27,8767.06,6,1,174,15,5,172.89,9,31,0,1,122.89,0.00,0.00,0.40,2,7.00,4,823.23,0,3,5,java.lang.Object,0.00,10,0,8,0,10,2,1,5,181,1
"org.apache.jackrabbit.spi.RepositoryServiceImpl$NamePathResolverImpl",7,0.17,1.00,21,0.23,2799.82,9,2,174,17,12,172.60,15,29,0,1,132.71,0.00,0.00,0.64,0,0.00,1,677.68,0,5,12,java.lang.Object,0.00,10,0,7,0,10,2,1,5,171,1
"org.apache.jackrabbit.spi.RepositoryServiceImpl$NamespaceCache",5,0.25,1.40,23,0.22,6313.82,7,2,174,10,1,124.04,1,31,0,2,124.04,0.00,0.50,0.70,0,0.00,2,655.26,0,3,1,org.apache.jackrabbit.spi.commons.namespace.AbstractNamespaceResolver,0.00,5,1,7,0,5,2,0,1,160,2
"org.apache.jackrabbit.spi.RepositoryServiceImpl$NamespaceResolverImpl",3,0.50,1.67,14,0.13,2927.34,4,1,174,6,1,145.50,11,22,0,1,124.88,0.00,0.00,0.67,0,1.00,2,378.40,0,2,1,java.lang.Object,0.00,3,0,5,0,3,1,1,3,92,1
"org.apache.jackrabbit.spi.RepositoryStubImpl",5,0.38,1.40,23,0.25,5437.45,7,2,19,16,16,164.44,14,32,1,2,124.55,1.00,0.33,0.20,1,8.00,3,761.58,0,4,15,org.apache.jackrabbit.test.RepositoryStub,0.14,11,1,7,1,11,1,0,6,169,1
"org.apache.jackrabbit.spi.RepositoryStubImpl$AbstractRepositoryConfig",1,0.00,1.00,3,0.01,72.00,1,0,19,1,1,138.58,0,4,0,1,138.58,0.00,0.00,0.00,0,1.00,1,32.00,0,1,1,java.lang.Object,0.00,0,0,1,0,0,0,0,0,12,0
"org.apache.jackrabbit.spi.ServiceStubImpl",4,0.00,1.75,25,0.33,7740.98,9,5,16,12,12,165.96,6,35,1,2,115.96,1.00,0.33,0.20,0,10.00,2,977.22,1,3,11,org.apache.jackrabbit.spi.RepositoryServiceStub,0.60,8,1,7,1,8,1,0,2,210,1
"org.apache.jackrabbit.spi.SessionInfoImpl",10,0.06,1.20,34,0.27,3682.35,14,4,4,18,10,172.84,28,47,7,2,132.95,0.00,0.50,0.20,0,54.00,2,812.85,4,5,3,org.apache.jackrabbit.spi.commons.SessionInfoImpl,0.11,8,1,12,0,8,5,0,7,207,1
"org.apache.jackrabbit.spi.TestAll",1,0.00,1.00,5,0.05,1005.92,1,0,3,4,1,73.18,8,7,0,2,121.28,0.00,0.50,0.00,0,1.00,1,159.94,0,1,1,junit.framework.TestCase,0.00,3,1,1,0,3,0,0,3,40,1
"org.apache.jackrabbit.spi.URIResolver",3,0.00,1.00,4,0.04,155.83,3,0,5,3,5,207.49,3,5,1,1,157.49,0.00,0.00,0.00,0,3.00,1,106.00,0,3,4,,0.00,0,0,3,0,0,0,0,1,34,0
"org.apache.jackrabbit.spi.URIResolverImpl",14,0.10,3.29,159,2.49,120053.07,18,4,31,86,28,140.79,29,215,1,1,100.91,0.00,0.00,0.16,8,50.00,12,7467.00,0,10,28,java.lang.Object,0.00,72,0,46,0,72,4,1,21,1319,0
"org.apache.jackrabbit.test.api.retention.AbstractRetentionTest",4,0.33,1.50,19,0.18,3254.00,6,2,9,8,8,125.53,3,27,5,4,125.53,2.67,0.25,0.25,0,4.00,2,548.31,3,3,3,org.apache.jackrabbit.test.AbstractJCRTest,0.15,4,3,6,8,4,1,0,1,130,2
"org.apache.jackrabbit.test.api.retention.HoldEffectTest",13,0.31,1.77,122,1.68,44164.74,16,3,9,38,4,157.47,16,152,1,5,107.47,0.00,0.80,0.62,2,0.00,9,5029.65,3,0,3,org.apache.jackrabbit.test.api.retention.AbstractRetentionTest,0.25,25,4,23,0,25,13,0,14,973,1
"org.apache.jackrabbit.test.api.retention.HoldTest",22,0.00,2.41,224,2.93,83735.04,22,0,15,53,3,155.30,37,300,1,5,105.30,0.00,0.80,0.00,3,0.00,7,8779.62,4,2,2,org.apache.jackrabbit.test.api.retention.AbstractRetentionTest,0.00,31,4,53,0,31,20,0,35,1683,1
"org.apache.jackrabbit.test.api.retention.RetentionPolicyEffectTest",9,0.21,1.89,85,1.03,24123.82,12,3,8,31,4,158.26,13,111,1,5,108.26,0.00,0.80,0.52,2,0.00,7,3095.34,3,0,3,org.apache.jackrabbit.test.api.retention.AbstractRetentionTest,0.28,22,4,17,0,22,9,0,11,619,1
"org.apache.jackrabbit.test.api.retention.RetentionPolicyTest",22,0.00,2.45,219,2.43,60202.08,22,0,12,47,3,158.13,37,308,1,5,108.13,0.00,0.80,0.00,2,0.00,7,7286.15,5,2,2,org.apache.jackrabbit.test.api.retention.AbstractRetentionTest,0.10,25,4,54,0,25,20,0,35,1470,1
"org.apache.jackrabbit.test.api.retention.RetentionPolicyTest$RetentionPolicy",1,0.00,1.00,3,0.01,111.66,1,0,12,1,0,137.08,0,4,0,1,137.08,0.00,0.00,0.00,0,1.00,1,41.22,0,1,0,java.lang.Object,0.00,0,0,1,0,0,0,0,0,14,0
"org.apache.jackrabbit.test.api.retention.TestAll",1,0.00,1.00,8,0.07,2228.14,1,0,3,3,5,68.66,7,10,1,2,110.95,0.00,0.50,0.00,0,1.00,1,223.66,0,1,4,junit.framework.TestCase,0.00,2,1,1,0,2,0,0,2,55,1
"org.apache.jackrabbit.webdav.jcr.AbstractItemResource",18,0.10,3.00,150,2.28,84323.30,21,3,36,87,30,65.86,141,219,2,2,108.15,5.00,0.14,0.24,3,102.00,10,6833.37,9,8,28,org.apache.jackrabbit.webdav.jcr.AbstractResource,0.13,69,1,54,5,69,10,2,42,1265,1
"org.apache.jackrabbit.webdav.jcr.AbstractResource",43,0.03,1.60,191,2.52,71504.69,54,11,60,112,55,90.85,285,285,4,1,123.07,0.00,0.00,0.06,10,854.00,5,7566.66,0,26,51,java.lang.Object,0.00,69,0,69,8,69,17,4,74,1577,1
"org.apache.jackrabbit.webdav.jcr.AbstractResource$EListener",2,0.00,2.50,16,0.24,5536.66,5,3,60,9,6,149.88,5,29,0,1,110.00,0.00,0.00,0.33,0,2.00,4,734.56,0,0,6,java.lang.Object,0.00,7,0,5,0,7,2,1,3,153,0
"org.apache.jackrabbit.webdav.jcr.DavLocatorFactoryImpl",3,0.50,3.33,29,0.31,11701.27,4,1,3,15,3,58.74,26,39,1,2,106.85,1.00,0.33,0.67,0,1.00,5,942.47,0,2,2,org.apache.jackrabbit.webdav.AbstractLocatorFactory,0.00,12,1,10,1,12,1,0,7,196,1
"org.apache.jackrabbit.webdav.jcr.DavResourceFactoryImpl",6,0.07,4.00,75,1.19,55416.15,9,3,25,40,24,55.07,66,103,1,1,99.20,0.00,0.00,0.39,1,6.00,10,3565.99,0,4,23,java.lang.Object,0.00,34,0,24,1,34,2,1,14,634,1
"org.apache.jackrabbit.webdav.jcr.DefaultItemCollection",29,0.30,4.62,384,5.75,262387.97,31,2,69,173,42,49.46,318,535,3,3,97.94,1.50,0.33,0.21,8,65.00,20,17262.25,22,10,39,org.apache.jackrabbit.webdav.jcr.AbstractItemResource,0.17,144,2,134,3,144,19,1,89,3044,1
"org.apache.jackrabbit.webdav.jcr.DefaultItemResource",14,0.77,2.57,104,1.45,45020.33,15,1,42,67,27,63.53,121,145,1,3,111.64,0.00,0.67,0.29,2,38.00,8,4339.33,9,3,26,org.apache.jackrabbit.webdav.jcr.AbstractItemResource,0.04,53,2,36,0,53,11,0,24,828,1
"org.apache.jackrabbit.webdav.jcr.ItemResourceConstants",0,0.00,0.00,48,1.35,46843.37,47,47,9,4,38,171.00,73,49,30,1,171.00,0.00,0.00,0.00,0,0.00,0,4037.55,0,0,8,,0.00,4,0,0,0,4,0,0,26,592,1
"org.apache.jackrabbit.webdav.jcr.JCRWebdavServerServlet",11,0.08,1.64,64,0.73,19205.05,23,12,19,38,17,69.28,101,86,1,3,119.28,1.50,0.33,0.16,1,50.00,4,2187.59,1,6,16,org.apache.jackrabbit.webdav.server.AbstractWebdavServlet,0.21,27,2,18,3,27,5,0,24,450,2
"org.apache.jackrabbit.webdav.jcr.JcrDavException",5,0.08,2.00,54,0.87,29811.52,8,3,30,21,30,61.52,38,63,25,3,103.81,0.00,0.67,0.27,0,10.00,5,2613.13,0,1,5,org.apache.jackrabbit.webdav.DavException,0.21,16,2,10,0,16,4,0,7,532,1
"org.apache.jackrabbit.webdav.jcr.JcrDavExceptionTest",2,0.00,1.50,10,0.09,1229.20,2,0,3,9,1,123.11,9,16,0,2,122.87,0.00,0.50,0.00,0,2.00,2,277.63,0,0,1,junit.framework.TestCase,0.00,7,1,3,0,7,2,0,6,71,1
"org.apache.jackrabbit.webdav.jcr.JcrDavExceptionTest$DerievedRepositoryException",0,0.00,0.00,1,0.01,72.00,0,0,3,0,0,171.00,0,2,0,2,171.00,0.00,0.50,0.00,0,0.00,0,24.00,0,0,0,javax.jcr.lock.LockException,0.00,0,1,0,0,0,0,0,0,8,3
"org.apache.jackrabbit.webdav.jcr.JcrDavSession",8,0.10,1.25,27,0.28,5361.04,11,3,8,21,25,98.67,54,38,21,1,130.90,0.00,0.00,0.25,2,12.00,2,830.31,0,4,4,java.lang.Object,0.00,13,0,10,2,13,4,1,12,208,2
"org.apache.jackrabbit.webdav.jcr.JcrValueType",2,0.00,2.00,12,0.22,8268.32,4,2,3,11,7,69.21,23,16,7,1,113.34,0.00,0.00,0.50,0,0.00,3,649.98,0,1,0,java.lang.Object,0.00,9,0,4,0,9,1,0,4,135,2
"org.apache.jackrabbit.webdav.jcr.RootCollection",13,1.00,1.38,78,0.99,32915.44,14,1,22,45,14,82.88,85,96,1,2,115.10,0.00,0.50,0.08,3,24.00,4,2975.27,4,5,13,org.apache.jackrabbit.webdav.jcr.AbstractResource,0.07,32,1,18,0,32,8,0,18,568,1
"org.apache.jackrabbit.webdav.jcr.VersionControlledItemCollection",17,0.88,4.53,222,3.33,175212.82,18,1,38,86,27,59.94,205,300,1,4,97.50,0.00,0.75,0.18,4,0.00,17,9987.39,13,7,26,org.apache.jackrabbit.webdav.jcr.DefaultItemCollection,0.11,69,3,77,0,69,10,1,74,1766,1
"org.apache.jackrabbit.webdav.jcr.WorkspaceResourceImpl",25,0.83,1.80,171,2.34,93910.03,26,1,44,94,29,95.81,138,217,1,2,113.69,0.00,0.50,0.20,5,123.00,7,7019.65,9,10,28,org.apache.jackrabbit.webdav.jcr.AbstractResource,0.12,69,1,45,0,69,15,2,43,1311,1
"org.apache.jackrabbit.spi.commons.query.AndQueryNode",4,0.00,1.25,11,0.08,1076.39,4,0,1,5,14,122.71,23,17,12,3,140.58,0.00,0.67,0.00,0,4.00,2,242.82,1,1,3,org.apache.jackrabbit.spi.commons.query.NAryQueryNode,0.15,1,2,5,0,1,3,0,5,68,1
"org.apache.jackrabbit.spi.commons.query.ConstantNameProvider",1,0.00,1.00,2,0.01,41.48,1,0,0,1,1,98.93,8,3,1,1,147.03,0.00,0.00,0.00,0,1.00,1,27.65,0,1,0,,0.00,0,0,1,0,0,0,0,2,11,1
"org.apache.jackrabbit.spi.commons.query.DefaultQueryNodeFactory",13,1.00,1.00,28,0.24,3235.91,14,1,2,25,19,161.52,46,49,4,1,140.90,0.00,0.00,0.08,0,24.00,1,708.75,0,4,15,java.lang.Object,0.00,12,0,13,0,12,9,1,15,202,1
"org.apache.jackrabbit.spi.commons.query.DefaultQueryNodeVisitor",13,0.00,1.00,27,0.22,2640.87,13,0,1,13,19,141.60,4,41,5,1,141.60,0.00,0.00,0.00,0,13.00,1,667.97,0,13,14,java.lang.Object,0.00,0,0,13,1,0,0,1,1,188,1
"org.apache.jackrabbit.spi.commons.query.DerefQueryNode",7,0.67,1.29,21,0.17,4220.37,8,1,2,9,14,113.38,39,31,11,4,131.25,0.00,0.75,0.43,0,15.00,3,520.21,3,2,4,org.apache.jackrabbit.spi.commons.query.LocationStepQueryNode,0.23,2,3,9,0,2,5,0,11,135,1
"org.apache.jackrabbit.spi.commons.query.ExactQueryNode",7,0.25,1.57,24,0.23,7636.08,9,2,2,10,10,111.30,40,35,8,2,129.18,1.00,0.33,0.29,0,14.00,4,691.35,0,3,3,org.apache.jackrabbit.spi.commons.query.QueryNode,0.29,3,1,11,1,3,4,0,10,171,1
"org.apache.jackrabbit.spi.commons.query.LocationStepQueryNode",12,0.05,1.25,40,0.42,11033.62,19,7,3,18,22,87.52,87,58,18,3,129.81,0.50,0.50,0.10,0,60.00,3,1252.66,2,3,5,org.apache.jackrabbit.spi.commons.query.NAryQueryNode,0.11,6,2,15,1,6,9,0,20,296,1
"org.apache.jackrabbit.spi.commons.query.NAryQueryNode",9,0.06,2.67,61,0.59,16954.15,11,2,5,23,11,83.74,61,79,9,2,115.96,8.00,0.10,0.44,0,0.00,4,1768.57,0,1,2,org.apache.jackrabbit.spi.commons.query.QueryNode,0.12,14,1,24,8,14,8,0,13,391,2
"org.apache.jackrabbit.spi.commons.query.NodeTypeQueryNode",4,0.00,1.25,11,0.09,1186.41,4,0,3,5,18,108.03,24,17,14,3,140.25,0.00,0.67,0.00,0,4.00,2,272.03,1,1,5,org.apache.jackrabbit.spi.commons.query.ExactQueryNode,0.17,1,2,5,0,1,3,0,8,74,1
"org.apache.jackrabbit.spi.commons.query.NotQueryNode",4,0.00,1.25,11,0.08,1076.39,4,0,1,5,13,122.71,20,17,11,3,140.58,0.00,0.67,0.00,0,4.00,2,242.82,1,1,3,org.apache.jackrabbit.spi.commons.query.NAryQueryNode,0.15,1,2,5,0,1,3,0,5,68,1
"org.apache.jackrabbit.spi.commons.query.OrQueryNode",4,0.00,1.25,11,0.08,1076.39,4,0,1,5,12,122.71,22,17,10,3,140.58,0.00,0.67,0.00,0,4.00,2,242.82,1,1,3,org.apache.jackrabbit.spi.commons.query.NAryQueryNode,0.15,1,2,5,0,1,3,0,5,68,1
"org.apache.jackrabbit.spi.commons.query.OrderQueryNode",11,0.60,1.18,32,0.30,5042.70,12,1,7,23,20,106.55,76,47,15,2,138.78,0.00,0.50,0.45,2,16.00,2,898.56,0,2,6,org.apache.jackrabbit.spi.commons.query.QueryNode,0.22,12,1,13,0,12,9,0,17,231,1
"org.apache.jackrabbit.spi.commons.query.OrderQueryNode$OrderSpec",7,0.17,1.29,21,0.18,4509.00,9,2,7,11,2,88.73,52,31,0,1,131.02,0.00,0.00,0.36,0,11.00,3,547.59,0,2,2,java.lang.Object,0.00,4,0,9,0,4,5,0,9,144,3
"org.apache.jackrabbit.spi.commons.query.PathQueryNode",10,0.19,2.10,52,0.57,20398.13,13,3,4,19,19,76.40,74,76,13,3,118.69,0.50,0.50,0.17,1,42.00,10,1709.66,3,2,7,org.apache.jackrabbit.spi.commons.query.NAryQueryNode,0.23,9,2,21,1,9,8,0,24,366,1
"org.apache.jackrabbit.spi.commons.query.PropertyFunctionQueryNode",6,0.15,1.33,28,0.24,4364.33,10,4,4,10,14,77.83,51,39,13,2,125.94,0.00,0.50,0.12,0,14.00,2,715.50,0,2,2,org.apache.jackrabbit.spi.commons.query.QueryNode,0.31,4,1,8,0,4,4,0,11,178,1
"org.apache.jackrabbit.spi.commons.query.QueryConstants",0,0.00,0.00,58,0.91,24369.42,53,53,3,1,8,171.00,176,59,7,1,171.00,0.00,0.00,0.00,0,0.00,0,2722.35,0,0,1,,0.00,1,0,0,0,1,0,0,55,408,1
"org.apache.jackrabbit.spi.commons.query.QueryConstants$ConstantNameProvider",1,0.00,2.00,26,0.46,12246.35,2,1,3,6,0,85.87,0,29,0,1,85.87,0.00,0.00,1.00,0,0.00,2,1380.54,0,1,0,java.lang.Object,0.00,5,0,2,0,5,0,0,0,246,0
"org.apache.jackrabbit.spi.commons.query.QueryConstants$ConstantNameProvider_0",1,0.00,2.00,13,0.18,4270.23,2,1,3,6,0,100.70,0,16,0,1,100.70,0.00,0.00,1.00,0,0.00,2,549.56,0,1,0,java.lang.Object,0.00,5,0,2,0,5,0,0,0,116,0
"org.apache.jackrabbit.spi.commons.query.QueryNode",7,0.07,1.00,27,0.31,5642.15,21,14,1,10,25,80.32,69,31,24,1,130.32,0.00,0.00,0.01,0,12.00,1,940.67,0,3,2,java.lang.Object,0.00,3,0,7,15,3,4,0,22,207,2
"org.apache.jackrabbit.spi.commons.query.QueryNodeFactory",12,0.00,1.00,13,0.08,245.28,12,0,1,12,24,128.46,80,17,10,1,160.68,0.00,0.00,0.00,0,12.00,1,240.28,0,9,14,,0.00,0,0,12,0,0,3,0,13,87,1
"org.apache.jackrabbit.spi.commons.query.QueryNodeVisitor",13,0.00,1.00,14,0.14,736.16,13,0,1,13,20,157.20,3,15,20,1,157.20,0.00,0.00,0.00,0,13.00,1,422.09,0,13,13,,0.00,0,0,13,0,0,0,0,1,135,1
"org.apache.jackrabbit.spi.commons.query.QueryObjectModelBuilder",4,0.00,1.00,5,0.04,187.53,4,0,5,4,2,107.84,38,10,2,1,157.84,0.00,0.00,0.00,0,4.00,1,112.42,0,3,0,,0.00,0,0,4,0,0,1,0,5,37,1
"org.apache.jackrabbit.spi.commons.query.QueryObjectModelBuilderRegistry",2,0.33,2.00,22,0.32,8855.48,5,3,11,8,5,83.14,28,32,4,1,103.28,0.00,0.00,0.17,0,2.00,3,945.51,0,1,1,java.lang.Object,0.00,6,0,4,0,6,1,0,6,194,1
"org.apache.jackrabbit.spi.commons.query.QueryParser",3,0.00,1.00,8,0.10,1925.19,3,0,2,6,8,108.28,40,19,3,1,137.66,0.00,0.00,0.00,0,3.00,1,308.05,0,1,5,java.lang.Object,0.00,3,0,3,0,3,2,0,4,73,1
"org.apache.jackrabbit.spi.commons.query.QueryRootNode",11,0.07,1.27,29,0.31,9353.40,14,3,4,21,26,118.77,63,44,22,2,136.65,0.00,0.50,0.27,0,33.00,4,924.62,0,4,5,org.apache.jackrabbit.spi.commons.query.QueryNode,0.22,10,1,14,0,10,7,0,15,236,1
"org.apache.jackrabbit.spi.commons.query.QueryTreeBuilder",4,0.00,1.00,5,0.04,162.28,4,0,2,4,6,108.34,38,10,3,1,158.34,0.00,0.00,0.00,0,4.00,1,113.36,0,2,3,,0.00,0,0,4,0,0,2,0,5,38,1
"org.apache.jackrabbit.spi.commons.query.QueryTreeBuilderRegistry",2,0.00,2.00,25,0.33,9203.40,5,3,11,9,3,72.36,26,33,2,1,101.74,0.00,0.00,0.33,0,2.00,3,979.04,0,1,1,java.lang.Object,0.00,7,0,4,0,7,1,0,6,202,1
"org.apache.jackrabbit.spi.commons.query.QueryTreeDump",17,0.21,2.35,214,2.67,102870.06,20,3,4,62,19,140.65,34,232,2,1,100.77,0.00,0.00,0.53,2,0.00,8,7998.70,0,13,18,java.lang.Object,0.00,45,0,40,0,45,4,1,10,1551,1
"org.apache.jackrabbit.spi.commons.query.RelationQueryNode",22,0.04,1.55,76,0.76,21270.67,32,10,7,38,19,87.30,164,115,11,3,129.59,0.00,0.67,0.14,0,206.00,5,2290.19,0,5,9,org.apache.jackrabbit.spi.commons.query.NAryQueryNode,0.08,16,2,34,0,16,17,1,37,536,1
"org.apache.jackrabbit.spi.commons.query.TextsearchQueryNode",13,0.08,1.69,49,0.48,12778.57,16,3,5,25,16,87.22,93,73,11,2,129.52,0.00,0.50,0.26,0,49.00,4,1449.14,0,4,6,org.apache.jackrabbit.spi.commons.query.QueryNode,0.20,12,1,22,0,12,9,0,20,345,1
"org.apache.jackrabbit.spi.commons.query.TraversingQueryNodeVisitor",7,0.00,1.29,21,0.24,4601.63,7,0,1,17,9,130.95,4,31,0,2,130.95,0.00,0.50,0.00,0,7.00,3,720.95,0,7,9,org.apache.jackrabbit.spi.commons.query.DefaultQueryNodeVisitor,0.00,10,1,9,0,10,0,0,1,176,1
"org.apache.jackrabbit.core.retention.AbstractRetentionTest",2,0.00,1.00,5,0.06,682.96,2,0,3,3,6,179.71,4,8,3,5,139.82,0.75,0.50,0.00,1,2.00,1,187.28,0,2,3,org.apache.jackrabbit.test.api.retention.AbstractRetentionTest,0.17,1,4,2,3,1,0,0,2,50,2
"org.apache.jackrabbit.core.retention.HoldImpl",9,0.12,1.56,52,0.61,15602.90,17,8,11,26,11,169.32,17,63,4,1,119.32,0.00,0.00,0.24,0,10.00,3,1823.38,0,5,7,java.lang.Object,0.00,17,0,14,0,17,4,1,7,398,0
"org.apache.jackrabbit.core.retention.HoldTest",5,1.00,2.40,41,0.46,10645.57,6,1,5,16,3,160.90,8,57,1,6,110.90,0.00,0.83,0.20,0,0.00,3,1370.78,1,0,2,org.apache.jackrabbit.core.retention.AbstractRetentionTest,0.18,11,5,12,0,11,5,0,6,288,1
"org.apache.jackrabbit.core.retention.HoldTest$Hold",2,0.00,1.00,5,0.03,405.51,2,0,5,4,0,141.60,0,7,0,1,141.60,0.00,0.00,0.00,0,2.00,1,97.95,0,1,0,java.lang.Object,0.00,2,0,2,0,2,1,0,0,30,0
"org.apache.jackrabbit.core.retention.HoldTest$Hold_0",2,0.00,1.00,5,0.03,308.41,2,0,5,3,0,142.54,0,7,0,1,142.54,0.00,0.00,0.00,0,2.00,1,86.19,0,1,0,java.lang.Object,0.00,1,0,2,0,1,1,0,0,27,0
"org.apache.jackrabbit.core.retention.HoldTest$Hold_1",2,0.00,1.00,5,0.03,459.70,2,0,5,4,0,141.17,0,7,0,1,141.17,0.00,0.00,0.00,0,2.00,1,103.16,0,1,0,java.lang.Object,0.00,2,0,2,0,2,1,0,0,31,0
"org.apache.jackrabbit.core.retention.RetentionManagerImpl",7,0.31,3.00,83,1.50,70483.46,13,6,22,42,11,100.61,30,112,3,2,100.38,0.00,0.50,0.43,0,0.00,6,4494.18,2,3,10,org.apache.jackrabbit.core.ProtectedItemModifier,0.00,35,1,21,0,35,4,1,13,806,1
"org.apache.jackrabbit.core.retention.RetentionPolicyImpl",7,0.04,1.71,36,0.36,10576.56,11,4,9,15,11,140.38,25,47,6,1,119.77,0.00,0.00,0.29,0,7.00,4,1073.92,0,3,5,java.lang.Object,0.00,8,0,12,0,8,4,1,7,252,1
"org.apache.jackrabbit.core.retention.RetentionPolicyTest",1,0.00,2.00,6,0.04,531.50,1,0,2,4,2,120.59,4,10,1,6,120.35,0.00,0.83,0.00,0,0.00,2,130.20,0,0,1,org.apache.jackrabbit.core.retention.AbstractRetentionTest,0.00,3,5,2,0,3,1,0,2,33,1
"org.apache.jackrabbit.core.retention.RetentionPolicyTest$RetentionPolicy",1,0.00,1.00,3,0.01,111.66,1,0,2,1,0,137.08,0,4,0,1,137.08,0.00,0.00,0.00,0,1.00,1,41.22,0,1,0,java.lang.Object,0.00,0,0,1,0,0,0,0,0,14,0
"org.apache.jackrabbit.core.retention.RetentionRegistry",2,0.00,1.00,3,0.03,182.53,2,0,2,2,8,205.56,3,4,7,1,155.56,0.00,0.00,0.00,0,2.00,1,81.08,0,0,1,,0.00,0,0,2,0,0,2,0,1,26,1
"org.apache.jackrabbit.core.retention.RetentionRegistryImpl",11,0.19,4.27,143,2.07,74900.23,20,9,31,72,19,66.71,69,195,3,1,98.93,0.00,0.00,0.28,4,10.00,11,6197.13,0,0,16,java.lang.Object,0.00,61,0,47,0,61,11,2,40,1130,1
"org.apache.jackrabbit.core.retention.RetentionRegistryImpl$PathMap.ElementVisitor",1,0.00,2.00,5,0.07,1071.98,1,0,31,6,1,120.91,0,7,0,1,120.91,0.00,0.00,0.00,0,1.00,2,207.27,0,0,1,java.lang.Object,0.00,5,0,2,0,5,1,0,0,49,0
"org.apache.jackrabbit.core.retention.RetentionRegistryImpl$PathMap.ElementVisitor_0",1,0.00,1.00,4,0.04,468.01,1,0,31,4,1,127.51,0,5,0,1,127.51,0.00,0.00,0.00,0,1.00,1,129.96,0,0,1,java.lang.Object,0.00,3,0,1,0,3,1,0,0,34,0
"org.apache.jackrabbit.core.retention.TestAll",1,0.00,1.00,6,0.05,1283.53,1,0,3,3,2,75.20,7,8,0,2,117.50,0.00,0.50,0.00,0,1.00,1,150.40,0,1,2,junit.framework.TestCase,0.00,2,1,1,0,2,0,0,2,39,1
"org.apache.jackrabbit.core.lock.AbstractLockInfo",12,0.02,1.42,51,0.44,9320.80,20,8,3,20,10,77.60,97,70,7,1,125.70,0.00,0.00,0.15,1,74.00,4,1306.08,0,4,3,java.lang.Object,0.00,8,0,17,2,8,8,0,24,311,2
"org.apache.jackrabbit.core.lock.ConcurrentLockingTest",3,0.00,1.00,12,0.07,767.77,5,2,5,5,2,150.19,11,13,1,5,129.58,0.00,0.80,0.50,0,0.00,1,205.62,1,0,1,org.apache.jackrabbit.core.AbstractConcurrencyTest,0.00,2,4,3,0,2,3,0,3,57,1
"org.apache.jackrabbit.core.lock.ConcurrentLockingTest$Task",1,0.00,2.00,11,0.10,2244.14,1,0,5,6,0,105.61,0,10,0,1,105.61,0.00,0.00,0.00,0,1.00,2,305.62,0,0,0,java.lang.Object,0.00,5,0,2,0,5,1,0,0,63,0
"org.apache.jackrabbit.core.lock.ConcurrentLockingTest$Task_0",1,0.00,2.00,12,0.12,3031.40,1,0,5,7,0,153.17,1,11,0,1,103.17,0.00,0.00,0.00,0,1.00,2,367.45,0,0,0,java.lang.Object,0.00,6,0,2,0,6,1,0,1,73,0
"org.apache.jackrabbit.core.lock.ConcurrentLockingTest$Task_1",1,0.00,3.00,12,0.12,2838.01,1,0,5,7,0,103.30,0,12,0,1,103.30,0.00,0.00,0.00,0,1.00,3,346.53,0,0,0,java.lang.Object,0.00,6,0,3,0,6,1,0,0,70,0
"org.apache.jackrabbit.core.lock.ConcurrentLockingWithTransactionsTest",3,0.17,1.33,15,0.13,2580.16,6,3,10,8,4,142.37,9,21,1,5,121.75,0.00,0.80,0.22,0,1.00,2,377.60,1,1,3,org.apache.jackrabbit.core.AbstractConcurrencyTest,0.00,5,4,4,0,5,2,0,4,93,1
"org.apache.jackrabbit.core.lock.ConcurrentLockingWithTransactionsTest$Task",1,0.00,4.00,22,0.31,15666.15,1,0,10,16,1,137.57,1,25,0,1,87.57,0.00,0.00,0.00,0,1.00,4,936.11,0,0,1,java.lang.Object,0.00,15,0,4,0,15,1,0,1,157,0
"org.apache.jackrabbit.core.lock.ConcurrentLockingWithTransactionsTest$Task_0",1,0.00,4.00,20,0.30,14300.47,1,0,10,15,1,129.31,2,23,0,1,89.43,0.00,0.00,0.00,0,1.00,4,893.65,0,0,1,java.lang.Object,0.00,14,0,4,0,14,1,0,2,150,0
"org.apache.jackrabbit.core.lock.ExtendedLockingTest",1,0.00,3.00,12,0.13,2976.95,1,0,5,9,2,103.37,4,18,1,4,103.14,0.00,0.75,0.00,0,0.00,3,383.75,0,0,1,org.apache.jackrabbit.test.AbstractJCRTest,0.00,8,3,3,0,8,1,0,2,79,1
"org.apache.jackrabbit.core.lock.LockImpl",10,0.06,1.50,35,0.31,4842.53,12,2,6,21,6,114.09,52,53,2,1,131.96,0.00,0.00,0.55,0,0.00,3,923.03,0,3,4,java.lang.Object,0.00,11,0,15,1,11,7,1,20,229,0
"org.apache.jackrabbit.core.lock.LockManager",12,0.00,1.00,13,0.14,681.03,12,0,7,12,12,107.19,118,18,10,1,157.19,0.00,0.00,0.00,0,12.00,1,434.10,0,4,3,,0.00,0,0,12,0,0,8,0,13,130,1
"org.apache.jackrabbit.core.lock.LockManagerImpl",40,0.02,3.08,457,6.47,272150.32,47,7,52,162,38,83.84,224,637,5,1,101.71,0.00,0.00,0.16,20,194.00,10,19408.81,0,6,33,java.lang.Object,0.00,122,0,123,0,122,34,4,69,3503,1
"org.apache.jackrabbit.core.lock.LockManagerImpl$HierarchyEvent",5,0.10,1.20,24,0.16,3222.39,10,5,52,5,2,76.38,45,31,0,1,126.38,0.00,0.00,0.28,0,5.00,2,491.12,0,2,2,java.lang.Object,0.00,0,0,6,0,0,3,0,10,128,1
"org.apache.jackrabbit.core.lock.LockManagerImpl$LockInfo",4,0.00,2.50,26,0.33,9151.15,4,0,52,10,6,67.20,34,41,0,2,115.31,0.00,0.50,0.00,0,8.00,7,975.75,3,0,6,org.apache.jackrabbit.core.lock.AbstractLockInfo,0.00,6,1,10,0,6,4,1,9,197,0
"org.apache.jackrabbit.core.lock.LockManagerImpl$PathMap.ElementVisitor",1,0.00,2.00,5,0.05,772.48,1,0,52,3,1,122.03,0,7,0,1,122.03,0.00,0.00,0.00,0,1.00,2,151.44,0,0,1,java.lang.Object,0.00,2,0,2,0,2,1,0,0,38,0
"org.apache.jackrabbit.core.lock.LockManagerImpl$PathMap.ElementVisitor_0",1,0.00,2.00,5,0.07,1023.56,1,0,52,6,1,121.06,0,7,0,1,121.06,0.00,0.00,0.00,0,1.00,2,198.35,0,0,1,java.lang.Object,0.00,5,0,2,0,5,1,0,0,47,0
"org.apache.jackrabbit.core.lock.LockManagerImpl$PathMap.ElementVisitor_1",1,0.00,1.00,4,0.04,421.02,1,0,52,3,1,127.88,0,5,0,1,127.88,0.00,0.00,0.00,0,1.00,1,115.51,0,0,1,java.lang.Object,0.00,2,0,1,0,2,1,0,0,31,0
"org.apache.jackrabbit.core.lock.LockManagerImpl$PathMap.ElementVisitor_2",1,0.00,3.00,17,0.19,7649.85,1,0,52,8,0,94.27,0,17,0,1,94.27,0.00,0.00,0.00,0,1.00,3,578.13,0,0,0,java.lang.Object,0.00,7,0,3,0,7,1,0,0,114,0
"org.apache.jackrabbit.core.lock.LockManagerImpl$ReentrantLock",2,0.00,4.00,27,0.25,8895.47,3,1,52,10,1,100.40,0,37,0,1,100.40,0.00,0.00,1.00,0,0.00,5,740.30,0,0,1,java.lang.Object,0.00,8,0,8,0,8,2,0,0,148,0
"org.apache.jackrabbit.core.lock.LockToken",5,0.75,2.80,49,0.59,48724.61,6,1,1,16,7,85.88,26,59,6,1,103.76,0.00,0.00,0.40,1,7.00,8,1773.55,0,3,1,java.lang.Object,0.00,11,0,14,0,11,2,0,6,348,0
"org.apache.jackrabbit.core.lock.SessionLockManager",12,0.20,1.92,78,1.00,29322.94,16,4,15,38,9,97.27,60,113,3,1,115.14,0.00,0.00,0.44,1,0.00,4,3001.18,0,3,6,java.lang.Object,0.00,26,0,23,0,26,9,1,16,626,1
"org.apache.jackrabbit.core.lock.TestAll",1,0.00,1.00,5,0.04,864.35,1,0,3,3,1,73.32,10,7,0,2,121.80,0.00,0.50,0.00,0,1.00,1,115.51,0,1,1,junit.framework.TestCase,0.00,2,1,1,0,2,0,0,2,31,1
"org.apache.jackrabbit.core.lock.XAEnvironment",15,0.14,3.27,175,2.23,86057.40,28,13,13,74,10,54.18,124,227,2,1,102.28,0.00,0.00,0.21,5,13.00,7,6678.90,0,5,8,java.lang.Object,0.00,59,0,49,0,59,10,0,36,1255,0
"org.apache.jackrabbit.core.lock.XAEnvironment$LockInfo",8,0.21,1.50,33,0.34,5971.03,10,2,13,12,4,107.95,45,50,0,2,125.82,0.00,0.50,0.31,0,26.00,3,1031.14,1,0,4,org.apache.jackrabbit.core.lock.AbstractLockInfo,0.10,4,1,12,0,4,8,0,11,241,0
"org.apache.jackrabbit.core.lock.XALock",2,1.00,2.00,10,0.09,1265.31,3,1,3,5,4,74.60,16,15,1,2,122.71,0.00,0.50,0.50,0,2.00,3,275.76,1,0,4,org.apache.jackrabbit.core.lock.LockImpl,0.17,3,1,4,0,3,2,0,4,69,0
"org.apache.jackrabbit.core.lock.XALockManager",21,0.10,1.90,119,1.35,37561.61,24,3,10,53,12,119.40,86,162,2,1,119.17,0.00,0.00,0.43,3,0.00,3,4050.58,0,4,11,java.lang.Object,0.00,32,0,40,0,32,17,2,27,873,1
"org.apache.jackrabbit.core.jndi.BindableRepository",14,0.03,1.14,46,0.46,7536.90,20,6,15,32,6,83.56,115,71,2,2,131.67,0.00,0.50,0.14,1,46.00,2,1376.98,0,8,4,org.apache.jackrabbit.commons.AbstractRepository,0.00,18,1,16,0,18,6,4,24,332,1
"org.apache.jackrabbit.core.jndi.BindableRepository$Thread",1,0.00,1.00,3,0.01,56.92,1,0,15,2,0,139.38,0,4,0,1,139.38,0.00,0.00,0.00,0,1.00,1,30.46,0,0,0,java.lang.Object,0.00,1,0,1,0,1,1,0,0,12,0
"org.apache.jackrabbit.core.jndi.BindableRepositoryFactory",1,0.00,2.00,9,0.12,3923.54,2,1,8,5,2,69.38,12,15,1,1,106.95,0.00,0.00,1.00,0,0.00,2,355.34,0,1,1,java.lang.Object,0.00,4,0,2,0,4,0,1,3,75,1
"org.apache.jackrabbit.core.jndi.RegistryHelper",3,0.00,1.33,14,0.22,6262.68,3,0,7,14,4,84.77,37,30,1,1,122.33,0.00,0.00,0.00,0,3.00,2,657.32,0,0,3,java.lang.Object,0.00,11,0,4,0,11,3,0,8,135,1
"org.apache.jackrabbit.core.jndi.RepositoryFactoryImpl",1,0.00,4.00,13,0.14,5338.25,2,1,6,6,1,55.65,11,20,1,1,99.78,0.00,0.00,1.00,0,0.00,4,432.03,0,1,0,java.lang.Object,0.00,5,0,4,0,5,0,1,4,91,1
"org.apache.jackrabbit.spi.commons.query.sql.Parser",36,0.07,5.47,657,7.94,465555.98,68,32,24,119,4,141.41,36,840,2,1,91.41,0.00,0.00,0.10,25,396.00,23,23819.05,0,25,2,java.lang.Object,0.00,83,0,197,0,83,11,0,15,4247,1
"org.apache.jackrabbit.spi.commons.query.sql.Parser$ColumnOrWildcard",0,0.00,0.00,4,0.02,232.53,3,3,24,0,0,171.00,0,5,0,1,171.00,0.00,0.00,0.00,0,0.00,0,66.44,0,0,0,java.lang.Object,0.00,0,0,0,0,0,0,0,0,20,2
"org.apache.jackrabbit.spi.commons.query.sql.ParserTest",4,0.00,4.75,62,0.81,33771.82,6,2,18,36,8,135.74,10,82,0,2,95.85,0.00,0.50,0.50,2,0.00,10,2419.03,1,1,8,junit.framework.TestCase,0.00,32,1,19,0,32,3,0,8,441,1
"org.apache.jackrabbit.spi.commons.query.sql.ParserTest$QOMF",2,0.00,1.00,5,0.04,290.50,2,0,18,2,3,142.74,0,9,0,2,142.74,0.00,0.50,0.00,0,2.00,1,106.80,0,1,3,org.apache.jackrabbit.spi.commons.query.qom.QueryObjectModelFactoryImpl,0.00,0,1,2,0,0,1,0,0,32,1
"org.apache.jackrabbit.spi.commons.query.sql.QOMFormatter",42,0.04,2.43,379,3.41,86634.50,46,4,38,114,2,109.10,28,462,2,1,109.10,0.00,0.00,0.21,8,0.00,14,10241.76,0,2,0,java.lang.Object,0.00,72,0,102,0,72,40,1,7,2281,1
"org.apache.jackrabbit.spi.commons.query.sql.SQL2QOMBuilder",4,0.67,1.25,12,0.17,3532.51,5,1,10,14,3,112.08,23,24,0,1,129.95,0.00,0.00,0.50,0,4.00,2,524.89,0,3,3,java.lang.Object,0.00,10,0,5,0,10,1,1,6,124,1
"org.apache.jackrabbit.spi.commons.nodetype.constraint.BooleanConstraint",2,0.00,3.00,23,0.29,10699.16,3,1,5,11,4,123.16,7,34,2,2,102.54,0.00,0.50,1.00,0,0.00,3,869.61,0,0,3,org.apache.jackrabbit.spi.commons.nodetype.constraint.ValueConstraint,0.00,9,1,6,0,9,2,0,3,172,0
"org.apache.jackrabbit.spi.commons.nodetype.constraint.BooleanConstraintTest",9,1.00,1.11,24,0.27,4410.96,10,1,6,17,4,138.56,4,39,0,3,138.56,0.00,0.67,0.00,1,18.00,2,803.49,0,7,4,org.apache.jackrabbit.spi.commons.nodetype.constraint.ValueConstraintTest,0.64,8,2,10,0,8,2,0,2,200,1
"org.apache.jackrabbit.spi.commons.nodetype.constraint.DateConstraint",3,0.62,7.00,70,1.02,79651.51,7,4,10,20,4,105.53,11,110,1,2,84.92,0.00,0.50,0.67,0,0.00,10,3045.17,0,0,4,org.apache.jackrabbit.spi.commons.nodetype.constraint.ValueConstraint,0.00,17,1,21,0,17,3,0,7,557,0
"org.apache.jackrabbit.spi.commons.nodetype.constraint.DateConstraintTest",6,1.00,1.00,25,0.29,6696.31,7,1,8,18,3,124.54,4,32,0,3,124.54,0.00,0.67,0.00,1,10.00,1,872.89,0,5,3,org.apache.jackrabbit.spi.commons.nodetype.constraint.ValueConstraintTest,0.72,12,2,6,0,12,1,0,2,200,1
"org.apache.jackrabbit.spi.commons.nodetype.constraint.NameConstraint",5,0.75,2.00,32,0.40,14310.63,6,1,10,18,8,135.21,16,52,2,2,114.59,0.00,0.50,0.40,0,9.00,3,1204.56,1,3,7,org.apache.jackrabbit.spi.commons.nodetype.constraint.ValueConstraint,0.00,13,1,10,0,13,2,0,6,252,0
"org.apache.jackrabbit.spi.commons.nodetype.constraint.NameConstraintTest",7,1.00,1.14,25,0.32,7098.75,8,1,5,18,3,129.50,3,35,0,3,129.50,0.00,0.67,0.00,1,3.00,2,966.27,1,5,3,org.apache.jackrabbit.spi.commons.nodetype.constraint.ValueConstraintTest,0.81,11,2,8,0,11,2,0,1,223,1
"org.apache.jackrabbit.spi.commons.nodetype.constraint.NumericConstraint",3,0.62,6.67,75,1.00,70811.19,7,4,7,20,4,104.60,11,117,2,2,83.98,0.00,0.50,0.67,1,0.00,9,2998.49,0,0,3,org.apache.jackrabbit.spi.commons.nodetype.constraint.ValueConstraint,0.00,17,1,20,0,17,3,0,7,545,0
"org.apache.jackrabbit.spi.commons.nodetype.constraint.NumericConstraintTest",9,1.00,1.00,21,0.22,3343.62,10,1,5,14,4,139.53,4,31,0,3,139.53,0.00,0.67,0.00,1,26.00,1,650.63,0,8,4,org.apache.jackrabbit.spi.commons.nodetype.constraint.ValueConstraintTest,0.64,5,2,9,0,5,1,0,2,169,1
"org.apache.jackrabbit.spi.commons.nodetype.constraint.PathConstraint",5,0.20,4.20,73,0.98,47201.42,10,5,13,31,12,96.85,23,109,3,2,96.61,0.00,0.50,0.36,0,5.00,7,2934.81,1,3,10,org.apache.jackrabbit.spi.commons.nodetype.constraint.ValueConstraint,0.00,26,1,21,0,26,2,0,13,554,0
"org.apache.jackrabbit.spi.commons.nodetype.constraint.PathConstraintTest",7,1.00,1.14,27,0.39,10294.33,8,1,8,16,6,128.23,3,38,0,3,128.23,0.00,0.67,0.00,2,11.00,2,1169.74,1,5,6,org.apache.jackrabbit.spi.commons.nodetype.constraint.ValueConstraintTest,0.81,9,2,8,0,9,2,0,1,265,1
"org.apache.jackrabbit.spi.commons.nodetype.constraint.ReferenceConstraint",5,1.00,1.80,30,0.36,12098.79,6,1,10,17,8,135.81,17,48,2,2,115.19,0.00,0.50,0.20,0,13.00,3,1090.70,1,3,7,org.apache.jackrabbit.spi.commons.nodetype.constraint.ValueConstraint,0.00,12,1,9,0,12,2,0,7,233,0
"org.apache.jackrabbit.spi.commons.nodetype.constraint.ReferenceConstraintTest",8,1.00,1.12,25,0.30,6384.62,9,1,9,19,5,130.32,5,36,0,3,130.32,0.00,0.67,0.00,1,22.00,2,908.79,1,5,5,org.apache.jackrabbit.spi.commons.nodetype.constraint.ValueConstraintTest,0.89,11,2,9,0,11,3,0,3,213,1
"org.apache.jackrabbit.spi.commons.nodetype.constraint.StringConstraint",2,0.00,2.50,21,0.29,11674.69,3,1,8,12,4,124.44,7,32,2,2,103.83,0.00,0.50,1.00,0,0.00,3,882.70,0,0,3,org.apache.jackrabbit.spi.commons.nodetype.constraint.ValueConstraint,0.00,10,1,5,0,10,2,0,3,173,0
"org.apache.jackrabbit.spi.commons.nodetype.constraint.StringConstraintTest",9,1.00,1.00,21,0.20,2891.09,10,1,8,12,6,140.03,4,31,0,3,140.03,0.00,0.67,0.00,1,19.00,1,598.13,0,8,6,org.apache.jackrabbit.spi.commons.nodetype.constraint.ValueConstraintTest,0.64,3,2,9,0,3,1,0,2,158,1
"org.apache.jackrabbit.spi.commons.nodetype.constraint.ValueConstraint",11,0.18,2.27,85,1.30,72167.30,15,4,12,30,37,60.75,111,139,30,1,109.23,0.00,0.00,0.09,1,23.00,9,3897.94,0,7,14,java.lang.Object,0.00,19,0,25,7,19,4,1,21,744,2
"org.apache.jackrabbit.spi.commons.nodetype.constraint.ValueConstraintTest",19,0.28,1.84,110,1.06,27112.61,22,3,13,30,15,119.95,9,119,7,2,119.95,7.00,0.11,0.07,7,58.00,4,3167.15,1,7,8,junit.framework.TestCase,0.00,11,1,35,7,11,12,0,7,685,2
"org.apache.jackrabbit.spi.commons.nodetype.constraint.ValueConstraintTest$NamespaceResolver",2,0.00,1.00,5,0.03,370.77,2,0,13,2,0,141.91,0,7,0,1,141.91,0.00,0.00,0.00,0,2.00,1,87.73,0,2,0,java.lang.Object,0.00,0,0,2,0,0,0,0,0,28,0
"org.apache.jackrabbit.j.AbstractConfig",6,0.00,2.33,45,0.61,17963.86,9,3,9,30,5,161.91,10,61,3,1,111.91,0.00,0.00,0.33,1,10.00,4,1817.27,0,1,2,java.lang.Object,0.00,24,0,14,3,24,5,0,3,369,2
"org.apache.jackrabbit.j.BootstrapConfig",12,0.04,1.17,40,0.28,4197.02,17,5,3,22,5,183.14,15,55,4,2,133.14,0.00,0.50,0.23,0,42.00,3,839.56,2,4,3,org.apache.jackrabbit.j2ee.AbstractConfig,0.22,10,1,14,0,10,8,0,1,229,1
"org.apache.jackrabbit.j.Installer",4,0.31,4.00,77,1.06,40225.14,17,13,11,28,1,109.60,72,99,1,1,91.46,0.00,0.00,0.31,2,0.00,10,3185.35,0,0,0,java.lang.Object,0.00,24,0,16,0,24,4,0,20,571,1
"org.apache.jackrabbit.j.JCRWebdavServerServlet",1,0.00,1.00,3,0.03,323.38,1,0,1,3,2,85.33,8,6,0,4,133.44,0.00,0.75,0.00,0,1.00,1,98.54,0,1,2,org.apache.jackrabbit.webdav.jcr.JCRWebdavServerServlet,0.07,2,3,1,0,2,0,0,2,29,1
"org.apache.jackrabbit.j.JNDIConfig",10,0.03,1.50,38,0.37,6417.74,14,4,5,25,3,181.00,16,54,2,2,131.00,0.00,0.50,0.22,0,38.00,3,1121.64,1,3,2,org.apache.jackrabbit.j2ee.AbstractConfig,0.12,15,1,15,0,15,7,0,4,263,1
"org.apache.jackrabbit.j.JcrApiNotFoundException",1,1.00,1.00,4,0.03,396.24,2,1,0,1,1,83.96,11,6,0,3,128.08,0.00,0.67,0.00,0,1.00,1,97.38,0,0,1,org.apache.jackrabbit.j2ee.ServletExceptionWithCause,0.00,0,2,1,0,0,1,0,3,27,1
"org.apache.jackrabbit.j.JcrRemotingServlet",1,0.00,1.00,3,0.04,346.31,1,0,1,3,2,90.91,7,5,0,5,133.20,0.00,0.80,0.00,0,1.00,1,107.71,0,1,2,org.apache.jackrabbit.server.remoting.davex.JcrRemotingServlet,0.07,2,4,1,0,2,0,0,2,31,1
"org.apache.jackrabbit.j.LoggingServlet",4,1.00,3.00,40,0.50,16153.22,5,1,20,28,1,114.18,68,64,0,2,105.05,0.00,0.50,0.25,3,6.00,6,1513.82,0,0,1,javax.servlet.http.HttpServlet,0.00,24,1,12,0,24,4,0,12,294,1
"org.apache.jackrabbit.j.LoggingServlet$ContextResolver",1,0.00,4.00,13,0.17,5567.46,1,0,20,11,0,99.63,0,20,0,1,99.63,0.00,0.00,0.00,0,1.00,4,505.13,0,1,0,java.lang.Object,0.00,10,0,4,0,10,0,1,0,98,1
"org.apache.jackrabbit.j.RMIConfig",15,0.02,1.53,62,0.68,30784.38,22,7,7,30,3,162.25,32,86,2,2,122.36,0.00,0.50,0.16,0,72.00,9,2032.85,1,5,2,org.apache.jackrabbit.j2ee.AbstractConfig,0.10,15,1,23,0,15,10,0,15,428,1
"org.apache.jackrabbit.j.RepositoryAccessServlet",10,0.08,3.80,115,1.35,51864.08,17,7,18,52,6,52.59,99,170,4,2,102.59,0.00,0.50,0.21,4,6.00,10,4059.04,0,8,2,javax.servlet.http.HttpServlet,0.00,42,1,38,0,42,2,0,32,789,1
"org.apache.jackrabbit.j.RepositoryAccessServlet$ClientFactoryDelegater",1,0.00,1.00,2,0.02,146.32,1,0,18,1,0,142.72,0,4,0,1,142.72,0.00,0.00,0.00,0,1.00,1,58.53,0,1,0,java.lang.Object,0.00,0,0,1,0,0,0,0,0,18,3
"org.apache.jackrabbit.j.RepositoryAccessServlet$RMIClientFactoryDelegater",1,1.00,1.00,5,0.06,878.60,2,1,18,5,0,171.75,1,8,0,2,121.75,0.00,0.50,0.00,0,1.00,1,190.92,0,1,0,org.apache.jackrabbit.j2ee.ClientFactoryDelegater,0.00,4,1,1,0,4,0,0,1,46,2
"org.apache.jackrabbit.j.RepositoryStartupServlet",21,0.05,3.24,201,2.64,121943.68,29,8,34,91,10,85.35,295,309,1,2,105.49,0.00,0.50,0.17,11,62.00,12,7931.47,2,6,9,org.apache.jackrabbit.servlet.AbstractRepositoryServlet,0.00,70,1,68,0,70,15,0,67,1460,1
"org.apache.jackrabbit.j.RepositoryStartupServlet$RMIRemoteFactoryDelegater",1,0.00,1.00,4,0.04,639.67,2,1,34,3,0,126.45,0,8,0,2,126.45,0.00,0.50,1.00,0,0.00,1,132.92,0,1,0,org.apache.jackrabbit.j2ee.RemoteFactoryDelegater,0.00,2,1,1,0,2,0,0,0,34,2
"org.apache.jackrabbit.j.RepositoryStartupServlet$RMIServerSocketFactory",1,0.00,1.00,3,0.03,373.67,1,0,34,2,0,132.94,0,4,0,1,132.94,0.00,0.00,0.00,0,1.00,1,78.32,0,1,0,java.lang.Object,0.00,1,0,1,0,1,0,0,0,22,0
"org.apache.jackrabbit.j.RepositoryStartupServlet$RemoteFactoryDelegater",1,0.00,1.00,2,0.02,121.82,1,0,34,1,0,143.35,0,4,0,1,143.35,0.00,0.00,0.00,0,1.00,1,48.73,0,1,0,java.lang.Object,0.00,0,0,1,0,0,0,0,0,16,3
"org.apache.jackrabbit.j.RepositoryStartupServlet$RepositoryFactory",1,0.00,2.00,7,0.04,1173.50,1,0,34,2,0,115.15,0,9,0,1,115.15,0.00,0.00,0.00,0,0.00,2,131.19,0,1,0,java.lang.Object,0.00,1,0,2,0,1,0,0,0,33,0
"org.apache.jackrabbit.j.ServletExceptionWithCause",1,1.00,2.00,6,0.05,687.61,2,1,1,3,5,109.11,15,9,5,2,119.47,1.00,0.33,0.00,0,1.00,2,156.28,0,0,0,javax.servlet.ServletException,0.00,2,1,2,1,2,1,0,3,40,1
"org.apache.jackrabbit.j.SimpleWebdavServlet",2,1.00,1.50,8,0.07,1118.48,3,1,1,4,2,78.33,20,12,0,4,126.81,0.00,0.75,0.50,0,2.00,2,216.88,0,1,2,org.apache.jackrabbit.webdav.simple.SimpleWebdavServlet,0.06,2,3,3,0,2,1,0,4,57,1
"org.apache.jackrabbit.core.persistence.bundle.util.BundleBinding",8,0.19,12.50,407,6.73,688863.17,11,3,25,103,19,67.71,134,553,4,2,68.18,0.00,0.50,0.50,3,0.00,29,20195.33,11,1,16,org.apache.jackrabbit.core.persistence.bundle.util.ItemStateBinding,0.00,95,1,100,0,95,7,0,75,3052,1
"org.apache.jackrabbit.core.persistence.bundle.util.BundleCache",8,0.19,1.88,54,0.63,28087.10,14,6,4,20,3,63.91,72,69,1,1,113.91,0.00,0.00,0.33,0,0.00,5,1880.17,0,0,2,java.lang.Object,0.00,12,0,15,0,12,8,0,18,391,1
"org.apache.jackrabbit.core.persistence.bundle.util.BundleCache$Entry",1,2.00,1.00,6,0.04,560.40,3,2,4,1,1,82.77,12,8,0,1,120.33,0.00,0.00,0.00,0,1.00,1,127.05,0,0,1,java.lang.Object,0.00,0,0,1,0,0,1,0,3,36,3
"org.apache.jackrabbit.core.persistence.bundle.util.ConnectionFactory",2,0.00,5.50,21,0.37,30058.04,2,0,7,10,4,80.27,29,36,4,1,100.41,0.00,0.00,0.00,0,2.00,10,1117.30,0,1,0,java.lang.Object,0.00,8,0,11,0,8,1,0,9,196,1
"org.apache.jackrabbit.core.persistence.bundle.util.ConnectionRecoveryManager",14,0.07,3.07,154,1.76,67428.24,26,12,11,48,9,73.51,186,211,8,1,102.90,0.00,0.00,0.15,8,58.00,7,5279.27,0,7,1,java.lang.Object,0.00,34,0,43,0,34,7,0,37,1029,1
"org.apache.jackrabbit.core.persistence.bundle.util.ConnectionRecoveryManager$StreamWrapper",1,2.00,1.00,6,0.04,562.20,3,2,11,1,0,72.21,8,8,0,1,120.32,0.00,0.00,0.00,0,1.00,1,134.95,0,0,0,java.lang.Object,0.00,0,0,1,0,0,1,0,1,37,2
"org.apache.jackrabbit.core.persistence.bundle.util.DbNameIndex",8,0.14,2.62,83,0.97,36063.61,14,6,5,25,7,62.41,61,121,5,1,104.70,0.00,0.00,0.29,2,10.00,4,2904.01,0,2,2,java.lang.Object,0.00,17,0,21,2,17,6,1,18,571,1
"org.apache.jackrabbit.core.persistence.bundle.util.ErrorHandling",4,0.00,1.75,21,0.19,5763.63,7,3,1,11,4,87.70,27,27,4,1,119.92,0.00,0.00,0.33,0,4.00,3,575.16,0,1,0,java.lang.Object,0.00,7,0,7,0,7,3,0,8,137,2
"org.apache.jackrabbit.core.persistence.bundle.util.HashMapIndex",5,0.35,2.80,63,0.77,28461.80,10,5,9,31,4,56.81,56,82,1,1,100.94,0.00,0.00,0.48,2,0.00,5,2298.44,0,1,3,java.lang.Object,0.00,26,0,14,0,26,4,1,11,458,1
"org.apache.jackrabbit.core.persistence.bundle.util.ItemStateBinding",23,0.05,2.00,197,2.38,88455.92,32,9,22,85,16,58.92,212,222,1,1,108.92,0.00,0.00,0.07,11,148.00,8,7148.45,0,9,15,java.lang.Object,0.00,62,0,46,1,62,14,0,67,1399,1
"org.apache.jackrabbit.core.persistence.bundle.util.LRUNodeIdCache",4,0.33,2.00,25,0.29,7936.68,9,5,4,13,2,65.85,38,34,1,1,115.85,0.00,0.00,0.45,0,0.00,3,876.31,0,0,1,java.lang.Object,0.00,9,0,8,0,9,4,0,10,190,1
"org.apache.jackrabbit.core.persistence.bundle.util.NGKDbNameIndex",3,0.00,1.33,14,0.15,3065.56,3,0,1,6,3,76.67,24,23,1,2,124.78,0.00,0.50,0.00,0,1.00,2,449.79,1,0,2,org.apache.jackrabbit.core.persistence.bundle.util.DbNameIndex,0.00,3,1,4,0,3,3,0,5,103,1
"org.apache.jackrabbit.core.persistence.bundle.util.NodePropBundle",34,0.03,1.29,135,1.54,34760.51,48,14,20,94,19,97.22,219,180,8,1,129.44,0.00,0.00,0.10,4,522.00,5,4612.53,0,11,12,java.lang.Object,0.00,60,0,44,0,60,23,0,72,997,1
"org.apache.jackrabbit.core.persistence.bundle.util.NodePropBundle$ChildNodeEntry",3,0.25,1.00,10,0.06,727.65,5,2,20,3,2,102.20,19,14,0,1,134.42,0.00,0.00,0.33,0,5.00,1,180.64,0,2,2,java.lang.Object,0.00,0,0,3,0,0,1,0,5,53,2
"org.apache.jackrabbit.core.persistence.bundle.util.NodePropBundle$PropertyEntry",18,0.02,1.28,60,0.49,9941.18,25,7,20,26,6,113.68,97,82,0,1,131.55,0.00,0.00,0.13,0,146.00,5,1482.00,0,5,6,java.lang.Object,0.00,8,0,23,0,8,13,0,26,360,2
"org.apache.jackrabbit.core.persistence.bundle.util.PostgreSQLNameIndex",4,0.67,1.75,28,0.28,7230.59,5,1,2,11,3,81.48,26,42,1,2,113.70,0.00,0.50,0.50,1,0.00,3,852.07,0,0,2,org.apache.jackrabbit.core.persistence.bundle.util.DbNameIndex,0.00,7,1,7,0,7,4,0,5,183,1
"org.apache.jackrabbit.core.persistence.bundle.util.TrackingInputStream",11,0.23,1.36,40,0.32,7877.35,14,3,2,18,3,130.88,47,56,3,2,130.65,0.00,0.50,0.55,0,0.00,2,948.04,0,0,0,java.io.InputStream,0.00,7,1,15,0,7,11,0,15,241,1
"org.apache.jackrabbit.jcr.LabelTest",5,0.00,1.00,32,0.44,6611.24,5,0,5,17,2,117.39,0,38,1,6,117.39,0.00,0.83,0.00,0,0.00,1,1327.53,0,0,1,org.apache.jackrabbit.test.api.version.VersionLabelTest,0.00,12,5,5,0,12,5,0,0,282,1
"org.apache.jackrabbit.jcr.TestAll",1,0.00,1.00,5,0.04,864.35,1,0,3,3,2,142.42,3,7,1,2,121.80,0.00,0.50,0.00,0,1.00,1,115.51,0,1,1,junit.framework.TestCase,0.00,2,1,1,0,2,0,0,1,31,1
"org.apache.jackrabbit.jcr.VersionHistoryImpl",26,0.20,1.77,170,2.12,56010.64,29,3,32,74,16,115.83,123,208,2,3,115.59,0.00,0.67,0.14,11,190.00,3,6345.55,6,15,14,org.apache.jackrabbit.jcr2spi.NodeImpl,0.04,48,2,46,0,48,11,1,42,1296,1
"org.apache.jackrabbit.jcr.VersionImpl",12,1.00,1.75,65,0.66,21631.30,13,1,18,24,8,119.39,58,83,2,3,119.16,0.00,0.67,0.08,3,38.00,4,1972.78,7,8,6,org.apache.jackrabbit.jcr2spi.NodeImpl,0.04,12,2,21,0,12,4,1,21,429,1
"org.apache.jackrabbit.jcr.VersionManager",19,0.00,1.00,20,0.31,1973.06,19,0,16,19,16,105.12,172,21,12,1,155.12,0.00,0.00,0.00,0,19.00,1,931.07,0,9,4,,0.00,0,0,19,0,0,10,0,20,252,1
"org.apache.jackrabbit.jcr.VersionManagerImpl",20,0.11,1.50,105,1.59,51770.09,22,2,35,59,25,167.96,22,134,1,1,117.96,0.00,0.00,0.40,1,0.00,6,4777.57,0,9,24,java.lang.Object,0.00,39,0,30,0,39,11,1,13,968,1
"org.apache.jackrabbit.core.security.AMContext",8,0.02,1.00,30,0.21,2832.21,15,7,6,8,12,83.13,72,45,9,1,133.13,0.00,0.00,0.12,0,50.00,1,637.61,0,7,3,java.lang.Object,0.00,0,0,8,0,0,1,0,15,162,1
"org.apache.jackrabbit.core.security.AbstractAccessControlManager",12,0.73,1.00,39,0.42,5687.03,13,1,16,17,6,99.91,75,49,1,1,132.13,0.00,0.00,0.33,4,28.00,1,1257.41,0,7,5,java.lang.Object,0.00,5,0,12,3,5,5,1,16,294,2
"org.apache.jackrabbit.core.security.AccessManager",10,3.00,1.00,14,0.14,769.24,13,3,8,10,22,126.77,136,18,16,1,156.15,0.00,0.00,0.00,0,10.00,1,420.62,0,0,6,,0.00,0,0,10,0,0,10,0,14,123,1
"org.apache.jackrabbit.core.security.AccessManagerTest",16,1.00,1.69,131,1.88,47421.98,17,1,25,48,14,159.85,22,180,1,4,109.85,0.00,0.75,0.00,2,0.00,3,5635.29,0,2,13,org.apache.jackrabbit.test.AbstractJCRTest,0.00,32,3,27,0,32,14,0,19,1125,1
"org.apache.jackrabbit.core.security.AnonymousPrincipal",5,0.75,1.40,15,0.09,1193.85,6,1,2,6,3,174.28,10,23,3,1,134.40,0.00,0.00,0.40,0,7.00,3,272.29,0,2,0,java.lang.Object,0.00,1,0,7,0,1,3,2,4,77,2
"org.apache.jackrabbit.core.security.DefaultAccessManager",25,0.07,2.16,171,2.01,56662.65,35,10,33,67,21,115.61,123,230,2,2,115.37,0.00,0.50,0.16,6,189.00,7,6023.74,0,8,19,org.apache.jackrabbit.core.security.AbstractAccessControlManager,0.11,42,1,54,0,42,17,1,39,1214,1
"org.apache.jackrabbit.core.security.DefaultAccessManager$CompiledPermissions",4,0.00,1.00,8,0.04,326.02,4,0,33,4,2,144.72,2,12,0,1,144.72,0.00,0.00,0.00,0,4.00,1,129.65,0,0,2,java.lang.Object,0.00,0,0,4,0,0,4,0,2,41,0
"org.apache.jackrabbit.core.security.DefaultAccessManager$WorkspaceAccess",2,1.00,3.00,24,0.24,7108.02,6,4,33,6,1,152.53,2,31,0,1,102.53,0.00,0.00,0.75,0,0.00,4,710.71,0,0,1,java.lang.Object,0.00,4,0,6,0,4,2,0,2,156,1
"org.apache.jackrabbit.core.security.JackrabbitSecurityManager",8,0.00,1.00,9,0.07,296.00,8,0,8,8,6,116.36,56,10,1,1,158.65,0.00,0.00,0.00,0,8.00,1,205.17,0,5,5,,0.00,0,0,8,0,0,3,0,8,69,1
"org.apache.jackrabbit.core.security.SecurityConstants",0,0.00,0.00,6,0.05,476.87,5,5,0,0,10,171.00,23,7,10,1,171.00,0.00,0.00,0.00,0,0.00,0,143.06,0,0,0,,0.00,0,0,0,0,0,0,0,6,35,1
"org.apache.jackrabbit.core.security.SimpleJBossAccessManager",11,0.07,1.55,43,0.61,21336.42,14,3,16,28,8,177.21,19,65,0,1,127.21,0.00,0.00,0.27,2,23.00,5,1830.13,0,0,8,java.lang.Object,0.00,17,0,17,0,17,11,1,7,372,1
"org.apache.jackrabbit.core.security.SystemPrincipal",5,0.75,1.40,15,0.09,1193.85,6,1,2,6,5,174.28,10,23,5,1,134.40,0.00,0.00,0.40,0,7.00,3,272.29,0,2,0,java.lang.Object,0.00,1,0,7,0,1,3,2,4,77,2
"org.apache.jackrabbit.core.security.TestAll",1,0.00,1.00,5,0.04,864.35,1,0,3,3,1,103.93,5,7,0,2,121.80,0.00,0.50,0.00,0,1.00,1,115.51,0,1,1,junit.framework.TestCase,0.00,2,1,1,0,2,0,0,1,31,1
"org.apache.jackrabbit.core.security.TestPrincipal",4,0.17,2.00,16,0.16,3782.49,6,2,3,8,5,174.95,5,23,5,1,124.95,0.00,0.00,0.38,0,0.00,4,480.51,0,1,0,java.lang.Object,0.00,4,0,8,0,4,3,1,1,115,1
"org.apache.jackrabbit.core.security.UserPrincipal",5,0.25,1.60,19,0.14,3004.05,6,1,2,8,2,171.10,13,28,2,1,131.21,0.00,0.00,0.80,0,0.00,3,427.63,0,2,0,java.lang.Object,0.00,3,0,8,0,3,3,2,4,110,1
"org.apache.jackrabbit.core.query.AQTQueryFactory",1,0.00,1.00,3,0.03,368.95,1,0,3,3,3,90.70,7,5,1,1,132.99,0.00,0.00,0.00,0,1.00,1,88.18,0,1,2,java.lang.Object,0.00,2,0,1,0,2,0,1,2,25,2
"org.apache.jackrabbit.core.query.AbstractIndexingTest",2,1.00,1.50,16,0.14,2233.95,5,3,2,6,3,153.10,5,20,2,5,113.22,0.75,0.50,0.83,0,0.00,2,405.78,3,0,1,org.apache.jackrabbit.core.query.AbstractQueryTest,0.26,4,4,3,3,4,2,0,2,96,1
"org.apache.jackrabbit.core.query.AbstractQueryHandler",11,0.08,1.18,32,0.28,4342.68,16,5,6,20,6,97.00,83,47,0,1,139.29,0.00,0.00,0.13,1,62.00,3,850.13,0,4,6,java.lang.Object,0.00,9,0,13,2,9,7,1,18,213,2
"org.apache.jackrabbit.core.query.AbstractQueryImpl",1,0.00,1.00,2,0.03,276.70,1,0,5,1,5,140.07,16,8,2,1,140.54,0.00,0.00,0.00,0,1.00,1,104.61,0,0,3,java.lang.Object,0.00,0,0,1,2,0,1,1,2,27,2
"org.apache.jackrabbit.core.query.AbstractQueryTest",13,0.21,2.00,101,1.22,40261.04,15,2,18,52,30,79.60,83,115,26,4,111.83,9.67,0.09,0.31,1,37.00,5,3657.79,2,3,4,org.apache.jackrabbit.test.AbstractJCRTest,0.22,39,3,26,29,39,10,0,16,735,1
"org.apache.jackrabbit.core.query.AbstractQueryTest$NodeIteratorAdapter",1,0.00,2.00,6,0.07,1693.22,1,0,18,5,0,116.39,0,9,0,1,116.39,0.00,0.00,0.00,0,1.00,2,208.76,1,1,0,java.lang.Object,0.00,4,0,2,0,4,0,0,0,48,0
"org.apache.jackrabbit.core.query.ChildAxisQueryTest",8,0.00,1.00,154,3.05,136602.06,8,0,7,19,2,89.97,7,187,1,5,89.97,0.00,0.80,0.00,0,0.00,1,9147.26,2,0,1,org.apache.jackrabbit.core.query.AbstractQueryTest,0.00,11,4,8,0,11,8,0,2,1629,1
"org.apache.jackrabbit.core.query.CompoundQueryFactory",3,1.00,2.33,18,0.19,5708.15,4,1,5,10,2,83.73,19,24,1,1,115.95,0.00,0.00,0.00,0,3.00,3,572.72,0,2,1,java.lang.Object,0.00,7,0,7,1,7,1,1,5,131,1
"org.apache.jackrabbit.core.query.DerefTest",5,0.53,1.20,82,1.16,32127.72,14,9,7,24,2,53.76,35,106,1,5,96.06,0.00,0.80,0.53,0,0.00,2,3487.69,3,0,1,org.apache.jackrabbit.core.query.AbstractQueryTest,0.24,19,4,6,0,19,5,0,8,664,1
"org.apache.jackrabbit.core.query.ExcerptTest",15,0.46,1.07,45,0.42,5541.20,17,2,6,24,2,182.97,15,83,1,5,132.97,0.00,0.80,0.07,4,54.00,2,1267.62,1,3,1,org.apache.jackrabbit.core.query.AbstractQueryTest,0.00,9,4,16,0,9,12,0,1,313,1
"org.apache.jackrabbit.core.query.ExecutableQuery",2,0.00,1.00,3,0.03,127.55,2,0,4,2,4,112.66,23,5,3,1,156.79,0.00,0.00,0.00,0,2.00,1,79.75,0,1,1,,0.00,0,0,2,0,0,1,0,3,26,1
"org.apache.jackrabbit.core.query.FnNameQueryTest",2,0.00,1.00,22,0.36,12019.26,2,0,2,5,2,152.40,3,32,1,5,102.40,0.00,0.80,0.00,0,0.00,1,1090.24,1,0,1,org.apache.jackrabbit.core.query.AbstractQueryTest,0.00,3,4,2,0,3,2,0,1,213,1
"org.apache.jackrabbit.core.query.FulltextQueryTest",14,0.00,1.21,162,2.76,69425.00,14,0,4,30,2,153.01,16,200,1,5,103.01,0.00,0.80,0.00,1,0.00,4,8265.35,1,0,1,org.apache.jackrabbit.core.query.AbstractQueryTest,0.00,16,4,17,0,16,14,0,7,1522,1
"org.apache.jackrabbit.core.query.IndexFormatVersionTest",4,0.00,1.00,15,0.18,2765.50,4,0,6,13,6,180.84,4,25,1,4,130.84,0.00,0.75,0.00,1,6.00,1,545.37,0,0,5,org.apache.jackrabbit.test.AbstractJCRTest,0.00,9,3,4,0,9,4,0,1,121,1
"org.apache.jackrabbit.core.query.IndexingAggregateTest",5,0.00,2.00,107,1.58,66624.35,5,0,13,38,3,128.92,10,111,1,6,89.04,0.00,0.83,0.00,2,2.00,3,4734.79,2,1,2,org.apache.jackrabbit.core.query.AbstractIndexingTest,0.00,33,5,10,0,33,4,0,7,823,1
"org.apache.jackrabbit.core.query.IndexingAggregateTest$NodeCreationCallback",1,0.00,2.00,6,0.08,1456.97,1,0,13,5,0,166.90,1,9,0,1,116.90,0.00,0.00,0.00,0,1.00,2,250.76,0,0,0,java.lang.Object,0.00,4,0,2,0,4,1,0,1,53,0
"org.apache.jackrabbit.core.query.IndexingAggregateTest$NodeCreationCallback_0",1,0.00,1.00,2,0.02,99.33,1,0,13,1,0,144.04,0,3,0,1,144.04,0.00,0.00,0.00,0,1.00,1,49.66,0,0,0,,0.00,0,0,1,0,0,1,0,0,16,2
"org.apache.jackrabbit.core.query.IndexingRuleTest",5,0.12,1.20,70,1.09,32374.99,7,2,8,25,2,148.19,5,85,1,6,98.19,0.00,0.83,0.60,0,0.00,2,3267.74,2,0,1,org.apache.jackrabbit.core.query.AbstractIndexingTest,0.00,20,5,6,0,20,5,0,3,602,1
"org.apache.jackrabbit.core.query.LargeResultSetTest",3,0.00,2.67,40,0.42,14914.14,3,0,7,13,4,140.00,6,43,1,5,100.11,0.00,0.80,0.00,2,1.00,4,1266.44,2,0,3,org.apache.jackrabbit.core.query.AbstractQueryTest,0.00,10,4,8,0,10,3,0,4,243,1
"org.apache.jackrabbit.core.query.LimitAndOffsetTest",9,0.44,1.00,85,0.96,29716.28,13,4,8,26,3,107.70,1,96,0,5,107.70,0.00,0.80,0.64,1,0.00,1,2888.95,2,1,3,org.apache.jackrabbit.core.query.AbstractQueryTest,0.22,17,4,9,0,17,8,0,1,627,1
"org.apache.jackrabbit.core.query.MixinTest",2,0.00,1.50,19,0.28,6400.86,2,0,5,14,3,128.32,6,28,1,5,107.71,0.00,0.80,0.00,0,2.00,2,829.53,2,0,2,org.apache.jackrabbit.core.query.AbstractQueryTest,0.13,12,4,3,0,12,2,0,4,162,1
"org.apache.jackrabbit.core.query.OnWorkspaceInconsistency",4,0.22,1.25,19,0.20,4917.24,7,3,12,10,10,80.03,46,31,2,1,124.16,0.00,0.00,0.17,0,8.00,2,613.75,0,2,8,java.lang.Object,0.00,6,0,5,0,6,2,0,8,143,2
"org.apache.jackrabbit.core.query.OnWorkspaceInconsistency$OnWorkspaceInconsistency",1,0.00,1.00,5,0.14,2784.82,1,0,12,11,8,117.80,0,18,0,1,117.80,0.00,0.00,0.00,0,0.00,1,426.72,0,0,8,java.lang.Object,0.00,10,0,1,0,10,1,0,0,83,0
"org.apache.jackrabbit.core.query.OrderByTest",21,0.00,1.19,128,1.89,65376.43,21,0,12,48,2,164.42,34,148,1,5,114.42,0.00,0.80,0.00,1,81.00,4,5667.14,3,8,1,org.apache.jackrabbit.core.query.AbstractQueryTest,0.00,27,4,25,0,27,13,0,18,1126,1
"org.apache.jackrabbit.core.query.PathQueryNodeTest",2,0.00,1.00,24,0.33,9078.93,3,1,10,10,9,101.95,0,28,1,2,101.95,0.00,0.50,1.00,0,0.00,1,976.05,0,0,8,junit.framework.TestCase,0.00,8,1,2,0,8,2,0,0,212,1
"org.apache.jackrabbit.core.query.PathQueryNodeTest$NamespaceResolver",2,0.00,2.00,7,0.07,1085.66,2,0,10,5,1,131.51,0,11,0,1,131.51,0.00,0.00,0.00,0,2.00,3,203.19,0,2,1,java.lang.Object,0.00,3,0,4,0,3,0,0,0,54,0
"org.apache.jackrabbit.core.query.PropertyTypeRegistry",6,0.05,3.00,74,0.93,49215.20,10,4,15,30,10,81.80,35,85,5,1,99.67,0.00,0.00,0.29,3,6.00,7,2789.57,0,0,5,java.lang.Object,0.00,24,0,18,0,24,6,1,14,521,1
"org.apache.jackrabbit.core.query.PropertyTypeRegistry$TypeMapping",1,3.00,1.00,8,0.06,883.86,4,3,15,1,1,134.73,3,10,0,1,114.11,0.00,0.00,0.00,0,1.00,1,188.02,0,0,1,java.lang.Object,0.00,0,0,1,0,0,1,0,3,50,2
"org.apache.jackrabbit.core.query.QOMQueryFactory",3,0.25,1.00,10,0.10,1411.91,5,2,8,7,3,89.86,22,16,1,1,132.16,0.00,0.00,0.33,0,4.00,1,313.04,0,2,2,java.lang.Object,0.00,4,0,3,0,4,1,1,6,81,1
"org.apache.jackrabbit.core.query.QueryFactory",2,0.00,1.00,3,0.02,166.89,2,0,4,2,4,105.87,18,5,4,1,155.87,0.00,0.00,0.00,0,2.00,1,73.51,0,2,0,,0.00,0,0,2,0,0,0,0,3,24,1
"org.apache.jackrabbit.core.query.QueryHandler",10,0.00,1.00,11,0.10,539.26,10,0,10,10,21,109.26,85,21,13,1,157.36,0.00,0.00,0.00,0,10.00,1,297.52,0,2,9,,0.00,0,0,10,0,0,8,0,11,94,1
"org.apache.jackrabbit.core.query.QueryHandlerContext",12,0.02,1.00,46,0.35,5908.89,22,10,9,16,16,83.90,106,66,6,1,132.00,0.00,0.00,0.12,0,112.00,1,1053.61,0,8,11,java.lang.Object,0.00,4,0,12,0,4,4,0,23,253,1
"org.apache.jackrabbit.core.query.QueryImpl",12,0.05,1.75,77,0.89,23112.01,22,10,20,39,14,73.69,88,116,6,2,115.98,1.00,0.33,0.14,3,62.00,3,2666.41,0,5,8,org.apache.jackrabbit.core.query.AbstractQueryImpl,0.00,27,1,21,1,27,7,0,25,544,1
"org.apache.jackrabbit.core.query.QueryManagerImpl",8,0.11,1.50,43,0.54,14898.52,12,4,19,28,14,76.79,63,62,4,1,119.08,0.00,0.00,0.16,1,26.00,3,1619.94,0,5,10,java.lang.Object,0.00,20,0,12,0,20,3,1,17,348,1
"org.apache.jackrabbit.core.query.QueryManagerImpl$QueryFactoryImpl",2,0.00,1.00,6,0.05,464.98,2,0,19,6,3,134.57,0,23,0,2,134.57,0.00,0.50,0.00,0,2.00,1,150.46,0,0,3,org.apache.jackrabbit.core.query.CompoundQueryFactory,0.00,4,1,2,0,4,2,0,0,41,1
"org.apache.jackrabbit.core.query.QueryManagerImpl$QueryFactoryImpl$AQTQueryFactory",1,0.00,1.00,3,0.03,469.74,1,0,19,1,0,132.16,0,0,0,1,132.16,0.00,0.00,0.00,0,0.00,1,103.91,0,1,0,java.lang.Object,0.00,0,0,1,0,0,0,0,0,27,0
"org.apache.jackrabbit.core.query.QueryManagerImpl$QueryFactoryImpl$QueryObjectModelFactoryImpl_0",1,0.00,1.00,3,0.04,385.81,1,0,19,1,1,132.84,0,0,0,1,132.84,0.00,0.00,0.00,0,0.00,1,108.66,0,1,1,java.lang.Object,0.00,0,0,1,0,0,0,0,0,29,0
"org.apache.jackrabbit.core.query.QueryManagerImpl$QueryObjectModelFactoryImpl",1,0.00,1.00,3,0.04,421.72,1,0,19,1,1,132.53,0,7,0,1,132.53,0.00,0.00,0.00,0,0.00,1,118.72,0,1,1,java.lang.Object,0.00,0,0,1,0,0,0,0,0,31,0
"org.apache.jackrabbit.core.query.QueryObjectModelImpl",6,0.40,1.00,22,0.24,3911.49,7,1,12,14,7,88.75,46,40,1,3,131.04,0.00,0.67,0.67,0,0.00,1,713.10,2,4,6,org.apache.jackrabbit.core.query.QueryImpl,0.00,8,2,6,0,8,2,1,9,165,1
"org.apache.jackrabbit.core.query.QueryResultTest",10,0.67,2.90,164,2.21,62628.29,11,1,6,33,2,135.83,20,164,1,5,95.94,0.00,0.80,0.40,0,0.00,4,6633.88,1,0,1,org.apache.jackrabbit.core.query.AbstractQueryTest,0.11,23,4,29,0,23,10,0,17,1170,1
"org.apache.jackrabbit.core.query.SQLTest",3,0.00,1.00,25,0.40,7450.25,3,0,3,10,2,110.58,2,33,1,5,110.58,0.00,0.80,0.00,0,0.00,1,1207.63,1,0,1,org.apache.jackrabbit.core.query.AbstractQueryTest,0.00,7,4,3,0,7,3,0,1,230,1
"org.apache.jackrabbit.core.query.SelectClauseTest",3,0.00,1.00,57,0.98,27451.34,3,0,4,10,2,142.10,3,70,1,5,92.10,0.00,0.80,0.00,0,0.00,1,2925.14,1,0,1,org.apache.jackrabbit.core.query.AbstractQueryTest,0.00,7,4,3,0,7,3,0,1,526,1
"org.apache.jackrabbit.core.query.ShareableNodeTest",2,0.00,1.00,87,1.56,82226.06,2,0,5,19,3,25.63,16,90,1,5,73.73,0.00,0.80,0.00,0,0.00,1,4691.04,1,0,2,org.apache.jackrabbit.core.query.AbstractQueryTest,0.00,17,4,2,0,17,2,0,14,810,1
"org.apache.jackrabbit.core.query.SimpleQueryTest",19,0.00,1.00,366,6.35,288282.02,19,0,5,32,2,90.37,17,397,1,5,90.37,0.00,0.80,0.00,0,0.00,1,19038.39,1,0,1,org.apache.jackrabbit.core.query.AbstractQueryTest,0.00,13,4,19,0,13,19,0,15,3423,1
"org.apache.jackrabbit.core.query.SkipDeletedNodesTest",7,0.17,2.57,107,1.34,34237.99,9,2,8,25,2,55.57,50,124,1,5,97.86,0.00,0.80,0.64,0,0.00,3,4007.63,2,0,1,org.apache.jackrabbit.core.query.AbstractQueryTest,0.23,18,4,18,0,18,7,0,26,723,1
"org.apache.jackrabbit.core.query.SkipDeniedNodesTest",6,0.16,2.00,65,0.93,27778.36,11,5,17,38,8,104.67,4,78,1,5,104.67,0.00,0.80,0.33,3,6.00,4,2804.61,2,2,7,org.apache.jackrabbit.test.api.security.AbstractAccessControlTest,0.27,32,4,12,0,32,4,0,1,541,1
"org.apache.jackrabbit.core.query.SynonymProviderTest",3,0.00,1.33,26,0.34,9995.05,3,0,2,7,2,130.12,11,28,1,5,109.51,0.00,0.80,0.00,0,0.00,2,1017.27,1,0,1,org.apache.jackrabbit.core.query.AbstractQueryTest,0.00,4,4,4,0,4,3,0,2,211,1
"org.apache.jackrabbit.core.query.TestAll",1,0.00,1.00,27,0.36,14346.62,1,0,4,3,23,36.40,10,29,0,2,84.87,0.00,0.50,0.00,0,1.00,1,1070.34,0,1,23,junit.framework.TestCase,0.00,2,1,1,0,2,0,0,2,207,1
"org.apache.jackrabbit.core.query.TextExtractorTest",4,0.17,3.00,60,0.79,29463.18,6,2,7,26,1,117.04,14,72,0,5,96.42,0.00,0.80,0.38,2,0.00,5,2359.76,1,1,1,org.apache.jackrabbit.core.query.AbstractQueryTest,0.00,22,4,12,0,22,3,0,6,436,1
"org.apache.jackrabbit.core.query.UpperLowerCaseQueryTest",13,0.00,1.92,151,2.92,139252.01,13,0,9,55,3,150.27,23,244,1,5,100.27,0.00,0.80,0.00,2,31.00,7,8763.43,3,0,2,org.apache.jackrabbit.core.query.AbstractQueryTest,0.00,42,4,25,0,42,13,0,19,1558,1
"org.apache.jackrabbit.core.query.VersionStoreQueryTest",1,0.00,1.00,16,0.26,8681.74,1,0,3,11,2,46.96,8,19,1,5,95.07,0.00,0.80,0.00,0,0.00,1,770.92,1,0,1,org.apache.jackrabbit.core.query.AbstractQueryTest,0.00,10,4,1,0,10,1,0,3,147,1
"org.apache.jackrabbit.core.query.XPathAxisTest",31,0.17,1.00,112,1.26,18650.96,37,6,2,35,2,131.32,3,144,1,5,131.32,0.00,0.80,0.33,0,0.00,1,3770.30,4,0,1,org.apache.jackrabbit.core.query.AbstractQueryTest,0.15,4,4,31,0,4,31,0,1,864,1
"org.apache.jackrabbit.core.data.AbstractDataRecord",5,0.25,1.00,12,0.09,1318.70,6,1,0,9,3,98.41,37,19,1,1,140.70,0.00,0.00,0.80,0,0.00,1,277.88,0,1,2,java.lang.Object,0.00,4,0,5,2,4,4,1,7,80,2
"org.apache.jackrabbit.core.data.CopyValueTest",4,0.00,4.75,100,1.42,107642.46,4,0,6,29,2,83.85,18,117,1,4,83.61,0.00,0.75,0.00,2,4.00,15,4272.26,0,0,1,org.apache.jackrabbit.test.AbstractJCRTest,0.00,25,3,19,0,25,4,0,8,698,1
"org.apache.jackrabbit.core.data.DBDataStoreTest",4,0.67,2.75,55,0.57,23037.57,7,3,7,25,4,139.49,10,53,0,2,99.60,0.00,0.50,0.83,0,0.00,5,1712.48,0,0,4,junit.framework.TestCase,0.00,21,1,11,0,21,4,0,8,342,1
"org.apache.jackrabbit.core.data.DataIdentifier",5,0.08,1.20,21,0.25,8547.46,8,3,1,10,16,74.94,44,26,16,1,123.04,0.00,0.00,0.27,0,5.00,2,741.12,0,1,0,java.lang.Object,0.00,5,0,6,0,5,4,1,10,168,2
"org.apache.jackrabbit.core.data.DataRecord",4,0.00,1.00,5,0.02,77.53,4,0,1,4,9,128.64,25,6,7,1,160.86,0.00,0.00,0.00,0,4.00,1,57.02,0,2,2,,0.00,0,0,4,0,0,2,0,5,25,1
"org.apache.jackrabbit.core.data.DataStore",10,0.00,1.00,11,0.07,321.10,10,0,3,10,21,109.14,94,12,18,1,159.14,0.00,0.00,0.00,0,10.00,1,205.55,0,1,3,,0.00,0,0,10,0,0,9,0,11,74,1
"org.apache.jackrabbit.core.data.DataStoreException",3,0.00,1.00,7,0.04,296.18,3,0,1,3,14,101.77,21,11,14,2,144.07,0.00,0.50,0.00,0,3.00,1,118.69,0,0,0,javax.jcr.RepositoryException,0.00,0,1,3,0,0,3,0,4,39,1
"org.apache.jackrabbit.core.data.DataStoreFactory",1,0.00,1.00,2,0.01,38.26,1,0,1,1,3,156.44,17,3,2,1,147.31,0.00,0.00,0.00,0,1.00,1,25.51,0,0,1,,0.00,0,0,1,0,0,1,0,2,11,1
"org.apache.jackrabbit.core.data.DataStoreTest",8,0.29,3.25,120,1.45,73858.27,10,2,13,54,7,145.63,14,137,1,3,95.63,0.00,0.67,0.25,4,14.00,7,4359.84,0,1,6,org.apache.jackrabbit.test.JUnitTest,0.00,46,2,26,0,46,7,0,10,812,1
"org.apache.jackrabbit.core.data.DataStoreTest$Thread",1,0.00,2.00,5,0.03,429.83,1,0,13,2,0,124.03,0,8,0,1,124.03,0.00,0.00,0.00,0,1.00,2,102.01,0,0,0,java.lang.Object,0.00,1,0,2,0,1,1,0,0,27,0
"org.apache.jackrabbit.core.data.ExportImportTest",7,0.00,2.71,117,1.66,72723.92,7,0,11,42,2,134.11,14,135,1,4,94.22,0.00,0.75,0.00,5,13.00,7,4970.18,0,0,1,org.apache.jackrabbit.test.AbstractJCRTest,0.00,35,3,19,0,35,7,0,7,884,1
"org.apache.jackrabbit.core.data.FileDataRecord",4,0.33,1.25,14,0.12,1981.24,5,1,3,10,5,114.06,21,21,1,2,131.93,0.00,0.50,0.75,0,0.00,2,348.92,0,1,4,org.apache.jackrabbit.core.data.AbstractDataRecord,0.00,6,1,5,0,6,3,0,6,90,1
"org.apache.jackrabbit.core.data.FileDataStore",19,0.00,2.37,136,1.69,75555.04,28,9,16,62,6,68.64,146,191,1,1,110.93,0.00,0.00,0.11,5,148.00,10,5079.65,0,4,5,java.lang.Object,0.00,43,0,45,0,43,15,1,36,979,1
"org.apache.jackrabbit.core.data.GCConcurrentTest",5,1.00,2.60,62,0.82,42206.01,6,1,13,37,4,99.60,4,69,1,4,99.60,0.00,0.75,0.20,3,8.00,5,2471.23,0,2,3,org.apache.jackrabbit.test.AbstractJCRTest,0.00,32,3,13,0,32,3,0,2,440,1
"org.apache.jackrabbit.core.data.GCEventListenerTest",6,0.08,2.17,65,0.81,37685.95,11,5,10,35,5,153.61,7,76,1,4,103.61,0.00,0.75,0.27,2,10.00,6,2415.41,0,1,4,org.apache.jackrabbit.test.AbstractJCRTest,0.00,29,3,13,0,29,5,1,2,421,1
"org.apache.jackrabbit.core.data.GCThread",9,0.09,1.56,43,0.45,11323.94,13,4,7,22,6,124.03,4,59,1,1,124.03,0.00,0.00,0.17,1,21.00,4,1349.74,0,1,5,java.lang.Object,0.00,13,0,14,0,13,8,2,2,285,1
"org.apache.jackrabbit.core.data.GarbageCollector",18,0.01,2.50,124,1.28,39078.90,29,11,32,57,19,73.20,137,164,4,1,115.49,0.00,0.00,0.10,7,166.00,10,3846.46,1,0,16,java.lang.Object,0.00,39,0,45,0,39,18,0,28,768,1
"org.apache.jackrabbit.core.data.GarbageCollector$Listener",3,0.33,3.33,27,0.29,5494.56,6,3,32,13,1,109.43,2,44,0,1,109.43,0.00,0.00,0.56,0,0.00,7,867.03,0,0,1,java.lang.Object,0.00,10,0,10,0,10,3,1,2,181,0
"org.apache.jackrabbit.core.data.GarbageCollector$SessionListener",2,0.00,1.00,4,0.02,104.88,2,0,32,3,1,146.23,0,6,0,1,146.23,0.00,0.00,0.00,0,2.00,1,59.35,0,0,1,java.lang.Object,0.00,1,0,2,0,1,2,0,0,21,0
"org.apache.jackrabbit.core.data.GarbageCollectorTest",10,0.44,2.60,136,1.87,63668.57,11,1,15,60,9,99.27,6,156,1,4,99.27,0.00,0.75,0.60,4,0.00,4,5597.67,0,0,8,org.apache.jackrabbit.test.AbstractJCRTest,0.00,50,3,26,0,50,10,1,4,981,1
"org.apache.jackrabbit.core.data.GarbageCollectorTest$Thread",1,0.00,2.00,7,0.06,737.25,1,0,15,8,0,116.73,0,10,0,1,116.73,0.00,0.00,0.00,0,1.00,2,190.84,0,0,0,java.lang.Object,0.00,7,0,2,0,7,1,0,0,45,0
"org.apache.jackrabbit.core.data.GarbageCollectorTest$Thread$InputStream",1,0.00,5.00,13,0.12,4021.03,2,1,15,4,0,150.69,1,17,0,1,100.69,0.00,0.00,1.00,0,0.00,5,356.14,0,0,0,java.lang.Object,0.00,3,0,5,0,3,1,0,1,73,0
"org.apache.jackrabbit.core.data.LazyFileInputStream",13,0.25,1.46,55,0.46,8343.18,16,3,6,20,3,146.96,45,78,3,2,126.35,0.00,0.50,0.10,1,31.00,3,1376.44,7,0,0,org.apache.commons.io.input.AutoCloseInputStream,0.00,7,1,19,0,7,13,0,10,341,1
"org.apache.jackrabbit.core.data.LazyFileInputStreamTest",4,0.00,1.50,69,0.85,94608.83,6,2,5,27,3,90.80,19,78,1,3,90.57,0.00,0.67,0.50,1,4.00,3,2556.80,0,0,2,org.apache.jackrabbit.test.JUnitTest,0.00,23,2,6,0,23,4,0,17,496,1
"org.apache.jackrabbit.core.data.NodeTypeTest",2,0.00,2.00,23,0.35,11993.64,2,0,8,16,3,122.86,7,32,1,4,102.24,0.00,0.75,0.00,1,2.00,3,1039.91,0,0,2,org.apache.jackrabbit.test.AbstractJCRTest,0.00,14,3,4,0,14,2,0,2,185,1
"org.apache.jackrabbit.core.data.OpenFilesTest",1,0.00,3.00,16,0.21,6658.73,1,0,6,15,2,63.50,6,19,1,4,95.72,0.00,0.75,0.00,0,0.00,3,636.86,0,0,1,org.apache.jackrabbit.test.AbstractJCRTest,0.00,14,3,3,0,14,1,0,2,115,1
"org.apache.jackrabbit.core.data.PersistenceManagerIteratorTest",2,1.00,7.00,77,1.27,140541.87,3,1,17,31,10,94.07,7,86,1,4,73.46,0.00,0.75,0.50,1,2.00,13,3799.97,0,0,9,org.apache.jackrabbit.test.AbstractJCRTest,0.00,29,3,14,0,29,2,0,5,573,1
"org.apache.jackrabbit.core.data.RandomInputStream",15,0.08,1.80,83,0.79,28331.41,26,11,3,18,3,118.99,3,107,3,2,118.99,0.00,0.50,0.16,4,42.00,5,2357.82,0,1,0,java.io.InputStream,0.00,3,1,27,0,3,14,0,1,527,1
"org.apache.jackrabbit.core.data.ScanEventListener",3,0.00,1.00,4,0.02,116.19,3,0,3,3,4,158.73,12,5,4,2,158.49,0.00,0.50,0.00,0,3.00,1,74.09,0,0,0,,0.00,0,1,3,0,0,3,0,4,27,1
"org.apache.jackrabbit.core.data.TempFileInputStreamTest",1,0.00,1.00,10,0.13,3884.92,1,0,5,8,3,126.05,3,12,1,3,105.43,0.00,0.67,0.00,0,1.00,1,390.48,0,0,2,org.apache.jackrabbit.test.JUnitTest,0.00,7,2,1,0,7,1,0,1,84,1
"org.apache.jackrabbit.core.data.TestAll",1,0.00,1.00,16,0.18,6826.31,1,0,3,3,12,47.79,8,18,0,2,95.89,0.00,0.50,0.00,0,1.00,1,552.81,0,1,12,junit.framework.TestCase,0.00,2,1,1,0,2,0,0,2,119,1
"org.apache.jackrabbit.core.data.TestTwoGetStreams",6,0.20,3.33,98,1.44,59831.97,8,2,11,27,5,114.93,22,123,1,4,94.32,0.00,0.75,0.67,1,0.00,4,4311.96,0,0,4,org.apache.jackrabbit.test.AbstractJCRTest,0.00,21,3,20,0,21,6,0,9,777,1
"org.apache.jackrabbit.test.AbstractJCRTest",23,0.03,3.30,305,4.58,248515.44,71,48,24,98,198,68.03,314,381,193,3,97.41,235.50,0.00,0.05,7,139.00,18,13754.10,3,7,5,org.apache.jackrabbit.test.JUnitTest,0.00,75,2,76,471,75,16,0,83,2342,2
"org.apache.jackrabbit.test.ISO8601",2,0.33,11.00,114,1.89,230909.02,5,3,4,25,2,17.54,105,137,2,1,65.09,0.00,0.00,0.50,0,2.00,17,5656.60,0,2,0,java.lang.Object,0.00,23,0,22,0,23,0,0,47,910,2
"org.apache.jackrabbit.test.JCRBenchmark",1,0.00,1.00,3,0.02,158.91,1,0,3,2,0,156.48,3,5,0,2,135.87,0.00,0.50,0.00,0,1.00,1,52.05,0,1,0,junit.framework.TestCase,0.00,1,1,1,0,1,0,0,1,17,1
"org.apache.jackrabbit.test.JCRTestResult",18,0.00,1.33,67,0.77,24472.17,22,4,9,48,4,149.08,64,101,3,2,128.46,0.00,0.50,0.25,2,0.00,3,2312.03,0,3,1,junit.framework.TestResult,0.00,30,1,24,0,30,15,0,13,540,1
"org.apache.jackrabbit.test.JCRTestSuite",1,0.00,1.00,14,0.35,12653.38,1,0,1,13,13,116.56,3,16,2,2,95.94,0.00,0.50,0.00,0,1.00,1,1044.91,0,0,11,junit.framework.TestSuite,0.00,12,1,1,0,12,1,0,1,225,1
"org.apache.jackrabbit.test.JNDIRepositoryStub",4,0.33,2.00,21,0.26,8999.03,6,2,8,11,3,138.99,12,31,0,2,118.37,0.00,0.50,0.25,0,6.00,5,777.46,0,3,3,org.apache.jackrabbit.test.RepositoryStub,0.15,7,1,8,0,7,1,0,5,164,1
"org.apache.jackrabbit.test.JUnitTest",0,0.00,0.00,3,0.05,1295.46,2,2,3,2,12,171.00,9,4,11,2,171.00,480.00,0.00,0.00,0,0.00,0,144.95,0,0,1,junit.framework.TestCase,0.00,2,1,0,480,2,0,0,3,33,2
"org.apache.jackrabbit.test.LogPrintWriter",11,0.20,1.36,43,0.35,5553.15,13,2,4,21,3,152.46,43,60,3,2,131.84,0.00,0.50,0.32,1,16.00,4,1047.02,2,0,0,java.io.PrintWriter,0.00,10,1,15,0,10,11,0,13,262,1
"org.apache.jackrabbit.test.LogPrintWriter$NullWriter",3,0.00,1.00,4,0.04,273.44,3,0,4,3,0,205.57,3,8,0,2,155.57,0.00,0.50,0.00,0,3.00,1,110.76,0,0,0,java.io.Writer,0.00,0,1,3,0,0,3,0,3,35,2
"org.apache.jackrabbit.test.NotExecutableException",2,0.00,1.00,4,0.02,118.02,2,0,0,2,225,95.83,19,7,225,2,145.83,0.00,0.50,0.00,0,2.00,1,53.51,0,0,0,java.lang.Exception,0.00,0,1,2,0,0,2,0,3,20,1
"org.apache.jackrabbit.test.RepositoryHelper",15,0.11,1.13,37,0.33,5127.89,17,2,7,27,4,97.50,107,56,1,1,139.79,0.00,0.00,0.40,4,0.00,3,977.23,0,13,3,java.lang.Object,0.00,12,0,17,0,12,2,0,19,259,1
"org.apache.jackrabbit.test.RepositoryStub",9,0.03,2.56,88,1.55,73187.67,43,34,14,28,17,75.02,119,118,15,1,104.40,0.00,0.00,0.06,0,35.00,14,4648.68,0,8,2,java.lang.Object,0.00,19,0,23,6,19,1,0,19,798,2
"org.apache.jackrabbit.test.RepositoryStubException",1,0.00,1.00,3,0.02,106.02,1,0,0,1,7,157.87,3,5,7,2,137.25,0.00,0.50,0.00,0,1.00,1,45.51,0,0,0,java.lang.Exception,0.00,0,1,1,0,0,1,0,1,16,1
"org.apache.jackrabbit.test.TestAll",1,0.00,1.00,3,0.02,158.91,1,0,3,2,1,135.87,0,5,0,2,135.87,0.00,0.50,0.00,0,1.00,1,52.05,0,1,1,junit.framework.TestCase,0.00,1,1,1,0,1,0,0,0,17,1
"org.apache.jackrabbit.test.TestAll$JCRTestSuite",1,0.00,1.00,10,0.21,5974.27,1,0,4,9,7,103.96,0,12,0,2,103.96,0.00,0.50,0.00,0,1.00,1,639.51,0,0,7,junit.framework.TestSuite,0.00,8,1,1,0,8,1,0,0,146,2
"org.apache.jackrabbit.test.XMLChar",21,0.03,1.95,724,20.15,1282085.56,30,9,1,23,2,117.51,615,757,2,1,76.03,0.00,0.00,0.08,4,61.00,6,60456.28,0,0,0,java.lang.Object,0.00,2,0,41,0,2,21,0,463,6924,1
"org.apache.jackrabbit.webdav.xml.DomUtil",36,0.50,2.03,206,2.39,68938.21,38,2,14,87,104,68.92,329,259,102,1,118.92,0.00,0.00,0.01,10,70.00,5,7157.13,0,25,3,java.lang.Object,0.00,51,0,73,0,51,11,0,42,1559,1
"org.apache.jackrabbit.webdav.xml.ElementIterator",8,0.00,1.62,42,0.37,8579.86,12,4,7,17,34,103.08,46,53,33,1,120.95,0.00,0.00,0.25,2,8.00,3,1099.17,0,2,2,java.lang.Object,0.00,9,0,13,0,9,6,1,10,253,1
"org.apache.jackrabbit.webdav.xml.Namespace",8,0.05,1.50,32,0.31,7229.56,14,6,2,15,40,125.17,3,45,40,1,125.17,0.00,0.00,0.12,1,20.00,3,933.16,0,4,0,java.lang.Object,0.00,7,0,12,0,7,4,0,1,227,1
"org.apache.jackrabbit.webdav.xml.XmlSerializable",1,0.00,1.00,2,0.01,41.48,1,0,2,1,24,109.47,12,3,24,1,147.03,0.00,0.00,0.00,0,1.00,1,27.65,0,1,0,,0.00,0,0,1,0,0,0,0,2,11,1
"org.apache.jackrabbit.core.nodetype.virtual.VirtualNodeTypeStateManager",8,0.14,2.25,70,1.05,25165.87,16,8,22,37,17,59.58,79,123,1,1,109.58,0.00,0.00,0.25,4,14.00,4,3135.18,0,1,16,java.lang.Object,0.00,29,0,18,0,29,7,1,23,629,1
"org.apache.jackrabbit.core.nodetype.virtual.VirtualNodeTypeStateProvider",12,1.00,2.25,116,2.15,109457.47,13,1,22,67,17,71.81,83,157,1,2,104.03,0.00,0.50,0.08,4,28.00,4,6454.70,2,6,16,org.apache.jackrabbit.core.virtual.AbstractVISProvider,0.05,55,1,27,0,55,6,0,30,1141,1
"org.apache.jackrabbit.webdav.client.methods.AclMethod",3,1.00,1.00,9,0.08,986.02,4,1,6,4,4,133.62,13,13,0,3,133.38,0.00,0.67,0.00,0,3.00,1,231.63,1,1,4,org.apache.jackrabbit.webdav.client.methods.DavMethodBase,0.29,1,2,3,0,1,2,0,5,62,1
"org.apache.jackrabbit.webdav.client.methods.BaselineControlMethod",4,1.00,1.50,17,0.20,4536.91,5,1,10,12,5,145.01,15,25,0,3,124.39,0.00,0.67,0.00,0,6.00,3,588.62,1,1,5,org.apache.jackrabbit.webdav.client.methods.DavMethodBase,0.27,8,2,6,0,8,3,0,8,129,1
"org.apache.jackrabbit.webdav.client.methods.BindMethod",3,0.00,1.00,8,0.06,745.67,3,0,3,3,4,141.14,13,12,1,3,140.91,0.00,0.67,0.00,0,3.00,1,184.26,1,1,3,org.apache.jackrabbit.webdav.client.methods.DavMethodBase,0.29,0,2,3,0,0,2,0,5,52,1
"org.apache.jackrabbit.webdav.client.methods.CheckinMethod",4,1.00,1.00,11,0.09,1052.69,5,1,5,8,5,161.33,13,16,1,3,140.71,0.00,0.67,0.00,0,4.00,1,261.63,0,2,4,org.apache.jackrabbit.webdav.client.methods.DavMethodBase,0.27,4,2,4,0,4,2,0,5,72,1
"org.apache.jackrabbit.webdav.client.methods.CheckoutMethod",3,1.00,1.00,8,0.07,852.87,4,1,4,4,4,140.68,13,12,1,3,140.45,0.00,0.67,0.00,0,3.00,1,195.03,0,1,3,org.apache.jackrabbit.webdav.client.methods.DavMethodBase,0.29,1,2,3,0,1,2,0,5,54,1
"org.apache.jackrabbit.webdav.client.methods.CopyMethod",4,1.00,1.25,14,0.14,2186.13,5,1,7,7,7,99.37,27,20,1,3,131.59,0.00,0.67,0.00,0,4.00,2,432.39,1,1,6,org.apache.jackrabbit.webdav.client.methods.DavMethodBase,0.27,3,2,5,0,3,3,0,7,108,1
"org.apache.jackrabbit.webdav.client.methods.DavMethod",7,0.00,1.00,8,0.05,281.99,7,0,6,7,7,116.07,55,9,4,2,158.36,0.00,0.50,0.00,0,7.00,1,153.73,0,3,3,,0.00,0,1,7,0,0,4,0,8,55,1
"org.apache.jackrabbit.webdav.client.methods.DavMethodBase",18,0.07,1.78,86,0.85,21723.28,23,5,24,42,46,106.27,99,122,37,2,124.14,33.00,0.03,0.13,7,98.00,5,2546.04,1,5,9,org.apache.commons.httpclient.methods.EntityEnclosingMethod,0.00,24,1,32,33,24,13,2,31,567,2
"org.apache.jackrabbit.webdav.client.methods.DavMethodTest",3,1.00,1.00,11,0.10,1491.18,4,1,6,8,3,131.97,1,15,1,2,131.97,0.00,0.50,0.00,0,3.00,1,311.33,2,0,2,junit.framework.TestCase,0.00,5,1,3,0,5,3,0,1,79,1
"org.apache.jackrabbit.webdav.client.methods.DavMethodTest$TestDavMethod",10,0.00,1.00,20,0.10,873.22,10,0,6,12,2,144.48,0,30,0,3,144.48,0.00,0.67,0.00,0,10.00,1,292.85,0,3,2,org.apache.jackrabbit.webdav.client.methods.DavMethodBase,0.64,2,2,10,0,2,7,0,0,95,1
"org.apache.jackrabbit.webdav.client.methods.DeleteMethod",3,1.00,1.00,8,0.07,852.87,4,1,4,4,10,190.45,3,12,7,3,140.45,0.00,0.67,0.00,0,3.00,1,195.03,0,1,3,org.apache.jackrabbit.webdav.client.methods.DavMethodBase,0.29,1,2,3,0,1,2,0,1,54,1
"org.apache.jackrabbit.webdav.client.methods.LabelMethod",5,1.00,1.00,14,0.15,2114.30,6,1,7,9,6,106.87,34,21,1,3,139.09,0.00,0.67,0.00,0,5.00,1,459.83,2,1,5,org.apache.jackrabbit.webdav.client.methods.DavMethodBase,0.26,4,2,5,0,4,4,0,8,117,1
"org.apache.jackrabbit.webdav.client.methods.LockMethod",10,0.11,1.90,68,0.70,16423.17,13,3,21,32,17,68.40,82,89,3,3,116.50,0.00,0.67,0.23,2,38.00,3,2095.43,6,3,14,org.apache.jackrabbit.webdav.client.methods.DavMethodBase,0.32,22,2,19,0,22,7,0,23,451,1
"org.apache.jackrabbit.webdav.client.methods.MergeMethod",3,1.00,1.00,9,0.08,986.02,4,1,6,4,5,133.62,14,13,1,3,133.38,0.00,0.67,0.00,0,3.00,1,231.63,1,1,4,org.apache.jackrabbit.webdav.client.methods.DavMethodBase,0.29,1,2,3,0,1,2,0,6,62,1
"org.apache.jackrabbit.webdav.client.methods.MkActivityMethod",3,1.00,1.00,8,0.07,852.87,4,1,4,4,3,140.68,12,12,0,3,140.45,0.00,0.67,0.00,0,3.00,1,195.03,0,1,3,org.apache.jackrabbit.webdav.client.methods.DavMethodBase,0.29,1,2,3,0,1,2,0,5,54,1
"org.apache.jackrabbit.webdav.client.methods.MkColMethod",3,1.00,1.00,8,0.07,852.87,4,1,4,4,7,140.68,13,12,4,3,140.45,0.00,0.67,0.00,0,3.00,1,195.03,0,1,3,org.apache.jackrabbit.webdav.client.methods.DavMethodBase,0.29,1,2,3,0,1,2,0,5,54,1
"org.apache.jackrabbit.webdav.client.methods.MkWorkspaceMethod",3,1.00,1.00,8,0.07,852.87,4,1,4,4,3,140.68,13,12,0,3,140.45,0.00,0.67,0.00,0,3.00,1,195.03,0,1,3,org.apache.jackrabbit.webdav.client.methods.DavMethodBase,0.29,1,2,3,0,1,2,0,5,54,1
"org.apache.jackrabbit.webdav.client.methods.MoveMethod",3,1.00,1.00,10,0.10,1512.24,4,1,6,5,9,132.16,14,14,4,3,131.92,0.00,0.67,0.00,0,3.00,1,305.81,1,1,5,org.apache.jackrabbit.webdav.client.methods.DavMethodBase,0.29,2,2,3,0,2,2,0,5,78,1
"org.apache.jackrabbit.webdav.client.methods.OptionsMethod",11,0.17,1.55,52,0.53,12999.39,14,3,14,26,8,124.48,53,64,3,3,124.25,0.00,0.67,0.18,0,32.00,5,1583.39,2,4,5,org.apache.jackrabbit.webdav.client.methods.DavMethodBase,0.21,15,2,17,0,15,7,0,12,360,1
"org.apache.jackrabbit.webdav.client.methods.OrderPatchMethod",5,1.00,1.40,21,0.27,6213.14,6,1,8,9,8,74.10,45,27,2,3,124.10,0.00,0.67,0.00,0,5.00,2,822.48,1,1,6,org.apache.jackrabbit.webdav.client.methods.DavMethodBase,0.26,4,2,7,0,4,4,0,8,183,1
"org.apache.jackrabbit.webdav.client.methods.PollMethod",7,0.25,2.00,42,0.41,8753.22,9,2,17,20,11,138.04,25,58,1,3,117.43,0.00,0.67,0.29,1,14.00,3,1239.39,5,2,10,org.apache.jackrabbit.webdav.client.methods.DavMethodBase,0.24,13,2,14,0,13,5,1,8,270,1
"org.apache.jackrabbit.webdav.client.methods.PollMethod$EventBundle",1,0.00,1.00,3,0.02,254.64,1,0,17,2,0,134.26,0,4,0,1,134.26,0.00,0.00,0.00,0,1.00,1,70.91,0,1,0,java.lang.Object,0.00,1,0,1,0,1,0,0,0,21,0
"org.apache.jackrabbit.webdav.client.methods.PropFindMethod",6,1.00,2.33,47,0.70,47109.59,7,1,13,22,12,76.39,36,65,5,3,108.61,0.00,0.67,0.00,0,10.00,9,2091.71,2,1,7,org.apache.jackrabbit.webdav.client.methods.DavMethodBase,0.25,16,2,14,0,16,5,0,11,374,1
"org.apache.jackrabbit.webdav.client.methods.PropPatchMethod",7,0.00,4.57,108,1.55,84388.99,10,3,23,47,16,62.42,43,135,2,3,94.64,0.00,0.67,0.33,0,8.00,10,4639.40,3,3,14,org.apache.jackrabbit.webdav.client.methods.DavMethodBase,0.36,40,2,32,0,40,4,1,17,798,1
"org.apache.jackrabbit.webdav.client.methods.PutMethod",3,1.00,1.00,8,0.07,1087.83,4,1,4,4,5,139.85,14,12,2,3,139.62,0.00,0.67,0.00,0,3.00,1,221.36,0,1,3,org.apache.jackrabbit.webdav.client.methods.DavMethodBase,0.29,1,2,3,0,1,2,0,5,60,1
"org.apache.jackrabbit.webdav.client.methods.RebindMethod",3,0.00,1.00,8,0.06,745.67,3,0,3,3,4,141.14,13,12,1,3,140.91,0.00,0.67,0.00,0,3.00,1,184.26,1,1,3,org.apache.jackrabbit.webdav.client.methods.DavMethodBase,0.29,0,2,3,0,0,2,0,5,52,1
"org.apache.jackrabbit.webdav.client.methods.ReportMethod",3,0.25,1.33,16,0.16,3318.58,5,2,8,6,8,103.02,16,21,2,3,120.89,0.00,0.67,0.33,0,1.00,2,483.01,2,1,6,org.apache.jackrabbit.webdav.client.methods.DavMethodBase,0.29,3,2,4,0,3,2,0,5,113,1
"org.apache.jackrabbit.webdav.client.methods.SearchMethod",5,1.00,1.20,16,0.17,3122.64,6,1,7,7,6,171.03,14,23,1,3,131.15,0.00,0.67,0.00,0,5.00,2,503.67,1,1,5,org.apache.jackrabbit.webdav.client.methods.DavMethodBase,0.26,2,2,6,0,2,4,0,6,125,1
"org.apache.jackrabbit.webdav.client.methods.SubscribeMethod",8,0.29,2.25,55,0.61,15079.74,10,2,20,30,14,83.77,52,76,1,3,115.99,0.00,0.67,0.25,1,26.00,4,1839.45,6,3,13,org.apache.jackrabbit.webdav.client.methods.DavMethodBase,0.23,22,2,18,0,22,5,1,13,384,1
"org.apache.jackrabbit.webdav.client.methods.UnLockMethod",3,1.00,1.00,10,0.09,1315.22,4,1,8,5,8,132.63,14,14,2,3,132.40,0.00,0.67,0.00,0,3.00,1,277.61,1,1,6,org.apache.jackrabbit.webdav.client.methods.DavMethodBase,0.29,2,2,3,0,2,2,0,5,71,1
"org.apache.jackrabbit.webdav.client.methods.UnSubscribeMethod",3,1.00,1.00,9,0.08,1019.55,4,1,5,4,5,183.27,5,13,1,3,133.27,0.00,0.67,0.00,0,3.00,1,235.33,1,1,4,org.apache.jackrabbit.webdav.client.methods.DavMethodBase,0.29,1,2,3,0,1,2,0,3,63,1
"org.apache.jackrabbit.webdav.client.methods.UnbindMethod",3,0.00,1.00,8,0.05,510.71,3,0,3,3,4,142.44,13,12,1,3,142.20,0.00,0.67,0.00,0,3.00,1,157.92,1,1,3,org.apache.jackrabbit.webdav.client.methods.DavMethodBase,0.29,0,2,3,0,0,2,0,5,46,1
"org.apache.jackrabbit.webdav.client.methods.UncheckoutMethod",3,1.00,1.00,8,0.07,852.87,4,1,4,4,3,140.68,13,12,0,3,140.45,0.00,0.67,0.00,0,3.00,1,195.03,0,1,3,org.apache.jackrabbit.webdav.client.methods.DavMethodBase,0.29,1,2,3,0,1,2,0,5,54,1
"org.apache.jackrabbit.webdav.client.methods.UpdateMethod",3,1.00,1.00,9,0.08,986.02,4,1,6,4,5,133.62,13,13,1,3,133.38,0.00,0.67,0.00,0,3.00,1,231.63,1,1,4,org.apache.jackrabbit.webdav.client.methods.DavMethodBase,0.29,1,2,3,0,1,2,0,5,62,1
"org.apache.jackrabbit.webdav.client.methods.VersionControlMethod",3,1.00,1.00,8,0.07,852.87,4,1,4,4,4,140.68,13,12,1,3,140.45,0.00,0.67,0.00,0,3.00,1,195.03,0,1,3,org.apache.jackrabbit.webdav.client.methods.DavMethodBase,0.29,1,2,3,0,1,2,0,5,54,1
"org.apache.jackrabbit.webdav.client.methods.XmlRequestEntity",5,0.12,1.40,21,0.26,6013.16,7,2,15,18,3,124.21,4,32,2,1,124.21,0.00,0.00,0.40,0,2.00,3,770.88,0,1,1,java.lang.Object,0.00,13,0,7,0,13,4,1,2,170,1
"org.apache.jackrabbit.core.virtual.AbstractVISProvider",28,0.02,2.14,173,2.03,64732.11,34,6,27,87,25,83.09,170,239,1,1,115.31,0.00,0.00,0.14,11,238.00,6,6077.90,0,11,25,java.lang.Object,0.00,59,0,60,1,59,17,2,46,1258,2
"org.apache.jackrabbit.core.virtual.VirtualItemStateProvider",7,0.00,1.00,8,0.06,278.20,7,0,8,7,18,116.11,50,14,10,2,158.41,0.00,0.50,0.00,0,7.00,1,191.63,0,2,9,,0.00,0,1,7,0,0,5,0,8,63,1
"org.apache.jackrabbit.core.virtual.VirtualNodeState",11,0.20,1.55,57,0.68,16627.21,14,3,11,24,13,71.68,88,80,5,3,119.79,0.00,0.67,0.15,5,35.00,3,2029.50,3,5,10,org.apache.jackrabbit.core.state.NodeState,0.00,13,2,17,0,13,6,0,16,443,1
"org.apache.jackrabbit.core.virtual.VirtualPropertyState",4,0.67,1.50,13,0.11,2728.81,5,1,4,5,10,112.92,23,19,5,3,130.79,0.00,0.67,0.50,0,4.00,3,327.00,2,2,5,org.apache.jackrabbit.core.state.PropertyState,0.06,1,2,6,0,1,2,0,6,85,1
"org.apache.jackrabbit.core.virtual.VirtualValueProvider",1,0.00,1.00,2,0.01,44.48,1,0,2,1,3,96.79,9,3,1,1,146.79,0.00,0.00,0.00,0,1.00,1,29.65,0,1,2,,0.00,0,0,1,0,0,0,0,2,12,1
"org.apache.jackrabbit.test.api.version.AbstractMergeTest",3,0.50,3.00,41,0.44,12289.38,11,8,7,10,8,63.19,37,52,7,4,100.75,2.33,0.27,0.46,1,1.00,5,1309.46,3,0,1,org.apache.jackrabbit.test.AbstractJCRTest,0.31,7,3,9,7,7,3,0,17,257,2
"org.apache.jackrabbit.test.api.version.AbstractOnParentVersionTest",3,0.30,2.00,24,0.30,6179.15,8,5,5,14,6,78.84,20,31,5,5,111.06,1.25,0.40,0.40,0,0.00,3,901.35,2,1,1,org.apache.jackrabbit.test.api.version.AbstractVersionTest,0.33,11,4,6,5,11,2,0,5,187,2
"org.apache.jackrabbit.test.api.version.AbstractVersionTest",4,0.33,3.50,52,0.65,20558.80,9,5,8,19,20,67.71,27,75,18,4,99.94,8.00,0.11,0.45,0,2.00,10,1947.04,5,1,2,org.apache.jackrabbit.test.AbstractJCRTest,0.30,15,3,14,24,15,3,0,8,365,1
"org.apache.jackrabbit.test.api.version.CheckinTest",19,0.00,1.32,104,1.38,22786.02,19,0,7,43,2,88.40,115,136,1,5,120.62,0.00,0.80,0.00,0,0.00,2,4131.45,2,0,1,org.apache.jackrabbit.test.api.version.AbstractVersionTest,0.11,24,4,25,0,24,19,0,25,884,1
"org.apache.jackrabbit.test.api.version.CheckoutTest",11,0.00,2.64,93,1.09,32805.88,11,0,6,29,2,91.86,57,127,1,5,109.73,0.00,0.80,0.00,0,2.00,5,3273.16,1,0,1,org.apache.jackrabbit.test.api.version.AbstractVersionTest,0.13,18,4,29,0,18,11,0,19,661,1
"org.apache.jackrabbit.test.api.version.CopyTest",3,0.00,1.33,26,0.37,6584.43,3,0,7,23,2,62.83,26,34,1,5,110.93,0.00,0.80,0.00,0,1.00,2,1107.28,3,0,1,org.apache.jackrabbit.test.api.version.simple.AbstractVersionTest,0.33,20,4,4,0,20,3,0,6,211,1
"org.apache.jackrabbit.test.api.version.FrozenNodeTest",9,0.00,1.00,81,1.30,19292.60,9,0,5,26,2,129.79,33,93,0,5,109.17,0.00,0.80,0.00,0,0.00,1,3912.34,2,0,2,org.apache.jackrabbit.test.api.version.AbstractVersionTest,0.14,17,4,9,0,17,9,0,10,756,1
"org.apache.jackrabbit.test.api.version.GetContainingHistoryTest",1,0.00,1.00,5,0.06,832.44,1,0,2,7,2,101.79,14,9,1,5,121.93,0.00,0.80,0.00,0,0.00,1,180.51,0,0,1,org.apache.jackrabbit.test.api.version.AbstractVersionTest,0.00,6,4,1,0,6,1,0,3,43,1
"org.apache.jackrabbit.test.api.version.GetCreatedTest",2,0.00,1.00,13,0.16,2111.18,2,0,4,13,2,68.17,19,16,1,5,118.16,0.00,0.80,0.00,0,0.00,1,473.38,0,0,1,org.apache.jackrabbit.test.api.version.AbstractVersionTest,0.00,11,4,2,0,11,2,0,5,104,1
"org.apache.jackrabbit.test.api.version.GetPredecessorsTest",2,0.00,1.00,17,0.26,4912.03,2,0,3,21,2,81.24,26,22,1,5,110.62,0.00,0.80,0.00,0,0.00,1,771.29,0,0,1,org.apache.jackrabbit.test.api.version.AbstractVersionTest,0.00,19,4,2,0,19,2,0,9,157,1
"org.apache.jackrabbit.test.api.version.GetReferencesNodeTest",4,0.33,1.50,36,0.34,5915.42,8,4,6,14,3,68.06,30,44,1,4,110.35,0.00,0.75,0.50,1,0.00,2,1010.45,4,0,2,org.apache.jackrabbit.test.AbstractJCRTest,0.30,10,3,6,0,10,4,0,10,216,1
"org.apache.jackrabbit.test.api.version.GetVersionableUUIDTest",2,0.00,1.00,9,0.13,1749.35,2,0,4,16,2,75.38,19,16,1,5,125.38,0.00,0.80,0.00,0,0.00,1,388.43,0,0,1,org.apache.jackrabbit.test.api.version.AbstractVersionTest,0.00,14,4,2,0,14,2,0,4,90,1
"org.apache.jackrabbit.test.api.version.MergeCancelMergeTest",5,0.25,1.80,70,1.12,40203.24,6,1,6,37,2,47.36,48,74,1,5,97.36,0.00,0.80,0.80,0,0.00,3,3355.79,2,0,1,org.apache.jackrabbit.test.api.version.AbstractMergeTest,0.48,32,4,9,0,32,5,0,28,600,1
"org.apache.jackrabbit.test.api.version.MergeCheckedoutSubNodeTest",7,0.17,1.29,58,0.89,17125.51,8,1,4,33,2,62.47,58,70,1,5,110.57,0.00,0.80,0.86,0,0.00,2,2662.94,2,0,1,org.apache.jackrabbit.test.api.version.AbstractMergeTest,0.45,26,4,9,0,26,7,0,30,525,1
"org.apache.jackrabbit.test.api.version.MergeDoneMergeTest",5,0.25,1.80,66,1.02,31238.24,6,1,6,36,2,49.42,46,70,1,5,99.42,0.00,0.80,0.80,0,0.00,3,3067.42,2,0,1,org.apache.jackrabbit.test.api.version.AbstractMergeTest,0.48,31,4,9,0,31,5,0,26,554,1
"org.apache.jackrabbit.test.api.version.MergeNodeIteratorTest",4,0.00,3.75,81,1.27,56862.73,5,1,6,27,2,40.99,42,99,1,5,89.46,0.00,0.80,1.00,0,0.00,6,3808.71,1,0,1,org.apache.jackrabbit.test.api.version.AbstractMergeTest,0.33,23,4,15,0,23,4,0,25,679,1
"org.apache.jackrabbit.test.api.version.MergeNodeTest",21,0.05,2.05,214,3.01,73776.05,22,1,13,67,3,57.51,188,278,1,5,105.61,0.00,0.80,0.95,0,0.00,4,9023.74,4,0,2,org.apache.jackrabbit.test.api.version.AbstractMergeTest,0.32,46,4,43,0,46,21,0,118,1708,1
"org.apache.jackrabbit.test.api.version.MergeNonVersionableSubNodeTest",8,0.00,1.00,83,1.51,32021.84,8,0,2,34,2,56.85,86,93,1,5,105.33,0.00,0.80,0.00,0,0.00,1,4533.70,1,0,1,org.apache.jackrabbit.test.api.version.AbstractMergeTest,0.29,26,4,8,0,26,8,0,54,850,1
"org.apache.jackrabbit.test.api.version.MergeSubNodeTest",13,0.08,1.31,147,2.27,49994.35,14,1,4,47,2,53.86,120,159,1,5,103.86,0.00,0.80,0.92,0,0.00,3,6798.43,2,0,1,org.apache.jackrabbit.test.api.version.AbstractMergeTest,0.38,34,4,17,0,34,13,0,62,1301,1
"org.apache.jackrabbit.test.api.version.OnParentVersionAbortTest",5,0.00,1.80,28,0.29,4103.13,5,0,5,20,3,79.55,37,42,1,6,121.84,0.00,0.83,0.00,0,4.00,2,870.36,2,0,2,org.apache.jackrabbit.test.api.version.AbstractOnParentVersionTest,0.17,15,5,9,0,15,5,0,11,195,1
"org.apache.jackrabbit.test.api.version.OnParentVersionComputeTest",3,0.00,1.00,24,0.27,4307.26,3,0,5,20,2,80.23,19,28,1,6,112.45,0.00,0.83,0.00,0,2.00,1,813.77,1,0,1,org.apache.jackrabbit.test.api.version.AbstractOnParentVersionTest,0.18,17,5,3,0,17,3,0,3,172,1
"org.apache.jackrabbit.test.api.version.OnParentVersionCopyTest",4,0.67,1.50,35,0.39,8170.65,5,1,5,22,2,63.05,32,42,1,6,111.15,0.00,0.83,0.50,0,0.00,2,1171.57,2,0,1,org.apache.jackrabbit.test.api.version.AbstractOnParentVersionTest,0.18,18,5,6,0,18,4,0,12,240,1
"org.apache.jackrabbit.test.api.version.OnParentVersionIgnoreTest",5,0.00,1.40,44,0.52,9354.80,5,0,5,26,2,79.25,31,52,1,6,111.47,0.00,0.83,0.00,0,4.00,2,1553.58,2,0,1,org.apache.jackrabbit.test.api.version.AbstractOnParentVersionTest,0.17,21,5,7,0,21,5,0,7,320,1
"org.apache.jackrabbit.test.api.version.OnParentVersionInitializeTest",3,0.00,1.00,24,0.27,4307.26,3,0,5,20,2,80.23,19,28,1,6,112.45,0.00,0.83,0.00,0,2.00,1,813.77,1,0,1,org.apache.jackrabbit.test.api.version.AbstractOnParentVersionTest,0.18,17,5,3,0,17,3,0,3,172,1
"org.apache.jackrabbit.test.api.version.RemoveVersionTest",10,0.25,2.90,113,1.23,37329.74,14,4,12,41,3,71.56,69,141,1,5,103.78,0.00,0.80,0.48,0,0.00,5,3691.05,3,0,2,org.apache.jackrabbit.test.api.version.AbstractVersionTest,0.27,31,4,29,0,31,10,0,26,730,1
"org.apache.jackrabbit.test.api.version.RestoreTest",71,0.11,1.56,663,9.50,254992.90,78,7,13,121,3,75.08,431,802,1,5,107.31,0.00,0.80,0.25,0,0.00,4,28485.15,4,0,2,org.apache.jackrabbit.test.api.version.AbstractVersionTest,0.10,50,4,111,0,50,71,0,172,5429,1
"org.apache.jackrabbit.test.api.version.SessionMoveVersionExceptionTest",2,0.00,2.00,15,0.18,3143.35,2,0,3,10,2,84.77,27,24,1,5,114.15,0.00,0.80,0.00,0,0.00,2,538.64,0,0,1,org.apache.jackrabbit.test.api.version.AbstractVersionTest,0.00,8,4,4,0,8,2,0,11,114,1
"org.apache.jackrabbit.test.api.version.TestAll",1,0.00,1.00,34,0.48,19589.08,1,0,3,3,32,35.95,11,36,2,2,80.07,0.00,0.50,0.00,0,1.00,1,1426.92,0,1,30,junit.framework.TestCase,0.00,2,1,1,0,2,0,0,2,263,1
"org.apache.jackrabbit.test.api.version.VersionGraphTest",8,0.00,1.50,41,0.62,10021.25,8,0,6,28,2,78.15,59,56,1,5,120.44,0.00,0.80,0.00,0,0.00,2,1867.51,0,0,1,org.apache.jackrabbit.test.api.version.AbstractVersionTest,0.00,20,4,12,0,20,8,0,11,389,1
"org.apache.jackrabbit.test.api.version.VersionHistoryTest",79,0.09,1.96,436,5.15,135406.27,82,3,28,211,2,119.54,374,631,1,5,119.30,0.00,0.80,0.42,0,0.00,13,15443.76,4,0,1,org.apache.jackrabbit.test.api.version.AbstractVersionTest,0.09,132,4,155,0,132,79,0,86,3218,1
"org.apache.jackrabbit.test.api.version.VersionHistoryTest$ItemVisitorTest",3,0.50,1.00,7,0.06,477.71,4,1,28,5,0,142.43,0,11,0,1,142.43,0.00,0.00,0.67,0,1.00,1,165.42,0,0,0,java.lang.Object,0.00,2,0,3,0,2,3,1,0,48,1
"org.apache.jackrabbit.test.api.version.VersionLabelTest",23,0.45,2.09,198,2.64,67850.14,28,5,9,60,3,67.53,169,242,2,5,109.82,0.25,0.67,0.63,0,0.00,3,7921.20,3,0,1,org.apache.jackrabbit.test.api.version.AbstractVersionTest,0.20,37,4,48,1,37,23,0,36,1546,1
"org.apache.jackrabbit.test.api.version.VersionStorageTest",3,0.50,1.67,18,0.22,3938.95,4,1,5,15,2,69.19,26,28,1,5,117.30,0.00,0.80,0.67,0,2.00,2,664.87,1,0,1,org.apache.jackrabbit.test.api.version.AbstractVersionTest,0.17,12,4,5,0,12,3,0,11,143,1
"org.apache.jackrabbit.test.api.version.VersionTest",68,0.10,1.85,319,3.71,93730.10,71,3,21,167,2,123.91,301,499,1,5,123.68,0.00,0.80,0.43,0,0.00,13,11120.49,2,0,1,org.apache.jackrabbit.test.api.version.AbstractVersionTest,0.11,99,4,126,0,99,68,0,75,2400,1
"org.apache.jackrabbit.test.api.version.VersionTest$ItemVisitorTest",3,0.50,1.00,7,0.06,477.71,4,1,21,5,0,142.43,0,11,0,1,142.43,0.00,0.00,0.67,0,1.00,1,165.42,0,0,0,java.lang.Object,0.00,2,0,3,0,2,3,1,0,48,1
"org.apache.jackrabbit.test.api.version.WorkspaceMoveVersionExceptionTest",2,0.00,2.00,13,0.17,2838.02,2,0,3,10,2,87.61,26,22,1,5,116.99,0.00,0.80,0.00,0,0.00,2,522.03,0,0,1,org.apache.jackrabbit.test.api.version.AbstractVersionTest,0.00,8,4,4,0,8,2,0,10,110,1
"org.apache.jackrabbit.test.api.version.WorkspaceRestoreTest",16,0.20,2.50,177,2.56,80069.97,26,10,12,53,3,70.59,102,221,1,5,102.81,0.00,0.80,0.29,0,0.00,8,7678.85,2,0,2,org.apache.jackrabbit.test.api.version.AbstractVersionTest,0.23,37,4,40,0,37,16,0,48,1436,1
"org.apache.jackrabbit.core.security.authorization.principalbased.ACLEditor",19,0.04,3.26,208,2.85,124837.76,23,4,30,78,18,85.49,103,257,2,2,103.36,0.00,0.50,0.21,12,82.00,8,8551.12,4,12,17,org.apache.jackrabbit.core.ProtectedItemModifier,0.00,59,1,62,0,59,7,2,42,1580,1
"org.apache.jackrabbit.core.security.authorization.principalbased.ACLEditor$ItemBasedPrincipal",2,0.00,1.00,5,0.03,261.14,2,0,30,3,1,143.11,0,7,0,1,143.11,0.00,0.00,0.00,0,2.00,1,81.08,0,2,1,java.lang.Object,0.00,1,0,2,0,1,0,0,0,26,0
"org.apache.jackrabbit.core.security.authorization.principalbased.ACLProvider",8,0.04,2.88,88,1.35,44712.90,12,4,40,57,20,70.18,51,113,1,2,102.40,0.00,0.50,0.22,1,32.00,6,4055.07,6,3,19,org.apache.jackrabbit.core.security.authorization.AbstractAccessControlProvider,0.00,49,1,23,0,49,5,1,20,727,1
"org.apache.jackrabbit.core.security.authorization.principalbased.ACLProvider$CompiledPermissionImpl",6,0.00,3.00,63,0.88,29219.36,9,3,40,34,5,72.19,40,90,0,2,104.41,0.00,0.50,0.33,0,2.00,7,2647.99,2,1,5,org.apache.jackrabbit.core.security.authorization.AbstractCompiledPermissions,0.14,28,1,18,0,28,5,1,24,501,1
"org.apache.jackrabbit.core.security.authorization.principalbased.ACLProvider$EffectivePrincipalBasedPolicy",2,1.00,1.00,5,0.03,652.65,3,1,40,3,0,139.98,0,8,0,1,139.98,0.00,0.00,0.50,0,2.00,1,103.14,0,1,0,java.lang.Object,0.00,1,0,2,0,1,1,1,0,31,3
"org.apache.jackrabbit.core.security.authorization.principalbased.ACLProvider$Entries",2,1.00,4.00,34,0.54,39672.58,3,1,40,11,4,42.84,16,41,0,1,90.94,0.00,0.00,0.00,0,2.00,7,1617.61,0,1,4,java.lang.Object,0.00,9,0,8,0,9,1,0,2,279,1
"org.apache.jackrabbit.core.security.authorization.principalbased.ACLTemplate",16,0.07,2.12,111,1.70,64136.10,25,9,28,59,18,95.55,84,150,11,1,113.43,0.00,0.00,0.18,3,42.00,6,5090.44,0,4,7,java.lang.Object,0.00,43,0,34,0,43,12,2,31,951,0
"org.apache.jackrabbit.core.security.authorization.principalbased.ACLTemplate$Entry",4,0.17,1.25,20,0.23,5585.95,6,2,28,12,2,170.11,7,27,0,2,120.11,0.00,0.50,0.62,0,0.00,2,701.00,1,0,2,org.apache.jackrabbit.core.security.authorization.AccessControlEntryImpl,0.00,8,1,5,0,8,4,0,3,151,0
"org.apache.jackrabbit.core.security.authorization.principalbased.ACLTemplateTest",4,1.00,1.00,17,0.25,3697.20,5,1,8,14,6,125.19,3,23,1,6,125.19,0.00,0.83,0.25,2,0.00,1,745.51,0,2,5,org.apache.jackrabbit.core.security.authorization.AbstractACLTemplateTest,0.12,10,5,4,0,10,2,0,1,165,1
"org.apache.jackrabbit.core.security.authorization.principalbased.EntryTest",8,0.32,1.62,89,1.41,48012.47,12,4,19,35,9,102.29,6,99,1,6,102.29,0.00,0.83,0.53,1,0.00,4,4234.24,2,2,8,org.apache.jackrabbit.core.security.authorization.AbstractEntryTest,0.12,27,5,13,0,27,6,0,4,797,1
"org.apache.jackrabbit.core.security.authorization.principalbased.EvaluationUtil",3,0.00,5.33,50,0.56,27061.65,3,0,14,12,9,134.44,6,54,4,1,94.55,0.00,0.00,0.00,0,3.00,8,1687.03,0,2,5,java.lang.Object,0.00,9,0,16,0,9,1,0,4,321,0
"org.apache.jackrabbit.core.security.authorization.principalbased.GlobPattern",9,0.00,2.11,49,0.45,12911.50,13,4,5,20,4,159.78,18,67,3,1,119.90,0.00,0.00,0.25,2,14.00,4,1355.93,0,2,1,java.lang.Object,0.00,11,0,19,0,11,7,0,10,312,0
"org.apache.jackrabbit.core.security.authorization.principalbased.GlobPatternTest",2,1.00,1.00,4,0.03,501.50,3,1,3,3,2,180.76,5,7,1,3,140.88,0.00,0.67,0.00,0,2.00,1,103.22,0,0,1,org.apache.jackrabbit.test.JUnitTest,0.00,1,2,2,0,1,2,0,3,30,1
"org.apache.jackrabbit.core.security.authorization.principalbased.LockTest",3,0.00,1.00,7,0.08,1050.31,3,0,9,6,6,189.74,3,12,1,7,139.74,0.00,0.86,0.00,0,4.00,1,245.19,0,2,5,org.apache.jackrabbit.core.security.authorization.AbstractLockManagementTest,0.12,3,6,3,0,3,1,0,1,64,1
"org.apache.jackrabbit.core.security.authorization.principalbased.NodeTypeTest",3,0.00,1.00,7,0.08,1050.31,3,0,9,6,6,189.74,3,12,1,7,139.74,0.00,0.86,0.00,0,4.00,1,245.19,0,2,5,org.apache.jackrabbit.core.security.authorization.AbstractNodeTypeManagementTest,0.11,3,6,3,0,3,1,0,1,64,1
"org.apache.jackrabbit.core.security.authorization.principalbased.TestAll",1,0.00,1.00,11,0.11,3828.97,1,0,3,3,7,55.46,10,13,0,2,103.94,0.00,0.50,0.00,0,1.00,1,341.05,0,1,7,junit.framework.TestCase,0.00,2,1,1,0,2,0,0,2,79,1
"org.apache.jackrabbit.core.security.authorization.principalbased.VersionTest",6,0.20,2.00,40,0.54,10282.96,8,2,16,21,7,166.35,9,57,1,7,116.35,0.00,0.86,0.33,0,10.00,5,1624.84,4,2,6,org.apache.jackrabbit.core.security.authorization.AbstractVersionManagementTest,0.12,15,6,12,0,15,4,0,7,333,1
"org.apache.jackrabbit.core.security.authorization.principalbased.WriteTest",6,1.00,1.67,60,1.06,47138.54,7,1,22,36,15,152.91,7,74,1,7,102.91,0.00,0.86,0.00,1,0.00,4,3181.29,5,2,14,org.apache.jackrabbit.core.security.authorization.AbstractWriteTest,0.09,30,6,10,0,30,4,0,5,581,1
"org.apache.jackrabbit.jcr.AddMixinTest",7,0.25,2.29,69,0.86,27052.75,9,2,10,27,3,89.09,38,85,1,4,106.97,0.00,0.75,0.29,0,0.00,4,2594.57,2,0,2,org.apache.jackrabbit.test.AbstractJCRTest,0.27,20,3,16,0,20,7,0,6,507,1
"org.apache.jackrabbit.jcr.BitsetENTCacheImpl",14,0.10,1.71,90,0.92,26597.96,20,6,7,46,7,73.74,98,112,4,1,116.03,0.00,0.00,0.26,5,0.00,4,2766.73,0,4,3,java.lang.Object,0.00,32,0,24,0,32,10,1,33,622,0
"org.apache.jackrabbit.jcr.BitsetENTCacheImpl$BitsetKey",12,0.09,3.42,124,1.60,103573.30,15,3,7,20,2,60.13,84,149,0,1,102.42,0.00,0.00,0.42,1,0.00,8,4804.37,0,3,2,java.lang.Object,0.00,8,0,41,0,8,9,1,21,958,1
"org.apache.jackrabbit.jcr.DefinitionValidator",6,0.00,11.33,278,4.69,781651.29,9,3,23,64,12,117.62,161,342,1,1,68.14,0.00,0.00,0.33,4,10.00,42,14074.71,0,1,11,java.lang.Object,0.00,58,0,68,0,58,5,0,55,2142,0
"org.apache.jackrabbit.jcr.EffectiveNodeType",21,0.00,1.00,22,0.15,854.90,21,0,6,21,18,198.21,58,25,14,1,158.32,0.00,0.00,0.00,0,21.00,1,449.10,0,13,5,,0.00,0,0,21,0,0,8,0,9,156,1
"org.apache.jackrabbit.jcr.EffectiveNodeTypeCache",8,0.00,1.00,10,0.06,224.51,8,0,2,8,5,127.37,53,11,2,3,159.60,0.00,0.67,0.00,0,8.00,1,168.83,0,0,3,,0.00,0,2,8,0,0,8,0,10,62,1
"org.apache.jackrabbit.jcr.EffectiveNodeTypeCache$Key",3,0.00,1.00,4,0.02,72.40,3,0,2,3,1,117.82,22,5,0,2,160.11,0.00,0.50,0.00,0,3.00,1,54.98,0,2,1,,0.00,0,1,3,0,0,1,0,3,23,0
"org.apache.jackrabbit.jcr.EffectiveNodeTypeImpl",29,0.03,4.24,356,5.29,446003.17,36,7,18,86,9,79.57,167,490,2,1,97.44,0.00,0.00,0.17,6,239.00,27,15858.22,0,18,7,java.lang.Object,0.00,57,0,123,0,57,11,2,79,2910,1
"org.apache.jackrabbit.jcr.EffectiveNodeTypeProvider",4,0.00,1.00,5,0.06,370.50,4,0,5,4,13,105.51,39,11,10,1,155.51,0.00,0.00,0.00,0,4.00,1,165.71,0,0,3,,0.00,0,0,4,0,0,4,0,5,49,1
"org.apache.jackrabbit.jcr.ItemDefinitionProvider",8,0.00,1.00,9,0.15,1205.77,8,0,8,8,19,133.70,117,28,14,1,153.85,0.00,0.00,0.00,0,8.00,1,457.08,0,8,6,,0.00,0,0,8,0,0,0,0,10,122,1
"org.apache.jackrabbit.jcr.ItemDefinitionProviderImpl",17,0.01,3.12,158,1.99,118917.37,22,5,16,38,14,86.99,88,241,1,1,104.87,0.00,0.00,0.21,5,55.00,10,5972.01,0,15,13,java.lang.Object,0.00,21,0,53,0,21,2,1,48,1189,1
"org.apache.jackrabbit.jcr.MandatoryItemTest",3,0.50,6.67,62,0.80,40639.96,6,3,11,26,3,110.11,11,81,1,4,89.50,0.00,0.75,0.67,0,0.00,9,2388.81,1,0,2,org.apache.jackrabbit.test.AbstractJCRTest,0.15,23,3,20,0,23,3,0,11,453,1
"org.apache.jackrabbit.jcr.NodeTypeCache",7,0.33,2.29,61,0.70,34955.64,9,2,12,29,7,75.78,44,84,3,1,108.00,0.00,0.00,0.21,0,18.00,6,2109.00,0,3,4,java.lang.Object,0.00,22,0,16,0,22,4,0,10,424,1
"org.apache.jackrabbit.jcr.NodeTypeCache$NodeTypeStorage",4,0.00,1.00,9,0.11,1424.79,4,0,12,8,3,139.68,0,16,0,1,139.68,0.00,0.00,0.00,0,4.00,1,322.97,0,2,3,java.lang.Object,0.00,4,0,4,0,4,2,0,0,83,0
"org.apache.jackrabbit.jcr.NodeTypeDefinitionProvider",1,0.00,1.00,2,0.01,78.44,1,0,4,1,6,165.47,3,3,4,1,144.85,0.00,0.00,0.00,0,1.00,1,41.22,0,1,2,,0.00,0,0,1,0,0,0,0,1,14,1
"org.apache.jackrabbit.jcr.NodeTypeImpl",29,0.09,2.48,224,2.56,104716.53,34,5,26,75,18,93.38,155,290,3,2,111.25,0.00,0.50,0.28,5,190.00,14,7692.91,0,13,16,org.apache.jackrabbit.spi.commons.nodetype.AbstractNodeType,0.00,46,1,72,0,46,16,1,64,1534,1
"org.apache.jackrabbit.jcr.NodeTypeImplTest",2,1.00,3.00,28,0.28,7939.41,5,3,6,13,5,139.54,5,32,1,4,99.65,0.00,0.75,0.83,0,0.00,3,852.54,1,0,4,org.apache.jackrabbit.test.AbstractJCRTest,0.16,11,3,6,0,11,2,0,3,174,1
"org.apache.jackrabbit.jcr.NodeTypeManagerImpl",21,0.04,3.05,249,3.60,261348.92,28,7,37,104,22,81.78,107,299,3,2,99.65,0.00,0.50,0.18,6,146.00,17,10813.22,0,12,20,org.apache.jackrabbit.spi.commons.nodetype.AbstractNodeTypeManager,0.00,83,1,64,0,83,9,3,35,1907,1
"org.apache.jackrabbit.jcr.NodeTypeRegistry",7,0.00,1.00,8,0.07,493.85,7,0,7,7,8,114.15,53,11,5,1,156.44,0.00,0.00,0.00,0,7.00,1,216.64,0,2,3,,0.00,0,0,7,0,0,5,0,8,68,1
"org.apache.jackrabbit.jcr.NodeTypeRegistryImpl",24,0.09,3.42,334,4.21,337156.84,32,8,31,115,19,54.21,171,387,2,1,96.50,0.00,0.00,0.21,7,100.00,20,12619.59,0,3,17,java.lang.Object,0.00,91,0,82,0,91,21,3,94,2292,1
"org.apache.jackrabbit.jcr.NodeTypeRegistryImpl$NodeTypeDefinitionMap",15,0.29,2.87,135,2.12,180602.25,16,1,31,79,7,153.03,26,164,0,1,103.03,0.00,0.00,0.73,3,0.00,19,6360.57,0,7,7,java.lang.Object,0.00,64,0,43,0,64,8,2,16,1077,1
"org.apache.jackrabbit.jcr.NodeTypeRegistryListener",3,0.00,1.00,4,0.02,61.53,3,0,1,3,4,118.38,22,5,3,1,160.67,0.00,0.00,0.00,0,3.00,1,56.53,0,0,1,,0.00,0,0,3,0,0,3,0,4,23,1
"org.apache.jackrabbit.jcr.NodeTypeStorage",4,0.00,1.00,5,0.05,349.12,4,0,5,4,5,155.95,19,6,3,1,155.72,0.00,0.00,0.00,0,4.00,1,146.78,0,2,2,,0.00,0,0,4,0,0,2,0,3,45,1
"org.apache.jackrabbit.jcr.RemoveMixinTest",5,0.00,1.60,43,0.53,12607.32,7,2,9,21,3,110.65,22,55,1,4,110.42,0.00,0.75,0.50,0,0.00,2,1586.66,2,0,2,org.apache.jackrabbit.test.AbstractJCRTest,0.29,16,3,8,0,16,5,0,4,320,1
"org.apache.jackrabbit.jcr.TestAll",1,0.00,1.00,8,0.07,2228.14,1,0,3,3,5,131.56,3,10,1,2,110.95,0.00,0.50,0.00,0,1.00,1,223.66,0,1,4,junit.framework.TestCase,0.00,2,1,1,0,2,0,0,1,55,1
"org.apache.jackrabbit.commons.AbstractItem",3,0.00,4.00,36,0.42,28344.66,3,0,4,12,2,117.25,54,52,2,1,99.12,0.00,0.00,0.00,0,3.00,7,1264.29,1,2,0,java.lang.Object,0.00,9,0,12,2,9,1,1,5,248,2
"org.apache.jackrabbit.commons.AbstractNode",32,0.00,1.91,182,2.16,72905.60,32,0,19,79,2,88.96,435,250,0,2,118.34,0.00,0.50,0.00,8,32.00,8,6493.79,0,19,2,org.apache.jackrabbit.commons.AbstractItem,0.00,47,1,61,0,47,13,1,44,1373,2
"org.apache.jackrabbit.commons.AbstractProperty",25,0.00,1.24,80,0.88,23126.64,25,0,11,54,1,81.32,269,116,0,2,129.79,0.00,0.50,0.00,1,25.00,4,2633.12,0,5,1,org.apache.jackrabbit.commons.AbstractItem,0.00,29,1,31,0,29,20,2,29,619,2
"org.apache.jackrabbit.commons.AbstractRepository",4,0.00,1.00,11,0.10,1682.59,4,0,6,6,7,90.63,41,16,7,1,139.11,0.00,0.00,0.00,1,4.00,1,308.97,0,3,0,java.lang.Object,0.00,2,0,4,8,2,1,1,6,82,2
"org.apache.jackrabbit.commons.AbstractRepository$HashSet<String>",0,0.00,0.00,56,0.68,20239.60,0,0,6,0,0,171.00,1,56,0,1,171.00,0.00,0.00,0.00,0,0.00,0,2043.01,0,0,0,java.lang.Object,0.00,0,0,0,0,0,0,0,1,338,0
"org.apache.jackrabbit.commons.AbstractRepositoryTest",5,0.00,1.00,32,0.30,5321.55,5,0,4,8,2,85.91,30,38,0,3,118.14,0.00,0.67,0.00,0,5.00,1,893.01,3,0,2,org.apache.jackrabbit.commons.MockCase,0.00,3,2,5,0,3,5,0,6,206,1
"org.apache.jackrabbit.commons.AbstractSession",20,0.79,2.60,142,1.77,62180.59,21,1,26,72,8,74.19,240,217,2,1,111.75,0.00,0.00,0.25,6,70.00,9,5315.58,0,8,6,java.lang.Object,0.00,52,0,52,5,52,12,1,36,1080,2
"org.apache.jackrabbit.commons.AbstractWorkspace",1,0.00,4.00,12,0.14,4857.39,1,0,8,6,2,91.04,15,21,1,1,101.40,0.00,0.00,0.00,0,1.00,4,428.08,0,0,1,java.lang.Object,0.00,5,0,4,2,5,1,1,2,86,2
"org.apache.jackrabbit.commons.JcrUtils",14,0.00,1.00,28,0.44,9654.82,14,0,11,24,3,93.29,157,56,0,1,137.42,0.00,0.00,0.00,0,14.00,1,1316.95,0,0,3,java.lang.Object,0.00,10,0,14,0,10,14,0,15,314,1
"org.apache.jackrabbit.commons.MockCase",4,0.11,1.50,25,0.27,6941.08,7,3,7,18,1,72.24,47,35,1,2,116.37,1.00,0.33,0.42,0,2.00,3,816.71,0,2,0,junit.framework.TestCase,0.00,14,1,6,1,14,2,1,11,175,1
"org.apache.jackrabbit.commons.MockCase$MethodCall",2,2.00,1.00,9,0.09,1223.90,4,2,7,5,0,76.60,18,12,0,1,126.60,0.00,0.00,0.00,0,2.00,1,256.69,0,0,0,java.lang.Object,0.00,3,0,2,0,3,2,0,4,67,2
"org.apache.jackrabbit.commons.NamespaceHelper",8,0.04,2.62,68,0.79,26946.46,12,4,8,30,6,79.93,104,93,5,1,109.31,0.00,0.00,0.28,1,0.00,5,2371.80,0,6,1,java.lang.Object,0.00,22,0,21,0,22,2,0,19,486,1
"org.apache.jackrabbit.server.jcr.JCRWebdavServer",3,0.25,1.33,20,0.20,4071.29,7,4,19,9,9,87.86,41,26,1,1,117.24,0.00,0.00,0.08,0,4.00,2,610.62,0,0,8,java.lang.Object,0.00,6,0,4,0,6,3,1,14,139,1
"org.apache.jackrabbit.server.jcr.JCRWebdavServer$DavSessionImpl",3,0.00,1.00,7,0.05,428.90,3,0,19,3,1,110.58,18,11,0,2,142.80,0.00,0.50,0.00,0,1.00,1,142.37,0,0,1,org.apache.jackrabbit.webdav.jcr.JcrDavSession,0.00,0,1,3,0,0,3,0,3,44,1
"org.apache.jackrabbit.server.jcr.JCRWebdavServer$SessionCache",7,0.00,3.43,79,1.03,40415.60,9,2,19,38,5,59.96,54,103,0,1,102.25,0.00,0.00,0.50,4,0.00,8,3080.98,0,4,5,java.lang.Object,0.00,31,0,24,0,31,3,0,14,580,1
"org.apache.jackrabbit.server.jcr.JCRWebdavServer$SessionMap",3,0.00,1.00,7,0.07,955.13,3,0,19,3,1,140.06,0,11,0,2,140.06,0.00,0.50,0.00,0,3.00,1,198.47,3,3,1,java.util.HashMap,0.00,0,1,3,0,0,0,0,0,58,2
"org.apache.jackrabbit.spi.commons.query.qom.AbstractQOMNode",4,0.67,2.00,17,0.14,2807.20,5,1,4,8,12,93.75,27,27,8,1,125.97,0.00,0.00,0.50,0,4.00,3,423.77,0,3,4,java.lang.Object,0.00,4,0,8,32,4,1,0,5,107,2
"org.apache.jackrabbit.spi.commons.query.qom.AndImpl",4,0.33,1.00,13,0.10,1257.96,6,2,3,5,8,101.31,26,18,6,3,133.53,0.00,0.67,0.25,0,8.00,1,293.91,0,3,3,org.apache.jackrabbit.spi.commons.query.qom.ConstraintImpl,0.00,1,2,4,0,1,1,1,7,80,1
"org.apache.jackrabbit.spi.commons.query.qom.BindVariableValueImpl",4,0.67,1.00,11,0.08,921.37,5,1,3,5,10,108.95,24,18,7,3,141.17,0.00,0.67,0.50,0,4.00,1,242.68,1,3,4,org.apache.jackrabbit.spi.commons.query.qom.StaticOperandImpl,0.00,1,2,4,0,1,1,1,7,68,1
"org.apache.jackrabbit.spi.commons.query.qom.ChildNodeImpl",6,0.20,1.17,19,0.16,3049.96,8,2,6,10,11,99.63,36,29,7,3,131.86,0.00,0.67,0.33,0,14.00,2,486.67,2,5,5,org.apache.jackrabbit.spi.commons.query.qom.ConstraintImpl,0.00,4,2,7,0,4,1,1,9,123,1
"org.apache.jackrabbit.spi.commons.query.qom.ChildNodeJoinConditionImpl",6,0.20,1.00,17,0.12,1424.73,8,2,3,7,10,108.84,36,28,7,3,141.06,0.00,0.67,0.33,0,14.00,1,354.29,1,5,4,org.apache.jackrabbit.spi.commons.query.qom.JoinConditionImpl,0.00,1,2,6,0,1,1,1,9,100,1
"org.apache.jackrabbit.spi.commons.query.qom.ColumnImpl",7,0.08,1.00,22,0.17,2696.93,11,4,3,8,16,90.55,52,33,13,2,132.84,0.00,0.50,0.18,0,24.00,1,512.47,1,6,4,org.apache.jackrabbit.spi.commons.query.qom.AbstractQOMNode,0.00,1,1,7,0,1,1,1,13,135,1
"org.apache.jackrabbit.spi.commons.query.qom.ComparisonImpl",6,0.13,1.00,19,0.14,1671.96,9,3,5,8,11,91.66,42,29,6,3,133.95,0.00,0.67,0.22,0,18.00,1,421.05,0,5,6,org.apache.jackrabbit.spi.commons.query.qom.ConstraintImpl,0.00,2,2,6,0,2,1,1,10,113,1
"org.apache.jackrabbit.spi.commons.query.qom.ConstraintImpl",1,0.00,1.00,3,0.02,160.59,1,0,2,1,16,136.07,4,7,14,2,135.83,9.00,0.09,0.00,0,1.00,1,58.53,0,0,2,org.apache.jackrabbit.spi.commons.query.qom.AbstractQOMNode,0.00,0,1,1,9,0,1,1,1,19,2
"org.apache.jackrabbit.spi.commons.query.qom.DefaultQOMTreeVisitor",27,0.00,1.00,55,0.46,5451.48,27,0,0,27,32,162.23,85,83,4,1,141.62,0.00,0.00,0.00,0,27.00,1,1370.63,0,27,28,java.lang.Object,0.00,0,0,27,1,0,0,1,28,384,1
"org.apache.jackrabbit.spi.commons.query.qom.DefaultTraversingQOMTreeVisitor",10,0.00,1.30,51,0.63,17511.38,10,0,0,32,20,119.56,40,59,3,2,119.33,0.00,0.50,0.00,0,10.00,4,1895.93,0,10,18,org.apache.jackrabbit.spi.commons.query.qom.DefaultQOMTreeVisitor,0.00,22,1,13,0,22,0,0,11,428,1
"org.apache.jackrabbit.spi.commons.query.qom.DescendantNodeImpl",6,0.20,1.17,19,0.16,3049.96,8,2,6,10,11,99.63,36,33,7,3,131.86,0.00,0.67,0.33,0,14.00,2,486.67,2,5,5,org.apache.jackrabbit.spi.commons.query.qom.ConstraintImpl,0.00,4,2,7,0,4,1,1,9,123,1
"org.apache.jackrabbit.spi.commons.query.qom.DescendantNodeJoinConditionImpl",6,0.20,1.00,17,0.12,1424.73,8,2,3,7,8,108.84,36,28,5,3,141.06,0.00,0.67,0.33,0,14.00,1,354.29,1,5,4,org.apache.jackrabbit.spi.commons.query.qom.JoinConditionImpl,0.00,1,2,6,0,1,1,1,9,100,1
"org.apache.jackrabbit.spi.commons.query.qom.DynamicOperandImpl",3,0.50,1.00,9,0.06,681.71,4,1,3,3,18,116.77,16,15,15,2,134.65,7.00,0.11,0.67,0,1.00,1,179.42,1,2,3,org.apache.jackrabbit.spi.commons.query.qom.AbstractQOMNode,0.00,0,1,3,7,0,1,1,4,51,2
"org.apache.jackrabbit.spi.commons.query.qom.EquiJoinConditionImpl",10,0.06,1.00,29,0.20,2619.37,14,4,3,11,9,108.51,62,46,6,3,140.73,0.00,0.67,0.20,0,58.00,1,585.21,1,9,4,org.apache.jackrabbit.spi.commons.query.qom.JoinConditionImpl,0.00,1,2,10,0,1,1,1,15,164,1
"org.apache.jackrabbit.spi.commons.query.qom.FullTextSearchImpl",7,0.11,1.00,21,0.15,1808.37,10,3,4,8,12,91.92,49,34,9,3,134.21,0.00,0.67,0.24,0,24.00,1,442.56,1,6,4,org.apache.jackrabbit.spi.commons.query.qom.ConstraintImpl,0.00,1,2,7,0,1,1,1,12,122,1
"org.apache.jackrabbit.spi.commons.query.qom.FullTextSearchScoreImpl",2,0.00,1.00,5,0.05,500.81,2,0,3,3,11,123.01,10,10,8,3,140.88,0.00,0.67,0.00,0,2.00,1,139.27,0,1,4,org.apache.jackrabbit.spi.commons.query.qom.DynamicOperandImpl,0.00,1,2,2,0,1,1,1,3,40,1
"org.apache.jackrabbit.spi.commons.query.qom.JoinConditionImpl",1,0.00,1.00,3,0.02,160.59,1,0,2,1,12,156.45,3,7,10,2,135.83,4.00,0.17,0.00,0,1.00,1,58.53,0,0,2,org.apache.jackrabbit.spi.commons.query.qom.AbstractQOMNode,0.00,0,1,1,4,0,1,1,1,19,2
"org.apache.jackrabbit.spi.commons.query.qom.JoinImpl",8,0.04,1.00,30,0.27,6970.85,12,4,4,12,12,97.83,49,44,7,3,130.05,0.00,0.67,0.22,0,32.00,1,803.83,0,5,6,org.apache.jackrabbit.spi.commons.query.qom.SourceImpl,0.21,4,2,8,0,4,3,1,13,203,1
"org.apache.jackrabbit.spi.commons.query.qom.JoinType",4,0.67,1.50,15,0.15,3775.95,5,1,6,7,8,87.39,31,27,7,1,129.68,0.00,0.00,0.50,0,4.00,3,462.00,0,3,1,java.lang.Object,0.00,3,0,6,0,3,1,1,5,112,1
"org.apache.jackrabbit.spi.commons.query.qom.LengthImpl",3,1.00,1.00,9,0.08,915.87,4,1,3,5,11,101.41,18,13,8,3,133.64,0.00,0.67,0.33,0,4.00,1,227.75,0,2,4,org.apache.jackrabbit.spi.commons.query.qom.DynamicOperandImpl,0.00,2,2,3,0,2,1,1,5,62,1
"org.apache.jackrabbit.spi.commons.query.qom.LiteralImpl",3,1.00,1.00,9,0.07,909.92,4,1,3,4,7,133.89,13,13,5,3,133.66,0.00,0.67,0.33,0,4.00,1,216.64,0,2,3,org.apache.jackrabbit.spi.commons.query.qom.StaticOperandImpl,0.00,1,2,3,0,1,1,1,4,59,1
"org.apache.jackrabbit.spi.commons.query.qom.LowerCaseImpl",3,1.00,1.00,9,0.08,959.59,4,1,3,5,10,101.25,18,13,8,3,133.48,0.00,0.67,0.33,0,4.00,1,226.13,0,2,3,org.apache.jackrabbit.spi.commons.query.qom.DynamicOperandImpl,0.00,2,2,3,0,2,1,1,5,62,1
"org.apache.jackrabbit.spi.commons.query.qom.NodeLocalNameImpl",2,0.00,1.00,5,0.05,500.81,2,0,3,3,11,123.01,10,10,8,3,140.88,0.00,0.67,0.00,0,2.00,1,139.27,0,1,4,org.apache.jackrabbit.spi.commons.query.qom.DynamicOperandImpl,0.00,1,2,2,0,1,1,1,3,40,1
"org.apache.jackrabbit.spi.commons.query.qom.NodeNameImpl",2,0.00,1.00,5,0.05,500.81,2,0,3,3,11,123.01,10,8,8,3,140.88,0.00,0.67,0.00,0,2.00,1,139.27,0,1,4,org.apache.jackrabbit.spi.commons.query.qom.DynamicOperandImpl,0.00,1,2,2,0,1,1,1,3,40,1
"org.apache.jackrabbit.spi.commons.query.qom.NotImpl",3,1.00,1.00,9,0.07,885.84,4,1,3,4,8,101.53,18,13,6,3,133.75,0.00,0.67,0.33,0,4.00,1,209.36,0,2,3,org.apache.jackrabbit.spi.commons.query.qom.ConstraintImpl,0.00,1,2,3,0,1,1,1,5,58,1
"org.apache.jackrabbit.spi.commons.query.qom.Operator",8,0.19,1.38,30,0.40,8664.86,11,3,6,18,15,86.94,58,59,15,1,129.23,0.00,0.00,0.17,0,28.00,3,1207.60,0,6,0,java.lang.Object,0.00,10,0,11,0,10,2,1,10,280,1
"org.apache.jackrabbit.spi.commons.query.qom.OrImpl",4,0.33,1.00,13,0.10,1257.96,6,2,3,5,8,101.31,26,18,6,3,133.53,0.00,0.67,0.25,0,8.00,1,293.91,0,3,3,org.apache.jackrabbit.spi.commons.query.qom.ConstraintImpl,0.00,1,2,4,0,1,1,1,7,80,1
"org.apache.jackrabbit.spi.commons.query.qom.Order",3,1.00,1.67,13,0.11,2627.10,4,1,1,5,2,93.03,19,19,2,1,125.25,0.00,0.00,0.33,0,4.00,3,321.78,0,2,0,java.lang.Object,0.00,2,0,5,0,2,1,1,4,80,1
"org.apache.jackrabbit.spi.commons.query.qom.OrderingImpl",5,0.17,1.00,16,0.15,2188.55,8,3,4,8,14,90.11,35,24,10,2,132.40,0.00,0.50,0.20,0,10.00,1,438.74,0,3,5,org.apache.jackrabbit.spi.commons.query.qom.AbstractQOMNode,0.00,3,1,5,0,3,2,1,9,112,1
"org.apache.jackrabbit.spi.commons.query.qom.PropertyExistenceImpl",6,0.20,1.00,17,0.12,1424.73,8,2,3,7,12,108.84,37,28,9,3,141.06,0.00,0.67,0.33,0,14.00,1,354.29,1,5,4,org.apache.jackrabbit.spi.commons.query.qom.ConstraintImpl,0.00,1,2,6,0,1,1,1,10,100,1
"org.apache.jackrabbit.spi.commons.query.qom.PropertyValueImpl",4,0.67,1.00,11,0.09,1004.37,5,1,3,5,14,108.65,24,20,11,3,140.87,0.00,0.67,0.50,0,4.00,1,255.75,1,3,4,org.apache.jackrabbit.spi.commons.query.qom.DynamicOperandImpl,0.00,1,2,4,0,1,1,1,7,71,1
"org.apache.jackrabbit.spi.commons.query.qom.QOMTreeVisitor",27,0.00,1.00,28,0.29,1512.79,27,0,0,27,31,157.23,3,29,31,1,157.23,0.00,0.00,0.00,0,27.00,1,865.88,0,27,27,,0.00,0,0,27,0,0,0,0,1,275,1
"org.apache.jackrabbit.spi.commons.query.qom.QueryObjectModelFactoryImpl",49,0.03,1.94,215,2.87,101944.44,51,2,42,85,43,73.78,515,437,5,1,122.26,0.00,0.00,0.47,2,0.00,10,8606.36,0,48,38,java.lang.Object,0.00,36,0,95,2,36,1,1,60,1846,2
"org.apache.jackrabbit.spi.commons.query.qom.QueryObjectModelTree",8,0.06,1.50,43,0.50,14796.57,13,5,7,23,27,76.82,62,59,19,2,119.11,0.00,0.50,0.15,2,40.00,4,1487.49,0,5,10,org.apache.jackrabbit.spi.commons.query.qom.AbstractQOMNode,0.00,15,1,12,0,15,3,0,18,316,1
"org.apache.jackrabbit.spi.commons.query.qom.QueryObjectModelTree$DefaultTraversingQOMTreeVisitor",13,0.00,1.15,36,0.41,7358.34,13,0,7,29,14,138.06,0,56,0,1,138.06,0.00,0.00,0.00,1,24.00,3,1223.28,0,13,14,java.lang.Object,0.00,16,0,15,0,16,0,0,0,300,0
"org.apache.jackrabbit.spi.commons.query.qom.SameNodeImpl",5,0.25,1.20,17,0.15,2989.96,7,2,6,9,11,99.07,31,27,7,3,131.29,0.00,0.67,0.30,0,10.00,2,462.67,2,4,5,org.apache.jackrabbit.spi.commons.query.qom.ConstraintImpl,0.00,4,2,6,0,4,1,1,8,115,1
"org.apache.jackrabbit.spi.commons.query.qom.SameNodeJoinConditionImpl",8,0.10,1.00,23,0.16,1887.62,11,3,4,9,10,108.86,49,37,6,3,141.09,0.00,0.67,0.25,0,32.00,1,474.26,2,7,5,org.apache.jackrabbit.spi.commons.query.qom.JoinConditionImpl,0.00,1,2,8,0,1,1,1,12,132,1
"org.apache.jackrabbit.spi.commons.query.qom.SelectorImpl",7,0.25,1.00,19,0.13,1626.26,9,2,3,8,26,108.92,47,29,24,3,141.14,0.00,0.67,0.29,0,19.00,1,397.47,1,6,4,org.apache.jackrabbit.spi.commons.query.qom.SourceImpl,0.23,1,2,7,0,1,1,1,12,113,1
"org.apache.jackrabbit.spi.commons.query.qom.SourceImpl",2,0.00,1.00,4,0.03,209.72,2,0,2,2,9,164.47,6,6,7,2,143.86,2.00,0.25,0.00,0,2.00,1,78.18,0,0,3,org.apache.jackrabbit.spi.commons.query.qom.AbstractQOMNode,0.00,0,1,2,2,0,2,1,2,26,2
"org.apache.jackrabbit.spi.commons.query.qom.StaticOperandImpl",1,0.00,1.00,3,0.02,160.59,1,0,2,1,9,156.45,3,7,7,2,135.83,2.00,0.25,0.00,0,1.00,1,58.53,0,0,2,org.apache.jackrabbit.spi.commons.query.qom.AbstractQOMNode,0.00,0,1,1,2,0,1,1,1,19,2
"org.apache.jackrabbit.spi.commons.query.qom.UpperCaseImpl",3,1.00,1.00,9,0.08,959.59,4,1,3,5,10,101.25,18,13,8,3,133.48,0.00,0.67,0.33,0,4.00,1,226.13,0,2,3,org.apache.jackrabbit.spi.commons.query.qom.DynamicOperandImpl,0.00,2,2,3,0,2,1,1,5,62,1
"org.apache.jackrabbit.webdav.simple.DavResourceImpl",51,0.02,3.02,397,5.48,188648.42,65,14,66,169,50,93.25,268,578,2,1,111.12,0.00,0.00,0.09,22,1058.00,11,16431.32,0,25,48,java.lang.Object,0.00,118,0,154,4,118,26,3,99,3096,1
"org.apache.jackrabbit.webdav.simple.DavResourceImpl$PropertyExportCtx",9,0.00,1.89,43,0.47,10467.33,9,0,66,18,6,124.25,2,61,0,2,124.25,0.00,0.50,0.00,2,0.00,4,1399.81,0,1,6,org.apache.jackrabbit.server.io.AbstractExportContext,0.00,9,1,17,0,9,8,1,2,314,1
"org.apache.jackrabbit.webdav.simple.DavResourceImpl$ProperyImportCtx",8,0.14,1.12,22,0.13,1392.85,11,3,66,11,3,181.98,17,32,0,1,142.10,0.00,0.00,0.21,1,32.00,2,400.28,0,3,3,java.lang.Object,0.00,3,0,9,0,3,5,1,5,113,1
"org.apache.jackrabbit.webdav.simple.DavSessionImpl",6,0.60,1.00,16,0.13,1742.92,7,1,4,12,3,140.61,24,23,1,2,140.37,0.00,0.50,0.50,0,6.00,1,401.76,2,1,2,org.apache.jackrabbit.webdav.jcr.JcrDavSession,0.14,6,1,6,0,6,5,0,8,112,1
"org.apache.jackrabbit.webdav.simple.DavSessionProviderImpl",3,0.33,3.33,37,0.51,19201.65,6,3,15,19,10,80.35,43,46,1,1,100.49,0.00,0.00,0.56,0,1.00,6,1532.96,0,0,9,java.lang.Object,0.00,16,0,10,0,16,3,1,12,286,1
"org.apache.jackrabbit.webdav.simple.DefaultItemFilter",9,0.00,2.44,60,0.64,16964.88,13,4,9,25,2,116.21,41,77,1,1,115.98,0.00,0.00,0.25,1,27.00,4,1931.70,0,0,1,java.lang.Object,0.00,16,0,22,0,16,9,1,13,414,1
"org.apache.jackrabbit.webdav.simple.DeltaVResourceImpl",13,0.22,2.15,81,1.05,31329.61,16,3,28,41,25,97.29,75,114,3,2,115.16,3.00,0.20,0.13,3,56.00,4,3150.43,6,8,22,org.apache.jackrabbit.webdav.simple.DavResourceImpl,0.06,28,1,28,3,28,5,1,17,651,1
"org.apache.jackrabbit.webdav.simple.ItemFilter",5,0.00,1.00,6,0.04,228.27,5,0,2,5,3,115.64,35,7,3,1,157.93,0.00,0.00,0.00,0,5.00,1,128.18,0,0,0,,0.00,0,0,5,0,0,5,0,6,44,1
"org.apache.jackrabbit.webdav.simple.LocatorFactoryImpl",4,0.50,2.25,23,0.34,14951.84,6,2,5,15,3,156.49,8,33,0,1,116.61,0.00,0.00,0.12,1,6.00,6,1024.40,0,3,3,java.lang.Object,0.00,11,0,9,0,11,1,1,6,216,1
"org.apache.jackrabbit.webdav.simple.LocatorFactoryImpl$Locator",13,0.12,1.23,40,0.34,7000.65,17,4,5,21,3,181.65,21,56,0,1,131.65,0.00,0.00,0.13,4,74.00,2,1011.17,0,7,3,java.lang.Object,0.00,8,0,16,0,8,6,1,5,257,1
"org.apache.jackrabbit.webdav.simple.LocatorFactoryImplEx",4,1.00,2.25,21,0.22,7005.95,5,1,3,10,3,119.44,17,30,2,2,119.20,0.00,0.50,0.00,0,4.00,4,650.37,0,2,1,org.apache.jackrabbit.webdav.AbstractLocatorFactory,0.00,6,1,9,0,6,2,0,4,149,1
"org.apache.jackrabbit.webdav.simple.LocatorFactoryImplExTest",2,0.00,1.00,14,0.17,2755.71,3,1,3,12,3,114.99,8,17,0,2,114.76,0.00,0.50,1.00,0,0.00,1,509.28,1,0,3,junit.framework.TestCase,0.00,10,1,2,0,10,2,0,3,109,1
"org.apache.jackrabbit.webdav.simple.ResourceConfig",9,0.18,4.78,157,2.22,133730.84,16,7,25,44,18,43.78,79,199,7,1,91.89,0.00,0.00,0.30,3,0.00,20,6673.78,0,6,11,java.lang.Object,0.00,35,0,43,0,35,3,0,20,1132,1
"org.apache.jackrabbit.webdav.simple.ResourceFactoryImpl",8,0.14,2.38,66,0.82,27074.45,11,3,20,28,16,59.32,76,92,1,1,109.32,0.00,0.00,0.21,3,24.00,4,2465.91,0,5,15,java.lang.Object,0.00,20,0,19,0,20,3,1,12,502,1
"org.apache.jackrabbit.webdav.simple.SimpleWebdavServlet",19,0.00,1.58,83,0.84,22184.97,33,14,18,40,17,74.28,183,115,1,3,124.28,0.50,0.50,0.07,3,182.00,6,2523.04,1,11,16,org.apache.jackrabbit.webdav.server.AbstractWebdavServlet,0.18,21,2,30,1,21,8,0,35,546,2
"org.apache.jackrabbit.webdav.simple.VersionControlledResourceImpl",14,0.85,3.29,121,1.61,55074.24,15,1,29,46,24,58.73,134,174,1,3,108.73,0.00,0.67,0.21,2,58.00,7,4823.75,10,5,23,org.apache.jackrabbit.webdav.simple.DeltaVResourceImpl,0.12,32,2,46,0,32,9,1,37,935,1
"org.apache.jackrabbit.webdav.simple.VersionHistoryResourceImpl",9,1.00,2.78,68,1.08,32319.30,10,1,27,41,21,68.95,66,99,1,3,111.24,0.00,0.67,0.11,0,16.00,5,3237.79,8,3,20,org.apache.jackrabbit.webdav.simple.DeltaVResourceImpl,0.08,32,2,25,0,32,6,1,24,613,1
"org.apache.jackrabbit.webdav.simple.VersionResourceImpl",13,1.00,2.15,76,1.15,36097.06,14,1,34,49,25,75.34,96,107,1,3,117.63,0.00,0.67,0.08,1,35.00,6,3445.93,7,4,24,org.apache.jackrabbit.webdav.simple.DeltaVResourceImpl,0.16,36,2,28,0,36,9,1,26,656,1
"org.apache.jackrabbit.core.observation.ChangeLogBasedHierarchyMgr",3,0.00,1.00,11,0.12,1409.98,4,1,19,8,15,102.78,41,20,1,3,132.16,0.00,0.67,1.00,0,0.00,1,365.23,0,2,14,org.apache.jackrabbit.core.CachingHierarchyManager,0.00,5,2,3,0,5,1,0,6,91,0
"org.apache.jackrabbit.core.observation.ChangeLogBasedHierarchyMgr$AtticItemStateManager",5,0.50,1.40,21,0.19,3846.96,6,1,19,13,8,93.52,33,27,0,1,125.74,0.00,0.00,0.60,0,2.00,2,574.21,0,2,8,java.lang.Object,0.00,8,0,7,0,8,3,1,6,138,2
"org.apache.jackrabbit.core.observation.ChangeLogBasedHierarchyMgr$ChangeLogItemStateManager",5,0.12,1.80,22,0.20,4078.84,7,2,19,9,8,77.37,42,35,0,1,125.48,0.00,0.00,0.40,0,7.00,3,601.53,0,2,8,java.lang.Object,0.00,4,0,9,0,4,3,1,11,145,2
"org.apache.jackrabbit.core.observation.DelegatingObservationDispatcher",7,0.25,1.29,30,0.33,8716.27,9,2,7,23,10,81.82,50,46,4,2,124.11,0.00,0.50,0.29,1,10.00,3,999.95,0,0,6,org.apache.jackrabbit.core.observation.EventDispatcher,0.40,16,1,9,0,16,7,0,13,222,1
"org.apache.jackrabbit.core.observation.DispatchAction",3,0.25,1.00,10,0.07,874.66,5,2,1,3,3,83.79,27,14,1,1,133.79,0.00,0.00,0.33,0,5.00,1,203.24,0,1,2,java.lang.Object,0.00,0,0,3,0,0,2,0,6,57,0
"org.apache.jackrabbit.core.observation.EventConsumer",9,0.16,3.89,96,1.33,53283.85,16,7,19,46,15,59.55,106,134,5,1,103.68,0.00,0.00,0.29,0,0.00,8,3975.29,0,2,10,java.lang.Object,0.00,37,0,35,0,37,7,0,25,749,0
"org.apache.jackrabbit.core.observation.EventDispatcher",3,0.00,1.00,4,0.03,113.75,3,0,1,3,4,116.28,22,5,3,1,158.57,0.00,0.00,0.00,0,3.00,1,75.83,0,0,2,java.lang.Object,0.00,0,0,3,2,0,3,0,4,27,1
"org.apache.jackrabbit.core.observation.EventFilter",4,0.15,3.75,62,0.75,45906.07,13,9,9,20,13,138.80,88,78,6,1,94.86,0.00,0.00,0.22,0,6.00,12,2255.43,0,2,7,java.lang.Object,0.00,16,0,15,1,16,2,0,22,408,1
"org.apache.jackrabbit.core.observation.EventFilter$BlockAllFilter",2,0.00,1.00,5,0.03,264.06,2,0,9,2,2,143.31,8,8,0,2,143.07,0.00,0.50,0.00,0,2.00,1,97.53,0,0,2,org.apache.jackrabbit.core.observation.EventFilter,0.33,0,1,2,0,0,2,0,2,32,3
"org.apache.jackrabbit.core.observation.EventImpl",17,0.05,1.65,92,1.05,32398.66,23,6,15,53,14,86.76,118,124,5,1,118.98,0.00,0.00,0.22,5,19.00,3,3152.86,0,9,9,java.lang.Object,0.00,36,0,28,0,36,8,2,27,677,2
"org.apache.jackrabbit.core.observation.EventJournalImpl",13,0.03,2.31,109,1.27,50012.72,23,10,27,59,14,66.60,98,153,1,1,108.89,0.00,0.00,0.13,4,42.00,8,3810.41,0,3,13,java.lang.Object,0.00,46,0,30,0,46,10,1,40,734,1
"org.apache.jackrabbit.core.observation.EventJournalImpl$EventBundle",1,2.00,1.00,6,0.07,990.16,3,2,27,3,2,98.24,14,12,0,1,118.38,0.00,0.00,0.00,0,1.00,1,215.89,0,0,2,java.lang.Object,0.00,2,0,1,0,2,1,0,3,52,3
"org.apache.jackrabbit.core.observation.EventJournalImpl$RecordProcessor",7,0.25,1.29,19,0.17,3110.82,9,2,27,14,6,178.75,20,30,0,1,138.86,0.00,0.00,0.29,0,14.00,3,517.16,0,0,6,java.lang.Object,0.00,7,0,9,0,7,7,1,10,129,1
"org.apache.jackrabbit.core.observation.EventListenerIteratorImpl",9,0.06,1.78,44,0.35,7894.05,13,4,7,19,2,93.01,61,62,1,1,125.23,0.00,0.00,0.19,3,21.00,4,1062.49,0,2,1,java.lang.Object,0.00,10,0,16,0,10,7,1,15,253,0
"org.apache.jackrabbit.core.observation.EventState",35,0.00,1.60,176,2.43,70593.81,54,19,22,69,22,74.67,418,335,12,1,118.80,0.00,0.00,0.05,8,541.00,7,7281.91,0,27,10,java.lang.Object,0.00,34,0,56,0,34,8,0,60,1500,1
"org.apache.jackrabbit.core.observation.EventStateCollection",24,0.01,2.96,269,4.87,666455.75,31,7,27,99,33,52.78,275,414,15,1,96.91,0.00,0.00,0.14,7,294.00,23,14622.23,0,14,20,java.lang.Object,0.00,75,0,71,0,75,10,0,112,2398,2
"org.apache.jackrabbit.core.observation.EventStateCollectionFactory",1,0.00,1.00,2,0.01,38.26,1,0,1,1,9,97.31,9,3,8,1,147.31,0.00,0.00,0.00,0,1.00,1,25.51,0,0,1,,0.00,0,0,1,0,0,1,0,2,11,1
"org.apache.jackrabbit.core.observation.FilteredEventIterator",10,0.01,1.60,47,0.45,11024.31,18,8,7,21,5,82.18,73,70,2,1,124.48,0.00,0.00,0.14,2,26.00,5,1352.32,0,2,3,java.lang.Object,0.00,11,0,16,0,11,8,1,20,303,0
"org.apache.jackrabbit.core.observation.MixinTest",5,0.00,1.20,67,0.98,31253.22,5,0,6,18,3,81.64,27,81,1,5,99.51,0.00,0.80,0.00,1,0.00,2,2925.22,2,0,2,org.apache.jackrabbit.test.api.observation.AbstractObservationTest,0.00,13,4,6,0,13,5,0,7,555,1
"org.apache.jackrabbit.core.observation.MoveInPlaceTest",1,0.00,1.00,15,0.24,5008.72,1,0,4,14,2,118.61,3,17,1,5,97.99,0.00,0.80,0.00,0,0.00,1,734.94,1,0,1,org.apache.jackrabbit.core.query.AbstractQueryTest,0.00,13,4,1,0,13,1,0,1,137,1
"org.apache.jackrabbit.core.observation.ObservationDispatcher",10,0.17,2.30,86,0.99,27418.66,19,9,10,42,9,61.94,83,114,4,2,110.05,0.00,0.50,0.27,2,34.00,4,2980.29,0,2,5,org.apache.jackrabbit.core.observation.EventDispatcher,0.31,32,1,23,0,32,8,1,32,609,2
"org.apache.jackrabbit.core.observation.ObservationManagerImpl",11,0.08,2.09,81,1.06,48193.75,17,6,18,42,18,60.63,99,132,3,1,110.63,0.00,0.00,0.24,4,15.00,7,3193.97,0,4,16,java.lang.Object,0.00,31,0,23,0,31,7,2,23,626,1
"org.apache.jackrabbit.core.observation.ReorderTest",1,0.00,3.00,28,0.42,18576.03,1,0,6,13,4,96.93,34,31,1,5,83.15,0.00,0.80,0.00,0,0.00,3,1246.25,4,0,3,org.apache.jackrabbit.test.api.observation.AbstractObservationTest,0.00,12,4,3,0,12,1,0,6,217,1
"org.apache.jackrabbit.core.observation.ShareableNodesTest",4,0.00,1.25,43,0.63,16727.23,4,0,7,18,4,105.13,3,48,1,5,105.13,0.00,0.80,0.00,1,0.00,2,1877.45,3,0,3,org.apache.jackrabbit.test.api.observation.AbstractObservationTest,0.00,14,4,5,0,14,4,0,1,353,1
"org.apache.jackrabbit.core.observation.SynchronousEventListener",0,0.00,0.00,1,0.01,31.02,0,0,1,0,8,171.00,8,2,8,2,171.00,0.00,0.50,0.00,0,0.00,0,15.51,0,0,0,,0.00,0,1,0,0,0,0,0,1,6,1
"org.apache.jackrabbit.core.observation.TestAll",1,0.00,1.00,9,0.09,2740.87,1,0,3,3,5,64.20,11,11,0,2,108.33,0.00,0.50,0.00,0,1.00,1,261.86,0,1,5,junit.framework.TestCase,0.00,2,1,1,0,2,0,0,2,63,1
"org.apache.jackrabbit.core.observation.VersionEventsTest",5,0.00,2.00,109,1.60,53265.73,5,0,12,30,4,47.51,35,108,1,5,89.80,0.00,0.80,0.00,0,0.00,2,4788.47,2,0,3,org.apache.jackrabbit.test.api.observation.AbstractObservationTest,0.00,25,4,10,0,25,5,0,17,812,1
"org.apache.jackrabbit.core.security.authentication.AbstractLoginModule",23,0.05,3.30,204,2.56,125423.00,36,13,25,75,9,87.47,337,281,1,1,107.61,0.00,0.00,0.12,11,193.00,15,7694.45,0,9,8,java.lang.Object,0.00,52,0,76,2,52,14,1,47,1432,2
"org.apache.jackrabbit.core.security.authentication.AuthContext",3,0.00,1.00,4,0.02,82.39,3,0,2,3,9,111.19,30,5,9,1,159.67,0.00,0.00,0.00,0,3.00,1,52.95,0,1,0,,0.00,0,0,3,0,0,2,0,4,22,2
"org.apache.jackrabbit.core.security.authentication.AuthContextProvider",6,0.05,2.67,51,0.54,18132.94,10,4,13,20,8,59.68,54,72,2,1,109.68,0.00,0.00,0.29,3,10.00,5,1615.78,0,2,6,java.lang.Object,0.00,14,0,16,0,14,4,0,13,337,1
"org.apache.jackrabbit.core.security.authentication.Authentication",2,0.00,1.00,3,0.02,66.51,2,0,2,2,4,148.66,31,4,4,1,159.02,0.00,0.00,0.00,0,2.00,1,49.51,0,0,0,,0.00,0,0,2,0,0,2,0,3,19,1
"org.apache.jackrabbit.core.security.authentication.CallbackHandlerImpl",2,0.67,6.00,48,0.61,30607.54,8,6,13,16,6,56.77,27,56,1,1,86.15,0.00,0.00,0.50,0,2.00,9,1823.50,0,0,5,java.lang.Object,0.00,14,0,12,0,14,2,1,4,331,1
"org.apache.jackrabbit.core.security.authentication.CredentialsCallback",2,1.00,1.00,6,0.04,373.42,3,1,3,2,2,103.10,13,9,2,1,135.32,0.00,0.00,0.50,0,2.00,1,110.49,0,1,0,java.lang.Object,0.00,0,0,2,0,0,1,2,3,33,1
"org.apache.jackrabbit.core.security.authentication.CryptedSimpleCredentials",10,0.11,2.00,70,0.84,33785.77,14,4,9,35,5,132.14,30,90,3,1,111.53,0.00,0.00,0.35,3,14.00,5,2529.12,0,7,2,java.lang.Object,0.00,25,0,20,0,25,3,1,11,515,1
"org.apache.jackrabbit.core.security.authentication.DefaultLoginModule",4,0.33,3.00,37,0.49,13932.56,7,3,15,21,8,63.13,46,53,1,2,107.26,0.00,0.50,0.58,0,0.00,3,1464.09,2,2,7,org.apache.jackrabbit.core.security.authentication.AbstractLoginModule,0.00,17,1,12,0,17,2,0,7,290,1
"org.apache.jackrabbit.core.security.authentication.GuestLoginTest",3,0.00,1.33,11,0.09,1176.48,4,1,4,9,2,172.60,6,16,1,4,132.71,0.00,0.75,1.00,0,0.00,2,278.78,2,0,1,org.apache.jackrabbit.test.AbstractJCRTest,0.31,6,3,4,0,6,3,0,2,73,1
"org.apache.jackrabbit.core.security.authentication.ImpersonationCallback",2,1.00,1.50,7,0.05,702.65,3,1,2,2,2,88.93,23,11,2,1,133.06,0.00,0.00,0.50,0,2.00,2,140.50,0,1,0,java.lang.Object,0.00,0,0,3,0,0,1,1,4,40,1
"org.apache.jackrabbit.core.security.authentication.JAASAuthContext",4,0.00,1.50,18,0.18,5346.82,5,1,4,12,3,144.45,13,28,2,1,123.83,0.00,0.00,1.00,0,0.00,3,542.87,0,1,1,java.lang.Object,0.00,8,0,6,0,8,3,1,5,123,1
"org.apache.jackrabbit.core.security.authentication.LocalAuthContext",4,0.27,3.00,37,0.52,24690.02,9,5,13,23,4,125.92,13,53,1,1,105.30,0.00,0.00,0.40,0,0.00,7,1562.45,0,1,3,java.lang.Object,0.00,19,0,12,0,19,3,1,2,295,1
"org.apache.jackrabbit.core.security.authentication.NullLoginTest",1,0.00,1.00,10,0.13,3583.57,1,0,3,9,2,155.71,1,14,1,4,105.71,0.00,0.75,0.00,0,0.00,1,387.02,0,0,1,org.apache.jackrabbit.test.AbstractJCRTest,0.00,8,3,1,0,8,1,0,1,86,1
"org.apache.jackrabbit.core.security.authentication.RepositoryCallback",8,0.14,1.00,21,0.13,1334.14,12,4,3,8,3,142.27,4,30,2,1,142.27,0.00,0.00,0.12,0,32.00,1,377.47,0,4,1,java.lang.Object,0.00,0,0,8,0,0,4,1,1,110,1
"org.apache.jackrabbit.core.security.authentication.SimpleCredentialsAuthentication",3,0.25,3.67,26,0.36,13870.55,5,2,8,14,4,78.77,41,39,1,1,108.15,0.00,0.00,0.67,0,0.00,5,1067.00,0,0,3,java.lang.Object,0.00,11,0,11,0,11,3,1,5,217,0
"org.apache.jackrabbit.core.security.authentication.TestAll",1,1.00,1.00,7,0.07,1719.18,2,1,5,4,2,164.00,1,9,0,2,114.00,0.00,0.50,0.00,0,1.00,1,214.89,0,1,2,junit.framework.TestCase,0.00,3,1,1,0,3,0,0,1,53,1
"org.apache.jackrabbit.client.spi.RepositoryConfigImpl",9,0.02,2.22,55,0.61,18146.59,14,5,14,20,12,155.65,19,77,3,2,115.77,0.00,0.50,0.22,1,36.00,4,1843.47,0,5,9,org.apache.jackrabbit.client.AbstractRepositoryConfig,0.00,11,1,20,0,11,4,0,4,397,1
"org.apache.jackrabbit.client.spi.RepositoryConfigImpl$BatchReadConfig",1,0.00,1.00,3,0.02,171.91,1,0,14,1,2,135.60,0,4,0,1,135.60,0.00,0.00,0.00,0,1.00,1,61.30,0,0,2,java.lang.Object,0.00,0,0,1,0,0,1,0,0,18,0
"org.apache.jackrabbit.webdav.ordering.OrderPatch",6,0.07,2.00,50,0.70,33985.01,9,3,12,28,15,59.12,61,61,7,1,107.60,0.00,0.00,0.28,0,10.00,5,2090.55,0,4,8,java.lang.Object,0.00,22,0,12,0,22,2,2,17,392,1
"org.apache.jackrabbit.webdav.ordering.OrderPatch$Member",4,0.00,1.00,15,0.12,1744.76,6,2,12,8,3,114.54,22,20,0,1,132.42,0.00,0.00,0.50,0,2.00,1,358.30,0,2,3,java.lang.Object,0.00,4,0,4,0,4,2,1,5,93,2
"org.apache.jackrabbit.webdav.ordering.OrderingConstants",0,0.00,0.00,18,0.33,7696.03,17,17,3,1,11,171.00,55,19,8,1,171.00,0.00,0.00,0.00,0,0.00,0,999.83,0,0,3,,0.00,1,0,0,0,1,0,0,13,180,1
"org.apache.jackrabbit.webdav.ordering.OrderingDavServletRequest",3,0.00,1.00,4,0.02,105.15,3,0,2,3,4,110.73,25,5,0,2,158.84,0.00,0.50,0.00,0,3.00,1,58.38,0,2,4,,0.00,0,1,3,0,0,1,0,4,23,1
"org.apache.jackrabbit.webdav.ordering.OrderingResource",2,1.00,1.00,4,0.03,209.39,3,1,2,2,5,95.76,17,5,2,2,143.86,0.00,0.50,0.00,0,2.00,1,85.11,0,0,3,,0.00,0,1,2,0,0,2,0,3,27,1
"org.apache.jackrabbit.webdav.ordering.OrderingType",2,0.00,1.50,5,0.04,429.68,2,0,1,2,3,97.19,22,8,1,3,141.31,0.00,0.67,0.00,0,2.00,2,120.69,0,0,2,org.apache.jackrabbit.webdav.property.HrefProperty,0.00,0,2,3,0,0,2,1,4,35,1
"org.apache.jackrabbit.webdav.ordering.Position",6,0.00,2.17,45,0.53,15671.80,10,4,9,20,11,68.26,66,60,7,1,112.39,0.00,0.00,0.25,0,14.00,3,1590.00,0,4,4,java.lang.Object,0.00,14,0,13,0,14,2,2,11,342,1
"org.apache.jackrabbit.test.api.nodetype.CanAddChildNodeCallWithNodeTypeTest",9,0.38,2.56,88,1.26,36642.80,11,2,8,31,4,74.54,55,139,1,4,106.76,0.00,0.75,0.83,0,0.00,5,3785.64,2,0,3,org.apache.jackrabbit.test.AbstractJCRTest,0.25,22,3,23,0,22,9,0,12,718,1
"org.apache.jackrabbit.test.api.nodetype.CanAddChildNodeCallWithoutNodeTypeTest",7,0.00,1.86,44,0.59,13441.39,8,1,6,17,4,83.75,44,79,1,4,115.98,0.00,0.75,1.00,0,0.00,2,1778.37,2,0,3,org.apache.jackrabbit.test.AbstractJCRTest,0.27,10,3,13,0,10,7,0,9,361,1
"org.apache.jackrabbit.test.api.nodetype.CanRemoveItemTest",8,0.00,1.88,53,0.77,18578.78,9,1,7,22,4,83.10,51,105,1,4,115.32,0.00,0.75,1.00,0,0.00,2,2309.41,2,0,3,org.apache.jackrabbit.test.AbstractJCRTest,0.26,14,3,15,0,14,8,0,10,463,1
"org.apache.jackrabbit.test.api.nodetype.CanSetPropertyBinaryTest",6,0.00,2.17,80,1.62,82450.87,7,1,9,17,4,78.81,35,144,1,4,96.68,0.00,0.75,1.00,0,0.00,3,4852.97,2,0,3,org.apache.jackrabbit.test.AbstractJCRTest,0.28,11,3,13,0,11,6,0,8,849,1
"org.apache.jackrabbit.test.api.nodetype.CanSetPropertyBooleanTest",6,0.00,2.17,80,1.64,83139.00,7,1,9,17,4,64.43,36,145,1,4,96.66,0.00,0.75,1.00,0,0.00,3,4915.18,2,0,3,org.apache.jackrabbit.test.AbstractJCRTest,0.28,11,3,13,0,11,6,0,8,856,1
"org.apache.jackrabbit.test.api.nodetype.CanSetPropertyDateTest",6,0.00,2.17,90,2.08,113322.74,7,1,9,20,4,61.06,37,174,1,4,93.28,0.00,0.75,1.00,0,0.00,3,6252.90,2,0,3,org.apache.jackrabbit.test.AbstractJCRTest,0.28,14,3,13,0,14,6,0,10,1044,1
"org.apache.jackrabbit.test.api.nodetype.CanSetPropertyDoubleTest",6,0.00,2.17,90,2.08,114764.27,7,1,9,20,4,75.36,35,174,1,4,93.23,0.00,0.75,1.00,0,0.00,3,6237.18,2,0,3,org.apache.jackrabbit.test.AbstractJCRTest,0.28,14,3,13,0,14,6,0,8,1044,1
"org.apache.jackrabbit.test.api.nodetype.CanSetPropertyLongTest",6,0.00,2.17,90,2.08,114482.65,7,1,9,20,4,75.37,35,174,1,4,93.24,0.00,0.75,1.00,0,0.00,3,6243.57,2,0,3,org.apache.jackrabbit.test.AbstractJCRTest,0.28,14,3,13,0,14,6,0,8,1044,1
"org.apache.jackrabbit.test.api.nodetype.CanSetPropertyMultipleTest",5,0.00,1.80,33,0.50,13717.34,6,1,7,17,4,82.54,31,57,1,4,114.76,0.00,0.75,1.00,0,0.00,2,1495.47,2,0,3,org.apache.jackrabbit.test.AbstractJCRTest,0.29,12,3,9,0,12,5,0,8,298,1
"org.apache.jackrabbit.test.api.nodetype.CanSetPropertyNameTest",6,0.00,2.17,95,2.22,119056.12,7,1,9,19,4,75.24,35,183,1,4,93.11,0.00,0.75,1.00,0,0.00,3,6656.69,2,0,3,org.apache.jackrabbit.test.AbstractJCRTest,0.28,13,3,13,0,13,6,0,8,1095,1
"org.apache.jackrabbit.test.api.nodetype.CanSetPropertyPathTest",6,0.00,2.17,92,2.09,112069.15,7,1,9,19,4,75.44,35,174,1,4,93.32,0.00,0.75,1.00,0,0.00,3,6255.42,2,0,3,org.apache.jackrabbit.test.AbstractJCRTest,0.28,13,3,13,0,13,6,0,8,1044,1
"org.apache.jackrabbit.test.api.nodetype.CanSetPropertyStringTest",6,0.00,2.17,80,1.64,80921.97,7,1,9,17,4,78.87,35,146,1,4,96.75,0.00,0.75,1.00,0,0.00,3,4910.22,2,0,3,org.apache.jackrabbit.test.AbstractJCRTest,0.28,11,3,13,0,11,6,0,8,853,1
"org.apache.jackrabbit.test.api.nodetype.CanSetPropertyTest",5,0.00,1.80,31,0.45,11053.51,6,1,7,17,4,83.28,31,55,1,4,115.50,0.00,0.75,1.00,0,0.00,2,1364.70,2,0,3,org.apache.jackrabbit.test.AbstractJCRTest,0.29,12,3,9,0,12,5,0,8,276,1
"org.apache.jackrabbit.test.api.nodetype.NodeDefTest",11,0.07,3.36,148,1.64,54872.84,14,3,14,47,3,57.76,86,168,1,4,100.05,0.00,0.75,0.27,3,26.00,5,4917.28,2,0,2,org.apache.jackrabbit.test.AbstractJCRTest,0.24,36,3,37,0,36,11,0,30,936,1
"org.apache.jackrabbit.test.api.nodetype.NodeTypeManagerTest",6,0.20,1.83,37,0.46,9720.37,8,2,7,27,2,84.34,37,61,1,4,116.56,0.00,0.75,0.67,0,0.00,3,1392.50,3,0,1,org.apache.jackrabbit.test.AbstractJCRTest,0.28,21,3,11,0,21,6,0,12,298,1
"org.apache.jackrabbit.test.api.nodetype.NodeTypeTest",17,0.02,3.12,188,2.24,70703.89,20,3,15,62,3,85.52,101,265,1,4,103.39,0.00,0.75,0.31,3,0.00,6,6715.50,3,4,2,org.apache.jackrabbit.test.AbstractJCRTest,0.20,45,3,53,0,45,13,0,30,1290,1
"org.apache.jackrabbit.test.api.nodetype.NodeTypeUtil",11,1.00,12.45,468,6.25,1339370.13,12,1,14,58,18,40.44,144,586,17,1,69.82,0.00,0.00,0.09,3,20.00,71,18759.95,0,10,1,java.lang.Object,0.00,47,0,137,0,47,1,0,63,2990,1
"org.apache.jackrabbit.test.api.nodetype.PredefinedNodeTypeTest",31,0.42,1.68,197,2.60,136383.99,33,2,20,94,3,133.78,112,257,1,4,113.16,0.00,0.75,0.10,5,123.00,7,7786.16,2,4,2,org.apache.jackrabbit.test.AbstractJCRTest,0.15,63,3,52,0,63,27,0,40,1437,1
"org.apache.jackrabbit.test.api.nodetype.PredefinedNodeTypeTest$Comparator",1,0.00,3.00,10,0.14,6990.64,1,0,20,4,0,103.17,0,12,0,1,103.17,0.00,0.00,0.00,0,1.00,3,416.66,0,0,0,java.lang.Object,0.00,3,0,3,0,3,1,0,0,92,0
"org.apache.jackrabbit.test.api.nodetype.PredefinedNodeTypeTest$Comparator_0",1,0.00,6.00,17,0.22,14237.38,1,0,20,5,0,91.98,0,21,0,1,91.98,0.00,0.00,0.00,0,1.00,6,668.69,0,0,0,java.lang.Object,0.00,4,0,6,0,4,1,0,0,140,0
"org.apache.jackrabbit.test.api.nodetype.PredefinedNodeTypeTest$Comparator_1",1,0.00,3.00,10,0.11,4798.70,1,0,20,4,0,104.46,0,12,0,1,104.46,0.00,0.00,0.00,0,1.00,3,338.12,0,0,0,java.lang.Object,0.00,3,0,3,0,3,1,0,0,76,0
"org.apache.jackrabbit.test.api.nodetype.PropertyDefTest",11,0.08,4.36,165,2.35,117078.85,19,8,16,47,4,45.08,104,242,1,4,95.08,0.00,0.75,0.19,3,1.00,16,7064.64,2,0,3,org.apache.jackrabbit.test.AbstractJCRTest,0.24,36,3,48,0,36,11,0,35,1258,1
"org.apache.jackrabbit.test.api.nodetype.TestAll",1,0.00,1.00,22,0.28,10800.80,1,0,3,3,20,51.60,12,24,2,2,89.16,0.00,0.50,0.00,0,1.00,1,827.66,0,1,18,junit.framework.TestCase,0.00,2,1,1,0,2,0,0,3,167,1
"org.apache.jackrabbit.webdav.util.HttpDateFormat",1,0.00,1.00,5,0.05,718.04,2,1,3,2,0,143.05,3,7,0,2,122.44,0.00,0.50,1.00,0,0.00,1,147.97,1,0,0,java.text.SimpleDateFormat,0.00,1,1,1,0,1,1,0,1,38,1
"org.apache.jackrabbit.core.state.AbstractISMLockingTest",11,0.02,1.45,92,0.95,18125.55,15,4,10,41,12,69.60,82,93,2,2,111.89,2.00,0.25,0.27,4,16.00,2,2844.18,1,3,10,junit.framework.TestCase,0.00,30,1,16,2,30,8,0,15,601,2
"org.apache.jackrabbit.core.state.AbstractISMLockingTest$Runnable",1,0.00,2.00,6,0.06,833.70,1,0,10,3,0,118.81,0,9,0,1,118.81,0.00,0.00,0.00,0,0.00,2,174.91,0,0,0,java.lang.Object,0.00,2,0,2,0,2,1,0,0,42,0
"org.apache.jackrabbit.core.state.AbstractISMLockingTest$Runnable_0",1,0.00,2.00,5,0.04,435.25,1,0,10,5,0,123.99,0,8,0,1,123.99,0.00,0.00,0.00,0,1.00,2,128.93,0,0,0,java.lang.Object,0.00,4,0,2,0,4,1,0,0,33,0
"org.apache.jackrabbit.core.state.AbstractISMLockingTest$Runnable_1",1,0.00,2.00,5,0.04,435.25,1,0,10,5,0,123.99,0,8,0,1,123.99,0.00,0.00,0.00,0,1.00,2,128.93,0,0,0,java.lang.Object,0.00,4,0,2,0,4,1,0,0,33,0
"org.apache.jackrabbit.core.state.Cache",6,0.00,1.00,7,0.02,78.02,6,0,0,6,4,162.46,27,8,4,1,162.23,0.00,0.00,0.00,0,6.00,1,73.02,0,0,1,,0.00,0,0,6,0,0,6,0,7,33,1
"org.apache.jackrabbit.core.state.CacheAccessListener",2,1.00,1.00,4,0.02,110.68,3,1,0,2,3,113.82,13,5,3,1,146.04,0.00,0.00,0.00,0,2.00,1,58.38,0,0,1,,0.00,0,0,2,0,0,2,0,4,21,1
"org.apache.jackrabbit.core.state.CacheManager",13,0.00,2.15,100,1.30,116604.99,25,12,4,36,4,90.30,65,126,2,1,108.17,0.00,0.00,0.08,2,73.00,14,3901.40,0,0,2,java.lang.Object,0.00,23,0,28,0,23,13,1,34,717,1
"org.apache.jackrabbit.core.state.CacheManager$CacheInfo",7,0.03,1.00,25,0.16,2214.50,12,5,4,11,1,183.51,7,33,0,1,133.51,0.00,0.00,0.23,0,25.00,1,480.16,0,1,1,java.lang.Object,0.00,4,0,7,0,4,6,0,7,129,2
"org.apache.jackrabbit.core.state.ChangeLog",21,0.18,2.19,140,1.73,73205.94,25,4,4,58,47,71.61,152,194,40,1,113.90,0.00,0.00,0.42,2,0.00,7,5176.80,0,5,7,java.lang.Object,0.00,37,0,46,0,37,16,0,35,1136,1
"org.apache.jackrabbit.core.state.ChangeLogTest",4,0.00,1.75,44,0.61,16577.49,5,1,7,22,10,103.77,16,50,1,4,103.54,0.00,0.75,1.00,0,0.00,4,1821.48,1,0,9,org.apache.jackrabbit.test.AbstractJCRTest,0.15,18,3,7,0,18,4,0,4,348,1
"org.apache.jackrabbit.core.state.ChildNodeEntries",40,0.10,2.20,239,2.58,116117.23,43,3,14,97,6,157.36,112,325,2,1,117.48,0.00,0.00,0.23,7,210.00,9,7725.13,1,19,4,java.lang.Object,0.00,57,0,88,0,57,21,2,44,1633,0
"org.apache.jackrabbit.core.state.ChildNodeEntries$EntriesIterator",10,0.33,1.00,24,0.16,1743.43,11,1,14,17,0,142.12,0,35,0,1,142.12,0.00,0.00,0.70,0,0.00,1,488.46,0,2,0,java.lang.Object,0.00,7,0,10,0,7,8,1,0,143,0
"org.apache.jackrabbit.core.state.ChildNodeEntry",7,0.25,1.86,39,0.35,10200.48,11,4,2,13,35,169.87,9,54,33,1,119.87,0.00,0.00,0.46,0,0.00,4,1043.48,0,3,2,java.lang.Object,0.00,6,0,13,0,6,4,0,4,247,2
"org.apache.jackrabbit.core.state.DefaultISMLocking",2,1.00,1.00,8,0.08,1450.79,3,1,5,6,6,83.72,14,13,2,1,126.02,0.00,0.00,0.50,0,2.00,1,245.99,0,0,4,java.lang.Object,0.00,4,0,2,0,4,2,1,4,61,1
"org.apache.jackrabbit.core.state.DefaultISMLocking$RWLock",2,0.00,1.00,6,0.06,684.86,3,1,5,4,1,133.48,8,9,0,2,133.24,0.00,0.50,1.00,0,0.00,1,175.53,0,0,1,EDU.oswego.cs.dl.util.concurrent.ReentrantWriterPreferenceReadWriteLock,0.00,2,1,2,0,2,2,0,2,47,3
"org.apache.jackrabbit.core.state.DefaultISMLocking$ReadLockImpl",2,1.00,1.00,7,0.05,722.82,3,1,5,4,0,183.06,3,10,0,1,133.06,0.00,0.00,0.50,0,2.00,1,156.14,0,0,0,java.lang.Object,0.00,2,0,2,0,2,2,1,1,45,3
"org.apache.jackrabbit.core.state.DefaultISMLocking$WriteLock",2,0.00,1.00,10,0.08,996.25,2,0,5,6,1,144.30,6,14,0,1,123.69,0.00,0.00,0.00,1,0.00,1,242.70,0,0,1,java.lang.Object,0.00,4,0,2,0,4,2,0,2,65,0
"org.apache.jackrabbit.core.state.DefaultISMLockingTest",1,0.00,1.00,3,0.02,126.12,1,0,0,2,4,136.89,4,5,1,3,136.66,0.00,0.67,0.00,0,1.00,1,47.21,0,1,3,org.apache.jackrabbit.core.state.AbstractISMLockingTest,0.25,1,2,1,0,1,0,0,1,16,1
"org.apache.jackrabbit.core.state.FineGrainedISMLocking",5,0.22,3.20,69,0.73,23202.02,13,8,14,29,10,51.83,50,90,2,1,100.31,0.00,0.00,0.30,0,5.00,4,2186.43,0,1,8,java.lang.Object,0.00,24,0,16,0,24,4,1,24,432,1
"org.apache.jackrabbit.core.state.FineGrainedISMLocking$LockMap",5,0.25,3.80,61,0.63,24089.47,7,2,14,21,6,83.56,28,80,0,1,101.44,0.00,0.00,0.70,0,0.00,6,1902.41,0,0,6,java.lang.Object,0.00,16,0,19,0,16,5,0,6,382,3
"org.apache.jackrabbit.core.state.FineGrainedISMLocking$ReadLockImpl",3,1.00,2.00,21,0.14,2826.80,4,1,14,8,1,165.90,3,27,0,1,115.90,0.00,0.00,0.33,0,4.00,4,414.55,0,0,1,java.lang.Object,0.00,5,0,6,0,5,3,1,3,96,2
"org.apache.jackrabbit.core.state.FineGrainedISMLocking$WriteLockImpl",3,1.00,2.33,37,0.23,4596.59,4,1,14,8,1,155.47,5,45,0,1,105.47,0.00,0.00,0.00,0,1.00,3,690.32,0,0,1,java.lang.Object,0.00,5,0,7,0,5,3,1,5,150,2
"org.apache.jackrabbit.core.state.FineGrainedISMLockingTest",1,0.00,1.00,3,0.02,126.12,1,0,0,2,4,136.89,4,5,1,3,136.66,0.00,0.67,0.00,0,1.00,1,47.21,0,1,3,org.apache.jackrabbit.core.state.AbstractISMLockingTest,0.25,1,2,1,0,1,0,0,1,16,1
"org.apache.jackrabbit.core.state.ISMLocking",2,0.00,1.00,5,0.03,122.41,2,0,1,2,16,154.83,35,6,14,1,145.70,0.00,0.00,0.00,0,2.00,1,81.60,0,1,2,,0.00,0,0,2,0,0,1,0,3,29,1
"org.apache.jackrabbit.core.state.ISMLocking$ReadLock",1,0.00,1.00,2,0.01,23.00,1,0,1,1,0,169.66,3,3,0,1,149.05,0.00,0.00,0.00,0,1.00,1,18.00,0,0,0,,0.00,0,0,1,0,0,1,0,1,9,1
"org.apache.jackrabbit.core.state.ISMLocking$WriteLock",2,0.00,1.00,3,0.01,46.26,2,0,1,2,0,128.04,12,4,0,1,160.26,0.00,0.00,0.00,0,2.00,1,33.51,0,1,0,,0.00,0,0,2,0,0,1,0,2,15,1
"org.apache.jackrabbit.core.state.ISMLockingFactory",1,0.00,1.00,2,0.01,38.26,1,0,1,1,4,127.16,14,3,3,1,147.31,0.00,0.00,0.00,0,1.00,1,25.51,0,0,1,,0.00,0,0,1,0,0,1,0,2,11,1
"org.apache.jackrabbit.core.state.ItemState",30,0.05,1.53,114,1.02,22368.50,43,13,4,41,53,98.26,186,176,51,1,130.48,0.00,0.00,0.12,4,338.00,3,3055.07,0,4,3,java.lang.Object,0.00,11,0,46,4,11,26,0,50,706,2
"org.apache.jackrabbit.core.state.ItemStateCache",9,0.00,1.00,10,0.04,133.96,9,0,1,9,8,129.54,58,11,6,1,161.76,0.00,0.00,0.00,0,9.00,1,123.16,0,0,2,,0.00,0,0,9,0,0,9,0,10,52,1
"org.apache.jackrabbit.core.state.ItemStateCacheFactory",1,0.00,1.00,2,0.01,23.00,1,0,0,1,10,100.94,8,3,9,1,149.05,0.00,0.00,0.00,0,1.00,1,18.00,0,0,1,,0.00,0,0,1,0,0,1,0,2,9,1
"org.apache.jackrabbit.core.state.ItemStateException",2,0.00,1.00,5,0.03,221.18,2,0,0,2,78,93.68,18,8,78,2,143.68,2.00,0.25,0.00,0,2.00,1,88.69,0,0,0,java.lang.Exception,0.00,0,1,2,2,0,2,0,3,29,1
"org.apache.jackrabbit.core.state.ItemStateListener",4,0.00,1.00,5,0.02,77.04,4,0,0,4,10,118.59,29,6,10,1,160.88,0.00,0.00,0.00,0,4.00,1,72.04,0,0,1,,0.00,0,0,4,0,0,4,0,5,29,1
"org.apache.jackrabbit.core.state.ItemStateManager",4,0.00,1.00,5,0.03,131.61,4,0,1,4,31,110.95,32,8,25,1,159.05,0.00,0.00,0.00,0,4.00,1,98.08,0,2,6,,0.00,0,0,4,0,0,2,0,5,35,1
"org.apache.jackrabbit.core.state.ItemStateMap",13,0.12,1.85,53,0.56,12745.18,15,2,10,32,6,174.84,17,76,2,1,124.84,0.00,0.00,0.38,2,0.00,10,1687.12,0,3,4,java.lang.Object,0.00,19,0,24,1,19,10,2,7,381,1
"org.apache.jackrabbit.core.state.ItemStateReferenceCache",12,0.12,1.08,39,0.36,5970.26,15,3,5,35,8,89.66,85,53,2,1,131.95,0.00,0.00,0.44,0,0.00,2,1086.47,0,0,6,java.lang.Object,0.00,23,0,13,0,23,12,2,30,278,1
"org.apache.jackrabbit.core.state.ItemStateReferenceMap",1,0.00,1.00,3,0.02,263.49,1,0,1,2,2,90.01,11,5,1,2,134.14,0.00,0.50,0.00,0,1.00,1,70.86,0,0,1,org.apache.jackrabbit.core.state.ItemStateMap,0.00,1,1,1,0,1,1,0,2,22,1
"org.apache.jackrabbit.core.state.ItemStateStore",9,0.00,1.00,10,0.05,179.65,9,0,3,9,4,118.47,63,11,2,1,160.76,0.00,0.00,0.00,0,9.00,1,135.34,0,2,2,,0.00,0,0,9,0,0,7,0,10,55,1
"org.apache.jackrabbit.core.state.LocalItemStateManager",29,0.13,2.10,176,1.80,45486.82,35,6,6,81,29,74.35,217,252,7,1,116.64,0.00,0.00,0.29,1,33.00,5,5411.20,0,5,22,java.lang.Object,0.00,52,0,61,1,52,24,2,76,1185,1
"org.apache.jackrabbit.core.state.MLRUItemStateCache",19,0.07,1.53,100,0.92,22281.08,27,8,5,41,6,120.90,83,143,1,1,120.66,0.00,0.00,0.19,3,0.00,3,2758.66,0,2,5,java.lang.Object,0.00,22,0,29,0,22,17,2,30,618,1
"org.apache.jackrabbit.core.state.MLRUItemStateCache$Entry",2,0.00,1.00,8,0.06,829.00,4,2,5,3,1,127.93,0,11,0,1,127.93,0.00,0.00,0.50,0,2.00,1,194.73,0,0,1,java.lang.Object,0.00,1,0,2,0,1,2,0,0,53,2
"org.apache.jackrabbit.core.state.ManagedMLRUItemStateCacheFactory",2,1.00,1.00,9,0.06,1012.34,3,1,0,5,4,84.95,14,12,0,1,127.25,0.00,0.00,0.50,0,2.00,1,181.89,0,1,4,java.lang.Object,0.00,3,0,2,0,3,1,1,4,50,1
"org.apache.jackrabbit.core.state.NameSet",20,0.01,1.30,76,0.62,13451.86,24,4,5,37,4,113.00,111,103,3,1,130.87,0.00,0.00,0.24,2,0.00,3,1863.18,1,4,1,java.lang.Object,0.00,17,0,26,0,17,16,2,33,462,1
"org.apache.jackrabbit.core.state.NameSet$Iterator",3,0.50,1.00,8,0.05,548.45,4,1,5,6,0,141.96,0,11,0,1,141.96,0.00,0.00,0.67,0,1.00,1,147.94,0,1,0,java.lang.Object,0.00,3,0,3,0,3,2,0,0,46,0
"org.apache.jackrabbit.core.state.NameSet$NameSetCache",3,0.50,2.67,32,0.37,18839.71,5,2,5,13,0,59.44,35,44,0,1,103.56,0.00,0.00,0.83,0,0.00,4,1110.92,0,3,0,java.lang.Object,0.00,10,0,8,0,10,0,0,5,234,3
"org.apache.jackrabbit.core.state.NameSetTest",2,1.00,1.00,17,0.19,4590.37,4,2,3,8,4,150.73,4,20,1,2,110.85,0.00,0.50,1.00,0,0.00,1,571.34,0,0,3,junit.framework.TestCase,0.00,6,1,2,0,6,2,0,1,137,1
"org.apache.jackrabbit.core.state.NoSuchItemStateException",2,0.00,1.00,5,0.03,221.18,2,0,0,2,40,93.68,18,8,39,3,143.68,0.00,0.67,0.00,0,2.00,1,88.69,0,0,1,org.apache.jackrabbit.core.state.ItemStateException,0.00,0,2,2,0,0,2,0,3,29,1
"org.apache.jackrabbit.core.state.NodeReferences",9,0.08,1.00,22,0.18,2646.72,12,3,6,17,38,108.11,56,32,35,1,140.33,0.00,0.00,0.26,0,14.00,1,546.55,0,3,3,java.lang.Object,0.00,8,0,9,0,8,6,1,13,147,1
"org.apache.jackrabbit.core.state.NodeReferencesId",7,0.17,1.57,25,0.21,4376.54,9,2,3,15,36,88.79,51,37,34,1,131.08,0.00,0.00,0.36,0,0.00,3,643.61,0,3,2,java.lang.Object,0.00,8,0,11,0,8,4,1,10,163,1
"org.apache.jackrabbit.core.state.NodeState",53,0.01,1.81,270,3.02,154544.31,63,10,11,103,86,69.40,431,362,77,2,117.51,1.00,0.33,0.11,3,1263.00,15,9072.94,4,21,10,org.apache.jackrabbit.core.state.ItemState,0.12,50,1,96,1,50,32,0,95,1943,1
"org.apache.jackrabbit.core.state.NodeStateIterator",1,0.00,1.00,2,0.02,118.36,1,0,2,1,5,93.45,9,3,4,1,143.44,0.00,0.00,0.00,0,1.00,1,47.21,0,0,1,,0.00,0,0,1,0,0,1,0,2,16,1
"org.apache.jackrabbit.core.state.NodeStateListener",4,0.00,1.00,5,0.05,153.25,4,0,2,4,8,110.43,35,7,6,2,158.53,0.00,0.50,0.00,0,4.00,1,135.15,0,0,3,,0.00,0,1,4,0,0,4,0,5,43,1
"org.apache.jackrabbit.core.state.NodeStateMerger",1,0.00,22.00,60,0.95,102097.88,1,0,6,31,8,58.67,63,83,2,1,64.52,0.00,0.00,0.00,0,1.00,22,2846.98,0,0,6,java.lang.Object,0.00,30,0,22,0,30,1,0,32,467,0
"org.apache.jackrabbit.core.state.NodeStateMerger$MergeContext",4,0.00,1.00,5,0.02,77.04,4,0,6,4,2,160.88,0,6,0,1,160.88,0.00,0.00,0.00,0,4.00,1,72.04,0,0,2,,0.00,0,0,4,0,0,4,0,0,29,1
"org.apache.jackrabbit.core.state.PropertyState",17,0.00,1.06,53,0.38,5294.39,22,5,7,20,59,101.33,117,74,52,2,133.55,1.00,0.33,0.20,0,98.00,2,1132.56,2,6,7,org.apache.jackrabbit.core.state.ItemState,0.21,3,1,18,1,3,11,0,25,296,1
"org.apache.jackrabbit.core.state.SessionItemStateManager",46,0.07,2.13,308,3.65,164015.26,54,8,23,136,30,65.72,382,431,3,1,113.83,0.00,0.00,0.19,6,306.00,11,10954.28,0,9,27,java.lang.Object,0.00,90,0,98,0,90,37,3,130,2223,1
"org.apache.jackrabbit.core.state.SessionItemStateManager$AtticItemStateManager",4,0.00,1.25,13,0.11,2329.66,4,0,23,7,7,151.99,14,21,0,1,131.38,0.00,0.00,0.00,0,4.00,2,338.65,0,2,7,java.lang.Object,0.00,3,0,5,0,3,2,1,6,85,1
"org.apache.jackrabbit.core.state.SessionItemStateManager$NodeStateMerger.MergeContext",4,0.00,1.50,16,0.19,4253.38,4,0,23,8,6,124.61,0,24,0,1,124.61,0.00,0.00,0.00,0,8.00,3,579.22,0,0,6,java.lang.Object,0.00,4,0,6,0,4,4,0,0,132,0
"org.apache.jackrabbit.core.state.SharedItemStateManager",30,0.02,2.67,290,3.48,137029.45,41,11,34,123,49,57.88,325,394,12,1,106.36,0.00,0.00,0.11,8,302.00,8,10437.21,0,4,38,java.lang.Object,0.00,93,0,80,1,93,26,3,88,2019,1
"org.apache.jackrabbit.core.state.SharedItemStateManager$Update",17,0.04,4.82,281,3.59,222797.50,26,9,34,79,23,43.30,156,345,0,1,93.30,0.00,0.00,0.15,8,104.00,20,10765.39,0,4,23,java.lang.Object,0.00,62,0,82,0,62,13,1,71,1880,0
"org.apache.jackrabbit.core.state.SharedItemStateManager$Update$NodeStateMerger.MergeContext",4,0.00,2.00,20,0.22,6142.41,4,0,34,8,7,119.68,0,30,0,1,119.68,0.00,0.00,0.00,0,0.00,4,665.35,0,0,7,java.lang.Object,0.00,4,0,8,0,4,4,0,0,146,0
"org.apache.jackrabbit.core.state.StaleItemStateException",2,0.00,1.00,5,0.03,221.18,2,0,0,2,11,93.68,19,8,10,3,143.68,0.00,0.67,0.00,0,2.00,1,88.69,0,0,1,org.apache.jackrabbit.core.state.ItemStateException,0.00,0,2,2,0,0,2,0,3,29,1
"org.apache.jackrabbit.core.state.StateChangeDispatcher",11,0.35,3.00,71,0.78,24208.32,13,2,6,24,9,97.53,59,94,3,1,115.40,0.00,0.00,0.18,1,25.00,5,2352.47,0,1,6,java.lang.Object,0.00,13,0,33,0,13,10,0,14,508,1
"org.apache.jackrabbit.core.state.TestAll",1,0.00,1.00,8,0.07,2228.14,1,0,3,3,4,62.47,10,10,0,2,110.95,0.00,0.50,0.00,0,1.00,1,223.66,0,1,4,junit.framework.TestCase,0.00,2,1,1,0,2,0,0,2,55,1
"org.apache.jackrabbit.core.state.TimeBomb",4,0.00,1.75,23,0.17,4315.75,7,3,0,10,1,120.91,0,33,1,1,120.91,0.00,0.00,0.33,0,4.00,3,509.16,0,0,0,java.lang.Object,0.00,6,0,7,0,6,4,0,0,122,2
"org.apache.jackrabbit.core.state.TimeBomb$Runnable",1,0.00,2.00,8,0.06,948.48,1,0,0,3,0,163.71,1,12,0,1,113.71,0.00,0.00,0.00,0,0.00,2,168.54,0,0,0,java.lang.Object,0.00,2,0,2,0,2,1,0,1,40,0
"org.apache.jackrabbit.core.state.UpdatableItemStateManager",9,0.00,1.00,10,0.07,333.40,9,0,3,9,12,110.54,76,15,5,2,158.65,0.00,0.50,0.00,0,9.00,1,216.38,0,2,7,,0.00,0,1,9,0,0,7,0,10,74,1
"org.apache.jackrabbit.core.state.XAItemStateManager",22,0.01,4.09,266,3.31,227055.14,29,7,19,74,24,56.52,175,343,4,2,98.81,0.00,0.50,0.16,6,178.00,18,9934.56,5,4,20,org.apache.jackrabbit.core.state.LocalItemStateManager,0.08,52,1,90,0,52,18,1,50,1875,1
"org.apache.jackrabbit.core.state.XAItemStateManager$Predicate",1,0.00,2.00,7,0.07,1400.39,1,0,19,3,2,114.54,0,9,0,1,114.54,0.00,0.00,0.00,0,1.00,2,197.99,0,0,2,java.lang.Object,0.00,2,0,2,0,2,1,0,0,46,0
"org.apache.jackrabbit.core.persistence.xml.XMLPersistenceManager",24,0.12,4.46,466,7.81,426798.40,55,31,45,156,27,57.27,164,630,0,2,89.49,0.00,0.50,0.15,5,0.00,12,23427.11,1,8,27,org.apache.jackrabbit.core.persistence.AbstractPersistenceManager,0.00,132,1,107,0,132,16,0,98,3809,1
"org.apache.jackrabbit.test.api.version.simple.AbstractVersionTest",4,0.33,3.50,52,0.66,20359.47,9,5,8,18,8,67.75,27,75,6,4,99.97,2.33,0.27,0.45,0,2.00,10,1968.32,5,1,2,org.apache.jackrabbit.test.AbstractJCRTest,0.30,14,3,14,7,14,3,0,8,368,1
"org.apache.jackrabbit.test.api.version.simple.BasicTest",3,0.00,1.00,8,0.07,725.56,3,0,1,7,2,108.78,18,15,1,5,141.00,0.00,0.80,0.00,0,1.00,1,218.48,1,0,1,org.apache.jackrabbit.test.api.version.simple.AbstractVersionTest,0.17,4,4,3,0,4,3,0,3,59,1
"org.apache.jackrabbit.test.api.version.simple.CheckinTest",13,0.00,1.46,72,0.85,14298.35,13,0,5,29,2,88.67,80,98,1,5,120.89,0.00,0.80,0.00,0,0.00,2,2547.98,2,0,1,org.apache.jackrabbit.test.api.version.simple.AbstractVersionTest,0.12,16,4,19,0,16,13,0,19,557,1
"org.apache.jackrabbit.test.api.version.simple.CheckoutTest",9,0.00,2.33,67,0.75,21842.92,9,0,5,23,2,94.75,45,93,1,5,112.62,0.00,0.80,0.00,0,8.00,5,2241.31,1,0,1,org.apache.jackrabbit.test.api.version.simple.AbstractVersionTest,0.14,14,4,21,0,14,9,0,13,470,1
"org.apache.jackrabbit.test.api.version.simple.CopyTest",3,0.00,1.33,23,0.31,5149.17,3,0,5,18,2,81.72,20,32,1,5,113.94,0.00,0.80,0.00,0,1.00,2,917.79,3,0,1,org.apache.jackrabbit.test.api.version.simple.AbstractVersionTest,0.33,15,4,4,0,15,3,0,5,181,1
"org.apache.jackrabbit.test.api.version.simple.FrozenNodeTest",9,0.00,1.00,81,1.30,19292.60,9,0,5,26,3,129.79,34,93,1,5,109.17,0.00,0.80,0.00,0,0.00,1,3912.34,2,0,2,org.apache.jackrabbit.test.api.version.simple.AbstractVersionTest,0.14,17,4,9,0,17,9,0,10,756,1
"org.apache.jackrabbit.test.api.version.simple.RestoreTest",71,0.11,1.70,703,10.37,288846.33,78,7,13,126,3,74.64,446,857,1,5,106.86,0.00,0.80,0.25,0,0.00,4,31102.37,4,0,2,org.apache.jackrabbit.test.api.version.simple.AbstractVersionTest,0.10,55,4,121,0,55,71,0,192,5921,1
"org.apache.jackrabbit.test.api.version.simple.TestAll",1,0.00,1.00,10,0.10,3275.34,1,0,3,3,7,156.02,1,12,1,2,106.02,0.00,0.50,0.00,0,1.00,1,301.01,0,1,6,junit.framework.TestCase,0.00,2,1,1,0,2,0,0,1,71,1
"org.apache.jackrabbit.webdav.jcr.version.VersionHistoryItemCollection",5,1.00,2.60,42,0.62,15800.22,6,1,21,31,15,61.43,42,65,1,4,109.53,0.00,0.75,0.20,0,2.00,4,1847.72,6,2,14,org.apache.jackrabbit.webdav.jcr.DefaultItemCollection,0.08,26,3,13,0,26,3,1,13,369,1
"org.apache.jackrabbit.webdav.jcr.version.VersionItemCollection",7,1.00,3.00,62,0.96,28694.33,8,1,29,46,19,60.51,61,89,1,4,108.61,0.00,0.75,0.14,1,15.00,6,2876.57,6,3,18,org.apache.jackrabbit.webdav.jcr.DefaultItemCollection,0.12,39,3,21,0,39,4,1,20,533,1
"org.apache.jackrabbit.jcr.NodeIteratorImpl",10,0.10,1.80,65,0.60,16551.69,19,9,12,24,7,66.49,96,86,1,1,116.49,0.00,0.00,0.20,2,26.00,4,1798.20,0,2,6,java.lang.Object,0.00,14,0,18,0,14,8,1,28,386,1
"org.apache.jackrabbit.jcr.QueryImpl",10,0.08,1.70,66,0.93,27973.53,21,11,28,40,13,66.60,84,95,2,1,114.71,0.00,0.00,0.16,0,38.00,4,2775.96,0,6,11,java.lang.Object,0.00,30,0,17,1,30,4,1,23,546,1
"org.apache.jackrabbit.jcr.QueryManagerImpl",6,0.28,1.67,38,0.51,13851.40,11,5,18,22,11,67.26,49,57,1,1,115.37,0.00,0.00,0.43,1,0.00,4,1538.59,0,4,10,java.lang.Object,0.00,16,0,10,0,16,2,1,13,312,1
"org.apache.jackrabbit.jcr.QueryManagerImpl$QOMFactory",2,1.00,1.00,7,0.07,813.36,3,1,18,3,4,132.66,0,14,0,2,132.66,0.00,0.50,0.50,0,2.00,1,211.11,0,1,4,org.apache.jackrabbit.spi.commons.query.qom.QueryObjectModelFactoryImpl,0.00,1,1,2,0,1,1,0,0,54,1
"org.apache.jackrabbit.jcr.QueryObjectModelImpl",7,0.50,1.00,18,0.19,2641.70,8,1,24,14,7,160.09,21,34,1,2,139.48,0.00,0.50,0.57,0,3.00,1,562.54,0,6,6,org.apache.jackrabbit.jcr2spi.query.QueryImpl,0.12,7,1,7,0,7,1,1,7,142,1
"org.apache.jackrabbit.jcr.QueryObjectModelImpl$DummyQOM",13,0.75,1.00,28,0.21,2288.66,14,1,24,18,1,192.09,15,48,0,1,142.09,0.00,0.00,0.31,0,33.00,1,626.89,0,9,1,java.lang.Object,0.00,5,0,13,0,5,4,1,5,178,2
"org.apache.jackrabbit.jcr.QueryResultImpl",5,0.17,1.00,16,0.15,1856.46,8,3,7,11,7,100.74,32,27,1,1,132.97,0.00,0.00,0.47,1,2.00,1,443.55,0,4,6,java.lang.Object,0.00,6,0,5,0,6,1,1,9,117,0
"org.apache.jackrabbit.jcr.QueryTest",2,0.00,2.50,26,0.31,9590.38,2,0,7,14,2,120.87,6,27,1,5,100.25,0.00,0.80,0.00,0,0.00,3,933.06,1,0,1,org.apache.jackrabbit.test.api.query.AbstractQueryTest,0.00,12,4,5,0,12,2,0,2,179,1
"org.apache.jackrabbit.jcr.RowIteratorImpl",8,0.07,1.00,29,0.25,3048.34,14,6,21,17,10,88.75,91,40,1,1,132.88,0.00,0.00,0.10,1,0.00,1,755.97,0,2,9,java.lang.Object,0.00,9,0,8,0,9,6,1,19,190,0
"org.apache.jackrabbit.jcr.RowIteratorImpl$RowImpl",10,0.07,2.10,64,0.69,29064.45,13,3,21,22,5,72.24,70,82,0,1,114.53,0.00,0.00,0.27,2,22.00,6,2067.46,0,7,5,java.lang.Object,0.00,12,0,21,0,12,3,1,17,440,0
"org.apache.jackrabbit.jcr.ScoreNodeIterator",1,0.00,1.00,2,0.01,48.43,1,0,1,1,2,117.12,13,3,2,2,146.50,0.00,0.50,0.00,0,1.00,1,27.12,0,0,0,,0.00,0,1,1,0,0,1,0,2,11,1
"org.apache.jackrabbit.jcr.TestAll",1,0.00,1.00,5,0.04,864.35,1,0,3,3,2,142.42,3,7,1,2,121.80,0.00,0.50,0.00,0,1.00,1,115.51,0,1,1,junit.framework.TestCase,0.00,2,1,1,0,2,0,0,1,31,1
"org.apache.jackrabbit.commons.query.GQL",15,0.03,5.27,292,4.01,233980.35,40,25,27,78,5,129.20,326,382,2,1,89.90,0.00,0.00,0.07,8,80.00,17,12032.59,0,9,3,java.lang.Object,0.00,63,0,79,0,63,6,0,72,2069,2
"org.apache.jackrabbit.commons.query.GQL$ContainsExpression",2,1.00,5.00,41,0.50,27767.79,3,1,27,11,2,129.36,4,50,0,2,89.48,0.00,0.50,0.50,0,2.00,9,1499.75,0,0,2,org.apache.jackrabbit.commons.query.PropertyExpression,0.00,9,1,10,0,9,2,0,4,271,2
"org.apache.jackrabbit.commons.query.GQL$Expression",1,0.00,1.00,2,0.01,51.00,1,0,27,1,0,146.32,0,3,0,1,146.32,0.00,0.00,0.00,0,1.00,1,34.00,0,0,0,,0.00,0,0,1,0,0,1,0,0,13,1
"org.apache.jackrabbit.commons.query.GQL$Filter",1,0.00,1.00,2,0.01,69.06,1,0,27,1,0,96.81,10,3,0,1,145.29,0.00,0.00,0.00,0,1.00,1,36.53,0,0,0,,0.00,0,0,1,0,0,1,0,1,13,1
"org.apache.jackrabbit.commons.query.GQL$FilteredRowIterator",9,0.12,1.56,36,0.25,4550.91,12,3,27,12,0,127.38,39,54,0,1,127.15,0.00,0.00,0.22,2,21.00,4,736.45,0,2,0,java.lang.Object,0.00,3,0,14,0,3,7,1,13,186,2
"org.apache.jackrabbit.commons.query.GQL$MixinComparision",1,0.00,1.00,3,0.02,90.19,1,0,27,1,0,137.81,0,5,0,2,137.81,0.00,0.50,0.00,0,0.00,1,48.09,0,0,0,org.apache.jackrabbit.commons.query.ValueComparison,0.00,0,1,1,0,0,1,0,0,17,1
"org.apache.jackrabbit.commons.query.GQL$NAryExpression",4,0.33,1.75,21,0.20,4391.05,5,1,27,10,0,120.85,0,26,0,1,120.85,0.00,0.00,0.75,0,0.00,4,588.49,0,1,0,java.lang.Object,0.00,6,0,7,0,6,3,1,0,132,2
"org.apache.jackrabbit.commons.query.GQL$OptionalExpression",1,0.00,1.00,3,0.01,91.02,1,0,27,1,0,137.77,0,5,0,2,137.77,0.00,0.50,0.00,0,1.00,1,39.51,0,1,0,org.apache.jackrabbit.commons.query.NAryExpression,0.00,0,1,1,0,0,0,0,0,14,1
"org.apache.jackrabbit.commons.query.GQL$OrderByExpression",4,1.00,2.50,36,0.43,15460.37,5,1,27,15,2,106.95,2,43,0,1,106.95,0.00,0.00,0.25,1,4.00,7,1304.38,0,0,2,java.lang.Object,0.00,11,0,10,0,11,4,1,2,245,1
"org.apache.jackrabbit.commons.query.GQL$PrimaryTypeComparision",1,0.00,1.00,3,0.02,90.19,1,0,27,1,0,137.81,0,5,0,2,137.81,0.00,0.50,0.00,0,0.00,1,48.09,0,0,0,org.apache.jackrabbit.commons.query.ValueComparison,0.00,0,1,1,0,0,1,0,0,17,1
"org.apache.jackrabbit.commons.query.GQL$PropertyExpression",1,2.00,1.00,6,0.04,684.62,3,2,27,1,0,119.64,0,8,0,1,119.64,0.00,0.00,0.00,0,1.00,1,133.42,0,0,0,java.lang.Object,0.00,0,0,1,0,0,1,1,0,38,2
"org.apache.jackrabbit.commons.query.GQL$RequiredExpression",1,0.00,1.00,3,0.01,91.02,1,0,27,1,0,137.77,0,5,0,2,137.77,0.00,0.50,0.00,0,1.00,1,39.51,0,1,0,org.apache.jackrabbit.commons.query.NAryExpression,0.00,0,1,1,0,0,0,0,0,14,1
"org.apache.jackrabbit.commons.query.GQL$RowAdapter",9,0.00,1.11,24,0.22,3516.07,11,2,27,15,0,139.34,0,35,0,1,139.34,0.00,0.00,0.50,0,0.00,2,660.36,0,6,0,java.lang.Object,0.00,6,0,10,0,6,3,1,0,176,3
"org.apache.jackrabbit.commons.query.GQL$RowIterAdapter",4,1.00,1.25,17,0.12,2746.39,5,1,27,5,1,126.15,0,23,0,3,126.15,0.00,0.67,0.25,0,8.00,2,370.32,1,1,1,org.apache.jackrabbit.commons.iterator.RowIteratorAdapter,0.40,1,2,5,0,1,3,0,0,97,2
"org.apache.jackrabbit.commons.query.GQL$ValueComparison",2,0.00,1.00,7,0.08,939.94,2,0,27,6,1,132.16,0,11,0,2,132.16,0.00,0.50,0.00,0,2.00,1,235.66,0,0,1,org.apache.jackrabbit.commons.query.PropertyExpression,0.00,4,1,2,0,4,2,0,0,61,2
"org.apache.jackrabbit.core.fs.mem.MemoryFile",3,1.00,1.00,8,0.06,741.03,4,1,0,3,2,140.93,0,12,1,2,140.93,0.00,0.50,0.33,0,4.00,1,167.44,0,0,1,org.apache.jackrabbit.core.fs.mem.MemoryFileSystemEntry,0.29,0,1,3,0,0,3,0,0,48,1
"org.apache.jackrabbit.core.fs.mem.MemoryFileSystem",27,0.73,1.96,162,1.92,72394.19,28,1,15,64,8,114.82,1,210,2,1,114.82,0.00,0.00,0.30,12,115.00,8,5746.27,0,9,6,java.lang.Object,0.00,37,0,53,0,37,18,1,1,1183,1
"org.apache.jackrabbit.core.fs.mem.MemoryFileSystem$ByteArrayOutputStream",2,0.00,1.00,6,0.06,833.77,2,0,15,6,0,132.57,0,8,0,1,132.57,0.00,0.00,0.00,0,2.00,1,187.38,0,0,0,java.lang.Object,0.00,4,0,2,0,4,2,0,0,50,0
"org.apache.jackrabbit.core.fs.mem.MemoryFileSystemEntry",4,0.67,1.00,9,0.05,446.31,5,1,0,5,3,143.65,0,13,3,1,143.65,0.00,0.00,0.50,0,4.00,1,157.94,0,0,0,java.lang.Object,0.00,1,0,4,2,1,4,0,0,49,2
"org.apache.jackrabbit.core.fs.mem.MemoryFileSystemTest",1,0.00,1.00,3,0.02,126.12,1,0,2,2,3,136.66,0,5,0,3,136.66,0.00,0.67,0.00,0,1.00,1,47.21,0,1,3,org.apache.jackrabbit.core.fs.AbstractFileSystemTest,0.33,1,2,1,0,1,0,0,0,16,1
"org.apache.jackrabbit.core.fs.mem.MemoryFolder",1,0.00,1.00,3,0.01,91.02,1,0,0,1,2,137.77,0,5,1,2,137.77,0.00,0.50,0.00,0,1.00,1,39.51,0,0,1,org.apache.jackrabbit.core.fs.mem.MemoryFileSystemEntry,0.40,0,1,1,0,0,1,0,0,14,1
"org.apache.jackrabbit.core.jndi.provider.DummyContext",34,0.42,1.41,121,1.23,26112.70,36,2,17,57,2,151.02,113,169,2,2,130.40,0.00,0.50,0.09,14,198.00,3,3702.92,1,21,0,java.util.Hashtable,0.00,23,1,48,0,23,13,2,39,879,0
"org.apache.jackrabbit.core.jndi.provider.DummyContext$BindingEnum",2,0.00,1.00,6,0.05,692.27,2,0,17,5,0,133.21,0,9,0,2,133.21,0.00,0.50,0.00,0,2.00,1,143.20,0,1,0,org.apache.jackrabbit.core.jndi.provider.NamingEnum,0.00,3,1,2,0,3,1,0,0,41,0
"org.apache.jackrabbit.core.jndi.provider.DummyContext$FlatNameParser",1,0.00,1.00,7,0.06,832.71,2,1,17,3,0,137.09,3,10,0,1,116.48,0.00,0.00,1.00,0,0.00,1,180.99,0,1,0,java.lang.Object,0.00,2,0,1,0,2,0,1,1,49,1
"org.apache.jackrabbit.core.jndi.provider.DummyContext$NamingEnum",6,0.20,1.00,17,0.13,1732.88,8,2,17,13,0,140.39,0,24,0,1,140.39,0.00,0.00,0.33,2,6.00,1,398.94,0,2,0,java.lang.Object,0.00,7,0,6,0,7,4,1,0,110,0
"org.apache.jackrabbit.core.jndi.provider.DummyInitialContextFactory",1,0.00,3.00,12,0.15,6408.85,2,1,5,7,3,50.52,9,17,2,1,100.51,0.00,0.00,1.00,0,0.00,3,443.66,0,1,1,java.lang.Object,0.00,6,0,3,0,6,0,1,3,94,1
"org.apache.jackrabbit.core.journal.AbstractJournal",22,0.03,1.64,113,1.19,34399.50,31,9,12,52,15,87.44,151,166,6,1,119.66,0.00,0.00,0.08,5,246.00,7,3568.16,0,5,11,java.lang.Object,0.00,30,0,36,6,30,17,1,36,755,2
"org.apache.jackrabbit.core.journal.AbstractRecord",14,0.00,2.36,110,1.27,39526.40,19,5,24,56,21,112.34,65,151,2,1,112.10,0.00,0.00,0.20,4,62.00,4,3800.55,0,6,19,java.lang.Object,0.00,42,0,33,2,42,8,1,20,783,2
"org.apache.jackrabbit.core.journal.AppendRecord",26,0.03,1.88,156,1.52,37940.28,39,13,12,59,7,117.15,108,226,5,2,116.91,0.00,0.50,0.10,5,134.00,6,4552.89,0,4,3,org.apache.jackrabbit.core.journal.AbstractRecord,0.00,33,1,49,0,33,22,0,33,963,1
"org.apache.jackrabbit.core.journal.DatabaseJournal",50,0.03,2.10,384,4.37,149938.86,89,39,18,115,15,69.63,375,543,6,2,111.93,3.00,0.20,0.05,12,1322.00,6,13105.00,2,13,10,org.apache.jackrabbit.core.journal.AbstractJournal,0.06,65,1,105,3,65,37,0,95,2536,1
"org.apache.jackrabbit.core.journal.DatabaseJournal$DatabaseRevision",4,0.17,2.50,45,0.47,16185.57,6,2,18,11,3,61.25,30,58,0,1,103.54,0.00,0.00,0.62,0,0.00,4,1411.88,0,0,3,java.lang.Object,0.00,7,0,10,0,7,4,1,13,270,1
"org.apache.jackrabbit.core.journal.DatabaseJournal$RevisionTableJanitor",2,0.00,4.00,32,0.36,9495.86,2,0,18,10,0,97.05,9,43,0,1,96.81,0.00,0.00,0.00,1,0.00,4,1079.90,0,0,0,java.lang.Object,0.00,8,0,8,0,8,2,1,5,206,1
"org.apache.jackrabbit.core.journal.DatabaseRecordIterator",6,0.23,2.33,51,0.50,10793.95,13,7,9,19,7,63.38,50,69,1,1,111.49,0.00,0.00,0.33,2,0.00,3,1501.61,0,0,7,java.lang.Object,0.00,13,0,14,0,13,6,1,14,320,0
"org.apache.jackrabbit.core.journal.DefaultRecordProducer",3,0.00,1.33,17,0.13,2872.50,5,2,0,7,5,79.09,23,24,1,1,121.38,0.00,0.00,0.50,0,1.00,2,400.29,0,1,5,java.lang.Object,0.00,4,0,4,0,4,2,1,6,98,1
"org.apache.jackrabbit.core.journal.FileJournal",16,0.06,1.94,108,1.29,44349.86,28,12,6,42,12,96.84,91,140,1,2,114.71,0.00,0.50,0.14,2,78.00,7,3857.01,5,3,11,org.apache.jackrabbit.core.journal.AbstractJournal,0.11,26,1,31,0,26,13,0,26,753,1
"org.apache.jackrabbit.core.journal.FileJournalTest",5,0.35,1.60,51,0.62,14743.34,10,5,9,23,8,56.27,45,64,1,3,106.27,0.00,0.67,0.48,0,0.00,2,1869.64,2,0,7,org.apache.jackrabbit.test.JUnitTest,0.00,18,2,8,0,18,5,0,11,376,1
"org.apache.jackrabbit.core.journal.FileRecordIterator",5,0.14,3.20,56,0.55,27326.11,12,7,5,15,8,52.45,48,74,1,1,102.45,0.00,0.00,0.26,1,9.00,9,1643.87,0,1,7,java.lang.Object,0.00,10,0,16,0,10,4,1,13,337,1
"org.apache.jackrabbit.core.journal.FileRecordLog",18,0.08,2.00,144,1.62,55587.45,31,13,16,58,5,59.67,171,189,2,1,109.67,0.00,0.00,0.15,4,114.00,4,4868.29,0,1,3,java.lang.Object,0.00,40,0,36,0,40,17,0,33,981,1
"org.apache.jackrabbit.core.journal.FileRecordLog$DataBuffer",2,0.00,1.00,6,0.06,774.15,2,0,16,5,0,133.06,8,9,0,2,132.82,0.00,0.50,0.00,0,2.00,1,177.19,0,0,0,java.io.DataOutputStream,0.00,3,1,2,0,3,2,0,1,47,3
"org.apache.jackrabbit.core.journal.FileRevision",4,0.42,3.00,36,0.38,10377.56,8,4,5,17,4,58.27,36,53,2,1,108.27,0.00,0.00,0.56,1,0.00,4,1141.10,0,0,2,java.lang.Object,0.00,13,0,12,0,13,4,1,9,239,1
"org.apache.jackrabbit.core.journal.InstanceRevision",3,0.00,1.00,4,0.02,125.78,3,0,0,3,9,126.00,18,5,8,1,158.22,0.00,0.00,0.00,0,3.00,1,67.79,0,0,1,,0.00,0,0,3,0,0,3,0,4,25,1
"org.apache.jackrabbit.core.journal.JNDIDatabaseJournal",4,0.67,1.25,15,0.13,3543.68,5,1,5,9,2,81.46,41,23,0,3,129.94,0.00,0.67,0.50,0,4.00,2,396.19,0,2,2,org.apache.jackrabbit.core.journal.DatabaseJournal,0.08,5,2,5,0,5,2,0,8,96,1
"org.apache.jackrabbit.core.journal.Journal",9,0.00,1.00,10,0.07,319.27,9,0,1,9,9,126.57,60,12,3,1,158.79,0.00,0.00,0.00,0,9.00,1,198.07,0,3,6,,0.00,0,0,9,0,0,6,0,10,70,1
"org.apache.jackrabbit.core.journal.JournalException",2,0.00,1.00,5,0.03,221.18,2,0,0,2,34,93.68,18,8,34,2,143.68,0.00,0.50,0.00,0,2.00,1,88.69,0,0,0,java.lang.Exception,0.00,0,1,2,0,0,2,0,3,29,1
"org.apache.jackrabbit.core.journal.LockableFileRevision",5,0.35,3.80,57,0.67,26638.60,10,5,6,21,3,54.40,43,86,2,1,102.50,0.00,0.00,0.48,2,0.00,6,2012.58,0,0,1,java.lang.Object,0.00,16,0,19,0,16,5,0,11,398,0
"org.apache.jackrabbit.core.journal.LockableFileRevisionTest",3,0.00,1.00,13,0.09,1039.01,5,2,5,7,3,178.54,4,16,1,5,128.54,0.00,0.80,0.50,0,1.00,1,273.79,3,0,2,org.apache.jackrabbit.core.AbstractConcurrencyTest,0.31,4,4,3,0,4,3,0,1,72,1
"org.apache.jackrabbit.core.journal.LockableFileRevisionTest$Task",1,0.00,3.00,10,0.08,2211.08,1,0,5,2,0,107.11,0,12,0,1,107.11,0.00,0.00,0.00,0,0.00,3,250.76,0,0,0,java.lang.Object,0.00,1,0,3,0,1,1,0,0,53,0
"org.apache.jackrabbit.core.journal.MSSqlDatabaseJournal",4,0.67,1.25,14,0.12,2249.19,5,1,1,7,2,113.62,22,21,0,3,131.50,0.00,0.67,0.50,0,4.00,2,361.21,3,2,2,org.apache.jackrabbit.core.journal.DatabaseJournal,0.00,3,2,5,0,3,2,0,6,92,1
"org.apache.jackrabbit.core.journal.MemoryJournal",14,0.04,1.43,61,0.66,21403.56,22,8,9,28,9,91.16,87,88,2,2,123.38,0.00,0.50,0.09,1,102.00,5,1989.58,2,3,7,org.apache.jackrabbit.core.journal.AbstractJournal,0.11,14,1,20,0,14,11,0,25,424,1
"org.apache.jackrabbit.core.journal.MemoryJournal$MemoryRecord",4,0.11,1.00,14,0.09,1339.84,7,3,9,4,0,91.03,31,19,0,1,133.32,0.00,0.00,0.25,0,10.00,1,258.64,0,2,0,java.lang.Object,0.00,0,0,4,0,0,2,0,7,74,1
"org.apache.jackrabbit.core.journal.MemoryJournal$MemoryRecordIterator",4,0.17,1.25,19,0.22,5636.11,6,2,9,13,4,105.82,22,30,0,1,123.69,0.00,0.00,0.38,0,4.00,2,674.28,0,1,4,java.lang.Object,0.00,9,0,5,0,9,3,1,7,143,1
"org.apache.jackrabbit.core.journal.MemoryRevision",3,1.00,1.00,7,0.05,455.14,4,1,0,3,3,124.72,16,11,1,1,142.60,0.00,0.00,0.33,0,4.00,1,138.48,0,0,2,java.lang.Object,0.00,0,0,3,0,0,3,1,6,41,1
"org.apache.jackrabbit.core.journal.OracleDatabaseJournal",4,0.17,2.00,28,0.28,8173.50,6,2,4,16,2,81.03,24,39,0,3,113.25,0.00,0.67,0.38,0,4.00,3,847.53,1,2,2,org.apache.jackrabbit.core.journal.DatabaseJournal,0.00,12,2,8,0,12,2,0,9,187,1
"org.apache.jackrabbit.core.journal.ReadRecord",24,0.02,1.54,104,0.90,22199.41,30,6,5,35,9,164.97,69,152,4,2,125.08,0.00,0.50,0.15,2,144.00,4,2687.85,0,3,5,org.apache.jackrabbit.core.journal.AbstractRecord,0.00,11,1,37,0,11,21,0,21,625,1
"org.apache.jackrabbit.core.journal.Record",31,0.00,1.00,32,0.20,950.73,31,0,5,31,27,141.42,184,33,21,1,159.29,0.00,0.00,0.00,0,31.00,1,606.40,0,9,6,,0.00,0,0,31,0,0,22,0,32,217,1
"org.apache.jackrabbit.core.journal.RecordConsumer",4,0.00,1.00,5,0.02,62.02,4,0,0,4,4,129.40,24,6,3,1,161.63,0.00,0.00,0.00,0,4.00,1,57.02,0,1,1,,0.00,0,0,4,0,0,3,0,5,25,1
"org.apache.jackrabbit.core.journal.RecordIterator",3,0.00,1.00,4,0.02,60.48,3,0,1,3,11,118.44,21,5,9,1,160.73,0.00,0.00,0.00,0,3.00,1,45.65,0,0,2,,0.00,0,0,3,0,0,3,0,4,20,1
"org.apache.jackrabbit.core.journal.RecordProducer",1,0.00,1.00,2,0.01,38.26,1,0,0,1,6,103.18,11,3,4,1,147.31,0.00,0.00,0.00,0,1.00,1,25.51,0,0,2,,0.00,0,0,1,0,0,1,0,2,11,1
"org.apache.jackrabbit.core.journal.RotatingLogFile",7,0.14,2.14,53,0.71,30290.84,13,6,7,29,3,62.56,57,75,3,1,110.67,0.00,0.00,0.29,2,12.00,7,2132.17,0,2,0,java.lang.Object,0.00,22,0,15,0,22,5,1,14,424,1
"org.apache.jackrabbit.core.journal.RotatingLogFile$Comparator",1,0.00,1.00,5,0.04,805.33,1,0,7,2,1,122.04,0,6,0,1,122.04,0.00,0.00,0.00,0,1.00,1,128.00,0,0,1,java.lang.Object,0.00,1,0,1,0,1,1,0,0,34,0
"org.apache.jackrabbit.core.journal.RotatingLogFile$FilenameFilter",1,0.00,1.00,3,0.03,292.00,1,0,7,2,0,133.79,0,4,0,1,133.79,0.00,0.00,0.00,0,0.00,1,80.00,0,0,0,java.lang.Object,0.00,1,0,1,0,1,1,0,0,22,0
"org.apache.jackrabbit.core.journal.TestAll",1,0.00,1.00,6,0.05,1311.02,1,0,3,3,2,79.86,12,8,0,2,117.42,0.00,0.50,0.00,0,1.00,1,143.51,0,1,2,junit.framework.TestCase,0.00,2,1,1,0,2,0,0,2,38,1
"org.apache.jackrabbit.spi.BatchReadConfig",1,0.00,1.00,2,0.02,88.11,1,0,3,1,6,134.10,15,3,4,1,144.45,0.00,0.00,0.00,0,1.00,1,46.05,0,0,2,,0.00,0,0,1,0,0,1,0,2,15,1
"org.apache.jackrabbit.spi.BatchTest",31,0.71,1.61,473,8.64,264755.44,35,4,30,103,20,96.06,9,546,1,3,96.06,0.00,0.67,0.94,3,0.00,4,25909.94,2,3,19,org.apache.jackrabbit.spi.AbstractSPITest,0.18,72,2,50,0,72,28,0,7,4579,1
"org.apache.jackrabbit.spi.BatchTest$AbstractNamespaceResolver",2,0.00,2.00,5,0.06,1092.00,2,0,30,3,0,138.06,0,7,0,1,138.06,0.00,0.00,0.00,0,2.00,2,176.00,0,2,0,java.lang.Object,0.00,1,0,4,0,1,0,0,0,46,0
"org.apache.jackrabbit.spi.BinaryPartSource",4,0.33,1.50,14,0.12,1942.08,5,1,5,10,2,131.96,3,23,1,1,131.96,0.00,0.00,0.75,0,0.00,2,346.47,0,2,1,java.lang.Object,0.00,6,0,6,0,6,2,1,1,90,1
"org.apache.jackrabbit.spi.ChildInfoImpl",7,0.25,2.14,40,0.43,15668.27,11,4,3,16,5,100.50,38,53,2,1,118.37,0.00,0.00,0.46,0,0.00,4,1291.33,0,3,3,java.lang.Object,0.00,9,0,15,0,9,4,1,13,292,1
"org.apache.jackrabbit.spi.CloneTest",4,0.78,2.50,47,0.64,17544.63,10,6,14,28,12,153.26,5,61,1,3,103.26,0.00,0.67,0.75,1,0.00,6,1915.43,2,1,11,org.apache.jackrabbit.spi.AbstractSPITest,0.86,24,2,10,0,24,3,0,3,377,1
"org.apache.jackrabbit.spi.CloneTest$AbstractNamespaceResolver",2,0.00,2.00,5,0.06,1092.00,2,0,14,3,0,138.06,0,7,0,1,138.06,0.00,0.00,0.00,0,2.00,2,176.00,0,2,0,java.lang.Object,0.00,1,0,4,0,1,0,0,0,46,0
"org.apache.jackrabbit.spi.ConnectionTest",2,0.33,1.00,14,0.14,2258.07,5,3,11,11,8,165.44,3,19,1,3,115.44,0.00,0.67,0.50,0,0.00,1,427.66,1,0,7,org.apache.jackrabbit.spi.AbstractSPITest,0.60,9,2,2,0,9,2,0,1,97,1
"org.apache.jackrabbit.spi.ConnectionTest$AbstractNamespaceResolver",2,0.00,2.00,5,0.06,1092.00,2,0,11,3,0,138.06,0,7,0,1,138.06,0.00,0.00,0.00,0,2.00,2,176.00,0,2,0,java.lang.Object,0.00,1,0,4,0,1,0,0,0,46,0
"org.apache.jackrabbit.spi.CopyTest",5,0.67,2.40,64,0.90,25873.25,11,6,14,29,12,151.30,5,82,1,3,101.30,0.00,0.67,0.70,1,0.00,6,2700.49,2,1,11,org.apache.jackrabbit.spi.AbstractSPITest,0.75,24,2,12,0,24,4,0,3,518,1
"org.apache.jackrabbit.spi.CopyTest$AbstractNamespaceResolver",2,0.00,2.00,5,0.06,1092.00,2,0,14,3,0,138.06,0,7,0,1,138.06,0.00,0.00,0.00,0,2.00,2,176.00,0,2,0,java.lang.Object,0.00,1,0,4,0,1,0,0,0,46,0
"org.apache.jackrabbit.spi.ExtensionTest",12,0.20,1.08,64,0.76,11822.70,16,4,16,35,14,121.34,7,82,1,3,121.34,0.00,0.67,0.44,4,0.00,2,2269.07,2,1,13,org.apache.jackrabbit.spi.AbstractSPITest,0.40,23,2,13,0,23,11,0,5,489,1
"org.apache.jackrabbit.spi.ExtensionTest$AbstractNamespaceResolver",2,0.00,2.00,5,0.06,1092.00,2,0,16,3,0,138.06,0,7,0,1,138.06,0.00,0.00,0.00,0,2.00,2,176.00,0,2,0,java.lang.Object,0.00,1,0,4,0,1,0,0,0,46,0
"org.apache.jackrabbit.spi.GetMethod",3,1.00,1.00,8,0.06,775.91,4,1,5,4,4,190.77,3,12,1,3,140.77,0.00,0.67,0.00,0,3.00,1,189.26,0,1,3,org.apache.jackrabbit.webdav.client.methods.DavMethodBase,0.29,1,2,3,0,1,2,0,1,53,0
"org.apache.jackrabbit.spi.ItemInfoImpl",4,0.17,1.25,14,0.10,2052.58,6,2,5,7,5,99.59,26,20,2,1,131.81,0.00,0.00,0.38,0,6.00,2,312.83,0,2,3,java.lang.Object,0.00,3,0,5,2,3,2,2,7,83,2
"org.apache.jackrabbit.spi.ItemInfoJsonHandler",16,0.17,2.94,159,2.09,71251.10,29,13,22,74,17,156.42,29,221,1,1,106.42,0.00,0.00,0.24,4,16.00,6,6281.09,0,3,16,java.lang.Object,0.00,58,0,47,0,58,13,1,23,1208,0
"org.apache.jackrabbit.spi.NodeInfoImpl",14,0.02,1.71,68,0.76,20554.64,22,8,19,42,14,123.48,13,84,2,2,123.48,0.00,0.50,0.14,0,82.00,5,2270.97,1,7,12,org.apache.jackrabbit.spi2davex.ItemInfoImpl,0.00,28,1,24,0,28,7,1,5,484,1
"org.apache.jackrabbit.spi.PostMethod",7,0.06,1.43,35,0.38,7939.21,10,3,12,22,5,141.40,24,53,2,3,120.79,0.00,0.67,0.29,0,11.00,2,1153.73,3,2,3,org.apache.jackrabbit.webdav.client.methods.DavMethodBase,0.24,15,2,10,0,15,5,0,14,261,0
"org.apache.jackrabbit.spi.PropertyInfoImpl",11,0.05,1.45,43,0.40,7206.27,15,4,8,18,7,130.94,7,60,2,2,130.94,0.00,0.50,0.30,0,24.00,3,1203.68,0,2,5,org.apache.jackrabbit.spi2davex.ItemInfoImpl,0.00,7,1,16,0,7,9,1,5,288,1
"org.apache.jackrabbit.spi.QValueFactoryImpl",16,0.29,1.75,71,0.95,35627.02,19,3,46,36,19,122.29,76,112,2,2,122.05,0.00,0.50,0.06,0,68.00,7,2857.56,0,13,17,org.apache.jackrabbit.spi.commons.value.AbstractQValueFactory,0.00,20,1,28,0,20,3,0,25,588,0
"org.apache.jackrabbit.spi.QValueFactoryImpl$BinaryQValue",27,0.02,3.00,233,2.63,119606.38,37,10,46,82,11,76.12,186,329,0,1,108.35,0.00,0.00,0.12,4,194.00,8,7884.16,1,9,11,java.lang.Object,0.00,55,0,81,0,55,18,3,73,1556,1
"org.apache.jackrabbit.spi.QValueFactoryImpl$BinaryQValue$Binary_0",4,0.00,1.00,12,0.10,1875.99,4,0,46,9,0,132.17,0,18,0,1,132.17,0.00,0.00,0.00,1,4.00,1,297.91,0,1,0,java.lang.Object,0.00,5,0,4,0,5,3,0,0,76,0
"org.apache.jackrabbit.spi.QValueFactoryImpl$DateQValue",4,0.00,1.75,19,0.17,5079.81,5,1,46,9,1,124.21,16,26,0,2,123.97,0.00,0.50,1.00,0,0.00,4,517.20,0,1,1,org.apache.jackrabbit.spi2davex.QValueImpl,0.00,5,1,7,0,5,3,0,4,123,1
"org.apache.jackrabbit.spi.QValueFactoryImpl$QValueImpl",16,2.00,2.69,108,1.30,70476.01,18,2,46,37,6,163.05,24,143,0,2,113.05,0.00,0.50,0.00,1,46.00,9,3901.82,1,5,6,org.apache.jackrabbit.spi.commons.value.AbstractQValue,0.20,21,1,43,0,21,11,1,10,789,2
"org.apache.jackrabbit.spi.QValueFactoryImpl$QValueImpl$Binary",4,0.00,1.00,12,0.10,1875.99,4,0,46,9,0,132.17,0,18,0,1,132.17,0.00,0.00,0.00,1,4.00,1,297.91,0,1,0,java.lang.Object,0.00,5,0,4,0,5,3,0,0,76,0
"org.apache.jackrabbit.spi.ReadTest",10,0.47,1.80,60,0.71,13777.25,14,4,18,34,15,117.12,8,86,1,3,117.12,0.00,0.67,0.68,2,0.00,4,2137.53,2,3,14,org.apache.jackrabbit.spi.AbstractSPITest,0.46,24,2,18,0,24,7,0,6,451,1
"org.apache.jackrabbit.spi.ReadTest$AbstractNamespaceResolver",2,0.00,2.00,5,0.06,1092.00,2,0,18,3,0,138.06,0,7,0,1,138.06,0.00,0.00,0.00,0,2.00,2,176.00,0,2,0,java.lang.Object,0.00,1,0,4,0,1,0,0,0,46,0
"org.apache.jackrabbit.spi.RepositoryServiceImpl",17,0.03,2.59,176,2.79,118021.64,31,14,49,87,37,123.84,52,231,3,2,103.23,0.00,0.50,0.05,5,147.00,6,8373.86,7,9,34,org.apache.jackrabbit.spi2dav.RepositoryServiceImpl,0.00,70,1,44,0,70,8,0,22,1519,1
"org.apache.jackrabbit.spi.RepositoryServiceImpl$BatchImpl",26,0.01,2.23,224,2.88,91201.42,33,7,49,95,20,129.83,78,272,0,1,109.21,0.00,0.00,0.15,10,154.00,6,8642.63,0,3,20,java.lang.Object,0.00,69,0,58,0,69,23,1,34,1684,1
"org.apache.jackrabbit.spi.RepositoryServiceImpl$BatchReadConfig",1,0.00,1.00,3,0.02,171.91,1,0,49,1,2,135.60,0,5,0,1,135.60,0.00,0.00,0.00,0,1.00,1,61.30,0,0,2,java.lang.Object,0.00,0,0,1,0,0,1,0,0,18,0
"org.apache.jackrabbit.spi.RepositoryStubImpl",2,1.00,1.00,7,0.08,1317.54,3,1,8,5,6,131.24,9,10,0,3,131.01,0.00,0.67,0.00,0,2.00,1,235.34,0,1,6,org.apache.jackrabbit.spi2dav.RepositoryStubImpl,0.00,3,2,2,0,3,1,0,3,59,1
"org.apache.jackrabbit.spi.RepositoryStubImpl$BatchReadConfig",1,0.00,1.00,3,0.02,171.91,1,0,8,1,2,135.60,0,4,0,1,135.60,0.00,0.00,0.00,0,1.00,1,61.30,0,0,2,java.lang.Object,0.00,0,0,1,0,0,1,0,0,18,0
"org.apache.jackrabbit.spi.ServiceStubImpl",2,0.20,1.50,13,0.14,2535.31,7,5,8,5,6,138.06,6,17,0,3,117.44,0.00,0.67,0.10,0,2.00,2,409.64,1,1,6,org.apache.jackrabbit.spi2dav.ServiceStubImpl,0.25,3,2,3,0,3,1,0,2,92,1
"org.apache.jackrabbit.spi.ServiceStubImpl$BatchReadConfig",1,0.00,3.00,7,0.06,1159.41,1,0,8,3,2,165.09,1,11,0,1,115.09,0.00,0.00,0.00,0,0.00,3,193.44,0,0,2,java.lang.Object,0.00,2,0,3,0,2,1,0,1,43,0
"org.apache.jackrabbit.spi.TestAll",1,0.00,1.00,11,0.14,3815.35,1,0,3,5,7,143.84,2,13,0,2,103.95,0.00,0.50,0.00,0,1.00,1,405.41,0,1,7,junit.framework.TestCase,0.00,4,1,1,0,4,0,0,2,88,1
"org.apache.jackrabbit.spi.ValueLoader",3,0.50,2.67,35,0.49,17808.46,4,1,18,25,13,142.10,7,48,2,1,102.21,0.00,0.00,0.67,0,1.00,5,1480.05,0,0,11,java.lang.Object,0.00,22,0,8,0,22,3,0,3,266,0
"org.apache.jackrabbit.spi.ValueLoader$Target",1,0.00,1.00,2,0.01,42.34,1,0,18,1,0,147.20,4,3,0,1,146.96,0.00,0.00,0.00,0,1.00,1,30.34,0,0,0,,0.00,0,0,1,0,0,1,0,1,12,0
"org.apache.jackrabbit.jcr.ChildNodeAttic",11,0.30,2.27,67,0.57,11022.49,13,2,8,26,3,168.15,17,77,1,1,118.15,0.00,0.00,0.23,0,16.00,4,1698.38,0,4,3,java.lang.Object,0.00,15,0,25,0,15,7,0,6,384,0
"org.apache.jackrabbit.jcr.ChildNodeEntries",12,0.00,1.00,13,0.08,276.27,12,0,7,12,5,112.17,106,14,2,1,160.27,0.00,0.00,0.00,0,12.00,1,237.44,0,2,3,,0.00,0,0,12,0,0,10,0,13,88,1
"org.apache.jackrabbit.jcr.ChildNodeEntriesImpl",20,0.07,3.25,186,2.36,92407.14,28,8,20,64,10,58.17,178,235,2,1,106.28,0.00,0.00,0.19,7,6.00,9,7072.56,0,10,8,java.lang.Object,0.00,44,0,65,0,44,10,1,65,1417,1
"org.apache.jackrabbit.jcr.ChildNodeEntriesImpl$LinkedEntries",10,0.00,1.60,50,0.44,10856.83,10,0,20,19,2,88.69,67,64,0,2,120.91,0.00,0.50,0.00,1,10.00,3,1306.72,0,6,2,org.apache.commons.collections.list.AbstractLinkedList,0.00,9,1,16,0,9,4,0,15,317,2
"org.apache.jackrabbit.jcr.ChildNodeEntriesImpl$LinkedEntries$LinkNode",8,0.71,1.50,31,0.29,8411.31,9,1,20,13,3,169.20,16,42,0,2,129.31,0.00,0.50,0.38,1,14.00,4,870.55,4,4,3,Node,0.00,5,1,12,0,5,4,0,8,209,2
"org.apache.jackrabbit.jcr.ChildNodeEntriesImpl$LinkedEntries$LinkNodeIterator",4,0.17,1.50,18,0.14,2428.54,6,2,20,9,0,126.53,0,25,0,1,126.53,0.00,0.00,0.38,1,6.00,2,428.00,0,1,0,java.lang.Object,0.00,5,0,6,0,5,3,1,0,107,1
"org.apache.jackrabbit.jcr.ChildNodeEntriesImpl$LinkedEntries$NameMap",10,0.11,3.60,105,1.28,53957.83,12,2,20,29,3,104.25,49,133,0,1,104.01,0.00,0.00,0.60,3,0.00,7,3854.91,0,7,3,java.lang.Object,0.00,19,0,36,0,19,3,0,25,778,2
"org.apache.jackrabbit.jcr.ChildPropertyEntries",7,0.00,1.00,8,0.04,194.22,7,0,2,7,4,127.41,45,9,2,1,159.64,0.00,0.00,0.00,0,7.00,1,129.48,0,2,2,,0.00,0,0,7,0,0,5,0,8,49,1
"org.apache.jackrabbit.jcr.ChildPropertyEntriesImpl",8,0.04,1.75,53,0.49,10322.84,12,4,12,24,6,137.96,26,65,1,1,117.35,0.00,0.00,0.28,2,0.00,3,1474.13,0,2,5,java.lang.Object,0.00,16,0,14,0,16,6,1,10,334,1
"org.apache.jackrabbit.jcr.EntryFactory",12,0.05,1.25,47,0.42,7877.03,20,8,9,22,15,151.58,47,64,6,1,130.97,0.00,0.00,0.08,0,88.00,2,1262.27,0,5,11,java.lang.Object,0.00,10,0,15,0,10,7,0,17,301,1
"org.apache.jackrabbit.jcr.EntryFactory$InvalidationStrategy",2,0.00,1.00,3,0.02,84.27,2,0,9,2,1,110.10,17,4,0,1,158.21,0.00,0.00,0.00,0,2.00,1,56.18,0,0,1,,0.00,0,0,2,0,0,2,0,2,20,1
"org.apache.jackrabbit.jcr.EntryFactory$NodeEntryListener",2,0.00,1.00,3,0.02,84.27,2,0,9,2,1,158.21,0,4,0,1,158.21,0.00,0.00,0.00,0,2.00,1,56.18,0,0,1,,0.00,0,0,2,0,0,2,0,0,20,1
"org.apache.jackrabbit.jcr.EntryValidation",4,1.00,3.50,33,0.32,9046.43,5,1,6,12,4,73.05,48,50,1,1,110.61,0.00,0.00,0.00,0,4.00,5,963.96,0,0,3,java.lang.Object,0.00,8,0,14,0,8,4,0,16,214,1
"org.apache.jackrabbit.jcr.HierarchyEntry",16,0.00,1.00,17,0.09,493.30,16,0,8,16,21,116.98,113,18,17,1,159.27,0.00,0.00,0.00,0,16.00,1,283.71,0,4,6,,0.00,0,0,16,0,0,12,0,17,106,1
"org.apache.jackrabbit.jcr.HierarchyEntryImpl",22,0.08,2.36,141,1.54,50797.23,27,5,16,51,15,73.00,166,199,3,1,115.29,0.00,0.00,0.13,9,206.00,6,4620.28,0,11,13,java.lang.Object,0.00,29,0,52,2,29,11,1,66,946,1
"org.apache.jackrabbit.jcr.HierarchyEventListener",5,0.08,5.40,87,1.24,109173.45,8,3,18,34,11,52.98,60,110,1,1,90.54,0.00,0.00,0.27,2,10.00,17,3727.04,0,2,11,java.lang.Object,0.00,29,0,27,0,29,3,1,30,633,1
"org.apache.jackrabbit.jcr.HierarchyManager",12,0.00,1.00,13,0.12,656.89,12,0,9,12,22,109.21,107,14,13,1,157.31,0.00,0.00,0.00,0,12.00,1,346.08,0,6,9,,0.00,0,0,12,0,0,6,0,13,110,1
"org.apache.jackrabbit.jcr.HierarchyManagerImpl",14,0.08,2.36,107,1.14,33890.81,19,5,16,47,20,133.25,45,148,2,1,112.63,0.00,0.00,0.27,3,42.00,4,3432.70,0,6,18,java.lang.Object,0.00,33,0,33,0,33,8,1,18,728,1
"org.apache.jackrabbit.jcr.NodeEntry",29,0.00,1.00,30,0.30,1747.59,29,0,16,29,62,108.88,253,31,54,2,156.98,0.00,0.50,0.00,0,29.00,1,885.29,0,19,10,,0.00,0,1,29,0,0,10,0,30,273,1
"org.apache.jackrabbit.jcr.NodeEntryImpl",73,0.03,3.53,757,9.84,428684.16,81,8,45,266,44,61.44,514,966,8,2,103.73,0.00,0.50,0.10,23,2194.00,15,29516.33,12,23,40,org.apache.jackrabbit.jcr2spi.hierarchy.HierarchyEntryImpl,0.17,193,1,258,0,193,50,1,240,5530,1
"org.apache.jackrabbit.jcr.NodeEntryImpl$EagerInvalidation",2,0.00,1.00,4,0.04,297.63,2,0,45,3,2,124.79,11,7,0,1,142.66,0.00,0.00,0.00,0,2.00,1,110.26,0,0,2,java.lang.Object,0.00,1,0,2,0,1,2,1,3,33,1
"org.apache.jackrabbit.jcr.NodeEntryImpl$LazyInvalidation",4,0.33,3.00,32,0.29,7383.23,8,4,45,6,2,62.86,43,46,0,1,111.34,0.00,0.00,0.50,1,0.00,4,878.91,0,0,2,java.lang.Object,0.00,2,0,12,0,2,4,1,12,197,1
"org.apache.jackrabbit.jcr.NodeEntryImpl$RevertInfo",3,0.00,2.00,24,0.29,5467.44,8,5,45,9,3,111.48,1,32,0,1,111.48,0.00,0.00,0.20,0,5.00,4,873.33,0,0,3,java.lang.Object,0.00,6,0,6,0,6,3,0,1,190,1
"org.apache.jackrabbit.jcr.PropertyEntry",3,0.00,1.00,4,0.03,175.02,3,0,5,3,30,114.80,22,5,29,2,157.09,0.00,0.50,0.00,0,3.00,1,87.51,0,3,2,,0.00,0,1,3,0,0,0,0,4,30,1
"org.apache.jackrabbit.jcr.PropertyEntryImpl",10,0.00,1.40,32,0.34,8006.45,10,0,11,19,13,112.39,54,48,3,2,130.26,0.00,0.50,0.00,1,18.00,5,1024.20,4,5,12,org.apache.jackrabbit.jcr2spi.hierarchy.HierarchyEntryImpl,0.12,9,1,14,0,9,5,1,15,244,1
"org.apache.jackrabbit.jcr.UniqueIdResolver",10,0.04,3.00,73,0.86,23283.13,13,3,13,37,9,94.84,52,108,1,1,112.71,0.00,0.00,0.37,2,0.00,6,2573.81,0,2,8,java.lang.Object,0.00,27,0,30,0,27,8,2,26,548,1
"org.apache.jackrabbit.core.query.lucene.join.AbstractCondition",4,0.67,1.00,10,0.09,1072.60,5,1,4,8,11,98.36,31,15,8,1,140.65,0.00,0.00,0.50,0,4.00,1,265.94,0,1,3,java.lang.Object,0.00,4,0,4,8,4,3,1,6,73,2
"org.apache.jackrabbit.core.query.lucene.join.AncestorNodeJoin",3,0.40,2.67,38,0.50,20328.33,8,5,8,15,7,80.21,42,44,1,2,100.35,0.00,0.50,0.47,1,0.00,4,1485.29,1,1,6,org.apache.jackrabbit.core.query.lucene.join.AbstractCondition,0.00,12,1,8,0,12,2,0,10,291,1
"org.apache.jackrabbit.core.query.lucene.join.AncestorPathNodeJoin",2,0.67,2.50,21,0.29,7379.15,5,3,8,12,9,95.04,30,33,1,2,105.40,0.00,0.50,0.67,0,0.00,3,862.09,1,1,8,org.apache.jackrabbit.core.query.lucene.join.AbstractCondition,0.00,10,1,5,0,10,1,0,8,173,1
"org.apache.jackrabbit.core.query.lucene.join.ChildNodeJoin",2,0.80,3.50,33,0.42,15410.69,7,5,8,15,7,94.72,33,39,1,2,95.19,0.00,0.50,0.60,0,0.00,5,1274.42,1,1,6,org.apache.jackrabbit.core.query.lucene.join.AbstractCondition,0.00,13,1,7,0,13,1,0,8,247,1
"org.apache.jackrabbit.core.query.lucene.join.Condition",3,0.00,1.00,4,0.03,191.29,3,0,3,3,5,124.57,19,6,3,1,156.79,0.00,0.00,0.00,0,3.00,1,78.03,0,2,2,,0.00,0,0,3,0,0,1,0,4,28,1
"org.apache.jackrabbit.core.query.lucene.join.DescendantNodeJoin",3,0.42,3.67,49,0.61,26845.78,9,6,8,17,7,74.52,44,55,1,2,94.67,0.00,0.50,0.44,1,0.00,5,1841.55,1,1,6,org.apache.jackrabbit.core.query.lucene.join.AbstractCondition,0.00,14,1,11,0,14,2,0,11,359,1
"org.apache.jackrabbit.core.query.lucene.join.DescendantPathNodeJoin",2,0.50,2.50,20,0.28,7767.12,4,2,8,12,9,85.08,28,32,1,2,105.22,0.00,0.50,0.75,0,0.00,3,836.08,1,1,8,org.apache.jackrabbit.core.query.lucene.join.AbstractCondition,0.00,10,1,5,0,10,1,0,7,165,1
"org.apache.jackrabbit.core.query.lucene.join.EquiJoin",2,1.00,2.00,21,0.33,9055.74,6,4,8,12,6,104.28,32,32,1,2,104.75,0.00,0.50,0.75,0,0.00,3,993.57,0,1,5,org.apache.jackrabbit.core.query.lucene.join.AbstractCondition,0.00,10,1,4,0,10,1,0,8,194,1
"org.apache.jackrabbit.core.query.lucene.join.Join",9,0.04,2.67,75,1.00,61224.66,16,7,19,28,17,56.91,83,114,3,1,106.91,0.00,0.00,0.17,1,25.00,6,3001.03,0,4,14,java.lang.Object,0.00,19,0,24,0,19,5,1,23,613,1
"org.apache.jackrabbit.core.query.lucene.join.Join$DefaultQOMTreeVisitor",4,0.89,2.50,74,1.23,64087.13,7,3,19,28,18,140.85,7,98,0,1,90.85,0.00,0.00,1.00,0,0.00,4,3687.10,0,4,18,java.lang.Object,0.00,24,0,10,0,24,0,0,7,668,0
"org.apache.jackrabbit.core.query.lucene.join.ParentNodeJoin",2,0.50,2.00,19,0.26,8452.87,4,2,6,9,7,62.56,22,26,1,2,106.69,0.00,0.50,0.75,0,0.00,3,785.37,1,1,6,org.apache.jackrabbit.core.query.lucene.join.AbstractCondition,0.00,7,1,4,0,7,1,0,5,155,1
"org.apache.jackrabbit.core.query.lucene.join.SameNodeJoin",2,0.50,1.50,12,0.16,3197.01,4,2,5,6,6,68.17,21,19,1,2,116.65,0.00,0.50,0.75,0,0.00,2,465.51,1,1,5,org.apache.jackrabbit.core.query.lucene.join.AbstractCondition,0.00,4,1,3,0,4,1,0,5,103,1
"org.apache.jackrabbit.core.query.lucene.join.ScoreNodeMap",2,0.00,3.00,24,0.26,11530.33,3,1,5,10,9,119.01,36,29,8,1,100.88,0.00,0.00,1.00,0,0.00,3,789.27,0,1,1,java.lang.Object,0.00,8,0,6,0,8,1,0,6,171,2
"org.apache.jackrabbit.jcr.EventImpl",10,0.04,2.30,70,0.79,22237.49,15,5,15,33,10,80.71,62,86,1,1,112.93,0.00,0.00,0.24,4,0.00,8,2365.56,0,7,9,java.lang.Object,0.00,23,0,23,0,23,3,1,19,498,1
"org.apache.jackrabbit.jcr.FilteredEventIterator",10,0.00,1.40,44,0.41,8143.74,18,8,10,18,7,83.25,74,61,1,1,125.54,0.00,0.00,0.12,2,26.00,3,1236.93,0,2,6,java.lang.Object,0.00,8,0,14,0,8,8,1,20,287,0
"org.apache.jackrabbit.jcr.InternalEventListener",2,0.00,1.00,3,0.01,58.89,2,0,3,2,5,109.43,19,4,3,1,159.43,0.00,0.00,0.00,0,2.00,1,39.26,0,1,2,,0.00,0,0,2,0,0,1,0,3,16,1
"org.apache.jackrabbit.jcr.ObservationManagerImpl",10,0.19,2.20,86,1.01,39939.64,16,6,23,42,12,90.90,55,121,1,1,108.77,0.00,0.00,0.33,1,0.00,7,3036.33,0,4,11,java.lang.Object,0.00,32,0,22,0,32,6,2,20,586,1
"org.apache.jackrabbit.webdav.lock.AbstractActiveLock",3,1.00,2.33,23,0.32,12277.01,4,1,4,16,5,68.55,23,31,2,1,110.84,0.00,0.00,0.33,1,5.00,5,972.96,0,2,3,java.lang.Object,0.00,13,0,7,3,13,1,2,11,193,2
"org.apache.jackrabbit.webdav.lock.AbstractLockEntry",1,1.00,1.00,7,0.09,1748.72,2,1,6,7,5,65.46,10,9,2,1,113.94,0.00,0.00,0.00,0,0.00,1,274.40,0,1,3,java.lang.Object,0.00,6,0,1,3,6,0,2,2,65,2
"org.apache.jackrabbit.webdav.lock.ActiveLock",13,0.00,1.00,14,0.07,317.72,13,0,1,13,21,142.20,76,15,19,2,160.07,0.00,0.50,0.00,0,13.00,1,206.64,0,4,2,,0.00,0,1,13,0,0,9,0,14,81,1
"org.apache.jackrabbit.webdav.lock.ActiveLockTest",2,1.00,1.00,20,0.28,5168.37,3,1,7,22,5,127.44,6,23,1,2,106.83,0.00,0.50,0.00,0,2.00,1,848.86,0,0,4,junit.framework.TestCase,0.00,20,1,2,0,20,2,0,2,167,1
"org.apache.jackrabbit.webdav.lock.DefaultActiveLock",13,0.08,1.23,36,0.34,6149.55,17,4,2,25,8,138.89,60,53,2,2,138.66,1.00,0.33,0.17,1,77.00,3,1022.08,0,4,6,org.apache.jackrabbit.webdav.lock.AbstractActiveLock,0.00,12,1,16,1,12,9,0,16,251,1
"org.apache.jackrabbit.webdav.lock.LockDiscovery",7,0.67,1.71,36,0.38,8856.86,8,1,10,22,13,78.08,55,46,7,2,120.37,0.00,0.50,0.43,1,10.00,3,1151.41,1,3,6,org.apache.jackrabbit.webdav.property.AbstractDavProperty,0.00,15,1,12,0,15,4,0,11,254,1
"org.apache.jackrabbit.webdav.lock.LockDiscovery$ALockImpl",15,0.50,1.40,53,0.50,8740.41,16,1,10,29,5,131.35,3,75,0,1,131.35,0.00,0.00,0.53,1,7.00,3,1500.09,0,6,5,java.lang.Object,0.00,14,0,21,0,14,9,1,3,364,2
"org.apache.jackrabbit.webdav.lock.LockEntry",2,0.00,1.00,3,0.01,65.85,2,0,1,2,6,126.83,13,4,3,2,159.05,0.00,0.50,0.00,0,2.00,1,38.73,0,2,3,,0.00,0,1,2,0,0,0,0,3,16,1
"org.apache.jackrabbit.webdav.lock.LockInfo",12,0.04,2.08,68,0.75,25973.41,19,7,10,29,21,70.39,100,89,14,1,118.49,0.00,0.00,0.18,0,64.00,9,2245.87,0,3,7,java.lang.Object,0.00,17,0,25,0,17,9,2,15,454,1
"org.apache.jackrabbit.webdav.lock.LockManager",5,0.00,1.00,6,0.07,360.30,5,0,2,5,12,107.89,51,10,7,1,156.37,0.00,0.00,0.00,0,5.00,1,198.80,0,3,6,,0.00,0,0,5,0,0,2,0,6,59,1
"org.apache.jackrabbit.webdav.lock.Scope",5,0.00,2.00,35,0.46,13558.49,10,5,8,23,30,69.99,36,46,26,1,112.28,0.00,0.00,0.20,1,10.00,3,1367.76,0,3,4,java.lang.Object,0.00,18,0,10,0,18,2,1,7,295,1
"org.apache.jackrabbit.webdav.lock.SimpleLockManager",7,0.50,4.14,69,1.13,54880.31,8,1,7,36,12,54.41,64,101,1,1,104.41,0.00,0.00,0.57,1,3.00,9,3395.61,0,4,11,java.lang.Object,0.00,29,0,29,0,29,3,1,17,644,1
"org.apache.jackrabbit.webdav.lock.SupportedLock",7,0.17,1.57,29,0.30,5532.01,8,1,6,19,6,83.33,52,41,2,2,125.62,0.00,0.50,0.86,0,0.00,3,913.94,1,3,4,org.apache.jackrabbit.webdav.property.AbstractDavProperty,0.00,12,1,11,0,12,4,0,10,213,1
"org.apache.jackrabbit.webdav.lock.SupportedLock$WriteLockEntry",3,1.00,1.67,12,0.13,3382.38,4,1,6,7,2,92.17,19,18,0,2,124.39,0.00,0.50,0.33,0,4.00,3,379.23,0,1,2,org.apache.jackrabbit.webdav.lock.AbstractLockEntry,0.00,4,1,5,0,4,2,0,4,92,3
"org.apache.jackrabbit.webdav.lock.TestAll",1,0.00,1.00,5,0.04,864.35,1,0,3,3,1,121.80,0,7,0,2,121.80,0.00,0.50,0.00,0,1.00,1,115.51,0,1,1,junit.framework.TestCase,0.00,2,1,1,0,2,0,0,0,31,1
"org.apache.jackrabbit.webdav.lock.Type",5,0.00,2.00,34,0.42,12158.88,9,4,8,23,25,72.86,35,45,21,1,115.15,0.00,0.00,0.25,1,10.00,3,1273.82,0,3,4,java.lang.Object,0.00,18,0,10,0,18,2,1,7,276,1
"org.apache.jackrabbit.webdav.property.AbstractDavProperty",6,0.27,3.00,53,0.66,41318.72,9,3,10,18,27,58.36,61,64,22,1,106.84,0.00,0.00,0.11,1,14.00,10,1980.42,0,2,5,java.lang.Object,0.00,12,0,18,22,12,4,1,8,399,2
"org.apache.jackrabbit.webdav.property.DavProperty",3,0.00,1.00,4,0.02,91.55,3,0,2,3,44,139.17,42,5,41,3,159.31,0.00,0.67,0.00,0,3.00,1,54.48,0,2,3,,0.00,0,2,3,0,0,1,0,4,22,1
"org.apache.jackrabbit.webdav.property.DavPropertyIterator",1,0.00,1.00,2,0.01,70.32,1,0,2,1,4,96.75,10,3,3,2,145.23,0.00,0.50,0.00,0,1.00,1,35.16,0,1,1,,0.00,0,1,1,0,0,0,0,2,13,1
"org.apache.jackrabbit.webdav.property.DavPropertyName",10,0.01,1.70,58,0.79,28053.69,25,15,7,26,58,69.55,81,76,54,1,117.65,0.00,0.00,0.07,1,14.00,4,2379.52,0,7,4,java.lang.Object,0.00,16,0,17,0,16,3,2,20,496,1
"org.apache.jackrabbit.webdav.property.DavPropertyNameIterator",1,0.00,1.00,2,0.01,48.43,1,0,1,1,5,167.12,3,3,4,2,146.50,0.00,0.50,0.00,0,1.00,1,27.12,0,1,1,,0.00,0,1,1,0,0,0,0,1,11,1
"org.apache.jackrabbit.webdav.property.DavPropertyNameSet",12,0.18,1.25,34,0.31,5319.96,14,2,8,30,31,121.00,67,50,26,2,138.88,0.00,0.50,0.33,2,18.00,3,935.16,0,1,5,org.apache.jackrabbit.webdav.property.PropContainer,0.33,18,1,15,0,18,11,0,16,236,1
"org.apache.jackrabbit.webdav.property.DavPropertyNameSet$PropertyNameIterator",5,0.25,1.00,12,0.07,762.99,6,1,8,8,2,142.58,0,18,0,1,142.58,0.00,0.00,0.80,0,0.00,1,222.77,0,2,2,java.lang.Object,0.00,3,0,5,0,3,3,1,0,69,1
"org.apache.jackrabbit.webdav.property.DavPropertySet",16,0.20,1.06,41,0.40,6029.47,18,2,9,35,23,97.18,114,59,18,2,139.47,0.00,0.50,0.31,3,12.00,2,1187.48,0,1,5,org.apache.jackrabbit.webdav.property.PropContainer,0.36,19,1,17,0,19,15,0,21,312,1
"org.apache.jackrabbit.webdav.property.DavPropertySet$PropIter",7,0.06,1.43,28,0.21,3713.41,10,3,9,14,3,147.62,25,39,0,1,127.00,0.00,0.00,0.29,2,11.00,3,618.73,0,1,3,java.lang.Object,0.00,7,0,10,0,7,6,1,10,159,1
"org.apache.jackrabbit.webdav.property.DefaultDavProperty",6,0.50,1.67,33,0.34,10346.87,8,2,7,16,21,70.84,65,44,17,2,119.32,0.00,0.50,0.08,0,10.00,5,1022.88,0,2,4,org.apache.jackrabbit.webdav.property.AbstractDavProperty,0.00,10,1,10,0,10,4,0,9,223,1
"org.apache.jackrabbit.webdav.property.HrefProperty",6,0.20,2.83,53,0.72,33377.66,8,2,9,27,23,59.10,63,66,19,2,107.58,1.00,0.33,0.33,1,6.00,8,2171.06,1,3,4,org.apache.jackrabbit.webdav.property.AbstractDavProperty,0.00,21,1,17,1,21,3,0,9,419,1
"org.apache.jackrabbit.webdav.property.PropContainer",6,1.00,1.33,17,0.18,3762.07,7,1,9,13,7,95.39,47,21,3,1,137.68,0.00,0.00,0.17,1,10.00,3,549.46,0,2,4,java.lang.Object,0.00,7,0,8,2,7,4,2,7,128,2
"org.apache.jackrabbit.webdav.property.ResourceType",6,0.00,2.33,52,0.61,20780.06,13,7,10,17,12,65.12,71,62,6,2,109.25,0.00,0.50,0.14,0,6.00,4,1818.03,0,1,6,org.apache.jackrabbit.webdav.property.AbstractDavProperty,0.00,11,1,14,0,11,5,0,17,389,1
"org.apache.jackrabbit.webdav.property.ResourceType$TypeName",4,0.11,1.25,16,0.14,2075.55,7,3,10,7,3,127.11,0,22,0,1,127.11,0.00,0.00,0.42,0,0.00,2,410.07,0,1,3,java.lang.Object,0.00,3,0,5,0,3,3,1,0,107,2
"org.apache.jackrabbit.commons.predicate.DeclaringTypePredicate",3,0.25,1.33,13,0.17,3110.71,5,2,4,8,1,74.73,28,19,0,2,124.73,0.00,0.50,0.33,0,4.00,2,508.68,0,0,1,org.apache.jackrabbit.commons.predicate.DepthPredicate,0.00,5,1,4,0,5,3,0,6,121,1
"org.apache.jackrabbit.commons.predicate.DepthPredicate",3,0.25,1.67,15,0.14,3891.23,5,2,2,4,6,70.30,29,22,5,1,120.30,0.00,0.00,0.33,0,4.00,3,434.21,0,0,1,java.lang.Object,0.00,1,0,5,5,1,3,1,6,103,1
"org.apache.jackrabbit.commons.predicate.IsMandatoryPredicate",4,1.00,1.25,13,0.13,2153.24,5,1,4,7,1,181.64,7,19,0,2,131.64,0.00,0.50,0.25,0,6.00,2,381.02,0,0,1,org.apache.jackrabbit.commons.predicate.DepthPredicate,0.00,3,1,5,0,3,4,0,2,99,1
"org.apache.jackrabbit.commons.predicate.IsNodePredicate",4,0.67,1.00,11,0.08,942.47,5,1,2,5,2,98.80,30,16,1,2,141.09,0.00,0.50,0.50,0,4.00,1,249.19,0,0,1,org.apache.jackrabbit.commons.predicate.DepthPredicate,0.00,1,1,4,0,1,4,0,6,70,1
"org.apache.jackrabbit.commons.predicate.NamePredicate",3,1.00,1.00,9,0.08,970.76,4,1,2,5,1,91.15,22,13,0,2,133.44,0.00,0.50,0.33,0,4.00,1,245.89,0,0,1,org.apache.jackrabbit.commons.predicate.DepthPredicate,0.00,2,1,3,0,2,3,0,5,66,1
"org.apache.jackrabbit.commons.predicate.NodeTypePredicate",3,0.25,2.00,17,0.17,3066.54,5,2,3,8,1,72.59,30,26,0,2,121.07,0.00,0.50,0.33,0,4.00,4,521.32,0,0,1,org.apache.jackrabbit.commons.predicate.DepthPredicate,0.00,5,1,6,0,5,3,0,7,123,1
"org.apache.jackrabbit.commons.predicate.NtFilePredicate",5,0.14,2.60,36,0.41,12385.23,14,9,3,13,1,70.24,35,51,0,1,112.53,0.00,0.00,0.22,0,6.00,9,1243.15,0,0,1,java.lang.Object,0.00,8,0,13,0,8,5,1,10,258,1
"org.apache.jackrabbit.commons.predicate.PathPredicate",2,0.00,3.50,21,0.26,7308.33,3,1,3,11,1,61.23,22,29,0,1,105.35,0.00,0.00,1.00,0,0.00,4,766.48,0,0,1,java.lang.Object,0.00,9,0,7,0,9,2,1,4,158,1
"org.apache.jackrabbit.commons.predicate.Predicate",1,0.00,1.00,4,0.02,513.67,1,0,0,2,7,97.82,13,5,7,1,127.20,0.00,0.00,0.00,0,1.00,1,70.86,0,0,0,,0.00,1,0,1,0,1,1,0,3,22,1
"org.apache.jackrabbit.commons.predicate.Predicate$Predicate",1,0.00,1.00,3,0.01,95.05,1,0,0,1,0,137.63,0,4,0,1,137.63,0.00,0.00,0.00,0,1.00,1,41.22,0,0,0,java.lang.Object,0.00,0,0,1,0,0,1,0,0,14,0
"org.apache.jackrabbit.webdav.bind.BindConstants",0,0.00,0.00,11,0.18,3428.54,10,10,3,1,10,171.00,14,12,7,1,171.00,0.00,0.00,0.00,0,0.00,0,529.10,0,0,3,,0.00,1,0,0,0,1,0,0,4,104,1
"org.apache.jackrabbit.webdav.bind.BindInfo",5,0.33,2.60,49,0.64,36819.71,8,3,9,16,12,144.62,11,62,6,1,104.73,0.00,0.00,0.07,0,8.00,9,1906.72,0,4,6,java.lang.Object,0.00,11,0,13,0,11,1,1,2,373,1
"org.apache.jackrabbit.webdav.bind.BindServletRequest",5,0.00,1.00,6,0.04,216.44,5,0,2,5,6,125.89,32,7,1,1,158.11,0.00,0.00,0.00,0,5.00,1,115.14,0,3,5,,0.00,0,0,5,0,0,2,0,6,41,1
"org.apache.jackrabbit.webdav.bind.BindableResource",3,0.00,1.00,4,0.03,199.94,3,0,3,3,4,138.77,17,5,2,1,156.64,0.00,0.00,0.00,0,3.00,1,92.69,0,1,2,,0.00,0,0,3,0,0,2,0,3,31,1
"org.apache.jackrabbit.webdav.bind.ParentElement",5,0.33,2.60,49,0.64,36970.61,8,3,9,16,9,144.60,14,62,3,1,104.72,0.00,0.00,0.07,0,8.00,9,1917.59,0,4,6,java.lang.Object,0.00,11,0,13,0,11,1,1,3,375,1
"org.apache.jackrabbit.webdav.bind.ParentSet",2,1.00,1.00,7,0.05,516.23,3,1,2,2,3,116.34,10,10,1,2,134.21,0.00,0.50,0.00,0,2.00,1,147.07,0,1,2,org.apache.jackrabbit.webdav.property.AbstractDavProperty,0.00,0,1,2,0,0,1,0,3,41,1
"org.apache.jackrabbit.webdav.bind.RebindInfo",5,0.33,2.60,49,0.64,36819.71,8,3,9,16,12,144.62,11,62,6,1,104.73,0.00,0.00,0.07,0,8.00,9,1906.72,0,4,6,java.lang.Object,0.00,11,0,13,0,11,1,1,2,373,1
"org.apache.jackrabbit.webdav.bind.UnbindInfo",5,0.50,2.00,34,0.43,19571.21,7,2,9,16,12,153.41,11,44,6,1,113.52,0.00,0.00,0.10,0,8.00,6,1287.02,0,3,6,java.lang.Object,0.00,11,0,10,0,11,2,1,2,259,1
"org.apache.jackrabbit.core.security.authorization.combined.CombinedEditor",7,0.25,2.71,67,0.94,39359.08,9,2,12,23,3,105.88,32,74,1,1,105.65,0.00,0.00,0.71,0,0.00,3,2814.37,0,4,2,java.lang.Object,0.00,16,0,19,0,16,3,1,18,543,0
"org.apache.jackrabbit.core.security.authorization.combined.CombinedProvider",8,0.07,2.38,75,0.84,25558.53,10,2,24,33,13,89.74,42,84,0,2,107.61,0.00,0.50,0.44,0,0.00,4,2520.84,5,3,13,org.apache.jackrabbit.core.security.authorization.AbstractAccessControlProvider,0.12,25,1,19,0,25,5,0,22,511,1
"org.apache.jackrabbit.core.security.authorization.combined.CombinedProvider$CompiledPermissionImpl",4,1.00,2.25,34,0.34,9383.04,5,1,24,13,3,110.82,17,35,0,2,110.59,0.00,0.50,0.25,1,6.00,3,1007.78,1,0,3,org.apache.jackrabbit.core.security.authorization.AbstractCompiledPermissions,0.17,9,1,9,0,9,4,0,9,213,1
"org.apache.jackrabbit.core.security.authorization.combined.TestAll",1,0.00,1.00,5,0.04,864.35,1,0,3,3,1,73.32,10,7,0,2,121.80,0.00,0.50,0.00,0,1.00,1,115.51,0,1,1,junit.framework.TestCase,0.00,2,1,1,0,2,0,0,2,31,1
"org.apache.jackrabbit.core.security.authorization.combined.WriteTest",6,1.00,2.17,72,1.13,40531.40,7,1,18,26,8,82.54,32,92,1,8,100.41,0.00,0.88,0.00,3,0.00,4,3383.48,7,4,7,org.apache.jackrabbit.core.security.authorization.acl.WriteTest,0.09,20,7,13,0,20,2,0,14,629,1
"org.apache.jackrabbit.commons.xml.DefaultContentHandler",12,0.09,1.00,26,0.27,3700.60,13,1,5,23,2,97.88,90,47,2,2,140.17,2.00,0.25,0.92,0,0.00,1,797.01,0,0,0,org.xml.sax.helpers.DefaultHandler,0.00,11,1,12,2,11,12,0,15,216,1
"org.apache.jackrabbit.commons.xml.DocumentViewExporter",4,0.00,1.50,19,0.28,6322.83,4,0,11,12,5,73.26,36,33,1,2,123.26,0.00,0.50,0.00,0,6.00,3,837.70,6,0,4,org.apache.jackrabbit.commons.xml.Exporter,0.00,8,1,6,0,8,4,0,11,171,1
"org.apache.jackrabbit.commons.xml.Exporter",20,0.04,2.20,156,2.14,63669.50,29,9,21,77,4,82.33,260,218,3,1,111.71,0.00,0.00,0.14,6,116.00,5,6428.29,0,5,1,java.lang.Object,0.00,57,0,44,2,57,15,0,41,1282,2
"org.apache.jackrabbit.commons.xml.ParsingContentHandler",3,0.00,1.33,11,0.13,2469.34,3,0,9,10,4,82.07,25,18,3,3,130.18,0.00,0.67,0.00,0,3.00,2,384.70,0,1,1,org.apache.jackrabbit.commons.xml.DefaultContentHandler,0.00,7,2,4,0,7,2,0,4,90,1
"org.apache.jackrabbit.commons.xml.ParsingContentHandlerTest",3,0.00,1.67,28,0.32,6730.76,3,0,5,13,2,158.90,5,40,0,2,108.90,0.00,0.50,0.00,1,3.00,2,957.09,0,0,2,junit.framework.TestCase,0.00,10,1,5,0,10,3,0,1,194,1
"org.apache.jackrabbit.commons.xml.ProxyContentHandler",13,0.08,1.00,28,0.28,3804.40,14,1,5,25,1,98.06,96,50,1,2,140.35,1.00,0.33,0.92,0,0.00,1,826.90,0,1,0,org.xml.sax.helpers.DefaultHandler,0.00,12,1,13,1,12,12,0,16,226,1
"org.apache.jackrabbit.commons.xml.SerializingContentHandler",13,0.01,3.23,153,2.12,118108.95,23,10,21,56,7,63.15,162,193,6,3,100.71,0.00,0.67,0.09,5,63.00,14,6365.41,6,3,1,org.apache.jackrabbit.commons.xml.DefaultContentHandler,0.24,43,2,42,0,43,10,0,65,1176,1
"org.apache.jackrabbit.commons.xml.SerializingContentHandlerTest",3,0.00,1.33,64,0.84,25297.86,3,0,4,18,1,140.70,5,71,0,2,90.70,0.00,0.50,0.00,1,3.00,2,2522.96,0,0,1,junit.framework.TestCase,0.00,15,1,4,0,15,3,0,1,451,1
"org.apache.jackrabbit.commons.xml.SystemViewExporter",6,0.00,2.17,50,0.59,15596.41,9,3,10,14,4,62.14,49,67,2,2,110.24,0.00,0.50,0.33,3,0.00,4,1782.03,6,0,2,org.apache.jackrabbit.commons.xml.Exporter,0.00,8,1,13,0,8,6,0,14,362,1
"org.apache.jackrabbit.commons.xml.SystemViewExporter$Writer",3,0.00,1.33,9,0.08,2192.23,3,0,10,6,1,130.58,0,15,0,1,130.58,0.00,0.00,0.00,0,3.00,2,254.70,0,0,1,java.lang.Object,0.00,3,0,4,0,3,3,0,0,61,0
"org.apache.jackrabbit.commons.xml.ToXmlContentHandler",14,0.08,2.21,92,1.02,41628.61,17,3,10,24,3,82.22,96,135,3,2,114.44,0.00,0.50,0.26,4,26.00,8,3046.68,0,1,0,org.xml.sax.helpers.DefaultHandler,0.00,10,1,31,0,10,13,0,21,630,1
"org.apache.jackrabbit.commons.xml.ToXmlContentHandlerTest",8,0.00,1.00,103,1.45,45411.68,8,0,4,21,1,101.18,0,141,0,2,101.18,0.00,0.50,0.00,0,8.00,1,4341.69,0,0,1,junit.framework.TestCase,0.00,13,1,8,0,13,8,0,0,832,1
"org.apache.jackrabbit.commons.xml.XmlnsContentHandler",3,0.00,2.00,23,0.33,11850.10,5,2,7,14,2,78.77,20,38,1,3,110.99,0.00,0.67,0.50,0,1.00,4,980.31,2,0,1,org.apache.jackrabbit.commons.xml.ProxyContentHandler,0.00,11,2,6,0,11,3,0,6,194,1
"org.apache.jackrabbit.commons.xml.XmlnsContentHandlerTest",1,0.00,1.00,18,0.24,8530.38,1,0,4,12,2,93.22,0,26,0,2,93.22,0.00,0.50,0.00,0,1.00,1,723.79,0,0,2,junit.framework.TestCase,0.00,11,1,1,0,11,1,0,0,143,1
"org.apache.jackrabbit.jcr.NamespaceRegistryTest",9,0.25,1.67,88,1.12,29254.28,15,6,12,31,3,89.76,47,115,1,4,107.63,0.00,0.75,0.39,2,0.00,2,3367.45,2,2,2,org.apache.jackrabbit.test.AbstractJCRTest,0.25,22,3,15,0,22,7,0,12,664,1
"org.apache.jackrabbit.jcr.TestAll",1,0.00,1.00,5,0.04,864.35,1,0,3,3,2,142.42,3,7,1,2,121.80,0.00,0.50,0.00,0,1.00,1,115.51,0,1,1,junit.framework.TestCase,0.00,2,1,1,0,2,0,0,1,31,1
"org.apache.jackrabbit.core.security.user.AdministratorTest",2,0.00,2.00,13,0.14,2738.12,2,0,5,12,5,157.00,4,19,1,5,117.12,0.00,0.80,0.00,0,0.00,3,417.87,0,0,4,org.apache.jackrabbit.api.security.user.AbstractUserTest,0.00,10,4,4,0,10,2,0,2,92,1
"org.apache.jackrabbit.core.security.user.AuthorizableImpl",23,0.03,2.52,199,2.62,85868.57,26,3,31,87,21,91.10,127,257,4,1,108.97,0.00,0.00,0.36,8,1.00,5,7874.90,0,9,18,java.lang.Object,0.00,64,0,58,2,64,14,2,36,1517,1
"org.apache.jackrabbit.core.security.user.AuthorizableImpl$NodeBasedPrincipal",2,0.00,1.00,5,0.03,289.05,2,0,31,2,2,124.89,11,8,0,2,142.76,0.00,0.50,0.00,0,2.00,1,92.70,0,1,2,org.apache.jackrabbit.core.security.principal.PrincipalImpl,0.00,0,1,2,0,0,1,1,3,30,0
"org.apache.jackrabbit.core.security.user.AuthorizableImplTest",11,0.23,3.09,137,1.88,60732.33,14,3,21,49,15,151.02,15,165,1,5,101.02,0.00,0.80,0.12,1,0.00,5,5635.93,3,0,14,org.apache.jackrabbit.api.security.user.AbstractUserTest,0.11,38,4,34,0,38,11,0,13,1097,1
"org.apache.jackrabbit.core.security.user.GroupAdministratorTest",19,0.21,2.68,226,3.19,115864.03,26,7,14,57,12,142.00,46,293,1,5,102.12,0.00,0.80,0.34,1,0.00,6,9561.07,7,1,11,org.apache.jackrabbit.api.security.user.AbstractUserTest,0.19,38,4,51,0,38,18,0,44,1796,1
"org.apache.jackrabbit.core.security.user.GroupImpl",12,0.41,2.25,76,0.95,26390.59,14,2,20,43,11,97.59,60,101,6,2,115.47,0.00,0.50,0.12,3,44.00,5,2839.07,3,6,7,org.apache.jackrabbit.core.security.user.AuthorizableImpl,0.00,31,1,27,0,31,6,1,21,576,0
"org.apache.jackrabbit.core.security.user.GroupImpl$MemberIterator",5,0.12,1.80,28,0.26,6894.48,7,2,20,14,2,120.07,1,39,0,1,120.07,0.00,0.00,0.40,0,5.00,4,770.28,0,2,2,java.lang.Object,0.00,9,0,9,0,9,3,1,1,172,1
"org.apache.jackrabbit.core.security.user.GroupImpl$NodeBasedGroup",7,1.00,1.86,37,0.35,8135.65,8,1,20,15,1,102.77,38,47,0,2,120.65,0.00,0.50,0.14,1,12.00,4,1042.86,0,2,1,org.apache.jackrabbit.core.security.user.NodeBasedPrincipal,0.00,8,1,13,0,8,5,1,13,232,1
"org.apache.jackrabbit.core.security.user.ImpersonationImpl",7,0.11,4.00,106,1.31,50387.23,10,3,21,43,15,117.05,23,125,1,1,96.44,0.00,0.00,0.43,2,0.00,6,3918.68,0,2,15,java.lang.Object,0.00,36,0,28,0,36,5,2,13,722,0
"org.apache.jackrabbit.core.security.user.ImpersonationImplTest",4,0.52,1.75,44,0.62,13079.63,11,7,12,23,7,154.35,7,53,1,5,104.35,0.00,0.80,0.54,0,0.00,3,1862.38,5,0,6,org.apache.jackrabbit.api.security.user.AbstractUserTest,0.26,19,4,7,0,19,4,0,5,378,1
"org.apache.jackrabbit.core.security.user.IndexNodeResolver",6,0.60,2.33,53,0.81,27930.73,7,1,12,23,6,76.01,40,69,2,2,108.23,0.00,0.50,0.50,1,6.00,7,2421.93,2,5,4,org.apache.jackrabbit.core.security.user.NodeResolver,0.00,17,1,14,0,17,1,0,8,457,0
"org.apache.jackrabbit.core.security.user.IndexNodeResolverTest",1,1.00,2.00,6,0.07,1623.65,2,1,6,4,6,166.53,1,9,1,5,116.53,0.00,0.80,0.00,0,1.00,2,217.68,0,1,5,org.apache.jackrabbit.core.security.user.NodeResolverTest,0.00,3,4,2,0,3,0,0,1,52,1
"org.apache.jackrabbit.core.security.user.NodeResolver",8,0.29,1.25,25,0.26,4057.23,11,3,10,12,9,81.85,72,35,6,1,131.85,0.00,0.00,0.08,1,20.00,3,765.93,0,7,3,java.lang.Object,0.00,4,0,10,2,4,1,0,9,191,1
"org.apache.jackrabbit.core.security.user.NodeResolverTest",15,0.25,1.67,129,2.03,62172.80,17,2,17,55,15,108.71,3,165,2,4,108.71,0.67,0.50,0.27,2,0.00,5,6082.07,2,2,13,org.apache.jackrabbit.test.AbstractJCRTest,0.11,40,3,25,2,40,13,0,3,1180,2
"org.apache.jackrabbit.core.security.user.NotUserAdministratorTest",10,0.31,2.50,97,1.30,29201.93,14,4,14,39,11,147.79,26,134,1,5,107.90,0.00,0.80,0.52,0,0.00,3,3890.52,5,0,10,org.apache.jackrabbit.api.security.user.AbstractUserTest,0.23,29,4,25,0,29,10,0,24,765,1
"org.apache.jackrabbit.core.security.user.TestAll",1,0.00,1.00,14,0.16,5586.62,1,0,3,3,10,80.87,5,16,0,2,98.74,0.00,0.50,0.00,0,1.00,1,465.96,0,1,10,junit.framework.TestCase,0.00,2,1,1,0,2,0,0,1,103,1
"org.apache.jackrabbit.core.security.user.TraversingNodeResolver",9,0.38,3.78,83,1.31,56860.16,10,1,19,42,7,62.88,69,130,2,2,105.17,0.00,0.50,0.67,3,0.00,10,3923.87,2,5,5,org.apache.jackrabbit.core.security.user.NodeResolver,0.00,33,1,34,0,33,4,0,17,730,0
"org.apache.jackrabbit.core.security.user.TraversingNodeResolverTest",1,1.00,2.00,6,0.07,1681.57,2,1,6,4,6,166.41,1,9,1,5,116.41,0.00,0.80,0.00,0,1.00,2,215.93,0,1,5,org.apache.jackrabbit.core.security.user.NodeResolverTest,0.00,3,4,2,0,3,0,0,1,52,1
"org.apache.jackrabbit.core.security.user.UserAccessControlProvider",14,0.05,2.43,109,1.26,40520.70,20,6,33,47,19,94.14,80,141,1,2,112.01,0.00,0.50,0.12,2,62.00,6,3786.35,5,6,18,org.apache.jackrabbit.core.security.authorization.AbstractAccessControlProvider,0.00,33,1,34,0,33,8,1,22,758,1
"org.apache.jackrabbit.core.security.user.UserAccessControlProvider$CompiledPermissionsImpl",6,0.13,7.33,112,1.77,164101.59,9,3,33,43,8,68.64,84,156,0,2,88.78,0.00,0.50,0.44,0,2.00,27,5323.24,3,1,8,org.apache.jackrabbit.core.security.authorization.AbstractCompiledPermissions,0.29,37,1,44,0,37,5,1,48,863,1
"org.apache.jackrabbit.core.security.user.UserAdministratorTest",16,0.23,2.56,162,2.10,57873.55,21,5,16,52,12,155.46,29,220,1,5,105.46,0.00,0.80,0.41,1,0.00,6,6290.88,8,1,11,org.apache.jackrabbit.api.security.user.AbstractUserTest,0.20,36,4,41,0,36,15,0,27,1225,1
"org.apache.jackrabbit.core.security.user.UserConstants",0,0.00,0.00,18,0.34,8467.35,17,17,3,2,14,171.00,18,19,11,1,171.00,0.00,0.00,0.00,0,0.00,0,1033.22,0,0,3,,0.00,2,0,0,0,2,0,0,5,185,0
"org.apache.jackrabbit.core.security.user.UserImpl",10,0.19,2.00,49,0.53,11830.87,13,3,13,26,18,124.42,43,72,10,2,124.18,0.00,0.50,0.17,3,46.00,3,1584.12,3,6,10,org.apache.jackrabbit.core.security.user.AuthorizableImpl,0.00,16,1,20,0,16,4,1,15,355,0
"org.apache.jackrabbit.core.security.user.UserImpl$NodeBasedAdminPrincipal",2,0.00,1.00,5,0.03,346.89,2,0,13,4,2,142.14,0,8,0,2,142.14,0.00,0.50,0.00,0,2.00,1,102.43,0,1,2,org.apache.jackrabbit.core.security.principal.AdminPrincipal,0.00,2,1,2,0,2,1,1,0,32,1
"org.apache.jackrabbit.core.security.user.UserImplTest",6,0.16,1.33,47,0.60,12528.68,11,5,16,36,8,113.27,4,60,1,5,113.27,0.00,0.80,0.33,0,0.00,2,1796.94,5,0,7,org.apache.jackrabbit.api.security.user.AbstractUserTest,0.25,30,4,8,0,30,6,0,2,368,1
"org.apache.jackrabbit.core.security.user.UserManagerImpl",26,0.01,2.81,228,3.02,108839.92,31,5,34,88,26,90.68,139,305,8,2,108.55,0.00,0.50,0.21,8,162.00,8,9055.32,3,17,21,org.apache.jackrabbit.core.ProtectedItemModifier,0.00,62,1,73,0,62,9,3,43,1740,1
"org.apache.jackrabbit.core.security.user.UserManagerImpl$AuthorizableIterator",5,0.00,2.20,34,0.33,9627.99,8,3,34,16,2,155.81,13,46,0,1,115.93,0.00,0.00,0.33,0,5.00,6,977.10,0,2,2,java.lang.Object,0.00,11,0,11,0,11,3,1,7,208,2
"org.apache.jackrabbit.core.security.user.UserManagerImplTest",18,0.32,3.17,243,3.44,141841.37,20,2,19,68,13,148.50,26,324,1,5,98.50,0.00,0.80,0.19,1,0.00,7,10322.28,6,1,12,org.apache.jackrabbit.api.security.user.AbstractUserTest,0.10,50,4,57,0,50,17,0,24,1927,1
"org.apache.jackrabbit.spi.TestAll",1,0.00,1.00,3,0.02,158.91,1,0,3,2,1,185.87,1,5,0,2,135.87,0.00,0.50,0.00,0,1.00,1,52.05,0,1,1,junit.framework.TestCase,0.00,1,1,1,0,1,0,0,1,17,1
"org.apache.jackrabbit.jcr.AbstractItemStateFactory",5,0.25,1.40,27,0.25,5112.68,7,2,4,14,5,103.28,28,32,2,1,121.15,0.00,0.00,0.30,1,2.00,2,738.17,0,0,3,java.lang.Object,0.00,9,0,7,2,9,5,1,11,176,2
"org.apache.jackrabbit.jcr.ChangeLog",8,0.07,3.75,79,1.21,74549.99,12,4,13,30,12,55.74,69,107,5,1,103.84,0.00,0.00,0.31,0,6.00,16,3644.81,0,2,7,java.lang.Object,0.00,22,0,30,0,22,6,0,32,639,1
"org.apache.jackrabbit.jcr.ItemState",20,0.07,1.70,92,1.02,37216.71,26,6,15,46,40,74.57,166,134,32,1,122.67,0.00,0.00,0.10,4,118.00,7,3063.27,0,7,11,java.lang.Object,0.00,26,0,34,2,26,13,0,41,659,2
"org.apache.jackrabbit.jcr.ItemState$MergeResult",2,0.00,1.00,3,0.01,46.83,2,0,15,2,0,160.45,8,4,0,1,160.22,0.00,0.00,0.00,0,2.00,1,31.22,0,0,0,,0.00,0,0,2,0,0,2,0,2,14,1
"org.apache.jackrabbit.jcr.ItemState$SimpleMergeResult",3,1.00,1.00,7,0.04,426.32,4,1,15,3,0,192.82,4,11,0,1,142.82,0.00,0.00,0.33,0,4.00,1,115.44,0,0,0,java.lang.Object,0.00,0,0,3,0,0,3,1,2,37,1
"org.apache.jackrabbit.jcr.ItemStateCreationListener",1,0.00,1.00,2,0.01,60.50,1,0,0,1,5,103.45,7,3,4,2,145.74,0.00,0.50,0.00,0,1.00,1,35.16,0,0,1,,0.00,0,1,1,0,0,1,0,2,13,1
"org.apache.jackrabbit.jcr.ItemStateFactory",9,0.00,1.00,10,0.11,681.25,9,0,8,9,18,106.20,83,14,12,1,156.20,0.00,0.00,0.00,0,9.00,1,339.12,0,2,8,,0.00,0,0,9,0,0,7,0,10,100,1
"org.apache.jackrabbit.jcr.ItemStateLifeCycleListener",1,0.00,1.00,2,0.01,54.79,1,0,0,1,1,101.95,11,3,1,1,146.08,0.00,0.00,0.00,0,1.00,1,36.53,0,0,1,,0.00,0,0,1,0,0,1,0,2,13,1
"org.apache.jackrabbit.jcr.ItemStateValidator",16,0.06,3.12,140,2.28,84344.40,26,10,25,69,21,134.02,310,213,5,1,107.74,0.00,0.00,0.16,8,0.00,7,6838.84,0,1,16,java.lang.Object,0.00,53,0,50,0,53,15,0,69,1282,1
"org.apache.jackrabbit.jcr.NodeState",26,0.17,1.69,131,1.48,47610.32,30,4,19,61,70,71.01,211,181,58,2,119.11,0.00,0.50,0.09,8,186.00,6,4448.34,4,13,16,org.apache.jackrabbit.jcr2spi.state.ItemState,0.22,35,1,44,0,35,13,0,46,950,1
"org.apache.jackrabbit.jcr.PropertyState",15,0.04,2.47,106,1.22,48637.70,20,5,13,39,31,63.14,150,142,23,2,111.62,0.00,0.50,0.16,3,62.00,6,3666.11,4,5,10,org.apache.jackrabbit.jcr2spi.state.ItemState,0.29,24,1,37,0,24,10,0,34,758,1
"org.apache.jackrabbit.jcr.PropertyState$PropertyData",4,0.22,2.00,23,0.22,5541.24,7,3,13,8,2,170.03,5,28,0,1,120.03,0.00,0.00,0.17,2,6.00,4,659.68,0,0,2,java.lang.Object,0.00,4,0,8,0,4,4,0,5,154,1
"org.apache.jackrabbit.jcr.PropertyState$PropertyDiffer",3,0.00,1.67,15,0.13,2561.19,5,2,13,5,0,121.73,1,20,0,1,121.73,0.00,0.00,0.50,0,1.00,3,393.56,0,0,0,java.lang.Object,0.00,2,0,5,0,2,3,1,1,97,1
"org.apache.jackrabbit.jcr.SessionItemStateManager",23,0.08,2.13,223,3.67,133439.58,29,6,44,118,35,57.49,194,293,2,2,105.59,0.00,0.50,0.24,6,0.00,8,11015.38,0,4,33,org.apache.jackrabbit.jcr2spi.operation.TransientOperationVisitor,0.00,95,1,49,0,95,19,1,81,1978,1
"org.apache.jackrabbit.jcr.Status",7,0.21,3.00,67,0.80,41355.43,18,11,0,8,27,114.58,122,111,27,1,105.45,0.00,0.00,0.27,0,13.00,7,2413.21,0,1,0,java.lang.Object,0.00,1,0,21,0,1,6,0,33,495,2
"org.apache.jackrabbit.jcr.TransientISFactory",12,0.06,1.08,41,0.48,8562.13,15,3,15,26,18,130.95,53,60,1,2,130.71,0.00,0.50,0.28,0,24.00,2,1429.85,1,2,17,org.apache.jackrabbit.jcr2spi.state.AbstractItemStateFactory,0.00,14,1,13,0,14,10,2,21,338,2
"org.apache.jackrabbit.jcr.TransientItemStateFactory",2,0.00,1.00,3,0.04,248.10,2,0,7,2,13,110.39,22,9,5,2,154.51,0.00,0.50,0.00,0,2.00,1,117.56,0,0,8,,0.00,0,1,2,0,0,2,0,3,33,1
"org.apache.jackrabbit.jcr.TransientItemStateManager",13,0.21,3.54,151,1.95,107935.06,19,6,19,54,15,71.62,172,207,1,1,101.00,0.00,0.00,0.36,1,4.00,15,5850.45,0,2,14,java.lang.Object,0.00,41,0,46,0,41,11,1,60,1088,1
"org.apache.jackrabbit.jcr.UpdatableItemStateManager",3,0.00,1.00,4,0.02,134.12,3,0,2,3,5,125.78,19,5,3,1,158.00,0.00,0.00,0.00,0,3.00,1,73.06,0,0,2,,0.00,0,0,3,0,0,3,0,4,26,1
"org.apache.jackrabbit.jcr.WorkspaceItemStateFactory",18,0.03,2.94,189,2.65,103632.86,22,4,29,84,23,53.84,169,257,1,2,103.84,0.00,0.50,0.28,9,70.00,8,7955.58,2,4,22,org.apache.jackrabbit.jcr2spi.state.AbstractItemStateFactory,0.00,66,1,53,0,66,14,1,65,1464,1
"org.apache.jackrabbit.jcr.WorkspaceItemStateFactory$ItemInfos",6,0.07,2.17,37,0.34,8608.76,9,3,29,22,3,137.55,21,50,0,1,116.94,0.00,0.00,0.39,1,2.00,3,1022.03,0,2,3,java.lang.Object,0.00,16,0,13,0,16,4,1,7,237,1
"org.apache.jackrabbit.core.persistence.util.BLOBStore",4,0.00,1.00,5,0.04,175.53,4,0,2,4,9,109.59,43,6,8,1,158.07,0.00,0.00,0.00,0,4.00,1,125.02,0,2,1,,0.00,0,0,4,0,0,2,0,5,41,1
"org.apache.jackrabbit.core.persistence.util.FileSystemBLOBStore",6,0.60,1.67,42,0.48,19347.35,7,1,7,23,13,79.51,37,53,8,1,111.73,0.00,0.00,0.50,1,6.00,4,1448.74,0,3,5,java.lang.Object,0.00,17,0,10,2,17,3,1,16,296,1
"org.apache.jackrabbit.core.persistence.util.ResourceBasedBLOBStore",1,0.00,1.00,2,0.01,72.19,1,0,1,1,5,124.99,14,3,4,2,145.14,0.00,0.50,0.00,0,1.00,1,42.09,0,1,1,,0.00,0,1,1,0,0,0,0,2,15,1
"org.apache.jackrabbit.core.persistence.util.Serializer",6,0.20,4.00,159,2.36,139559.50,8,2,25,82,22,132.79,146,175,7,1,83.51,0.00,0.00,0.33,0,14.00,6,7075.07,0,0,15,java.lang.Object,0.00,76,0,24,0,76,6,0,78,1209,2
"org.apache.jackrabbit.webdav.security.AclProperty",6,1.00,1.50,25,0.36,9112.73,7,1,13,18,16,81.10,43,34,5,2,123.39,0.00,0.50,0.17,0,10.00,3,1068.99,0,2,12,org.apache.jackrabbit.webdav.property.AbstractDavProperty,0.00,12,1,9,0,12,4,0,6,230,1
"org.apache.jackrabbit.webdav.security.AclProperty$Ace",11,0.11,2.09,87,1.20,56651.20,23,12,13,31,9,149.96,23,109,0,1,110.08,0.00,0.00,0.18,0,56.00,6,3612.76,0,3,9,java.lang.Object,0.00,20,0,23,0,20,8,2,3,681,2
"org.apache.jackrabbit.webdav.security.AclResource",2,1.00,1.00,4,0.03,249.04,3,1,6,2,9,161.41,37,5,3,2,143.27,0.00,0.50,0.00,0,2.00,1,102.03,0,1,7,,0.00,0,1,2,0,0,1,0,4,31,1
"org.apache.jackrabbit.webdav.security.AclRestrictionsProperty",7,0.10,1.57,35,0.32,6334.71,14,7,5,12,5,142.16,25,47,0,2,121.54,0.00,0.50,0.22,0,16.00,5,948.16,1,2,5,org.apache.jackrabbit.webdav.property.AbstractDavProperty,0.00,5,1,11,0,5,5,0,6,221,1
"org.apache.jackrabbit.webdav.security.CurrentUserPrivilegeSetProperty",3,0.50,3.67,28,0.34,12290.41,4,1,10,12,9,64.37,21,36,3,2,106.66,0.00,0.50,0.67,0,1.00,7,1026.70,1,1,6,org.apache.jackrabbit.webdav.property.AbstractDavProperty,0.00,9,1,11,0,9,2,0,5,202,1
"org.apache.jackrabbit.webdav.security.Principal",13,0.08,2.31,92,1.13,38185.10,33,20,10,31,11,161.97,22,118,4,1,111.97,0.00,0.00,0.12,2,106.00,8,3395.28,0,10,7,java.lang.Object,0.00,18,0,30,0,18,3,2,7,668,1
"org.apache.jackrabbit.webdav.security.Privilege",6,0.01,1.67,44,0.67,23971.11,21,15,9,20,15,129.13,110,55,9,1,111.00,0.00,0.00,0.08,1,14.00,4,2024.78,0,5,6,java.lang.Object,0.00,14,0,10,0,14,1,1,20,399,1
"org.apache.jackrabbit.webdav.security.SecurityConstants",0,0.00,0.00,15,0.36,11418.95,14,14,6,2,21,171.00,65,16,15,1,171.00,0.00,0.00,0.00,0,0.00,0,1070.05,0,0,6,,0.00,2,0,0,0,2,0,0,17,196,1
"org.apache.jackrabbit.webdav.security.SupportedPrivilege",2,0.75,4.00,33,0.40,13848.28,10,8,5,9,7,53.23,14,41,2,1,95.52,0.00,0.00,0.50,0,2.00,6,1198.46,0,1,5,java.lang.Object,0.00,7,0,8,0,7,1,1,3,239,1
"org.apache.jackrabbit.webdav.security.SupportedPrivilegeSetProperty",2,1.00,1.50,7,0.07,1018.77,3,1,3,4,3,94.23,24,10,0,2,131.79,0.00,0.50,0.50,0,2.00,2,210.58,0,1,3,org.apache.jackrabbit.webdav.property.AbstractDavProperty,0.00,2,1,3,0,2,1,0,3,54,1
"org.apache.jackrabbit.jcr.CacheBehaviour",1,2.00,1.00,4,0.03,1028.34,3,2,0,2,12,158.21,20,6,12,1,124.82,0.00,0.00,0.00,0,1.00,1,104.79,0,0,0,java.lang.Object,0.00,1,0,1,0,1,1,0,3,31,2
"org.apache.jackrabbit.jcr.RepositoryConfig",4,0.00,1.00,5,0.02,103.55,4,0,2,4,15,180.49,12,6,13,1,159.87,0.00,0.00,0.00,0,4.00,1,62.48,0,2,2,,0.00,0,0,4,0,0,2,0,2,26,1
"org.apache.jackrabbit.webdav.search.QueryGrammerSet",5,0.25,1.60,31,0.36,13070.93,6,1,9,15,8,72.66,36,37,3,2,114.95,0.00,0.50,0.80,0,0.00,3,1082.80,1,3,5,org.apache.jackrabbit.webdav.property.AbstractDavProperty,0.00,10,1,8,0,10,2,1,6,232,1
"org.apache.jackrabbit.webdav.search.QueryGrammerSet$Grammer",3,0.17,1.67,16,0.12,1760.30,6,3,9,6,2,123.01,0,22,0,1,123.01,0.00,0.00,0.22,0,1.00,3,361.13,0,0,2,java.lang.Object,0.00,3,0,5,0,3,3,0,0,95,1
"org.apache.jackrabbit.webdav.search.SearchConstants",0,0.00,0.00,9,0.15,3100.00,8,8,3,2,7,171.00,51,10,4,1,171.00,0.00,0.00,0.00,0,0.00,0,440.00,0,0,3,,0.00,2,0,0,0,2,0,0,12,88,1
"org.apache.jackrabbit.webdav.search.SearchInfo",12,0.07,2.08,92,1.24,58049.92,25,13,17,39,14,62.19,100,115,7,1,110.29,0.00,0.00,0.14,0,64.00,10,3705.68,0,6,7,java.lang.Object,0.00,27,0,25,0,27,6,2,18,695,1
"org.apache.jackrabbit.webdav.search.SearchResource",2,1.00,1.00,4,0.03,161.65,3,1,2,2,10,107.19,25,5,6,1,144.75,0.00,0.00,0.00,0,2.00,1,75.01,0,2,4,,0.00,0,0,2,0,0,0,0,4,25,1
"org.apache.jackrabbit.core.security.simple.SimpleAccessManager",19,0.07,2.11,108,1.15,27131.67,28,9,21,37,17,140.53,73,149,2,2,119.91,0.00,0.50,0.18,5,96.00,5,3444.09,0,3,15,org.apache.jackrabbit.core.security.AbstractAccessControlManager,0.13,18,1,40,0,18,16,1,35,736,1
"org.apache.jackrabbit.core.security.simple.SimpleLoginModule",4,1.00,1.75,20,0.20,3944.75,5,1,13,8,2,89.00,26,28,0,2,121.22,0.00,0.50,0.25,0,8.00,2,585.92,2,2,2,org.apache.jackrabbit.core.security.authentication.AbstractLoginModule,0.00,4,1,7,0,4,2,0,7,135,1
"org.apache.jackrabbit.core.security.simple.SimpleLoginModule$Authentication",2,0.00,1.00,5,0.03,224.11,2,0,13,2,0,143.63,0,7,0,1,143.63,0.00,0.00,0.00,0,2.00,1,84.24,0,0,0,java.lang.Object,0.00,0,0,2,0,0,2,0,0,26,0
"org.apache.jackrabbit.core.security.simple.SimpleSecurityManager",9,0.12,3.11,103,1.27,59625.54,17,8,42,46,25,59.51,64,124,2,1,101.80,0.00,0.00,0.24,1,23.00,11,3811.20,0,5,24,java.lang.Object,0.00,37,0,28,0,37,4,1,29,693,1
"org.apache.jackrabbit.core.security.simple.SimpleSecurityManager$SimplePrincipalProvider",9,0.75,2.00,46,0.52,15172.91,10,1,42,24,8,119.36,3,67,0,1,119.36,0.00,0.00,0.33,2,18.00,4,1549.90,0,5,8,java.lang.Object,0.00,15,0,18,0,15,4,1,3,340,1
"org.apache.jackrabbit.server.util.HttpMultipartPost",12,0.07,2.58,116,1.25,41056.99,16,4,18,46,1,57.36,108,132,1,1,107.36,0.00,0.00,0.31,4,14.00,5,3744.65,0,7,0,java.lang.Object,0.00,34,0,31,0,34,5,0,15,757,0
"org.apache.jackrabbit.server.util.RequestData",7,0.11,1.43,24,0.28,6742.90,10,3,8,22,3,87.33,55,32,2,1,129.62,0.00,0.00,0.43,0,0.00,2,838.41,0,5,1,java.lang.Object,0.00,15,0,10,0,15,2,0,8,206,1
"org.apache.jackrabbit.core.AbstractConcurrencyTest",6,1.00,3.83,87,1.10,59789.42,7,1,8,30,11,46.45,57,89,10,4,96.45,3.00,0.23,0.17,3,14.00,10,3308.93,0,0,1,org.apache.jackrabbit.test.AbstractJCRTest,0.00,24,3,23,9,24,6,0,14,615,2
"org.apache.jackrabbit.core.AbstractConcurrencyTest$Executor",3,0.25,1.33,16,0.13,1816.98,7,4,8,5,0,122.95,0,23,0,1,122.95,0.00,0.00,0.42,0,1.00,2,380.67,0,1,0,java.lang.Object,0.00,2,0,4,0,2,2,1,0,96,2
"org.apache.jackrabbit.core.AbstractConcurrencyTest$Task",1,0.00,1.00,2,0.02,119.55,1,0,8,1,0,143.41,0,4,0,1,143.41,0.00,0.00,0.00,0,1.00,1,51.02,0,0,0,,0.00,0,0,1,0,0,1,0,0,16,1
"org.apache.jackrabbit.core.AbstractNodeData",9,0.88,1.22,24,0.15,1848.87,10,1,2,12,11,123.64,51,36,7,2,141.51,2.00,0.25,0.22,0,19.00,2,461.60,3,2,4,org.apache.jackrabbit.core.ItemData,0.19,3,1,11,2,3,7,0,11,134,2
"org.apache.jackrabbit.core.BatchedItemOperations",37,0.04,4.92,592,10.85,749081.72,43,6,48,188,39,131.11,785,968,3,2,91.81,0.00,0.50,0.21,17,0.00,33,32560.90,3,13,36,org.apache.jackrabbit.core.ItemValidator,0.00,151,1,182,0,151,24,0,222,5209,1
"org.apache.jackrabbit.core.CachingHierarchyManager",28,0.05,3.86,309,4.23,177700.80,37,9,22,102,20,53.79,235,433,4,2,101.90,1.00,0.33,0.16,12,102.00,9,12677.84,8,5,16,org.apache.jackrabbit.core.HierarchyManagerImpl,0.00,74,1,108,1,74,23,2,74,2359,1
"org.apache.jackrabbit.core.CachingHierarchyManager$LRUEntry",11,0.02,1.82,61,0.50,19463.44,15,4,22,13,2,101.34,61,78,0,1,119.21,0.00,0.00,0.23,2,60.00,5,1509.08,0,4,2,java.lang.Object,0.00,2,0,20,0,2,7,0,15,357,1
"org.apache.jackrabbit.core.CachingHierarchyManager$PathMap.ElementVisitor",1,0.00,2.00,6,0.07,1193.29,1,0,22,5,0,117.59,0,8,0,1,117.59,0.00,0.00,0.00,0,0.00,2,204.38,0,0,0,java.lang.Object,0.00,4,0,2,0,4,1,0,0,49,0
"org.apache.jackrabbit.core.CachingHierarchyManager$PathMap.ElementVisitor_0",1,0.00,3.00,17,0.19,7649.85,1,0,22,8,0,94.27,0,17,0,1,94.27,0.00,0.00,0.00,0,1.00,3,578.13,0,0,0,java.lang.Object,0.00,7,0,3,0,7,1,0,0,114,0
"org.apache.jackrabbit.core.CachingHierarchyManager$PathMapElementCounter",1,0.00,5.00,21,0.29,16021.79,2,1,22,5,0,88.20,0,30,0,1,88.20,0.00,0.00,1.00,0,0.00,5,878.61,0,0,0,java.lang.Object,0.00,4,0,5,0,4,1,1,0,163,0
"org.apache.jackrabbit.core.CachingHierarchyManagerTest",15,0.05,1.33,186,2.74,79157.38,18,3,19,54,20,101.60,69,203,1,2,101.37,0.00,0.50,0.29,3,0.00,4,8210.06,0,2,19,junit.framework.TestCase,0.00,39,1,20,0,39,13,0,21,1579,1
"org.apache.jackrabbit.core.CachingHierarchyManagerTest$Runnable",1,0.00,3.00,7,0.05,939.05,1,0,19,1,0,115.81,0,11,0,1,115.81,0.00,0.00,0.00,0,0.00,3,150.62,0,0,0,java.lang.Object,0.00,0,0,3,0,0,1,0,0,37,0
"org.apache.jackrabbit.core.CachingHierarchyManagerTest$StaticItemStateManager",16,0.03,2.00,96,1.25,45407.88,21,5,19,55,15,96.75,91,132,0,1,114.62,0.00,0.00,0.18,2,76.00,6,3749.02,0,7,15,java.lang.Object,0.00,39,0,32,0,39,9,1,22,784,1
"org.apache.jackrabbit.core.ConcurrencyTest",3,0.00,2.67,40,0.44,22647.86,7,4,7,14,2,138.57,8,42,1,4,98.68,0.00,0.75,0.25,0,4.00,6,1310.14,2,0,1,org.apache.jackrabbit.test.AbstractJCRTest,0.31,11,3,8,0,11,3,0,6,246,1
"org.apache.jackrabbit.core.ConcurrencyTest$TestSession",3,0.33,3.00,51,0.57,25876.47,6,3,7,17,0,143.86,3,62,0,1,93.86,0.00,0.00,0.56,1,0.00,6,1711.16,0,0,0,java.lang.Object,0.00,14,0,9,0,14,3,1,3,304,0
"org.apache.jackrabbit.core.ConcurrentAddRemoveMoveTest",11,0.00,1.91,86,1.00,18333.42,11,0,2,23,2,113.96,5,118,1,5,113.96,0.00,0.80,0.00,0,0.00,2,3008.80,1,0,1,org.apache.jackrabbit.core.ConcurrentModificationBase,0.14,12,4,21,0,12,11,0,3,626,2
"org.apache.jackrabbit.core.ConcurrentAddRemovePropertyTest",4,0.00,2.00,41,0.50,10095.69,4,0,2,16,2,156.75,4,54,1,5,106.75,0.00,0.80,0.00,0,0.00,2,1501.16,0,0,1,org.apache.jackrabbit.core.ConcurrentModificationBase,0.00,12,4,8,0,12,4,0,1,303,1
"org.apache.jackrabbit.core.ConcurrentCheckinMixedTransactionTest",1,0.00,1.00,8,0.09,1521.10,3,2,10,3,4,94.38,5,10,2,5,112.25,0.00,0.80,1.00,0,0.00,1,255.81,1,0,2,org.apache.jackrabbit.core.AbstractConcurrencyTest,0.00,2,4,1,0,2,1,0,2,58,1
"org.apache.jackrabbit.core.ConcurrentCheckinMixedTransactionTest$Task",1,0.00,12.00,31,0.42,29895.48,1,0,10,11,2,129.55,1,46,0,1,79.55,0.00,0.00,0.00,0,1.00,12,1253.15,0,0,2,java.lang.Object,0.00,10,0,12,0,10,1,0,1,210,0
"org.apache.jackrabbit.core.ConcurrentLoginTest",1,2.00,6.00,25,0.27,11976.42,3,2,7,11,2,75.97,15,24,1,4,86.33,0.00,0.75,0.00,0,1.00,6,811.19,0,0,1,org.apache.jackrabbit.test.AbstractJCRTest,0.00,10,3,6,0,10,1,0,6,155,1
"org.apache.jackrabbit.core.ConcurrentLoginTest$Runnable",1,0.00,3.00,12,0.10,2650.80,1,0,7,5,0,153.53,1,13,0,1,103.53,0.00,0.00,0.00,0,1.00,3,300.30,0,0,0,java.lang.Object,0.00,4,0,3,0,4,1,0,1,63,0
"org.apache.jackrabbit.core.ConcurrentMixinModificationTest",1,0.00,2.00,10,0.11,1928.55,1,0,2,8,2,89.80,5,14,1,5,107.67,0.00,0.80,0.00,0,0.00,2,316.70,0,0,1,org.apache.jackrabbit.core.ConcurrentModificationBase,0.00,7,4,2,0,7,1,0,2,68,1
"org.apache.jackrabbit.core.ConcurrentModificationBase",2,0.00,1.50,10,0.07,1198.37,3,1,2,4,7,162.85,4,14,6,4,122.96,2.00,0.30,1.00,0,0.00,2,221.85,2,0,1,org.apache.jackrabbit.test.AbstractJCRTest,0.32,2,3,3,6,2,2,0,1,58,2
"org.apache.jackrabbit.core.ConcurrentModificationWithSNSTest",6,0.00,1.83,45,0.45,7405.00,6,0,2,15,2,114.99,5,62,1,5,114.99,0.00,0.80,0.00,0,0.00,2,1347.40,2,0,1,org.apache.jackrabbit.core.ConcurrentModificationBase,0.16,9,4,11,0,9,6,0,2,297,1
"org.apache.jackrabbit.core.ConcurrentMoveTest",2,1.33,1.50,17,0.17,2803.42,5,3,1,7,2,152.33,4,22,1,5,112.44,0.00,0.80,1.00,0,0.00,2,510.17,1,0,1,org.apache.jackrabbit.core.ConcurrentModificationBase,0.19,5,4,3,0,5,2,0,2,117,1
"org.apache.jackrabbit.core.ConcurrentNodeModificationTest",1,1.00,6.00,36,0.43,23262.01,5,4,7,13,2,40.59,12,34,1,4,78.15,0.00,0.75,0.75,0,0.00,6,1287.41,0,0,1,org.apache.jackrabbit.test.AbstractJCRTest,0.00,12,3,6,0,12,1,0,5,228,1
"org.apache.jackrabbit.core.ConcurrentNodeModificationTest$TestSession",3,0.33,3.00,53,0.60,27587.11,6,3,7,17,0,93.64,2,60,0,1,93.64,0.00,0.00,0.56,1,0.00,6,1791.46,0,0,0,java.lang.Object,0.00,14,0,9,0,14,3,1,2,318,0
"org.apache.jackrabbit.core.ConcurrentReadWriteTest",1,3.00,5.00,33,0.48,22274.13,4,3,10,24,2,79.98,4,36,1,5,79.75,0.00,0.80,0.00,0,0.00,5,1452.68,0,0,1,org.apache.jackrabbit.core.AbstractConcurrencyTest,0.00,23,4,5,0,23,1,0,1,248,1
"org.apache.jackrabbit.core.ConcurrentReadWriteTest$Runnable",1,0.00,2.00,6,0.03,369.78,1,0,10,4,0,121.59,0,8,0,1,121.59,0.00,0.00,0.00,0,0.00,2,100.00,0,0,0,java.lang.Object,0.00,3,0,2,0,3,1,0,0,27,0
"org.apache.jackrabbit.core.ConcurrentReadWriteTest$Runnable$Task",1,0.00,5.00,21,0.27,13084.40,1,0,10,12,0,138.89,1,26,0,1,88.89,0.00,0.00,0.00,0,1.00,5,817.24,0,0,0,java.lang.Object,0.00,11,0,5,0,11,1,0,1,141,0
"org.apache.jackrabbit.core.ConcurrentReorderTest",3,0.00,1.67,21,0.19,2535.46,3,0,1,10,2,156.20,6,29,1,5,116.31,0.00,0.80,0.00,0,0.00,2,581.61,1,0,1,org.apache.jackrabbit.core.ConcurrentModificationBase,0.18,7,4,5,0,7,3,0,3,131,1
"org.apache.jackrabbit.core.ConcurrentSaveTest",3,0.12,2.00,29,0.27,7121.22,7,4,8,14,2,129.28,9,38,1,4,108.66,0.00,0.75,0.33,0,2.00,3,798.89,2,0,1,org.apache.jackrabbit.test.AbstractJCRTest,0.31,11,3,6,0,11,3,0,3,178,1
"org.apache.jackrabbit.core.ConcurrentSaveTest$Thread",1,0.00,3.00,15,0.16,3935.02,1,0,8,7,0,148.57,1,16,0,1,98.57,0.00,0.00,0.00,0,0.00,3,465.69,0,0,0,java.lang.Object,0.00,6,0,3,0,6,1,0,1,90,0
"org.apache.jackrabbit.core.ConcurrentSaveTest$Thread_0",1,0.00,4.00,16,0.19,6143.03,1,0,8,7,0,135.82,2,18,0,1,95.93,0.00,0.00,0.00,0,0.00,4,573.66,0,0,0,java.lang.Object,0.00,6,0,4,0,6,1,0,2,107,0
"org.apache.jackrabbit.core.ConcurrentVersioningTest",4,0.00,1.00,15,0.08,859.13,6,2,7,5,2,174.72,11,16,1,5,134.84,0.00,0.80,0.50,0,0.00,1,242.16,1,0,1,org.apache.jackrabbit.core.AbstractConcurrencyTest,0.00,1,4,4,0,1,4,0,3,68,1
"org.apache.jackrabbit.core.ConcurrentVersioningTest$Task",1,0.00,2.00,9,0.08,2015.65,1,0,7,4,0,159.22,1,8,0,1,109.22,0.00,0.00,0.00,0,1.00,2,248.44,0,0,0,java.lang.Object,0.00,3,0,2,0,3,1,0,1,53,0
"org.apache.jackrabbit.core.ConcurrentVersioningTest$Task_0",1,0.00,2.00,12,0.11,2546.07,1,0,7,6,0,103.76,0,11,0,1,103.76,0.00,0.00,0.00,0,1.00,2,315.16,0,0,0,java.lang.Object,0.00,5,0,2,0,5,1,0,0,66,0
"org.apache.jackrabbit.core.ConcurrentVersioningTest$Task_1",1,0.00,2.00,12,0.11,2988.00,1,0,7,6,0,153.22,1,11,0,1,103.22,0.00,0.00,0.00,0,1.00,2,328.00,0,0,0,java.lang.Object,0.00,5,0,2,0,5,1,0,1,68,0
"org.apache.jackrabbit.core.ConcurrentVersioningTest$Task_2",1,0.00,3.00,20,0.22,6623.70,1,0,7,13,0,132.01,2,17,0,1,92.13,0.00,0.00,0.00,0,1.00,3,665.30,0,0,0,java.lang.Object,0.00,12,0,3,0,12,1,0,2,123,0
"org.apache.jackrabbit.core.ConcurrentVersioningWithTransactionsTest",6,0.20,1.50,30,0.25,7334.10,8,2,10,16,4,160.41,17,43,1,5,120.52,0.00,0.80,0.33,0,0.00,3,755.87,1,2,3,org.apache.jackrabbit.core.AbstractConcurrencyTest,0.00,10,4,9,0,10,4,0,5,176,1
"org.apache.jackrabbit.core.ConcurrentVersioningWithTransactionsTest$Task",1,0.00,5.00,20,0.30,15726.18,1,0,10,14,1,109.67,3,24,0,1,89.05,0.00,0.00,0.00,0,1.00,5,911.36,0,0,1,java.lang.Object,0.00,13,0,5,0,13,1,0,3,154,0
"org.apache.jackrabbit.core.ConcurrentVersioningWithTransactionsTest$Task_0",1,0.00,4.00,22,0.30,15439.21,1,0,10,15,1,137.62,1,25,0,1,87.62,0.00,0.00,0.00,0,1.00,4,892.64,0,0,1,java.lang.Object,0.00,14,0,4,0,14,1,0,1,152,0
"org.apache.jackrabbit.core.ConcurrentVersioningWithTransactionsTest$Task_1",1,0.00,4.00,21,0.29,14996.60,1,0,10,15,1,128.36,2,24,0,1,88.47,0.00,0.00,0.00,0,1.00,4,880.68,0,0,1,java.lang.Object,0.00,14,0,4,0,14,1,0,2,150,0
"org.apache.jackrabbit.core.ConcurrentVersioningWithTransactionsTest$Task_2",1,0.00,5.00,27,0.38,20615.41,1,0,10,18,0,103.88,3,28,0,1,83.26,0.00,0.00,0.00,0,1.00,5,1127.25,0,0,0,java.lang.Object,0.00,17,0,5,0,17,1,0,3,186,0
"org.apache.jackrabbit.core.DefaultSecurityManager",11,0.18,4.36,184,2.53,124523.64,24,13,46,87,33,64.44,143,233,1,1,93.82,0.00,0.00,0.24,3,38.00,13,7597.14,0,6,32,java.lang.Object,0.00,76,0,48,0,76,5,1,52,1327,1
"org.apache.jackrabbit.core.DefaultSecurityManager$WorkspaceAccessManagerImpl",3,0.00,1.00,6,0.06,676.31,3,0,46,5,3,141.48,13,10,0,1,141.24,0.00,0.00,0.00,0,3.00,1,174.03,0,0,3,java.lang.Object,0.00,2,0,3,0,2,3,2,6,48,1
"org.apache.jackrabbit.core.HierarchyManager",11,0.00,1.00,12,0.12,547.91,11,0,4,11,29,128.25,151,18,24,1,157.63,0.00,0.00,0.00,0,11.00,1,354.83,0,5,5,,0.00,0,0,11,0,0,6,0,13,111,1
"org.apache.jackrabbit.core.HierarchyManagerImpl",23,0.01,3.52,269,3.52,189841.72,30,7,20,69,23,58.73,176,383,6,1,101.02,0.00,0.00,0.16,8,128.00,10,10561.41,0,11,17,java.lang.Object,0.00,46,0,81,3,46,12,1,47,1962,1
"org.apache.jackrabbit.core.InternalXAResource",6,0.00,1.00,7,0.04,169.53,6,0,0,6,5,127.35,37,8,4,1,159.57,0.00,0.00,0.00,0,6.00,1,128.53,0,0,2,,0.00,0,0,6,0,0,6,0,7,47,1
"org.apache.jackrabbit.core.InvalidDateTest",1,0.00,4.00,16,0.21,5443.88,1,0,6,9,2,64.12,6,25,1,4,96.35,0.00,0.75,0.00,0,0.00,4,636.99,0,0,1,org.apache.jackrabbit.test.AbstractJCRTest,0.00,8,3,4,0,8,1,0,4,122,1
"org.apache.jackrabbit.core.ItemData",12,0.18,1.00,33,0.22,2635.83,16,4,2,15,7,123.46,68,46,4,1,141.33,0.00,0.00,0.08,2,52.00,1,660.24,0,3,4,java.lang.Object,0.00,3,0,12,4,3,9,0,17,186,2
"org.apache.jackrabbit.core.ItemId",1,1.00,1.00,3,0.03,343.57,2,1,1,1,64,113.09,14,4,64,1,133.23,0.00,0.00,0.00,0,1.00,1,78.02,0,0,0,java.lang.Object,0.00,0,0,1,2,0,1,1,3,22,2
"org.apache.jackrabbit.core.ItemImpl",37,0.04,4.16,505,8.29,742458.04,48,11,53,185,44,51.11,435,737,15,1,95.24,0.00,0.00,0.13,19,277.00,34,24861.41,0,15,34,java.lang.Object,0.00,148,0,154,4,148,22,1,193,4003,2
"org.apache.jackrabbit.core.ItemLifeCycleListener",3,0.00,1.00,4,0.02,78.51,3,0,0,3,2,115.71,33,5,0,1,159.84,0.00,0.00,0.00,0,3.00,1,73.51,0,0,2,,0.00,0,0,3,0,0,3,0,4,27,1
"org.apache.jackrabbit.core.ItemManager",43,0.05,2.56,348,4.61,145841.72,51,8,37,150,52,59.30,415,503,25,1,109.30,0.00,0.00,0.17,16,413.00,5,13827.89,0,22,34,java.lang.Object,0.00,107,0,110,0,107,21,2,109,2729,1
"org.apache.jackrabbit.core.ItemManager$ShareableNodesCache",7,0.00,2.00,37,0.41,11888.28,8,1,37,19,2,101.46,40,54,0,1,119.33,0.00,0.00,1.00,0,0.00,4,1242.75,0,2,2,java.lang.Object,0.00,12,0,14,0,12,5,0,8,277,0
"org.apache.jackrabbit.core.ItemValidator",19,0.04,3.79,196,2.82,125503.84,35,16,28,71,24,53.31,185,289,7,1,103.31,0.00,0.00,0.10,8,138.00,18,8457.25,0,6,20,java.lang.Object,0.00,52,0,72,1,52,13,0,35,1588,1
"org.apache.jackrabbit.core.JackrabbitRepositoryStub",15,0.13,2.20,163,2.32,74871.71,20,5,29,66,12,104.63,63,242,3,2,104.39,2.00,0.25,0.08,10,59.00,5,6949.19,0,7,9,org.apache.jackrabbit.test.RepositoryStub,0.08,51,1,33,2,51,8,0,20,1313,1
"org.apache.jackrabbit.core.JackrabbitRepositoryStub$Principal",1,0.00,1.00,3,0.01,72.00,1,0,29,1,0,138.58,0,4,0,1,138.58,0.00,0.00,0.00,0,1.00,1,32.00,0,1,0,java.lang.Object,0.00,0,0,1,0,0,0,0,0,12,0
"org.apache.jackrabbit.core.LazyItemIterator",11,0.08,2.36,70,0.73,29813.67,17,6,13,23,5,66.64,93,96,3,1,114.74,0.00,0.00,0.24,2,14.00,8,2194.78,0,3,3,java.lang.Object,0.00,12,0,26,0,12,8,2,37,455,1
"org.apache.jackrabbit.core.LockTest",3,3.00,5.00,72,0.74,24317.84,6,3,10,15,3,56.14,19,64,1,4,88.36,0.00,0.75,0.00,0,0.00,5,2209.51,0,0,2,org.apache.jackrabbit.test.AbstractJCRTest,0.00,12,3,15,0,12,3,0,4,410,1
"org.apache.jackrabbit.core.LockTest$Thread",1,1.00,5.00,18,0.22,6869.31,2,1,10,14,1,143.59,1,23,0,1,93.59,0.00,0.00,0.00,0,1.00,5,672.07,0,0,1,java.lang.Object,0.00,13,0,5,0,13,1,0,1,126,0
"org.apache.jackrabbit.core.LockTest$Thread$Locked",1,0.00,2.00,10,0.10,2274.72,1,0,10,7,0,107.10,0,12,0,1,107.10,0.00,0.00,0.00,0,0.00,2,297.51,0,1,0,java.lang.Object,0.00,6,0,2,0,6,0,0,0,63,0
"org.apache.jackrabbit.core.LockTest$Thread_0",1,0.00,5.00,20,0.27,8402.82,2,1,10,13,1,141.19,1,24,0,1,91.19,0.00,0.00,1.00,0,0.00,5,815.15,0,0,1,java.lang.Object,0.00,12,0,5,0,12,1,0,1,147,0
"org.apache.jackrabbit.core.LockTest$Thread_0$Locked_1",1,0.00,1.00,7,0.07,1442.31,1,0,10,6,0,114.60,0,8,0,1,114.60,0.00,0.00,0.00,0,1.00,1,212.33,0,1,0,java.lang.Object,0.00,5,0,1,0,5,0,0,0,48,0
"org.apache.jackrabbit.core.LockTest$Thread_2",1,0.00,6.00,24,0.34,13953.02,2,1,10,14,1,126.35,2,29,0,1,86.46,0.00,0.00,1.00,0,0.00,6,1019.09,0,0,1,java.lang.Object,0.00,13,0,6,0,13,1,0,2,175,0
"org.apache.jackrabbit.core.LockTest$Thread_2$Locked_3",1,0.00,1.00,7,0.07,1442.31,1,0,10,6,0,114.60,0,8,0,1,114.60,0.00,0.00,0.00,0,1.00,1,212.33,0,1,0,java.lang.Object,0.00,5,0,1,0,5,0,0,0,48,0
"org.apache.jackrabbit.core.MoveTest",2,0.00,2.50,32,0.38,16468.56,2,0,5,19,1,77.17,10,36,0,4,95.04,0.00,0.75,0.00,1,2.00,4,1145.38,0,0,1,org.apache.jackrabbit.test.AbstractJCRTest,0.00,17,3,5,0,17,2,0,6,212,1
"org.apache.jackrabbit.core.NamespaceRegistryImpl",16,0.10,2.94,187,2.51,121371.94,28,12,19,55,12,59.06,118,264,5,1,101.35,0.00,0.00,0.18,4,26.00,11,7518.93,0,5,7,java.lang.Object,0.00,39,0,47,0,39,11,3,53,1432,1
"org.apache.jackrabbit.core.NodeData",1,0.00,1.00,3,0.02,96.98,1,0,2,1,3,93.43,11,5,1,3,137.56,0.00,0.67,0.00,0,1.00,1,51.97,0,0,2,org.apache.jackrabbit.core.AbstractNodeData,0.00,0,2,1,0,0,1,0,2,18,0
"org.apache.jackrabbit.core.NodeDataRef",5,0.25,1.00,14,0.10,1143.97,6,1,2,10,4,108.97,31,20,1,3,141.19,0.00,0.67,0.80,0,0.00,1,288.65,1,2,3,org.apache.jackrabbit.core.AbstractNodeData,0.23,5,2,5,0,5,3,0,7,84,0
"org.apache.jackrabbit.core.NodeId",7,0.17,1.57,27,0.21,4279.21,10,3,1,13,161,88.87,50,39,159,2,131.16,0.00,0.50,0.19,0,15.00,3,637.33,0,3,2,org.apache.jackrabbit.core.ItemId,0.25,6,1,11,0,6,4,0,12,162,1
"org.apache.jackrabbit.core.NodeIdIterator",1,0.00,1.00,2,0.01,59.45,1,0,2,1,10,97.32,10,3,9,2,145.80,0.00,0.50,0.00,0,1.00,1,33.60,0,0,1,,0.00,0,1,1,0,0,1,0,2,13,1
"org.apache.jackrabbit.core.NodeImpl",150,0.14,3.83,2030,32.52,2063238.93,153,3,93,559,111,48.07,1576,2965,63,2,96.55,2.00,0.25,0.20,55,4410.00,41,97562.77,12,78,54,org.apache.jackrabbit.core.ItemImpl,0.09,409,1,575,2,409,72,1,716,16258,1
"org.apache.jackrabbit.core.NodeImplTest",4,1.00,3.25,62,0.78,34662.47,5,1,15,30,6,135.73,10,73,1,4,95.85,0.00,0.75,0.00,2,2.00,7,2338.02,1,1,5,org.apache.jackrabbit.test.AbstractJCRTest,0.15,26,3,13,0,26,3,0,4,431,1
"org.apache.jackrabbit.core.PropertyData",3,0.00,1.00,7,0.04,332.27,3,0,2,3,4,111.45,19,11,2,2,143.67,0.00,0.50,0.00,0,3.00,1,122.13,2,2,2,org.apache.jackrabbit.core.ItemData,0.00,0,1,3,0,0,1,0,4,41,1
"org.apache.jackrabbit.core.PropertyId",8,0.04,1.75,42,0.43,14364.07,12,4,2,19,64,76.88,59,58,60,2,119.17,0.00,0.50,0.22,0,18.00,3,1288.02,0,3,4,org.apache.jackrabbit.core.ItemId,0.22,11,1,14,0,11,5,0,14,285,1
"org.apache.jackrabbit.core.PropertyImpl",49,0.35,2.22,354,4.53,186520.17,51,2,32,126,30,111.33,198,491,14,2,111.10,0.00,0.50,0.15,10,385.00,12,13577.99,4,18,19,org.apache.jackrabbit.core.ItemImpl,0.16,77,1,109,0,77,31,1,84,2658,1
"org.apache.jackrabbit.core.ProtectedItemModifier",11,0.45,2.27,75,1.05,29584.31,13,2,17,42,17,164.78,17,99,3,1,114.78,0.00,0.00,0.09,2,29.00,5,3138.33,0,4,17,java.lang.Object,0.00,31,0,25,4,31,7,0,10,636,2
"org.apache.jackrabbit.core.ReadVersionsWhileModified",1,1.00,3.00,14,0.18,4453.72,2,1,5,11,2,51.16,8,18,1,5,99.26,0.00,0.80,0.00,0,0.00,3,546.73,0,0,1,org.apache.jackrabbit.core.AbstractConcurrencyTest,0.00,10,4,3,0,10,1,0,2,107,1
"org.apache.jackrabbit.core.ReadVersionsWhileModified$Runnable",1,0.00,3.00,10,0.12,3179.38,1,0,5,8,0,105.87,0,15,0,1,105.87,0.00,0.00,0.00,0,0.00,3,356.06,0,0,0,java.lang.Object,0.00,7,0,3,0,7,1,0,0,73,0
"org.apache.jackrabbit.core.ReadWhileSaveTest",2,0.00,3.00,34,0.40,11902.45,2,0,14,20,1,115.74,6,38,0,4,95.12,0.00,0.75,0.00,1,0.00,4,1196.65,0,1,1,org.apache.jackrabbit.test.AbstractJCRTest,0.00,18,3,6,0,18,1,0,3,217,1
"org.apache.jackrabbit.core.ReadWhileSaveTest$Runnable",1,0.00,4.00,15,0.15,4391.71,1,0,14,10,0,98.13,0,18,0,1,98.13,0.00,0.00,0.00,0,1.00,4,443.99,0,0,0,java.lang.Object,0.00,9,0,4,0,9,1,0,0,89,0
"org.apache.jackrabbit.core.ReferencesTest",12,0.41,1.33,94,1.32,35304.19,14,2,6,30,2,112.33,49,115,1,4,112.10,0.00,0.75,0.12,5,38.00,3,3972.04,0,2,1,org.apache.jackrabbit.test.AbstractJCRTest,0.11,18,3,16,0,18,10,0,11,829,2
"org.apache.jackrabbit.core.RepositoryCopier",7,0.11,2.43,61,0.94,36814.30,10,3,18,40,10,65.52,49,101,1,1,107.81,0.00,0.00,0.43,4,0.00,5,2809.53,0,0,9,java.lang.Object,0.00,33,0,17,0,33,7,0,11,540,1
"org.apache.jackrabbit.core.RepositoryFactoryImpl",2,0.67,3.00,25,0.29,11337.49,5,3,6,7,3,63.37,25,37,1,1,100.93,0.00,0.00,0.67,0,0.00,3,865.45,0,2,2,java.lang.Object,0.00,5,0,6,0,5,0,1,6,183,1
"org.apache.jackrabbit.core.RepositoryImpl",58,0.02,2.31,486,6.41,264893.94,91,33,90,221,88,58.30,572,728,36,2,108.30,0.00,0.50,0.05,21,1494.00,18,19237.23,0,37,58,org.apache.jackrabbit.commons.AbstractRepository,0.00,163,1,134,0,163,21,5,160,3492,1
"org.apache.jackrabbit.core.RepositoryImpl$ExternalEventListener",6,0.00,1.00,13,0.10,1012.30,6,0,90,15,5,162.85,20,20,0,1,142.23,0.00,0.00,0.00,0,6.00,1,288.77,0,4,5,java.lang.Object,0.00,9,0,6,0,9,2,1,8,86,0
"org.apache.jackrabbit.core.RepositoryImpl$WorkspaceInfo",23,0.08,2.78,207,2.37,73391.50,38,15,90,73,22,59.10,237,337,0,1,107.58,0.00,0.00,0.15,9,224.00,10,7121.49,0,10,22,java.lang.Object,0.00,50,0,64,0,50,13,1,72,1388,1
"org.apache.jackrabbit.core.RepositoryImpl$WorkspaceJanitor",2,0.50,3.50,30,0.31,11196.70,4,2,90,9,2,96.85,33,39,0,1,97.33,0.00,0.00,0.75,0,0.00,6,932.49,0,0,2,java.lang.Object,0.00,7,0,7,0,7,2,1,11,177,1
"org.apache.jackrabbit.core.RestoreAndCheckoutTest",1,1.00,3.00,33,0.35,15405.41,2,1,4,11,2,33.02,8,31,1,4,81.13,0.00,0.75,0.00,0,0.00,3,1038.51,0,0,1,org.apache.jackrabbit.test.AbstractJCRTest,0.00,10,3,3,0,10,1,0,4,197,1
"org.apache.jackrabbit.core.RetentionRegistryImplTest",13,0.15,1.85,194,3.02,130588.83,19,6,21,52,13,146.59,18,234,1,6,96.59,0.00,0.83,0.31,1,0.00,5,9049.33,3,1,12,org.apache.jackrabbit.core.retention.AbstractRetentionTest,0.29,39,5,24,0,39,12,0,16,1699,1
"org.apache.jackrabbit.core.SearchManager",12,0.10,3.83,149,2.09,111551.13,30,18,37,63,30,88.83,184,220,6,1,99.19,0.00,0.00,0.14,4,0.00,17,6262.68,0,4,24,java.lang.Object,0.00,51,0,46,0,51,8,1,56,1121,1
"org.apache.jackrabbit.core.SearchManager$NodeIdIterator",4,0.67,1.00,10,0.07,749.95,5,1,37,8,1,141.87,0,14,0,1,141.87,0.00,0.00,0.50,1,4.00,1,202.85,0,1,1,java.lang.Object,0.00,4,0,4,0,4,3,0,0,60,0
"org.apache.jackrabbit.core.SearchManager$NodeStateIterator",4,0.67,1.50,19,0.20,5648.54,5,1,37,11,4,123.64,2,26,0,1,123.64,0.00,0.00,0.50,1,4.00,3,600.79,0,2,4,java.lang.Object,0.00,7,0,6,0,7,2,0,2,131,0
"org.apache.jackrabbit.core.SessionGarbageCollectedTest",1,0.00,7.00,27,0.36,21836.57,1,0,8,13,2,65.12,5,30,1,4,82.99,0.00,0.75,0.00,0,0.00,7,1077.10,0,0,1,org.apache.jackrabbit.test.AbstractJCRTest,0.00,12,3,7,0,12,1,0,3,188,1
"org.apache.jackrabbit.core.SessionImpl",79,0.01,2.23,540,7.07,323986.25,101,22,86,238,149,81.12,519,796,114,2,113.34,2.00,0.25,0.05,18,3570.00,19,21198.74,3,45,47,org.apache.jackrabbit.commons.AbstractSession,0.02,159,1,176,2,159,34,5,191,4003,1
"org.apache.jackrabbit.core.SessionListener",2,0.00,1.00,3,0.01,46.02,2,0,0,2,7,110.28,19,4,6,1,160.28,0.00,0.00,0.00,0,2.00,1,41.02,0,0,1,,0.00,0,0,2,0,0,2,0,3,17,1
"org.apache.jackrabbit.core.ShareableNodeTest",1,0.00,1.00,41,0.73,35417.64,1,0,7,21,3,74.54,16,49,1,4,75.02,0.00,0.75,0.00,0,0.00,1,2183.34,0,0,2,org.apache.jackrabbit.test.AbstractJCRTest,0.00,20,3,1,0,20,1,0,12,373,1
"org.apache.jackrabbit.core.ShareableNodeTest$EventCounter",3,0.00,1.33,10,0.06,587.50,4,1,7,4,1,135.09,0,15,0,1,135.09,0.00,0.00,1.00,0,0.00,2,167.99,0,0,1,java.lang.Object,0.00,1,0,4,0,1,3,1,0,49,0
"org.apache.jackrabbit.core.SystemSession",4,0.00,1.00,13,0.17,3235.27,4,0,19,11,17,81.83,41,25,6,3,130.30,0.00,0.67,0.00,0,4.00,1,510.54,0,3,13,org.apache.jackrabbit.core.SessionImpl,0.00,7,2,4,0,7,1,0,9,120,0
"org.apache.jackrabbit.core.SystemSession$SystemAccessManager",18,0.94,1.11,37,0.38,5192.73,19,1,19,25,10,140.61,82,66,0,2,140.37,0.00,0.50,0.11,1,46.00,3,1154.04,0,3,10,org.apache.jackrabbit.core.security.AbstractAccessControlManager,0.13,7,1,20,0,7,15,1,31,295,1
"org.apache.jackrabbit.core.TestAll",1,0.00,1.00,20,0.24,9438.09,1,0,3,3,16,43.06,8,22,0,2,91.17,0.00,0.50,0.00,0,1.00,1,733.87,0,1,16,junit.framework.TestCase,0.00,2,1,1,0,2,0,0,3,151,1
"org.apache.jackrabbit.core.TestHelper",1,0.00,1.00,3,0.03,371.33,1,0,1,3,2,88.84,11,6,1,1,132.97,0.00,0.00,0.00,0,1.00,1,92.00,0,0,1,java.lang.Object,0.00,2,0,1,0,2,1,0,2,25,1
"org.apache.jackrabbit.core.TestRepository",4,0.08,2.00,26,0.34,9710.69,8,4,11,16,9,104.80,61,43,4,1,115.16,0.00,0.00,0.31,0,4.00,5,1012.74,0,2,5,java.lang.Object,0.00,12,0,8,0,12,2,0,11,208,1
"org.apache.jackrabbit.core.TestRepository$",2,0.00,1.00,5,0.04,502.06,2,0,11,3,0,140.87,0,7,0,1,140.87,0.00,0.00,0.00,0,2.00,1,114.91,0,2,0,java.lang.Object,0.00,1,0,2,0,1,0,0,0,32,0
"org.apache.jackrabbit.core.TestRepository$RepositoryFactory",1,0.00,1.00,3,0.01,111.66,1,0,11,1,0,137.08,0,4,0,1,137.08,0.00,0.00,0.00,0,1.00,1,41.22,0,1,0,java.lang.Object,0.00,0,0,1,0,0,0,0,0,14,0
"org.apache.jackrabbit.core.TransactionContext",16,0.07,2.31,132,1.36,55480.05,31,15,8,37,11,61.14,130,160,9,2,109.24,0.00,0.50,0.13,6,124.00,7,4067.57,0,2,3,Timer.Task,0.00,21,1,37,0,21,14,0,33,800,1
"org.apache.jackrabbit.core.TransactionException",2,0.00,1.00,5,0.03,221.18,2,0,0,2,7,95.57,16,8,7,2,143.68,0.00,0.50,0.00,0,2.00,1,88.69,0,0,0,java.lang.Exception,0.00,0,1,2,0,0,2,0,3,29,1
"org.apache.jackrabbit.core.TransientRepository",17,0.07,1.59,94,0.98,23414.17,26,9,18,51,10,70.10,165,157,3,2,120.10,0.00,0.50,0.18,2,13.00,3,2941.32,0,5,7,org.apache.jackrabbit.commons.AbstractRepository,0.00,34,1,27,0,34,12,2,38,642,1
"org.apache.jackrabbit.core.TransientRepository$RepositoryFactory",1,0.00,1.00,2,0.01,38.26,1,0,18,1,1,105.02,7,3,0,1,147.31,0.00,0.00,0.00,0,1.00,1,25.51,0,0,1,,0.00,0,0,1,0,0,1,0,1,11,1
"org.apache.jackrabbit.core.TransientRepository$RepositoryFactory_0",1,0.00,1.00,3,0.02,222.80,1,0,18,2,1,134.71,0,0,0,1,134.71,0.00,0.00,0.00,0,1.00,1,58.19,0,0,1,java.lang.Object,0.00,1,0,1,0,1,1,0,0,18,0
"org.apache.jackrabbit.core.TransientRepository$RepositoryFactory_1",1,0.00,3.00,6,0.08,2026.72,1,0,18,4,3,115.68,0,0,0,1,115.68,0.00,0.00,0.00,0,1.00,3,226.26,0,0,3,java.lang.Object,0.00,3,0,3,0,3,1,0,0,51,0
"org.apache.jackrabbit.core.TransientRepositoryTest",3,0.00,1.00,12,0.10,1198.92,4,1,5,10,2,95.83,19,17,1,2,128.05,0.00,0.50,1.00,0,0.00,1,297.84,0,0,1,junit.framework.TestCase,0.00,7,1,3,0,7,3,0,5,76,1
"org.apache.jackrabbit.core.TransientRepositoryTest$TransientRepository.RepositoryFactory",1,0.00,1.00,3,0.02,176.32,1,0,5,2,1,135.51,0,4,0,1,135.51,0.00,0.00,0.00,0,1.00,1,57.02,0,1,1,java.lang.Object,0.00,1,0,1,0,1,0,0,0,18,0
"org.apache.jackrabbit.core.UserTransactionImpl",8,0.20,2.50,75,0.93,36218.52,13,5,13,29,16,74.18,48,111,14,1,106.41,0.00,0.00,0.38,0,0.00,6,2793.02,0,0,2,java.lang.Object,0.00,21,0,20,0,21,8,1,14,530,1
"org.apache.jackrabbit.core.UserTransactionImpl$Thread",1,0.00,2.00,6,0.05,718.61,1,0,13,4,0,119.32,0,9,0,1,119.32,0.00,0.00,0.00,0,0.00,2,152.95,0,0,0,java.lang.Object,0.00,3,0,2,0,3,1,0,0,37,0
"org.apache.jackrabbit.core.UserTransactionImpl$TimeBomb",1,0.00,1.00,3,0.01,96.66,1,0,13,2,0,137.57,0,4,0,1,137.57,0.00,0.00,0.00,0,1.00,1,43.31,0,0,0,java.lang.Object,0.00,1,0,1,0,1,1,0,0,15,0
"org.apache.jackrabbit.core.UserTransactionImpl$XidImpl",4,1.00,1.00,10,0.06,808.47,5,1,13,4,0,162.23,15,15,0,1,141.61,0.00,0.00,0.25,0,6.00,1,193.11,0,0,0,java.lang.Object,0.00,0,0,4,0,0,4,1,5,57,0
"org.apache.jackrabbit.core.WorkspaceImpl",31,0.09,2.61,295,3.85,170631.19,43,12,45,108,35,55.73,297,461,7,2,105.73,1.00,0.33,0.17,6,0.00,12,11552.76,0,18,30,org.apache.jackrabbit.commons.AbstractWorkspace,0.00,77,1,81,1,77,13,3,106,2107,1
"org.apache.jackrabbit.core.WorkspaceImpl$VersionSelector",1,0.00,2.00,6,0.06,1388.85,1,0,45,4,1,156.95,2,8,0,1,117.07,0.00,0.00,0.00,0,1.00,2,181.92,0,1,1,java.lang.Object,0.00,3,0,2,0,3,0,0,2,43,0
"org.apache.jackrabbit.core.XASessionImpl",22,0.04,2.09,132,1.49,43161.27,30,8,22,53,18,73.58,164,186,2,3,115.87,0.00,0.67,0.09,5,214.00,9,4469.32,2,5,17,org.apache.jackrabbit.core.SessionImpl,0.07,31,2,46,0,31,17,2,35,944,1
"org.apache.jackrabbit.core.XATest",45,0.86,1.84,760,9.47,354410.63,46,1,16,120,3,46.78,493,882,1,4,95.26,0.00,0.75,0.16,2,0.00,5,28396.39,4,0,2,org.apache.jackrabbit.test.AbstractJCRTest,0.12,75,3,83,0,75,45,0,323,5201,1
"org.apache.jackrabbit.core.XATest$Operation",1,0.00,1.00,4,0.03,341.48,1,0,16,4,0,128.59,0,5,0,1,128.59,0.00,0.00,0.00,0,1.00,1,97.86,0,0,0,java.lang.Object,0.00,3,0,1,0,3,1,0,0,27,0
"org.apache.jackrabbit.core.XATest$Operation_0",1,0.00,1.00,5,0.05,791.76,1,0,16,4,0,122.10,0,6,0,1,122.10,0.00,0.00,0.00,0,1.00,1,159.62,0,0,0,java.lang.Object,0.00,3,0,1,0,3,1,0,0,38,0
"org.apache.jackrabbit.core.XATest$Operation_1",1,0.00,1.00,4,0.03,341.48,1,0,16,4,0,128.59,0,5,0,1,128.59,0.00,0.00,0.00,0,1.00,1,97.86,0,0,0,java.lang.Object,0.00,3,0,1,0,3,1,0,0,27,0
"org.apache.jackrabbit.core.XATest$Operation_2",1,0.00,1.00,4,0.04,441.18,1,0,16,4,0,127.72,0,5,0,1,127.72,0.00,0.00,0.00,0,1.00,1,110.19,0,0,0,java.lang.Object,0.00,3,0,1,0,3,1,0,0,29,0
"org.apache.jackrabbit.core.XATest$Operation_3",1,0.00,1.00,4,0.04,386.40,1,0,16,5,0,128.17,0,5,0,1,128.17,0.00,0.00,0.00,0,1.00,1,112.00,0,0,0,java.lang.Object,0.00,4,0,1,0,4,1,0,0,30,0
"org.apache.jackrabbit.core.XATest$Operation_4",1,0.00,1.00,2,0.01,42.34,1,0,16,1,0,129.09,5,3,0,1,146.96,0.00,0.00,0.00,0,1.00,1,30.34,0,0,0,,0.00,0,0,1,0,0,1,0,1,12,0
"org.apache.jackrabbit.core.XAWorkspace",2,0.00,1.00,5,0.06,497.57,2,0,4,4,8,98.61,14,10,1,3,140.90,0.00,0.67,0.00,0,2.00,1,167.85,0,1,7,org.apache.jackrabbit.core.WorkspaceImpl,0.00,2,2,2,0,2,1,0,3,45,1
"org.apache.jackrabbit.core.ZombieHierarchyManager",6,0.80,2.17,31,0.36,7942.90,7,1,8,19,12,72.06,48,54,2,2,120.17,0.00,0.50,0.33,0,10.00,3,1083.07,4,3,10,org.apache.jackrabbit.core.HierarchyManagerImpl,0.00,13,1,13,0,13,3,0,19,250,1
"org.apache.jackrabbit.core.query.lucene.constraint.AndConstraint",2,0.00,1.00,8,0.09,1858.54,4,2,3,3,5,75.17,18,15,1,1,125.17,0.00,0.00,0.50,0,2.00,1,269.76,0,0,4,java.lang.Object,0.00,1,0,2,0,1,2,1,5,70,1
"org.apache.jackrabbit.core.query.lucene.constraint.ChildNodeConstraint",2,0.00,2.00,13,0.17,4332.72,2,0,8,9,9,83.32,13,23,1,3,115.55,0.00,0.67,0.00,0,2.00,3,506.27,1,0,8,org.apache.jackrabbit.core.query.lucene.constraint.HierarchyConstraint,0.00,7,2,4,0,7,2,0,3,104,1
"org.apache.jackrabbit.core.query.lucene.constraint.ComparisonConstraint",3,0.00,4.33,37,0.41,17905.06,6,3,8,7,10,52.20,32,53,2,2,100.67,1.00,0.33,0.33,1,5.00,7,1235.77,0,0,8,org.apache.jackrabbit.core.query.lucene.constraint.SelectorBasedConstraint,0.00,4,1,13,1,4,3,0,7,247,1
"org.apache.jackrabbit.core.query.lucene.constraint.Constraint",1,0.00,1.00,2,0.02,154.78,1,0,3,1,11,113.15,13,5,8,1,142.53,0.00,0.00,0.00,0,1.00,1,65.11,0,0,3,,0.00,0,0,1,0,0,1,0,2,19,1
"org.apache.jackrabbit.core.query.lucene.constraint.ConstraintBuilder",1,0.00,3.00,7,0.12,3717.20,1,0,34,4,28,144.49,20,18,1,1,111.11,0.00,0.00,0.00,0,1.00,3,347.62,0,1,27,java.lang.Object,0.00,3,0,3,0,3,0,0,3,72,1
"org.apache.jackrabbit.core.query.lucene.constraint.ConstraintBuilder$Visitor",20,0.21,1.45,85,1.36,38593.01,24,4,34,72,44,172.58,25,145,0,2,122.58,0.00,0.50,0.05,1,88.00,6,4083.47,0,19,44,org.apache.jackrabbit.core.query.lucene.DefaultQOMTreeVisitor,0.00,52,1,29,0,52,1,0,10,851,3
"org.apache.jackrabbit.core.query.lucene.constraint.DescendantNodeConstraint",2,0.00,3.50,22,0.23,7206.37,2,0,9,9,10,61.57,14,32,1,3,103.86,0.00,0.67,0.00,0,2.00,6,684.33,1,0,9,org.apache.jackrabbit.core.query.lucene.constraint.HierarchyConstraint,0.00,7,2,7,0,7,2,0,4,134,1
"org.apache.jackrabbit.core.query.lucene.constraint.DynamicOperand",1,1.00,1.00,3,0.04,627.79,2,1,3,1,12,130.70,16,5,10,1,131.17,0.00,0.00,0.00,0,1.00,1,118.43,0,1,2,java.lang.Object,0.00,0,0,1,7,0,0,0,3,31,2
"org.apache.jackrabbit.core.query.lucene.constraint.EvaluationContext",4,0.00,1.00,5,0.02,121.30,4,0,6,4,22,141.46,21,6,19,1,159.33,0.00,0.00,0.00,0,4.00,1,71.36,0,4,3,,0.00,0,0,4,0,0,0,0,5,28,1
"org.apache.jackrabbit.core.query.lucene.constraint.FullTextConstraint",1,0.00,1.00,3,0.03,400.62,1,0,4,2,5,88.58,11,8,1,3,132.71,0.00,0.67,0.00,0,1.00,1,103.51,0,0,4,org.apache.jackrabbit.core.query.lucene.constraint.QueryConstraint,0.00,1,2,1,0,1,1,0,2,28,1
"org.apache.jackrabbit.core.query.lucene.constraint.FullTextSearchScoreOperand",1,0.00,1.00,3,0.05,823.11,1,0,3,5,4,87.95,7,6,1,2,130.24,0.00,0.50,0.00,0,1.00,1,153.81,0,1,3,org.apache.jackrabbit.core.query.lucene.constraint.DynamicOperand,0.00,4,1,1,0,4,0,0,2,38,1
"org.apache.jackrabbit.core.query.lucene.constraint.HierarchyConstraint",2,0.00,2.00,13,0.12,2674.79,4,2,4,5,8,79.63,24,19,3,2,117.20,3.00,0.20,0.50,0,2.00,3,370.16,0,1,5,org.apache.jackrabbit.core.query.lucene.constraint.SelectorBasedConstraint,0.00,3,1,4,3,3,1,0,5,86,2
"org.apache.jackrabbit.core.query.lucene.constraint.LengthOperand",2,1.00,3.00,28,0.40,19058.08,3,1,9,15,10,54.37,14,32,1,2,96.66,0.00,0.50,0.50,0,2.00,5,1207.49,0,1,9,org.apache.jackrabbit.core.query.lucene.constraint.DynamicOperand,0.00,13,1,6,0,13,1,0,4,218,1
"org.apache.jackrabbit.core.query.lucene.constraint.LikeConstraint",2,1.00,1.00,7,0.10,1276.67,3,1,6,7,6,81.11,18,12,1,3,131.11,0.00,0.67,0.50,0,2.00,1,303.74,0,0,5,org.apache.jackrabbit.core.query.lucene.constraint.ComparisonConstraint,0.00,5,2,2,0,5,2,0,4,72,1
"org.apache.jackrabbit.core.query.lucene.constraint.LowerCaseOperand",2,1.00,1.50,14,0.15,4024.97,3,1,4,8,4,71.08,14,16,1,2,113.37,0.00,0.50,0.50,0,2.00,2,446.75,0,1,3,org.apache.jackrabbit.core.query.lucene.constraint.DynamicOperand,0.00,6,1,3,0,6,1,0,4,98,1
"org.apache.jackrabbit.core.query.lucene.constraint.NodeLocalNameOperand",1,0.00,1.00,5,0.09,1724.92,1,0,5,8,6,90.06,13,9,1,2,119.44,0.00,0.50,0.00,0,1.00,1,272.98,0,1,5,org.apache.jackrabbit.core.query.lucene.constraint.DynamicOperand,0.00,7,1,1,0,7,0,0,2,59,1
"org.apache.jackrabbit.core.query.lucene.constraint.NodeNameOperand",1,0.00,1.00,5,0.09,1692.96,1,0,5,7,5,81.94,12,8,1,2,119.50,0.00,0.50,0.00,0,1.00,1,268.12,0,1,4,org.apache.jackrabbit.core.query.lucene.constraint.DynamicOperand,0.00,6,1,1,0,6,0,0,2,58,1
"org.apache.jackrabbit.core.query.lucene.constraint.NotConstraint",2,1.00,1.00,6,0.06,1034.46,3,1,3,3,5,89.54,15,12,1,1,131.83,0.00,0.00,0.50,0,2.00,1,185.92,0,0,4,java.lang.Object,0.00,1,0,2,0,1,2,1,4,49,1
"org.apache.jackrabbit.core.query.lucene.constraint.OrConstraint",2,0.00,1.00,8,0.09,1858.54,4,2,3,3,5,75.17,18,15,1,1,125.17,0.00,0.00,0.50,0,2.00,1,269.76,0,0,4,java.lang.Object,0.00,1,0,2,0,1,2,1,5,70,1
"org.apache.jackrabbit.core.query.lucene.constraint.PropertyExistenceConstraint",1,0.00,1.00,3,0.03,400.62,1,0,4,2,5,103.33,13,8,1,3,132.71,0.00,0.67,0.00,0,1.00,1,103.51,0,0,4,org.apache.jackrabbit.core.query.lucene.constraint.QueryConstraint,0.00,1,2,1,0,1,1,0,2,28,1
"org.apache.jackrabbit.core.query.lucene.constraint.PropertyValueOperand",4,0.67,2.25,27,0.32,8053.13,5,1,13,18,12,67.66,32,44,2,2,115.77,0.00,0.50,0.50,1,6.00,3,960.08,0,3,10,org.apache.jackrabbit.core.query.lucene.constraint.DynamicOperand,0.00,14,1,9,0,14,1,0,6,203,1
"org.apache.jackrabbit.core.query.lucene.constraint.QueryConstraint",4,0.00,2.00,34,0.46,15090.19,7,3,14,17,10,60.51,42,52,2,2,108.99,2.00,0.25,0.33,1,4.00,4,1387.28,1,0,8,org.apache.jackrabbit.core.query.lucene.constraint.SelectorBasedConstraint,0.00,13,1,8,2,13,4,0,10,271,2
"org.apache.jackrabbit.core.query.lucene.constraint.SameNodeConstraint",2,0.00,1.50,9,0.10,2079.44,2,0,5,5,7,92.47,12,16,1,3,124.69,0.00,0.67,0.00,0,2.00,2,298.81,1,0,6,org.apache.jackrabbit.core.query.lucene.constraint.HierarchyConstraint,0.00,3,2,3,0,3,2,0,3,69,1
"org.apache.jackrabbit.core.query.lucene.constraint.SelectorBasedConstraint",3,0.00,1.33,11,0.10,1698.70,5,2,3,6,6,83.35,24,17,3,1,131.46,0.00,0.00,0.50,0,1.00,2,296.86,0,1,3,java.lang.Object,0.00,3,0,4,9,3,2,1,6,74,2
"org.apache.jackrabbit.core.query.lucene.constraint.UpperCaseOperand",2,1.00,1.50,14,0.15,4024.97,3,1,4,8,4,71.08,14,16,1,2,113.37,0.00,0.50,0.50,0,2.00,2,446.75,0,1,3,org.apache.jackrabbit.core.query.lucene.constraint.DynamicOperand,0.00,6,1,3,0,6,1,0,4,98,1
"org.apache.jackrabbit.jcr.AccessManager",5,6.00,1.00,12,0.14,1778.07,11,6,6,5,8,95.55,55,13,5,1,139.68,0.00,0.00,0.00,0,5.00,1,419.79,0,0,3,,0.00,0,0,5,0,0,5,0,7,109,1
"org.apache.jackrabbit.jcr.SecurityConstants",0,0.00,0.00,2,0.01,87.17,1,1,0,0,0,171.00,10,4,0,1,171.00,0.00,0.00,0.00,0,0.00,0,34.87,0,0,0,,0.00,0,0,0,0,0,0,0,2,11,1
"org.apache.jackrabbit.core.persistence.bundle.AbstractBundlePersistenceManager",33,0.00,2.73,291,4.18,348909.48,47,14,34,114,31,63.10,259,395,3,1,105.39,0.00,0.00,0.07,13,370.00,27,12531.12,0,16,28,java.lang.Object,0.00,81,0,90,9,81,17,3,72,2320,2
"org.apache.jackrabbit.core.persistence.bundle.BundleDbPersistenceManager",65,0.02,2.49,591,8.06,493254.10,98,33,48,208,31,62.35,470,805,7,2,104.64,7.00,0.11,0.05,17,1957.00,22,24172.62,5,23,24,org.apache.jackrabbit.core.persistence.bundle.AbstractBundlePersistenceManager,0.06,143,1,162,7,143,42,0,152,4285,1
"org.apache.jackrabbit.core.persistence.bundle.BundleDbPersistenceManager$CloseableBLOBStore",1,0.00,1.00,2,0.01,64.15,1,0,48,1,0,145.54,0,3,0,2,145.54,0.00,0.50,0.00,0,1.00,1,30.46,0,0,0,,0.00,0,1,1,0,0,1,0,0,12,2
"org.apache.jackrabbit.core.persistence.bundle.BundleDbPersistenceManager$DbBlobStore",6,0.16,1.50,45,0.60,15626.31,11,5,48,26,1,133.10,21,55,0,1,112.48,0.00,0.00,0.33,0,0.00,3,1788.25,0,2,1,java.lang.Object,0.00,20,0,9,0,20,4,1,10,370,1
"org.apache.jackrabbit.core.persistence.bundle.BundleDbPersistenceManager$DbBlobStore$FilterInputStream",1,0.00,1.00,4,0.02,218.17,1,0,48,3,0,180.12,1,5,0,1,130.12,0.00,0.00,0.00,0,1.00,1,68.97,0,0,0,java.lang.Object,0.00,2,0,1,0,2,1,0,1,21,0
"org.apache.jackrabbit.core.persistence.bundle.BundleDbPersistenceManager$FSBlobStore",3,1.00,1.33,11,0.09,1127.40,4,1,48,6,3,132.86,1,17,0,2,132.86,0.00,0.50,0.33,0,4.00,2,256.14,0,1,3,org.apache.jackrabbit.core.persistence.util.FileSystemBLOBStore,0.00,3,1,4,0,3,2,1,1,69,1
"org.apache.jackrabbit.core.persistence.bundle.BundleDbPersistenceManager$ListNodeIdIterator",5,0.38,1.20,15,0.12,1834.52,7,2,48,10,3,132.97,0,22,0,1,132.97,0.00,0.00,0.20,1,8.00,2,356.82,0,2,3,java.lang.Object,0.00,5,0,6,0,5,3,1,0,95,1
"org.apache.jackrabbit.core.persistence.bundle.BundleFsPersistenceManager",25,0.03,2.52,231,3.06,125920.63,34,9,32,97,22,73.82,154,306,1,2,106.04,0.00,0.50,0.14,5,244.00,7,9191.91,3,11,21,org.apache.jackrabbit.core.persistence.bundle.AbstractBundlePersistenceManager,0.07,72,1,63,0,72,14,0,42,1735,1
"org.apache.jackrabbit.core.persistence.bundle.BundleFsPersistenceManager$CloseableBLOBStore",1,0.00,1.00,2,0.01,64.15,1,0,32,1,0,145.54,0,3,0,2,145.54,0.00,0.50,0.00,0,1.00,1,30.46,0,0,0,,0.00,0,1,1,0,0,1,0,0,12,2
"org.apache.jackrabbit.core.persistence.bundle.BundleFsPersistenceManager$FSBlobStore",3,1.00,1.33,11,0.09,1158.56,4,1,32,6,3,132.77,1,17,0,2,132.77,0.00,0.50,0.33,0,4.00,2,265.04,0,1,3,org.apache.jackrabbit.core.persistence.util.FileSystemBLOBStore,0.00,3,1,4,0,3,2,1,1,71,1
"org.apache.jackrabbit.core.persistence.bundle.BundleFsPersistenceManager$FileNodeIdIterator",5,0.38,1.20,15,0.12,2191.25,7,2,32,9,2,132.36,0,22,0,1,132.36,0.00,0.00,0.20,1,8.00,2,371.18,0,2,2,java.lang.Object,0.00,4,0,6,0,4,3,1,0,98,2
"org.apache.jackrabbit.core.persistence.bundle.CachingPersistenceManager",1,0.00,1.00,2,0.01,30.51,1,0,1,1,3,99.60,10,3,2,1,148.08,0.00,0.00,0.00,0,1.00,1,25.51,0,0,1,,0.00,0,0,1,0,0,1,0,2,11,1
"org.apache.jackrabbit.core.persistence.bundle.DerbyPersistenceManager",14,0.00,1.57,64,0.78,17101.46,21,7,7,33,2,86.57,178,99,0,3,124.13,0.00,0.67,0.14,0,78.00,5,2342.49,11,5,2,org.apache.jackrabbit.core.persistence.bundle.BundleDbPersistenceManager,0.08,19,2,22,0,19,9,0,33,503,1
"org.apache.jackrabbit.core.persistence.bundle.H2PersistenceManager",5,0.75,1.80,23,0.23,3666.38,6,1,4,13,2,83.55,39,35,0,3,125.84,0.00,0.67,0.40,0,7.00,5,687.20,10,1,2,org.apache.jackrabbit.core.persistence.bundle.BundleDbPersistenceManager,0.03,8,2,9,0,8,4,0,8,156,1
"org.apache.jackrabbit.core.persistence.bundle.MSSqlPersistenceManager",4,0.67,1.25,14,0.12,2249.19,5,1,1,7,2,89.20,29,21,0,3,131.50,0.00,0.67,0.50,0,4.00,2,361.21,3,2,2,org.apache.jackrabbit.core.persistence.bundle.BundleDbPersistenceManager,0.00,3,2,5,0,3,2,0,4,92,1
"org.apache.jackrabbit.core.persistence.bundle.MySqlPersistenceManager",1,0.00,3.00,7,0.06,831.10,1,0,1,1,2,155.53,21,11,0,3,116.23,0.00,0.67,0.00,0,1.00,3,178.03,5,0,2,org.apache.jackrabbit.core.persistence.bundle.BundleDbPersistenceManager,0.00,0,2,3,0,0,1,0,3,43,1
"org.apache.jackrabbit.core.persistence.bundle.Oracle9PersistenceManager",7,0.08,2.43,67,1.09,42405.73,11,4,20,39,6,56.94,72,98,0,4,105.42,0.00,0.75,0.32,1,0.00,6,3278.51,3,2,6,org.apache.jackrabbit.core.persistence.bundle.OraclePersistenceManager,0.00,32,3,17,0,32,5,0,22,594,1
"org.apache.jackrabbit.core.persistence.bundle.Oracle9PersistenceManager$OracleBLOBStore",2,0.00,2.50,15,0.20,7702.17,2,0,20,7,0,150.92,4,24,0,2,111.03,0.00,0.50,0.00,0,2.00,4,596.79,0,0,0,org.apache.jackrabbit.core.persistence.bundle.DbBlobStore,0.00,5,1,5,0,5,2,0,2,113,0
"org.apache.jackrabbit.core.persistence.bundle.OraclePersistenceManager",8,0.19,2.25,56,0.64,18654.42,11,3,8,29,6,70.48,61,76,1,3,112.77,0.50,0.50,0.17,0,14.00,7,1911.70,10,3,5,org.apache.jackrabbit.core.persistence.bundle.BundleDbPersistenceManager,0.08,21,2,18,1,21,5,0,17,383,1
"org.apache.jackrabbit.core.persistence.bundle.PostgreSQLPersistenceManager",4,1.00,2.00,32,0.38,12572.86,5,1,14,20,8,61.51,33,48,0,3,109.61,0.00,0.67,0.25,0,6.00,3,1137.16,5,2,8,org.apache.jackrabbit.core.persistence.bundle.BundleDbPersistenceManager,0.06,16,2,8,0,16,2,0,6,220,1
"org.apache.jackrabbit.jca.AnonymousConnection",21,0.30,1.05,47,0.43,5913.36,24,3,11,23,1,180.36,54,70,1,1,140.47,0.00,0.00,0.05,0,59.00,2,1292.55,0,6,0,java.lang.Object,0.00,2,0,22,0,2,15,2,21,339,1
"org.apache.jackrabbit.jca.JCAConnectionManager",1,0.00,1.00,4,0.05,759.37,1,0,5,3,1,83.57,7,7,1,1,125.86,0.00,0.00,0.00,0,1.00,1,144.99,0,1,0,java.lang.Object,0.00,2,0,1,0,2,0,1,2,36,2
"org.apache.jackrabbit.jca.JCAConnectionRequestInfo",14,0.31,2.29,84,0.85,32326.99,16,2,5,27,6,135.91,54,104,6,1,115.30,0.00,0.00,0.21,3,42.00,4,2550.61,0,3,0,java.lang.Object,0.00,13,0,32,0,13,11,1,17,580,2
"org.apache.jackrabbit.jca.JCAManagedConnection",33,0.08,1.48,136,1.23,25713.03,40,7,16,70,6,146.29,129,205,3,1,125.68,0.00,0.00,0.07,8,426.00,7,3684.20,0,12,6,java.lang.Object,0.00,37,0,49,0,37,21,2,42,870,2
"org.apache.jackrabbit.jca.JCAManagedConnectionFactory",23,0.07,1.78,106,1.04,28168.59,28,5,13,44,11,124.33,93,155,5,1,124.09,0.00,0.00,0.13,6,169.00,5,3131.73,0,11,8,java.lang.Object,0.00,21,0,41,0,21,12,1,29,707,2
"org.apache.jackrabbit.jca.JCARepositoryHandle",4,0.11,2.50,29,0.30,12021.53,7,3,13,10,5,79.66,24,43,2,3,111.88,0.00,0.67,0.25,0,8.00,7,896.02,0,2,4,org.apache.jackrabbit.commons.repository.ProxyRepository,0.00,6,2,10,0,6,2,2,8,192,2
"org.apache.jackrabbit.jca.JCARepositoryHandle$JCARepositoryFactory",2,1.00,1.00,6,0.04,494.52,3,1,13,3,2,134.36,0,10,0,1,134.36,0.00,0.00,0.50,0,2.00,1,124.92,0,1,2,java.lang.Object,0.00,1,0,2,0,1,1,2,0,37,2
"org.apache.jackrabbit.jca.JCARepositoryManager",8,0.18,1.38,36,0.34,7216.00,12,4,9,20,5,92.98,49,50,3,1,125.20,0.00,0.00,0.09,2,26.00,2,1012.16,0,3,2,java.lang.Object,0.00,12,0,11,0,12,5,0,12,242,2
"org.apache.jackrabbit.jca.JCARepositoryManager$Reference",7,0.06,2.71,48,0.49,16254.45,10,3,9,20,2,115.47,34,70,0,1,115.24,0.00,0.00,0.38,1,11.00,6,1458.73,0,1,2,java.lang.Object,0.00,13,0,19,0,13,6,0,11,325,2
"org.apache.jackrabbit.jca.JCAResourceAdapter",5,1.00,1.00,10,0.10,1041.10,6,1,7,8,1,181.40,10,16,0,1,141.51,0.00,0.00,0.20,0,8.00,1,302.22,0,1,1,java.lang.Object,0.00,3,0,5,0,3,4,1,3,83,1
"org.apache.jackrabbit.jca.JCASessionHandle",46,0.96,1.00,94,0.99,12820.54,47,1,33,87,3,180.40,117,172,2,1,140.52,0.00,0.00,0.07,1,166.00,1,2969.05,0,22,2,java.lang.Object,0.00,41,0,46,0,41,24,1,39,793,2
"org.apache.jackrabbit.jca.TransactionBoundXAResource",11,0.00,1.09,33,0.30,4832.93,14,3,3,22,1,132.37,1,49,1,1,132.37,0.00,0.00,0.33,0,0.00,2,908.37,0,1,1,java.lang.Object,0.00,11,0,12,0,11,10,1,1,234,1
"org.apache.jackrabbit.core.cluster.ChangeLogRecord",23,0.02,2.17,201,2.58,93949.87,37,14,22,97,19,66.41,182,269,6,2,108.70,0.00,0.50,0.09,7,141.00,8,7735.65,0,5,14,org.apache.jackrabbit.core.cluster.ClusterRecord,0.23,74,1,50,0,74,18,0,45,1477,1
"org.apache.jackrabbit.core.cluster.ClusterContext",5,0.00,1.00,6,0.03,111.00,5,0,4,5,6,128.18,32,7,4,1,160.40,0.00,0.00,0.00,0,5.00,1,82.00,0,3,2,,0.00,0,0,5,0,0,2,0,6,33,1
"org.apache.jackrabbit.core.cluster.ClusterException",2,0.00,1.00,5,0.03,221.18,2,0,0,2,3,93.68,18,8,3,2,143.68,0.00,0.50,0.00,0,2.00,1,88.69,0,0,0,java.lang.Exception,0.00,0,1,2,0,0,2,0,3,29,1
"org.apache.jackrabbit.core.cluster.ClusterNode",32,0.05,3.28,341,4.17,150837.04,57,25,29,122,43,72.28,212,483,7,1,104.50,0.00,0.00,0.09,4,238.00,8,12498.97,0,6,37,java.lang.Object,0.00,90,0,105,0,90,26,6,63,2359,1
"org.apache.jackrabbit.core.cluster.ClusterNode$WorkspaceLockChannel",4,0.33,2.75,34,0.40,10790.91,5,1,29,7,9,110.30,17,50,0,1,110.06,0.00,0.00,0.75,0,0.00,4,1186.69,0,2,9,java.lang.Object,0.00,3,0,11,0,3,2,1,5,235,0
"org.apache.jackrabbit.core.cluster.ClusterNode$WorkspaceUpdateChannel",6,0.00,3.67,72,0.84,30226.07,8,2,29,20,7,101.53,26,102,0,1,101.29,0.00,0.00,0.50,0,0.00,6,2522.55,0,0,7,java.lang.Object,0.00,14,0,22,0,14,6,1,8,479,0
"org.apache.jackrabbit.core.cluster.ClusterOperation",1,0.00,1.00,2,0.01,30.51,1,0,0,1,4,103.95,11,3,4,1,148.08,0.00,0.00,0.00,0,1.00,1,25.51,0,0,0,,0.00,0,0,1,0,0,1,0,2,11,1
"org.apache.jackrabbit.core.cluster.ClusterRecord",12,0.09,1.08,32,0.23,3316.28,15,3,2,19,13,108.30,78,43,10,1,140.53,0.00,0.00,0.25,3,28.00,2,703.72,0,1,3,java.lang.Object,0.00,7,0,13,5,7,11,0,16,192,2
"org.apache.jackrabbit.core.cluster.ClusterRecordDeserializer",1,0.00,7.00,25,0.30,17876.12,1,0,2,11,10,36.44,10,38,2,1,84.92,0.00,0.00,0.00,0,1.00,7,896.76,0,1,8,java.lang.Object,0.00,10,0,7,0,10,0,0,2,171,1
"org.apache.jackrabbit.core.cluster.ClusterRecordDeserializer$ClusterRecord",3,0.00,1.00,4,0.02,81.72,3,0,2,3,1,209.70,3,7,0,1,159.70,0.00,0.00,0.00,0,3.00,1,54.48,0,0,1,java.lang.Object,0.00,0,0,3,0,0,3,0,3,22,0
"org.apache.jackrabbit.core.cluster.ClusterRecordProcessor",5,0.00,1.00,6,0.04,159.39,5,0,0,5,10,126.94,31,7,10,1,159.16,0.00,0.00,0.00,0,5.00,1,106.26,0,0,5,,0.00,0,0,5,0,0,5,0,6,39,1
"org.apache.jackrabbit.core.cluster.ClusterRecordTest",11,0.25,1.27,108,1.62,32351.10,17,6,18,64,20,75.81,66,125,1,3,108.04,0.00,0.67,0.39,0,0.00,3,4848.21,2,1,19,org.apache.jackrabbit.test.JUnitTest,0.00,53,2,14,0,53,10,0,18,946,1
"org.apache.jackrabbit.core.cluster.ClusterSession",44,0.95,1.02,90,0.74,9455.71,45,1,16,47,3,181.29,111,145,3,1,141.40,0.00,0.00,0.07,0,158.00,2,2220.06,0,20,0,java.lang.Object,0.00,3,0,45,0,3,24,1,36,614,0
"org.apache.jackrabbit.core.cluster.ClusterTest",3,0.25,1.33,23,0.28,5923.62,5,2,8,18,8,71.17,21,28,1,3,113.46,0.00,0.67,0.67,0,0.00,2,825.11,2,0,7,org.apache.jackrabbit.test.JUnitTest,0.00,15,2,4,0,15,3,0,6,177,1
"org.apache.jackrabbit.core.cluster.DefaultClusterOperation",3,0.25,1.00,10,0.07,848.91,5,2,0,4,4,91.60,23,15,2,1,133.90,0.00,0.00,0.33,0,5.00,1,210.74,0,1,3,java.lang.Object,0.00,1,0,3,0,1,2,1,6,60,1
"org.apache.jackrabbit.core.cluster.LockEventChannel",3,0.00,1.00,4,0.02,79.24,3,0,1,3,8,109.80,27,5,5,1,159.80,0.00,0.00,0.00,0,3.00,1,74.24,0,2,3,,0.00,0,0,3,0,0,1,0,4,27,1
"org.apache.jackrabbit.core.cluster.LockEventListener",2,0.00,1.00,3,0.03,115.53,2,0,2,2,6,107.13,18,4,5,1,157.13,0.00,0.00,0.00,0,2.00,1,77.02,0,0,1,,0.00,0,0,2,0,0,2,0,3,25,1
"org.apache.jackrabbit.core.cluster.LockRecord",11,0.06,1.18,43,0.33,4691.02,16,5,3,19,10,90.16,80,57,6,2,132.45,0.00,0.50,0.25,0,26.00,2,986.55,0,3,5,org.apache.jackrabbit.core.cluster.ClusterRecord,0.26,8,1,13,0,8,8,0,17,249,1
"org.apache.jackrabbit.core.cluster.NamespaceEventChannel",2,0.00,1.00,3,0.02,70.51,2,0,0,2,3,116.52,15,4,2,1,158.82,0.00,0.00,0.00,0,2.00,1,55.51,0,0,1,,0.00,0,0,2,0,0,2,0,3,21,1
"org.apache.jackrabbit.core.cluster.NamespaceEventListener",1,0.00,1.00,2,0.02,91.88,1,0,1,1,5,100.18,11,4,5,1,144.31,0.00,0.00,0.00,0,1.00,1,49.86,0,0,0,,0.00,0,0,1,0,0,1,0,2,17,1
"org.apache.jackrabbit.core.cluster.NamespaceRecord",8,0.07,1.00,29,0.21,3061.50,12,4,2,12,8,100.64,53,38,5,2,132.86,0.00,0.50,0.31,0,10.00,1,627.61,0,3,4,org.apache.jackrabbit.core.cluster.ClusterRecord,0.30,4,1,8,0,4,5,0,13,168,1
"org.apache.jackrabbit.core.cluster.NodeTypeEventChannel",4,0.00,1.00,5,0.02,77.04,4,0,2,4,4,143.01,23,6,2,1,160.88,0.00,0.00,0.00,0,4.00,1,72.04,0,0,2,,0.00,0,0,4,0,0,4,0,5,29,1
"org.apache.jackrabbit.core.cluster.NodeTypeEventListener",3,0.00,1.00,4,0.03,150.42,3,0,5,3,7,109.51,25,8,5,1,157.61,0.00,0.00,0.00,0,3.00,1,100.28,0,0,2,,0.00,0,0,3,0,0,3,0,4,33,1
"org.apache.jackrabbit.core.cluster.NodeTypeRecord",9,0.20,2.00,72,0.74,28430.13,19,10,9,25,11,61.49,80,88,6,2,109.60,0.00,0.50,0.28,0,6.00,6,2214.20,0,1,6,org.apache.jackrabbit.core.cluster.ClusterRecord,0.19,16,1,18,0,16,8,0,20,454,1
"org.apache.jackrabbit.core.cluster.SimpleClusterContext",7,0.17,1.00,18,0.12,1337.54,10,3,6,9,8,109.59,42,26,3,1,141.81,0.00,0.00,0.19,0,23.00,1,373.69,0,3,5,java.lang.Object,0.00,2,0,7,0,2,4,1,14,106,1
"org.apache.jackrabbit.core.cluster.SimpleEventListener",12,0.36,1.67,57,0.70,19729.79,13,1,14,31,13,80.81,86,86,4,1,123.10,0.00,0.00,0.67,1,0.00,5,2102.25,0,1,9,java.lang.Object,0.00,19,0,20,0,19,11,4,23,480,1
"org.apache.jackrabbit.core.cluster.SimpleEventListener$LockEvent",6,0.13,1.17,21,0.17,3885.70,9,3,14,10,1,98.81,38,31,0,1,131.03,0.00,0.00,0.44,0,2.00,2,522.03,0,2,1,java.lang.Object,0.00,4,0,7,0,4,4,0,9,137,2
"org.apache.jackrabbit.core.cluster.SimpleEventListener$NamespaceEvent",6,0.20,1.67,28,0.23,7222.65,9,3,14,8,1,91.94,37,41,0,1,124.17,0.00,0.00,0.50,0,0.00,4,691.39,0,3,1,java.lang.Object,0.00,2,0,10,0,2,3,0,9,178,2
"org.apache.jackrabbit.core.cluster.SimpleEventListener$NodeTypeEvent",5,0.05,1.20,20,0.18,4202.52,10,5,14,7,2,83.18,38,28,0,1,125.47,0.00,0.00,0.24,0,0.00,2,536.13,0,1,2,java.lang.Object,0.00,2,0,6,0,2,4,0,10,136,2
"org.apache.jackrabbit.core.cluster.SimpleEventListener$UnlockEvent",4,0.33,1.25,13,0.09,1610.37,5,1,14,6,1,132.87,19,19,0,1,132.64,0.00,0.00,0.75,0,0.00,2,266.07,0,1,1,java.lang.Object,0.00,2,0,5,0,2,3,0,5,74,2
"org.apache.jackrabbit.core.cluster.SimpleEventListener$UpdateEvent",9,0.12,1.22,33,0.34,8514.06,14,5,14,16,3,111.85,48,49,0,1,129.72,0.00,0.00,0.31,0,25.00,2,1009.73,0,4,3,java.lang.Object,0.00,7,0,11,0,7,5,1,13,245,2
"org.apache.jackrabbit.core.cluster.TestAll",1,0.00,1.00,6,0.05,1311.02,1,0,3,3,2,79.86,12,8,0,2,117.42,0.00,0.50,0.00,0,1.00,1,143.51,0,1,2,junit.framework.TestCase,0.00,2,1,1,0,2,0,0,2,38,1
"org.apache.jackrabbit.core.cluster.Update",6,0.00,1.00,7,0.03,86.51,6,0,2,6,5,129.65,37,8,4,1,161.87,0.00,0.00,0.00,0,6.00,1,81.51,0,4,1,,0.00,0,0,6,0,0,2,0,7,35,1
"org.apache.jackrabbit.core.cluster.UpdateEventChannel",5,0.00,1.00,6,0.03,101.04,5,0,0,5,9,142.85,29,7,7,1,160.72,0.00,0.00,0.00,0,5.00,1,96.04,0,0,2,,0.00,0,0,5,0,0,5,0,6,37,1
"org.apache.jackrabbit.core.cluster.UpdateEventFactory",7,0.06,1.29,49,0.88,23137.16,13,6,20,39,17,61.71,64,83,2,1,111.71,0.00,0.00,0.21,3,16.00,2,2647.95,0,6,15,java.lang.Object,0.00,32,0,9,0,32,1,0,14,523,1
"org.apache.jackrabbit.core.cluster.UpdateEventListener",1,0.00,1.00,2,0.03,188.72,1,0,4,1,9,104.29,12,4,7,1,141.85,0.00,0.00,0.00,0,1.00,1,79.49,0,0,2,,0.00,0,0,1,0,0,1,0,2,22,1
"org.apache.jackrabbit.core.cluster.WorkspaceEventChannel",2,0.00,1.00,3,0.02,54.51,2,0,1,2,4,209.70,3,4,2,1,159.70,0.00,0.00,0.00,0,2.00,1,49.51,0,0,2,,0.00,0,0,2,0,0,2,0,1,19,1
"org.apache.jackrabbit.core.cluster.WorkspaceListener",1,0.00,1.00,2,0.02,88.11,1,0,2,1,3,95.98,10,4,3,1,144.45,0.00,0.00,0.00,0,1.00,1,46.05,0,0,0,,0.00,0,0,1,0,0,1,0,2,15,1
"org.apache.jackrabbit.core.cluster.WorkspaceRecord",7,0.06,1.57,34,0.32,6747.78,10,3,6,17,9,107.07,35,46,5,2,124.94,0.00,0.50,0.29,1,4.00,3,945.33,1,1,5,org.apache.jackrabbit.core.cluster.ClusterRecord,0.32,10,1,11,0,10,6,0,10,220,1
"org.apache.jackrabbit.core.cluster.WorkspaceRecord$Action",3,0.00,1.00,4,0.03,170.31,3,0,6,3,2,157.19,0,5,0,1,157.19,0.00,0.00,0.00,0,3.00,1,84.18,0,0,2,java.lang.Object,0.00,0,0,3,0,0,3,0,0,29,3
"org.apache.jackrabbit.core.cluster.WorkspaceRecord$CreateWorkspaceAction",6,0.07,1.67,41,0.42,10875.10,9,3,6,29,3,116.20,4,50,0,2,116.20,0.00,0.50,0.39,0,10.00,3,1257.02,0,1,3,org.apache.jackrabbit.core.cluster.Action,0.00,23,1,10,0,23,5,0,4,274,2
"org.apache.jackrabbit.client.spi.RepositoryConfigImpl",3,0.38,2.33,24,0.30,10179.07,7,4,10,12,8,129.93,10,33,2,2,109.32,0.00,0.50,0.50,0,0.00,3,908.08,0,2,6,org.apache.jackrabbit.client.AbstractRepositoryConfig,0.00,9,1,7,0,9,1,0,3,189,1
"org.apache.jackrabbit.commons.json.JsonHandler",9,0.00,1.00,10,0.06,318.61,9,0,1,9,4,126.58,54,11,4,1,158.80,0.00,0.00,0.00,0,9.00,1,184.33,0,0,0,,0.00,0,0,9,0,0,9,0,10,69,1
"org.apache.jackrabbit.commons.json.JsonParser",8,0.05,6.75,149,1.91,153078.49,16,8,8,35,4,57.80,54,192,3,1,90.02,0.00,0.00,0.17,3,16.00,24,5743.78,0,3,1,java.lang.Object,0.00,27,0,54,0,27,5,0,15,1020,1
"org.apache.jackrabbit.commons.json.JsonParserTest",24,0.17,1.12,168,2.05,46661.58,25,1,8,41,3,113.55,11,187,1,2,113.55,0.00,0.50,0.83,2,0.00,2,6144.26,1,3,2,junit.framework.TestCase,0.00,17,1,27,0,17,21,0,7,1297,1
"org.apache.jackrabbit.commons.json.JsonParserTest$DummyJsonHandler",5,0.00,1.00,11,0.06,450.02,5,0,8,7,0,144.38,0,16,0,1,144.38,0.00,0.00,0.00,0,5.00,1,174.08,0,0,0,java.lang.Object,0.00,2,0,5,0,2,5,0,0,58,0
"org.apache.jackrabbit.commons.json.JsonParserTest$DummyJsonHandler_0",5,0.00,1.00,11,0.06,450.02,5,0,8,7,0,144.38,0,16,0,1,144.38,0.00,0.00,0.00,0,5.00,1,174.08,0,0,0,java.lang.Object,0.00,2,0,5,0,2,5,0,0,58,0
"org.apache.jackrabbit.commons.json.JsonParserTest$DummyJsonHandler_1",5,0.00,1.00,11,0.07,577.02,5,0,8,8,0,143.53,0,16,0,1,143.53,0.00,0.00,0.00,0,5.00,1,198.31,0,0,0,java.lang.Object,0.00,3,0,5,0,3,5,0,0,64,0
"org.apache.jackrabbit.commons.json.JsonParserTest$DummyJsonHandler_10",7,0.25,1.43,27,0.16,2255.20,9,2,8,11,0,133.37,0,32,0,1,133.37,0.00,0.00,0.29,0,10.00,4,494.39,0,0,0,java.lang.Object,0.00,4,0,10,0,4,7,0,0,133,0
"org.apache.jackrabbit.commons.json.JsonParserTest$DummyJsonHandler_11",7,0.25,1.43,27,0.16,2255.20,9,2,8,11,0,133.37,0,32,0,1,133.37,0.00,0.00,0.29,0,10.00,4,494.39,0,0,0,java.lang.Object,0.00,4,0,10,0,4,7,0,0,133,0
"org.apache.jackrabbit.commons.json.JsonParserTest$DummyJsonHandler_12",2,0.00,1.00,5,0.03,225.02,2,0,8,3,0,143.62,0,7,0,1,143.62,0.00,0.00,0.00,0,2.00,1,84.08,0,0,0,java.lang.Object,0.00,1,0,2,0,1,2,0,0,28,0
"org.apache.jackrabbit.commons.json.JsonParserTest$DummyJsonHandler_13",9,0.88,1.00,20,0.10,697.86,10,1,8,11,0,144.89,0,29,0,1,144.89,0.00,0.00,0.22,0,19.00,1,287.16,0,0,0,java.lang.Object,0.00,2,0,9,0,2,9,0,0,95,0
"org.apache.jackrabbit.commons.json.JsonParserTest$DummyJsonHandler_14",8,0.86,1.00,18,0.09,650.81,9,1,8,10,0,144.73,0,26,0,1,144.73,0.00,0.00,0.25,0,16.00,1,262.00,0,0,0,java.lang.Object,0.00,2,0,8,0,2,8,0,0,86,0
"org.apache.jackrabbit.commons.json.JsonParserTest$DummyJsonHandler_15",9,0.00,1.00,10,0.05,281.62,9,0,8,9,1,159.22,0,20,0,1,159.22,0.00,0.00,0.00,0,9.00,1,152.42,0,0,1,java.lang.Object,0.00,0,0,9,0,0,9,1,0,61,1
"org.apache.jackrabbit.commons.json.JsonParserTest$DummyJsonHandler_2",5,0.00,1.00,11,0.06,450.02,5,0,8,7,0,144.38,0,16,0,1,144.38,0.00,0.00,0.00,0,5.00,1,174.08,0,0,0,java.lang.Object,0.00,2,0,5,0,2,5,0,0,58,0
"org.apache.jackrabbit.commons.json.JsonParserTest$DummyJsonHandler_3",5,0.00,1.00,11,0.06,450.02,5,0,8,7,0,144.38,0,16,0,1,144.38,0.00,0.00,0.00,0,5.00,1,174.08,0,0,0,java.lang.Object,0.00,2,0,5,0,2,5,0,0,58,0
"org.apache.jackrabbit.commons.json.JsonParserTest$DummyJsonHandler_4",5,0.00,1.00,11,0.06,450.02,5,0,8,7,0,144.38,0,16,0,1,144.38,0.00,0.00,0.00,0,5.00,1,174.08,0,0,0,java.lang.Object,0.00,2,0,5,0,2,5,0,0,58,0
"org.apache.jackrabbit.commons.json.JsonParserTest$DummyJsonHandler_5",5,0.00,1.00,11,0.06,450.02,5,0,8,7,0,144.38,0,16,0,1,144.38,0.00,0.00,0.00,0,5.00,1,174.08,0,0,0,java.lang.Object,0.00,2,0,5,0,2,5,0,0,58,0
"org.apache.jackrabbit.commons.json.JsonParserTest$DummyJsonHandler_6",5,0.00,1.00,11,0.06,450.02,5,0,8,7,0,144.38,0,16,0,1,144.38,0.00,0.00,0.00,0,5.00,1,174.08,0,0,0,java.lang.Object,0.00,2,0,5,0,2,5,0,0,58,0
"org.apache.jackrabbit.commons.json.JsonParserTest$DummyJsonHandler_7",5,0.00,1.00,11,0.06,450.02,5,0,8,7,0,144.38,0,16,0,1,144.38,0.00,0.00,0.00,0,5.00,1,174.08,0,0,0,java.lang.Object,0.00,2,0,5,0,2,5,0,0,58,0
"org.apache.jackrabbit.commons.json.JsonParserTest$DummyJsonHandler_8",2,0.00,1.00,5,0.03,225.02,2,0,8,3,0,143.62,0,7,0,1,143.62,0.00,0.00,0.00,0,2.00,1,84.08,0,0,0,java.lang.Object,0.00,1,0,2,0,1,2,0,0,28,0
"org.apache.jackrabbit.commons.json.JsonParserTest$DummyJsonHandler_9",2,0.00,1.00,5,0.03,217.51,2,0,8,4,0,143.73,0,7,0,1,143.73,0.00,0.00,0.00,0,2.00,1,79.04,0,0,0,java.lang.Object,0.00,2,0,2,0,2,2,0,0,27,0
"org.apache.jackrabbit.commons.json.JsonUtil",1,0.00,11.00,36,0.43,33777.19,1,0,0,8,4,94.87,18,48,4,1,76.73,0.00,0.00,0.00,0,1.00,11,1289.80,0,1,0,java.lang.Object,0.00,7,0,11,0,7,0,0,10,221,1
"org.apache.jackrabbit.commons.json.JsonUtilTest",1,0.00,2.00,19,0.26,5693.85,1,0,4,9,2,43.57,9,19,1,2,93.57,0.00,0.50,0.00,0,1.00,2,793.15,0,0,1,junit.framework.TestCase,0.00,8,1,2,0,8,1,0,7,146,1
"org.apache.jackrabbit.commons.json.TestAll",1,0.00,1.00,6,0.05,1283.53,1,0,3,3,2,75.20,7,8,0,2,117.50,0.00,0.50,0.00,0,1.00,1,150.40,0,1,2,junit.framework.TestCase,0.00,2,1,1,0,2,0,0,2,39,1
"org.apache.jackrabbit.commons.visitor.FilteringItemVisitor",11,0.05,2.55,72,0.88,57516.88,19,8,9,22,1,70.19,84,103,0,1,112.48,0.00,0.00,0.08,2,30.00,15,2625.91,0,0,1,java.lang.Object,0.00,11,0,28,0,11,11,1,15,523,2
"org.apache.jackrabbit.api.security.JackrabbitAccessControlEntry",3,0.00,1.00,4,0.02,77.11,3,0,2,3,8,117.61,23,5,8,2,159.90,0.00,0.50,0.00,0,3.00,1,53.21,0,2,0,,0.00,0,1,3,0,0,1,0,4,22,1
"org.apache.jackrabbit.api.security.JackrabbitAccessControlList",6,0.00,1.00,7,0.07,483.45,6,0,8,6,22,111.86,71,9,22,3,155.99,0.00,0.67,0.00,0,6.00,1,202.34,0,1,0,,0.00,0,2,6,0,0,5,0,7,61,1
"org.apache.jackrabbit.api.security.JackrabbitAccessControlManager",2,0.00,1.00,3,0.03,208.27,2,0,6,2,5,164.24,34,4,4,2,155.11,0.00,0.50,0.00,0,2.00,1,104.13,0,2,1,,0.00,0,1,2,0,0,0,0,3,31,1
"org.apache.jackrabbit.api.security.JackrabbitAccessControlPolicy",1,0.00,1.00,2,0.01,44.19,1,0,1,1,8,98.34,10,3,8,2,146.81,0.00,0.50,0.00,0,1.00,1,26.09,0,1,0,,0.00,0,1,1,0,0,0,0,2,11,1
"org.apache.jackrabbit.jcr.AbstractCopy",6,0.00,1.17,30,0.34,7313.66,11,5,8,17,8,141.21,19,40,2,2,120.59,2.00,0.25,0.20,0,26.00,2,1009.50,1,4,6,org.apache.jackrabbit.jcr2spi.operation.AbstractOperation,0.00,11,1,7,2,11,2,0,8,215,2
"org.apache.jackrabbit.jcr.AbstractOperation",7,0.25,1.14,19,0.18,2673.96,9,2,9,17,29,121.53,38,27,24,1,139.41,0.00,0.00,0.29,0,19.00,2,531.20,0,3,5,java.lang.Object,0.00,10,0,8,28,10,4,1,8,138,2
"org.apache.jackrabbit.jcr.AddLabel",8,0.03,1.25,33,0.35,6468.23,13,5,15,18,14,125.83,33,45,6,2,125.59,0.00,0.50,0.18,0,32.00,3,1057.42,0,4,9,org.apache.jackrabbit.jcr2spi.operation.AbstractOperation,0.00,10,1,10,0,10,4,0,8,243,1
"org.apache.jackrabbit.jcr.AddNode",12,0.04,1.00,44,0.40,6762.48,19,7,15,20,13,171.42,28,59,8,2,131.54,0.00,0.50,0.11,0,88.00,1,1186.71,2,6,6,org.apache.jackrabbit.jcr2spi.operation.AbstractOperation,0.11,8,1,12,0,8,6,0,10,282,1
"org.apache.jackrabbit.jcr.AddProperty",12,0.05,1.00,42,0.37,5915.40,18,6,13,18,15,171.88,25,58,8,2,132.00,0.00,0.50,0.12,0,88.00,1,1123.34,1,5,8,org.apache.jackrabbit.jcr2spi.operation.AbstractOperation,0.11,6,1,12,0,6,7,0,8,269,1
"org.apache.jackrabbit.jcr.Checkin",7,0.12,1.43,32,0.35,7831.46,11,4,15,20,12,145.07,25,44,6,2,124.45,0.00,0.50,0.14,0,14.00,4,1062.57,0,3,7,org.apache.jackrabbit.jcr2spi.operation.AbstractOperation,0.00,13,1,10,0,13,4,0,9,234,1
"org.apache.jackrabbit.jcr.Checkout",5,0.08,1.60,28,0.32,7498.46,8,3,15,17,13,140.42,17,38,6,2,119.81,0.00,0.50,0.27,0,6.00,4,968.12,0,2,8,org.apache.jackrabbit.jcr2spi.operation.AbstractOperation,0.00,12,1,8,0,12,3,0,8,207,1
"org.apache.jackrabbit.jcr.Checkpoint",7,0.12,1.43,33,0.36,7972.91,11,4,15,19,12,164.28,17,45,6,2,124.39,0.00,0.50,0.14,0,14.00,4,1071.32,0,3,7,org.apache.jackrabbit.jcr2spi.operation.AbstractOperation,0.00,12,1,10,0,12,4,0,8,235,1
"org.apache.jackrabbit.jcr.Clone",5,0.38,1.40,24,0.28,5699.82,7,2,13,11,11,164.28,14,40,6,3,124.39,0.00,0.67,0.20,0,6.00,3,852.61,1,1,6,org.apache.jackrabbit.jcr2spi.operation.AbstractCopy,0.17,6,2,7,0,6,4,0,7,188,1
"org.apache.jackrabbit.jcr.Copy",3,0.00,1.00,9,0.14,2146.82,3,0,10,5,10,151.34,9,19,6,3,130.72,0.00,0.67,0.00,0,4.00,1,409.22,0,1,5,org.apache.jackrabbit.jcr2spi.operation.AbstractCopy,0.00,2,2,3,0,2,2,0,4,94,1
"org.apache.jackrabbit.jcr.CreateActivity",7,0.25,1.00,22,0.19,2822.68,11,4,11,10,9,172.57,17,30,6,2,132.68,0.00,0.50,0.04,0,18.00,1,581.19,0,3,4,org.apache.jackrabbit.jcr2spi.operation.AbstractOperation,0.00,3,1,7,0,3,4,0,8,147,1
"org.apache.jackrabbit.jcr.CreateConfiguration",8,0.11,1.00,27,0.26,4001.51,13,5,12,15,10,171.83,18,36,6,2,131.95,0.00,0.50,0.10,0,30.00,1,775.92,0,4,5,org.apache.jackrabbit.jcr2spi.operation.AbstractOperation,0.00,7,1,8,0,7,4,0,8,193,1
"org.apache.jackrabbit.jcr.LockOperation",12,0.08,1.25,45,0.40,6851.02,18,6,10,19,10,181.44,22,62,6,2,131.44,0.00,0.50,0.10,1,84.00,3,1198.55,0,5,5,org.apache.jackrabbit.jcr2spi.operation.AbstractOperation,0.00,7,1,15,0,7,7,0,9,294,1
"org.apache.jackrabbit.jcr.LockRefresh",5,1.00,1.00,15,0.12,1668.08,6,1,9,8,10,153.95,19,21,6,2,133.33,0.00,0.50,0.20,0,10.00,1,366.49,0,1,5,org.apache.jackrabbit.jcr2spi.operation.AbstractOperation,0.00,3,1,5,0,3,4,0,9,96,1
"org.apache.jackrabbit.jcr.LockRelease",5,0.75,1.20,21,0.20,3350.92,6,1,12,13,12,126.48,22,28,6,2,126.24,0.00,0.50,0.40,0,6.00,2,596.84,0,1,7,org.apache.jackrabbit.jcr2spi.operation.AbstractOperation,0.00,8,1,6,0,8,4,0,9,141,1
"org.apache.jackrabbit.jcr.Merge",11,0.03,1.55,50,0.48,9541.44,18,7,14,24,11,165.19,22,69,6,2,125.30,0.00,0.50,0.12,1,71.00,4,1439.51,0,4,6,org.apache.jackrabbit.jcr2spi.operation.AbstractOperation,0.00,13,1,17,0,13,7,0,9,330,1
"org.apache.jackrabbit.jcr.Move",11,0.05,2.00,85,1.09,51262.13,19,8,19,37,18,150.31,30,115,8,2,110.43,0.00,0.50,0.17,0,65.00,9,3270.71,4,6,11,org.apache.jackrabbit.jcr2spi.operation.AbstractOperation,0.11,26,1,22,0,26,5,0,17,612,1
"org.apache.jackrabbit.jcr.Operation",6,3.00,1.00,10,0.07,514.03,9,3,9,6,42,137.91,34,11,40,1,155.78,0.00,0.00,0.00,0,6.00,1,217.85,0,2,2,,0.00,0,0,6,0,0,4,0,7,67,1
"org.apache.jackrabbit.jcr.OperationVisitor",27,0.00,1.00,28,0.36,2136.00,27,0,12,27,32,156.05,18,29,32,1,156.05,0.00,0.00,0.00,0,27.00,1,1070.00,0,0,27,,0.00,0,0,27,0,0,27,0,6,306,1
"org.apache.jackrabbit.jcr.Remove",8,0.11,1.12,32,0.30,5440.37,12,4,9,18,15,166.09,17,42,10,2,126.21,2.00,0.25,0.16,0,24.00,2,914.32,2,4,6,org.apache.jackrabbit.jcr2spi.operation.AbstractOperation,0.13,10,1,9,2,10,4,0,9,218,1
"org.apache.jackrabbit.jcr.RemoveActivity",5,0.08,1.40,24,0.27,4927.20,8,3,12,16,13,145.51,17,34,6,3,124.89,0.00,0.67,0.27,0,9.00,3,800.14,0,2,8,org.apache.jackrabbit.jcr2spi.operation.Remove,0.30,11,2,7,0,11,3,0,8,180,1
"org.apache.jackrabbit.jcr.RemoveLabel",7,0.08,1.29,28,0.30,5363.99,11,4,15,17,14,126.01,31,39,6,2,125.77,0.00,0.50,0.18,0,24.00,3,893.17,0,4,9,org.apache.jackrabbit.jcr2spi.operation.AbstractOperation,0.00,10,1,9,0,10,3,0,8,209,1
"org.apache.jackrabbit.jcr.RemoveVersion",5,0.25,1.60,26,0.30,6016.22,7,2,13,17,14,141.18,18,38,6,3,120.56,0.00,0.67,0.30,0,9.00,3,887.24,0,1,9,org.apache.jackrabbit.jcr2spi.operation.Remove,0.45,12,2,8,0,12,4,0,9,197,1
"org.apache.jackrabbit.jcr.ReorderNodes",11,0.05,1.18,43,0.43,11362.70,17,6,9,19,12,179.43,19,57,7,2,129.43,0.00,0.50,0.12,0,72.00,2,1287.88,2,7,6,org.apache.jackrabbit.jcr2spi.operation.AbstractOperation,0.11,8,1,13,0,8,4,0,8,302,1
"org.apache.jackrabbit.jcr.ResolveMergeConflict",8,0.11,1.12,32,0.32,5682.85,12,4,12,17,12,146.68,24,42,6,2,126.06,0.00,0.50,0.16,0,36.00,2,950.82,0,3,7,org.apache.jackrabbit.jcr2spi.operation.AbstractOperation,0.00,9,1,9,0,9,5,0,9,228,1
"org.apache.jackrabbit.jcr.Restore",9,0.06,1.78,49,0.53,16919.59,13,4,13,16,12,119.25,44,60,6,2,119.01,0.00,0.50,0.19,0,35.00,4,1585.09,0,3,7,org.apache.jackrabbit.jcr2spi.operation.AbstractOperation,0.00,7,1,16,0,7,6,0,14,352,1
"org.apache.jackrabbit.jcr.SetMixin",8,0.14,1.38,34,0.33,7387.60,11,3,9,16,15,165.00,21,48,9,2,125.12,0.00,0.50,0.21,0,24.00,3,976.22,1,3,7,org.apache.jackrabbit.jcr2spi.operation.AbstractOperation,0.13,8,1,11,0,8,5,0,11,227,1
"org.apache.jackrabbit.jcr.SetPrimaryType",8,0.14,1.12,31,0.27,4816.85,11,3,8,14,13,171.17,18,42,8,2,131.29,0.00,0.50,0.21,0,24.00,2,805.45,1,3,6,org.apache.jackrabbit.jcr2spi.operation.AbstractOperation,0.13,6,1,9,0,6,5,0,8,196,1
"org.apache.jackrabbit.jcr.SetPropertyValue",10,0.06,1.20,43,0.42,10596.12,14,4,13,20,13,174.68,18,55,8,2,124.68,0.00,0.50,0.20,0,46.00,3,1245.44,1,4,6,org.apache.jackrabbit.jcr2spi.operation.AbstractOperation,0.12,10,1,12,0,10,6,0,8,282,1
"org.apache.jackrabbit.jcr.TransientOperationVisitor",19,0.00,1.00,39,0.47,4935.71,19,0,12,20,21,140.99,79,59,1,1,140.76,0.00,0.00,0.00,0,19.00,1,1415.82,0,0,20,java.lang.Object,0.00,1,0,19,1,1,19,1,20,348,2
"org.apache.jackrabbit.jcr.Update",6,0.30,1.00,20,0.17,2342.34,8,2,9,12,10,153.41,22,27,6,2,132.79,0.00,0.50,0.25,0,14.00,1,521.14,0,3,5,org.apache.jackrabbit.jcr2spi.operation.AbstractOperation,0.00,6,1,6,0,6,3,0,8,133,1
"org.apache.jackrabbit.jcr.WorkspaceImport",7,0.11,1.43,32,0.31,7512.13,10,3,12,15,11,145.21,25,44,6,2,124.59,0.00,0.50,0.24,0,20.00,3,924.97,0,2,6,org.apache.jackrabbit.jcr2spi.operation.AbstractOperation,0.00,8,1,10,0,8,5,0,11,213,1
"org.apache.jackrabbit.spi.commons.identifier.AbstractIdFactory",7,0.83,1.57,39,0.49,14970.08,8,1,10,22,10,100.73,35,55,2,1,118.60,0.00,0.00,0.29,2,13.00,3,1482.19,0,7,8,java.lang.Object,0.00,15,0,11,2,15,0,1,13,322,2
"org.apache.jackrabbit.spi.commons.identifier.AbstractIdFactory$ItemIdImpl",9,0.00,2.33,46,0.51,18191.78,12,3,10,23,5,158.59,19,65,0,1,118.70,0.00,0.00,0.33,1,8.00,4,1539.15,0,3,5,java.lang.Object,0.00,14,0,21,0,14,6,2,4,352,3
"org.apache.jackrabbit.spi.commons.identifier.AbstractIdFactory$NodeIdImpl",5,1.00,1.60,16,0.17,2822.12,6,1,10,8,3,131.43,0,25,0,2,131.43,0.00,0.50,0.00,0,5.00,3,496.25,1,0,3,org.apache.jackrabbit.spi.commons.identifier.ItemIdImpl,0.00,3,1,8,0,3,5,1,0,124,2
"org.apache.jackrabbit.spi.commons.identifier.AbstractIdFactory$PropertyIdImpl",5,0.50,1.40,18,0.15,2366.55,7,2,10,8,4,132.06,0,27,0,2,132.06,0.00,0.50,0.10,0,8.00,3,448.15,1,2,4,org.apache.jackrabbit.spi.commons.identifier.ItemIdImpl,0.00,3,1,7,0,3,3,2,0,115,2
"org.apache.jackrabbit.spi.commons.identifier.IdFactoryImpl",3,1.00,1.33,9,0.06,1117.64,4,1,3,5,12,182.89,3,14,8,2,132.89,0.00,0.50,0.33,0,4.00,2,183.15,0,2,4,org.apache.jackrabbit.spi.commons.identifier.AbstractIdFactory,0.20,2,1,4,0,2,1,0,1,51,2
"org.apache.jackrabbit.spi.commons.identifier.SerializationTest",3,0.25,1.00,20,0.28,5458.31,7,4,12,18,8,166.30,4,25,0,2,116.30,0.00,0.50,0.42,1,1.00,1,845.83,0,0,8,junit.framework.TestCase,0.00,15,1,3,0,15,3,0,1,186,1
"org.apache.jackrabbit.core.persistence.mem.InMemPersistenceManager",27,0.10,2.52,260,3.17,147827.45,42,15,31,100,20,87.88,139,346,0,2,105.75,0.00,0.50,0.16,2,0.00,6,9510.79,1,6,20,org.apache.jackrabbit.core.persistence.AbstractPersistenceManager,0.00,73,1,68,0,73,21,0,80,1796,1
"org.apache.jackrabbit.spi.TestAll",1,0.00,1.00,4,0.03,257.45,1,0,3,2,0,179.56,1,6,0,2,129.56,0.00,0.50,0.00,0,1.00,1,79.73,0,1,0,junit.framework.TestCase,0.00,1,1,1,0,1,0,0,1,24,1
"org.apache.jackrabbit.spi.TestAll$SpiTestSuite",1,0.00,1.00,4,0.04,273.77,1,0,3,3,1,179.35,1,6,0,2,129.35,0.00,0.50,0.00,0,1.00,1,109.51,0,0,1,junit.framework.TestSuite,0.00,2,1,1,0,2,1,0,1,30,2
"org.apache.jackrabbit.util.Base64",11,0.12,2.27,108,1.78,229531.04,15,4,7,18,6,53.10,97,140,6,1,101.20,0.00,0.00,0.14,2,39.00,8,5341.87,0,0,0,java.lang.Object,0.00,7,0,25,0,7,11,0,24,991,1
"org.apache.jackrabbit.util.ChildrenCollector",3,0.17,1.67,15,0.15,2436.59,6,3,5,4,0,79.61,21,23,0,2,121.90,0.00,0.50,0.44,0,1.00,2,463.16,0,0,0,TraversingItemVisitor.Default,0.00,1,1,5,0,1,3,0,4,111,1
"org.apache.jackrabbit.util.ChildrenCollectorFilter",7,0.12,4.43,80,0.85,44103.75,14,7,6,15,2,81.75,103,115,2,2,101.89,0.00,0.50,0.24,2,17.00,13,2536.80,0,0,0,TraversingItemVisitor.Default,0.00,8,1,31,0,8,7,0,19,531,1
"org.apache.jackrabbit.util.ISO8601",3,0.00,8.00,119,1.94,225170.56,6,3,4,26,19,54.69,119,145,19,1,72.78,0.00,0.00,0.33,1,4.00,17,5815.15,0,2,0,java.lang.Object,0.00,23,0,24,0,23,1,0,49,952,2
"org.apache.jackrabbit.util.ISO9075",6,0.20,3.67,74,1.07,65439.96,9,3,2,26,23,48.65,58,94,21,1,98.65,0.00,0.00,0.17,2,18.00,9,3206.82,0,3,2,java.lang.Object,0.00,20,0,22,0,20,3,0,21,621,1
"org.apache.jackrabbit.util.ISO9075Test",3,0.00,1.00,27,0.33,6451.71,3,0,1,7,1,159.16,3,37,0,2,109.16,0.00,0.50,0.00,0,3.00,1,986.45,0,0,1,junit.framework.TestCase,0.00,4,1,3,0,4,3,0,1,228,1
"org.apache.jackrabbit.util.LazyFileInputStream",13,0.03,1.54,54,0.44,9099.72,16,3,6,28,4,108.17,65,77,4,2,126.04,1.00,0.33,0.36,1,0.00,4,1329.86,0,0,0,java.io.InputStream,0.00,15,1,20,1,15,13,0,18,333,1
"org.apache.jackrabbit.util.Locked",6,0.40,3.00,56,0.72,37792.51,8,2,11,26,4,144.53,131,81,4,1,105.23,0.00,0.00,0.17,5,10.00,12,2157.34,0,5,0,java.lang.Object,0.00,20,0,18,0,20,1,0,23,392,2
"org.apache.jackrabbit.util.Locked$EventListener",1,0.00,1.00,4,0.03,297.46,1,0,11,2,1,129.06,0,6,0,1,129.06,0.00,0.00,0.00,0,1.00,1,82.01,0,0,1,java.lang.Object,0.00,1,0,1,0,1,1,0,0,24,0
"org.apache.jackrabbit.util.Text",32,0.30,2.88,292,4.20,276756.27,35,3,7,65,77,55.68,336,378,77,1,104.16,0.00,0.00,0.04,8,88.00,13,12598.02,0,27,0,java.lang.Object,0.00,33,0,92,0,33,5,0,49,2436,1
"org.apache.jackrabbit.util.TextTest",7,0.00,2.29,133,1.50,65403.75,7,0,4,24,1,112.46,25,132,0,2,91.84,0.00,0.50,0.00,2,7.00,5,4508.56,0,0,1,junit.framework.TestCase,0.00,17,1,16,0,17,7,0,21,888,1
"org.apache.jackrabbit.util.Timer",5,0.25,1.80,36,0.36,9978.59,11,6,1,12,5,103.00,77,50,5,1,113.35,0.00,0.00,0.37,0,0.00,4,1068.07,0,0,0,java.lang.Object,0.00,7,0,9,0,7,5,0,15,225,1
"org.apache.jackrabbit.util.Timer$IdleCheckerTask",1,0.00,3.00,7,0.07,1572.76,1,0,1,2,1,114.05,0,13,0,2,114.05,0.00,0.50,0.00,0,0.00,3,208.23,0,0,1,org.apache.jackrabbit.util.Task,0.00,1,1,3,0,1,1,0,0,47,1
"org.apache.jackrabbit.util.Timer$Task",2,1.00,1.50,9,0.07,1275.30,3,1,1,3,1,108.49,11,13,0,2,126.36,0.00,0.50,0.50,0,2.00,2,199.58,1,0,1,java.util.TimerTask,0.00,1,1,3,0,1,2,0,3,53,3
"org.apache.jackrabbit.util.TimerTest",6,0.40,1.00,28,0.29,4156.27,8,2,1,15,1,126.17,4,35,0,2,126.17,0.00,0.50,0.83,0,0.00,1,875.61,2,0,1,junit.framework.TestCase,0.00,9,1,6,0,9,6,0,1,202,1
"org.apache.jackrabbit.util.TimerTest$DummyTask",2,1.00,1.50,10,0.06,732.29,3,1,1,4,0,124.65,0,16,0,2,124.65,0.00,0.50,0.50,0,2.00,2,188.61,0,0,0,Timer.Task,0.00,2,1,3,0,2,2,0,0,51,2
"org.apache.jackrabbit.util.TransientFileFactory",5,0.10,2.00,38,0.38,8655.05,10,5,8,23,13,113.34,84,51,13,1,113.82,0.00,0.00,0.28,1,9.00,4,1130.73,0,2,0,java.lang.Object,0.00,18,0,10,0,18,3,0,26,246,1
"org.apache.jackrabbit.util.TransientFileFactory$MoribundFileReference",2,1.00,1.00,7,0.05,515.63,3,1,8,5,0,91.92,15,10,0,2,134.21,0.00,0.50,0.50,0,2.00,1,158.01,0,0,0,java.lang.ref.PhantomReference,0.00,3,1,2,0,3,2,0,3,45,1
"org.apache.jackrabbit.util.TransientFileFactory$ReaperThread",2,0.00,2.00,12,0.09,1670.29,2,0,8,4,0,139.42,7,18,0,2,118.81,0.00,0.50,0.00,0,2.00,3,260.49,0,0,0,org.apache.jackrabbit.util.Thread,0.00,2,1,4,0,2,2,0,4,64,1
"org.apache.jackrabbit.util.TransientFileFactory$Thread",1,0.00,1.00,3,0.01,56.92,1,0,8,2,0,139.38,0,4,0,1,139.38,0.00,0.00,0.00,0,1.00,1,30.46,0,0,0,java.lang.Object,0.00,1,0,1,0,1,1,0,0,12,0
"org.apache.jackrabbit.util.UUIDTest",2,0.00,1.50,28,0.33,13055.36,2,0,3,9,2,98.35,9,29,0,2,98.11,0.00,0.50,0.00,1,2.00,2,1004.28,0,0,2,junit.framework.TestCase,0.00,7,1,3,0,7,2,0,5,197,1
"org.apache.jackrabbit.util.WeakIdentityCollection",16,0.05,2.00,97,0.96,32032.48,20,4,7,33,3,83.59,111,115,3,1,115.82,0.00,0.00,0.30,2,16.00,4,2885.32,0,3,0,java.lang.Object,0.00,17,0,32,0,17,13,1,25,619,1
"org.apache.jackrabbit.util.WeakIdentityCollection$Iter",3,0.33,1.33,12,0.10,1648.60,6,3,7,6,1,94.68,18,17,0,1,126.90,0.00,0.00,0.56,0,1.00,2,307.64,0,1,1,java.lang.Object,0.00,3,0,4,0,3,2,1,6,77,2
"org.apache.jackrabbit.util.WeakIdentityCollection$WeakRef",1,1.00,1.00,5,0.04,427.96,2,1,7,1,0,74.21,9,7,0,2,124.21,0.00,0.50,0.00,0,0.00,1,115.52,0,0,0,java.lang.ref.WeakReference,0.00,0,1,1,0,0,1,0,2,32,2
"org.apache.jackrabbit.util.XMLChar",21,0.03,1.95,724,20.15,1282085.56,30,9,1,23,6,117.51,615,757,6,1,76.03,0.00,0.00,0.08,4,61.00,6,60456.28,0,0,0,java.lang.Object,0.00,2,0,41,0,2,21,0,463,6924,1
"org.apache.jackrabbit.core.integration.AxisQueryTest",6,0.20,3.67,90,1.20,50631.55,13,7,8,41,1,63.69,40,111,0,5,95.91,0.00,0.80,0.31,4,0.00,7,3597.25,2,2,1,org.apache.jackrabbit.core.query.AbstractQueryTest,0.12,35,4,22,0,35,4,0,18,648,1
"org.apache.jackrabbit.core.integration.ConcurrentQueryTest",4,0.33,4.25,89,0.99,39340.70,6,2,12,27,1,39.15,39,74,0,4,89.15,0.00,0.75,0.25,0,4.00,8,2972.35,2,0,1,org.apache.jackrabbit.test.AbstractJCRTest,0.30,23,3,17,0,23,4,0,17,532,1
"org.apache.jackrabbit.core.integration.ConcurrentQueryTest$QueryWorker",3,0.33,3.00,40,0.46,17149.25,9,6,12,16,0,99.61,2,50,0,2,99.61,0.00,0.50,0.39,0,1.00,7,1379.93,0,0,0,org.apache.jackrabbit.core.integration.Thread,0.00,13,1,9,0,13,3,0,2,256,3
"org.apache.jackrabbit.core.integration.ConcurrentQueryTest$Thread",1,0.00,5.00,20,0.17,5957.41,1,0,12,6,0,92.37,0,17,0,1,92.37,0.00,0.00,0.00,0,1.00,5,524.99,0,0,0,java.lang.Object,0.00,5,0,5,0,5,1,0,0,104,0
"org.apache.jackrabbit.core.integration.ConcurrentQueryTest$Thread_0",1,0.00,5.00,20,0.17,5994.86,1,0,12,6,0,92.35,0,17,0,1,92.35,0.00,0.00,0.00,0,1.00,5,506.57,0,0,0,java.lang.Object,0.00,5,0,5,0,5,1,0,0,102,0
"org.apache.jackrabbit.core.integration.GQLTest",20,0.58,1.15,211,2.90,79944.73,21,1,9,38,2,155.30,20,234,0,5,105.30,0.00,0.80,0.45,2,0.00,3,8689.81,2,2,2,org.apache.jackrabbit.core.query.AbstractQueryTest,0.00,18,4,23,0,18,18,0,18,1683,1
"org.apache.jackrabbit.core.integration.GQLTest$GQL.Filter",1,0.00,1.00,3,0.04,531.50,1,0,9,5,0,131.74,0,4,0,1,131.74,0.00,0.00,0.00,0,1.00,1,130.20,0,0,0,java.lang.Object,0.00,4,0,1,0,4,1,0,0,33,0
"org.apache.jackrabbit.core.integration.GQLTest$GQL.Filter_0",1,0.00,1.00,3,0.04,531.50,1,0,9,5,0,131.74,0,4,0,1,131.74,0.00,0.00,0.00,0,1.00,1,130.20,0,0,0,java.lang.Object,0.00,4,0,1,0,4,1,0,0,33,0
"org.apache.jackrabbit.core.integration.JCRAPITest",1,0.00,1.00,3,0.02,158.91,1,0,3,2,1,156.48,3,5,0,2,135.87,0.00,0.50,0.00,0,1.00,1,52.05,0,1,1,junit.framework.TestCase,0.00,1,1,1,0,1,0,0,1,17,1
"org.apache.jackrabbit.core.integration.JCRBenchmark",1,0.00,1.00,3,0.02,158.91,1,0,3,2,0,156.48,3,5,0,2,135.87,0.00,0.50,0.00,0,1.00,1,52.05,0,1,0,junit.framework.TestCase,0.00,1,1,1,0,1,0,0,1,17,1
"org.apache.jackrabbit.core.integration.MassiveRangeTest",1,0.00,3.00,19,0.21,5401.07,1,0,6,8,1,51.36,7,17,0,5,93.65,0.00,0.80,0.00,0,0.00,3,643.18,1,0,1,org.apache.jackrabbit.core.query.AbstractQueryTest,0.00,7,4,3,0,7,1,0,3,119,1
"org.apache.jackrabbit.core.integration.MassiveWildcardTest",1,0.00,3.00,23,0.29,9165.09,1,0,6,8,1,46.46,7,21,0,5,88.75,0.00,0.80,0.00,0,0.00,3,867.73,1,0,1,org.apache.jackrabbit.core.query.AbstractQueryTest,0.00,7,4,3,0,7,1,0,3,157,1
"org.apache.jackrabbit.core.integration.NodeImplTest",4,0.00,1.00,28,0.39,13850.02,5,1,7,16,1,132.22,13,43,0,4,111.60,0.00,0.75,1.00,0,0.00,1,1175.44,2,0,1,org.apache.jackrabbit.test.AbstractJCRTest,0.30,12,3,4,0,12,4,0,3,247,1
"org.apache.jackrabbit.core.integration.RepositoryFactoryImplTest",11,0.05,1.18,62,0.70,13857.95,15,4,16,27,6,141.09,43,76,0,4,120.47,0.00,0.75,0.30,4,5.00,2,2110.20,1,1,6,org.apache.jackrabbit.test.AbstractJCRTest,0.12,16,3,13,0,16,10,0,9,465,1
"org.apache.jackrabbit.core.integration.RepositoryFactoryImplTest$RepositoryManager",1,0.00,3.00,10,0.11,3833.83,1,0,16,4,0,105.22,0,15,0,1,105.22,0.00,0.00,0.00,0,1.00,3,316.70,0,1,0,java.lang.Object,0.00,3,0,3,0,3,0,0,0,68,3
"org.apache.jackrabbit.core.integration.RepositoryLockTest",2,0.50,2.50,21,0.25,6714.39,6,4,5,10,2,87.85,11,26,0,2,105.72,0.00,0.50,0.50,0,0.00,3,743.67,1,0,2,junit.framework.TestCase,0.00,8,1,5,0,8,2,0,5,156,1
"org.apache.jackrabbit.core.integration.RestoreSameNameSiblingTest",1,0.00,1.00,16,0.19,4420.64,1,0,5,15,1,53.25,11,20,0,4,97.38,0.00,0.75,0.00,0,0.00,1,572.92,0,0,1,org.apache.jackrabbit.test.AbstractJCRTest,0.00,14,3,1,0,14,1,0,7,113,1
"org.apache.jackrabbit.core.integration.SessionImplTest",2,0.00,2.00,17,0.22,5087.18,2,0,6,14,1,68.05,14,29,0,4,110.34,0.00,0.75,0.00,0,0.00,3,658.76,0,0,1,org.apache.jackrabbit.test.AbstractJCRTest,0.00,12,3,4,0,12,2,0,4,134,1
"org.apache.jackrabbit.core.integration.VersioningTest",5,0.12,2.60,133,1.76,80456.63,7,2,7,38,1,124.76,14,151,0,4,84.87,0.00,0.75,0.60,2,2.00,5,5274.97,2,0,1,org.apache.jackrabbit.test.AbstractJCRTest,0.29,33,3,13,0,33,5,0,5,939,1
"org.apache.jackrabbit.core.integration.WorkspaceInitTest",1,0.00,3.00,15,0.13,3014.68,1,0,5,8,1,81.61,5,13,0,4,99.48,0.00,0.75,0.00,0,1.00,3,377.17,0,0,1,org.apache.jackrabbit.test.AbstractJCRTest,0.00,7,3,3,0,7,1,0,3,79,1
"org.apache.jackrabbit.core.integration.WorkspaceInitTest$Runnable",1,0.00,2.00,5,0.04,574.94,1,0,5,4,0,123.04,0,8,0,1,123.04,0.00,0.00,0.00,0,1.00,2,120.59,0,0,0,java.lang.Object,0.00,3,0,2,0,3,1,0,0,31,0
"org.apache.jackrabbit.webdav.header.CodedUrlHeader",6,0.20,2.00,36,0.42,19606.68,9,3,3,15,8,81.92,37,45,7,1,114.14,0.00,0.00,0.17,1,14.00,5,1255.80,0,5,1,java.lang.Object,0.00,9,0,12,0,9,1,1,6,272,1
"org.apache.jackrabbit.webdav.header.DepthHeader",7,0.42,2.00,36,0.38,11574.69,9,2,4,14,10,87.20,47,48,8,1,119.42,0.00,0.00,0.14,1,24.00,4,1136.93,0,3,2,java.lang.Object,0.00,7,0,14,0,7,4,2,8,256,1
"org.apache.jackrabbit.webdav.header.Header",2,0.00,1.00,3,0.01,46.83,2,0,0,2,10,210.22,3,4,10,1,160.22,0.00,0.00,0.00,0,2.00,1,31.22,0,2,0,,0.00,0,0,2,0,0,0,0,1,14,1
"org.apache.jackrabbit.webdav.header.IfHeader",15,0.07,3.60,170,1.89,82672.59,20,5,12,47,9,120.53,281,221,7,1,102.40,0.00,0.00,0.27,4,40.00,16,5673.60,0,5,2,java.lang.Object,0.00,32,0,54,0,32,10,1,61,1070,1
"org.apache.jackrabbit.webdav.header.IfHeader$IfHeaderInterface",1,0.00,1.00,2,0.02,92.96,1,0,12,1,0,133.91,15,3,0,1,144.27,0.00,0.00,0.00,0,1.00,1,46.48,0,0,0,,0.00,0,0,1,0,0,1,0,1,16,2
"org.apache.jackrabbit.webdav.header.IfHeader$IfHeaderList",1,0.00,3.00,12,0.13,3616.66,1,0,12,3,0,102.00,16,13,0,2,102.47,0.00,0.50,0.00,0,0.00,3,381.64,0,0,0,java.util.ArrayList,0.00,2,1,3,0,2,1,1,2,79,2
"org.apache.jackrabbit.webdav.header.IfHeader$IfHeaderMap",1,0.00,2.00,9,0.12,3416.54,1,0,12,3,0,78.04,13,12,0,2,107.42,0.00,0.50,0.00,0,0.00,2,349.16,0,0,0,java.util.HashMap,0.00,2,1,2,0,2,1,1,1,75,2
"org.apache.jackrabbit.webdav.header.IfHeader$IfList",5,0.00,1.40,20,0.21,5317.98,5,0,12,9,0,74.63,49,25,0,2,124.63,0.00,0.50,0.00,0,8.00,3,634.37,1,0,0,java.util.ArrayList,0.00,4,1,7,0,4,5,0,6,144,2
"org.apache.jackrabbit.webdav.header.IfHeader$IfListEntry",6,0.07,1.33,17,0.14,2148.17,9,3,12,7,0,91.12,64,23,0,1,139.59,0.00,0.00,0.28,0,10.00,3,430.78,0,3,0,java.lang.Object,0.00,1,0,8,0,1,3,0,9,115,3
"org.apache.jackrabbit.webdav.header.IfHeader$IfListEntryEtag",3,0.00,1.00,7,0.05,450.34,3,0,12,3,0,94.53,25,11,0,2,142.63,0.00,0.50,0.00,0,3.00,1,141.86,1,1,0,org.apache.jackrabbit.webdav.header.IfListEntry,0.00,0,1,3,0,0,2,0,3,44,2
"org.apache.jackrabbit.webdav.header.IfHeader$IfListEntryToken",3,0.00,1.00,7,0.05,450.34,3,0,12,3,0,94.53,25,11,0,2,142.63,0.00,0.50,0.00,0,3.00,1,141.86,1,1,0,org.apache.jackrabbit.webdav.header.IfListEntry,0.00,0,1,3,0,0,2,0,3,44,2
"org.apache.jackrabbit.webdav.header.LabelHeader",5,0.38,1.40,19,0.16,3227.18,7,2,5,11,6,131.00,3,27,2,1,131.00,0.00,0.00,0.20,0,7.00,2,490.68,0,4,4,java.lang.Object,0.00,6,0,7,0,6,1,1,1,120,1
"org.apache.jackrabbit.webdav.header.OverwriteHeader",5,0.06,1.40,19,0.17,2753.38,9,4,4,8,5,152.16,17,26,3,1,131.54,0.00,0.00,0.30,0,2.00,2,510.42,0,2,2,java.lang.Object,0.00,3,0,7,0,3,3,1,4,124,1
"org.apache.jackrabbit.webdav.header.PollTimeoutHeader",3,0.00,1.00,9,0.08,1232.20,3,0,2,5,5,132.86,13,13,3,2,132.62,0.00,0.50,0.00,0,3.00,1,234.81,1,2,2,org.apache.jackrabbit.webdav.header.TimeoutHeader,0.22,2,1,3,0,2,1,0,2,61,1
"org.apache.jackrabbit.webdav.header.TimeoutHeader",6,0.30,2.00,33,0.38,16458.02,8,2,4,15,8,117.93,27,46,6,1,117.69,0.00,0.00,0.25,1,14.00,6,1138.55,0,3,2,java.lang.Object,0.00,9,0,12,1,9,3,2,5,234,1
"org.apache.jackrabbit.test.api.security.AbstractAccessControlTest",8,0.71,1.75,42,0.46,11493.28,9,1,8,15,13,119.93,3,55,11,4,119.93,9.33,0.09,0.38,1,10.00,2,1369.82,2,5,2,org.apache.jackrabbit.test.AbstractJCRTest,0.13,7,3,14,28,7,3,0,1,306,2
"org.apache.jackrabbit.test.api.security.AccessControlDiscoveryTest",19,0.00,1.89,172,2.55,95166.19,19,0,13,54,3,106.36,89,193,1,5,106.12,0.00,0.80,0.00,1,0.00,4,7637.73,2,1,2,org.apache.jackrabbit.test.api.security.AbstractAccessControlTest,0.00,35,4,36,0,35,18,0,30,1466,1
"org.apache.jackrabbit.test.api.security.AccessControlListTest",23,0.25,3.22,312,4.08,165173.21,28,5,20,75,3,148.81,31,357,1,5,98.81,0.00,0.80,0.44,2,0.00,7,12232.80,5,2,2,org.apache.jackrabbit.test.api.security.AbstractAccessControlTest,0.19,52,4,74,0,52,21,0,29,2273,1
"org.apache.jackrabbit.test.api.security.AccessControlListTest$AccessControlEntry",2,0.00,1.00,5,0.02,157.59,2,0,20,2,0,144.84,0,7,0,1,144.84,0.00,0.00,0.00,0,2.00,1,60.53,0,2,0,java.lang.Object,0.00,0,0,2,0,0,0,0,0,21,0
"org.apache.jackrabbit.test.api.security.AccessControlListTest$Privilege",5,0.00,1.00,11,0.05,564.06,5,0,20,5,0,143.61,0,16,0,1,143.61,0.00,0.00,0.00,0,5.00,1,159.73,0,3,0,java.lang.Object,0.00,0,0,5,0,0,2,0,0,52,0
"org.apache.jackrabbit.test.api.security.AccessControlPolicyIteratorTest",5,0.00,1.60,36,0.40,8424.58,6,1,6,19,3,163.96,7,46,1,5,113.96,0.00,0.80,1.00,0,0.00,3,1191.79,2,0,2,org.apache.jackrabbit.test.api.security.AbstractAccessControlTest,0.14,14,4,8,0,14,5,0,5,249,1
"org.apache.jackrabbit.test.api.security.AccessControlPolicyTest",24,0.04,2.67,275,3.33,106058.81,27,3,21,67,3,153.22,30,337,1,5,103.22,0.00,0.80,0.38,0,0.00,4,9989.61,7,0,2,org.apache.jackrabbit.test.api.security.AbstractAccessControlTest,0.18,43,4,64,0,43,24,0,28,1908,1
"org.apache.jackrabbit.test.api.security.AccessControlPolicyTest$AccessControlPolicy",0,0.00,0.00,1,0.00,12.00,0,0,21,0,0,171.00,0,0,0,1,171.00,0.00,0.00,0.00,0,0.00,0,8.00,0,0,0,java.lang.Object,0.00,0,0,0,0,0,0,0,0,4,0
"org.apache.jackrabbit.test.api.security.RSessionAccessControlDiscoveryTest",6,0.40,1.17,27,0.31,4503.14,9,3,7,18,3,125.86,5,38,1,5,125.86,0.00,0.80,0.67,0,0.00,2,923.70,2,0,2,org.apache.jackrabbit.test.api.security.AbstractAccessControlTest,0.27,12,4,7,0,12,6,0,1,213,1
"org.apache.jackrabbit.test.api.security.RSessionAccessControlPolicyTest",7,0.39,2.00,38,0.36,5539.26,10,3,9,21,3,171.94,10,58,1,5,121.94,0.00,0.80,0.67,0,0.00,3,1092.06,2,0,2,org.apache.jackrabbit.test.api.security.AbstractAccessControlTest,0.26,14,4,14,0,14,7,0,8,247,1
"org.apache.jackrabbit.test.api.security.RSessionAccessControlPolicyTest$AccessControlPolicy",2,0.00,1.00,5,0.03,323.55,2,0,9,4,0,142.38,0,7,0,1,142.38,0.00,0.00,0.00,0,2.00,1,89.65,0,2,0,java.lang.Object,0.00,2,0,2,0,2,0,0,0,28,0
"org.apache.jackrabbit.test.api.security.RSessionAccessControlTest",9,0.38,1.89,64,0.77,13113.95,13,4,10,30,3,114.42,8,89,1,4,114.42,0.00,0.75,0.58,0,0.00,2,2305.94,3,0,2,org.apache.jackrabbit.test.AbstractJCRTest,0.25,21,3,17,0,21,9,0,8,480,1
"org.apache.jackrabbit.test.api.security.TestAll",1,0.00,1.00,11,0.11,3828.97,1,0,3,3,8,83.80,14,13,1,2,103.94,0.00,0.50,0.00,0,1.00,1,341.05,0,1,7,junit.framework.TestCase,0.00,2,1,1,0,2,0,0,4,79,1
"org.apache.jackrabbit.jcr.Dumpable",1,0.00,1.00,2,0.01,30.51,1,0,1,1,1,110.52,12,3,1,1,148.08,0.00,0.00,0.00,0,1.00,1,25.51,0,0,0,,0.00,0,0,1,0,0,1,0,2,11,1
"org.apache.jackrabbit.jcr.LogUtil",4,0.33,2.50,32,0.40,13782.50,5,1,10,20,15,59.25,37,47,9,1,109.25,0.00,0.00,0.75,1,0.00,4,1200.02,0,4,6,java.lang.Object,0.00,16,0,10,0,16,0,0,6,250,1
"org.apache.jackrabbit.jcr.ReferenceChangeTracker",6,0.07,1.83,27,0.31,6851.63,9,3,10,23,5,92.10,41,40,2,1,124.32,0.00,0.00,0.39,0,2.00,4,915.83,0,2,3,java.lang.Object,0.00,17,0,11,0,17,4,0,10,207,1
"org.apache.jackrabbit.jcr.StateUtility",4,0.00,2.50,29,0.34,13277.48,4,0,8,15,9,132.15,12,38,3,1,111.54,0.00,0.00,0.00,0,4.00,5,1034.99,0,2,7,java.lang.Object,0.00,11,0,10,0,11,2,0,4,212,1
"org.apache.jackrabbit.spi.commons.logging.AbstractLogger",3,0.50,2.00,27,0.26,9025.87,4,1,1,8,8,70.29,36,39,7,1,107.85,0.00,0.00,0.67,0,1.00,3,767.97,0,2,1,java.lang.Object,0.00,5,0,6,8,5,1,0,7,169,1
"org.apache.jackrabbit.spi.commons.logging.AbstractLogger$Callable",1,0.00,1.00,2,0.01,51.30,1,0,1,1,0,146.30,0,3,0,1,146.30,0.00,0.00,0.00,0,1.00,1,27.65,0,1,0,,0.00,0,0,1,0,0,0,0,0,11,1
"org.apache.jackrabbit.spi.commons.logging.AbstractLogger$SafeCallable",1,0.00,1.00,2,0.01,29.41,1,0,1,1,0,148.21,0,3,0,1,148.21,0.00,0.00,0.00,0,1.00,1,19.61,0,1,0,,0.00,0,0,1,0,0,0,0,0,9,1
"org.apache.jackrabbit.spi.commons.logging.BatchLogger",12,1.00,1.00,37,0.40,6063.67,13,1,7,13,10,181.91,13,45,2,2,131.91,0.00,0.50,0.08,0,22.00,1,1209.92,1,1,8,org.apache.jackrabbit.spi.commons.logging.AbstractLogger,0.00,1,1,12,0,1,11,1,4,293,1
"org.apache.jackrabbit.spi.commons.logging.BatchLogger$Callable",1,0.00,1.00,4,0.03,283.82,1,0,7,1,0,129.22,0,4,0,1,129.22,0.00,0.00,0.00,0,0.00,1,85.66,0,1,0,java.lang.Object,0.00,0,0,1,0,0,0,0,0,23,0
"org.apache.jackrabbit.spi.commons.logging.BatchLogger$Callable_0",1,0.00,1.00,4,0.03,264.00,1,0,7,1,0,129.47,0,4,0,1,129.47,0.00,0.00,0.00,0,0.00,1,80.00,0,1,0,java.lang.Object,0.00,0,0,1,0,0,0,0,0,22,0
"org.apache.jackrabbit.spi.commons.logging.BatchLogger$Callable_1",1,0.00,1.00,4,0.03,264.00,1,0,7,1,0,129.47,0,4,0,1,129.47,0.00,0.00,0.00,0,0.00,1,80.00,0,1,0,java.lang.Object,0.00,0,0,1,0,0,0,0,0,22,0
"org.apache.jackrabbit.spi.commons.logging.BatchLogger$Callable_2",1,0.00,1.00,4,0.02,244.46,1,0,7,1,0,129.74,0,4,0,1,129.74,0.00,0.00,0.00,0,0.00,1,74.42,0,1,0,java.lang.Object,0.00,0,0,1,0,0,0,0,0,21,0
"org.apache.jackrabbit.spi.commons.logging.BatchLogger$Callable_3",1,0.00,1.00,4,0.02,244.46,1,0,7,1,0,129.74,0,4,0,1,129.74,0.00,0.00,0.00,0,0.00,1,74.42,0,1,0,java.lang.Object,0.00,0,0,1,0,0,0,0,0,21,0
"org.apache.jackrabbit.spi.commons.logging.BatchLogger$Callable_4",1,0.00,1.00,4,0.02,225.21,1,0,7,1,0,130.02,0,4,0,1,130.02,0.00,0.00,0.00,0,0.00,1,68.92,0,1,0,java.lang.Object,0.00,0,0,1,0,0,0,0,0,20,0
"org.apache.jackrabbit.spi.commons.logging.BatchLogger$Callable_5",1,0.00,1.00,4,0.03,264.00,1,0,7,1,0,129.47,0,4,0,1,129.47,0.00,0.00,0.00,0,0.00,1,80.00,0,1,0,java.lang.Object,0.00,0,0,1,0,0,0,0,0,22,0
"org.apache.jackrabbit.spi.commons.logging.BatchLogger$Callable_6",1,0.00,1.00,4,0.02,244.46,1,0,7,1,0,129.74,0,4,0,1,129.74,0.00,0.00,0.00,0,0.00,1,74.42,0,1,0,java.lang.Object,0.00,0,0,1,0,0,0,0,0,21,0
"org.apache.jackrabbit.spi.commons.logging.BatchLogger$Callable_7",1,0.00,1.00,4,0.02,244.46,1,0,7,1,0,129.74,0,4,0,1,129.74,0.00,0.00,0.00,0,0.00,1,74.42,0,1,0,java.lang.Object,0.00,0,0,1,0,0,0,0,0,21,0
"org.apache.jackrabbit.spi.commons.logging.BatchLogger$Callable_8",1,0.00,1.00,4,0.03,264.00,1,0,7,1,0,129.47,0,4,0,1,129.47,0.00,0.00,0.00,0,0.00,1,80.00,0,1,0,java.lang.Object,0.00,0,0,1,0,0,0,0,0,22,0
"org.apache.jackrabbit.spi.commons.logging.IdFactoryLogger",8,1.00,1.00,25,0.22,3424.36,9,1,5,9,8,182.48,12,28,1,2,132.48,0.00,0.50,0.12,0,14.00,1,667.41,1,7,7,org.apache.jackrabbit.spi.commons.logging.AbstractLogger,0.00,1,1,8,0,1,1,1,3,172,1
"org.apache.jackrabbit.spi.commons.logging.IdFactoryLogger$SafeCallable",1,0.00,1.00,3,0.02,151.81,1,0,5,1,0,136.03,0,3,0,1,136.03,0.00,0.00,0.00,0,0.00,1,54.60,0,1,0,java.lang.Object,0.00,0,0,1,0,0,0,0,0,17,0
"org.apache.jackrabbit.spi.commons.logging.IdFactoryLogger$SafeCallable_0",1,0.00,1.00,3,0.02,151.81,1,0,5,1,0,136.03,0,3,0,1,136.03,0.00,0.00,0.00,0,0.00,1,54.60,0,1,0,java.lang.Object,0.00,0,0,1,0,0,0,0,0,17,0
"org.apache.jackrabbit.spi.commons.logging.IdFactoryLogger$SafeCallable_1",1,0.00,1.00,3,0.02,151.81,1,0,5,1,0,136.03,0,3,0,1,136.03,0.00,0.00,0.00,0,0.00,1,54.60,0,1,0,java.lang.Object,0.00,0,0,1,0,0,0,0,0,17,0
"org.apache.jackrabbit.spi.commons.logging.IdFactoryLogger$SafeCallable_2",1,0.00,1.00,3,0.02,136.54,1,0,5,1,0,136.39,0,3,0,1,136.39,0.00,0.00,0.00,0,0.00,1,49.51,0,1,0,java.lang.Object,0.00,0,0,1,0,0,0,0,0,16,0
"org.apache.jackrabbit.spi.commons.logging.IdFactoryLogger$SafeCallable_3",1,0.00,1.00,3,0.02,136.54,1,0,5,1,0,136.39,0,3,0,1,136.39,0.00,0.00,0.00,0,0.00,1,49.51,0,1,0,java.lang.Object,0.00,0,0,1,0,0,0,0,0,16,0
"org.apache.jackrabbit.spi.commons.logging.IdFactoryLogger$SafeCallable_4",1,0.00,1.00,3,0.02,136.54,1,0,5,1,0,136.39,0,3,0,1,136.39,0.00,0.00,0.00,0,0.00,1,49.51,0,1,0,java.lang.Object,0.00,0,0,1,0,0,0,0,0,16,0
"org.apache.jackrabbit.spi.commons.logging.LogWriter",4,0.00,1.00,5,0.05,276.78,4,0,0,4,15,114.22,31,6,15,1,156.51,0.00,0.00,0.00,0,4.00,1,137.36,0,0,0,,0.00,0,0,4,0,0,4,0,5,43,1
"org.apache.jackrabbit.spi.commons.logging.LogWriterProvider",7,0.00,1.00,8,0.05,218.34,7,0,7,7,13,159.47,32,9,5,1,159.23,0.00,0.00,0.00,0,7.00,1,145.56,0,7,8,,0.00,0,0,7,0,0,0,0,8,53,1
"org.apache.jackrabbit.spi.commons.logging.NameFactoryLogger",4,1.00,1.00,13,0.10,1574.26,5,1,2,5,5,153.38,12,16,1,2,132.77,0.00,0.50,0.25,0,6.00,1,314.94,1,3,4,org.apache.jackrabbit.spi.commons.logging.AbstractLogger,0.00,1,1,4,0,1,1,1,3,84,1
"org.apache.jackrabbit.spi.commons.logging.NameFactoryLogger$SafeCallable",1,0.00,1.00,3,0.02,151.81,1,0,2,1,0,136.03,0,3,0,1,136.03,0.00,0.00,0.00,0,0.00,1,54.60,0,1,0,java.lang.Object,0.00,0,0,1,0,0,0,0,0,17,0
"org.apache.jackrabbit.spi.commons.logging.NameFactoryLogger$SafeCallable_0",1,0.00,1.00,3,0.02,136.54,1,0,2,1,0,136.39,0,3,0,1,136.39,0.00,0.00,0.00,0,0.00,1,49.51,0,1,0,java.lang.Object,0.00,0,0,1,0,0,0,0,0,16,0
"org.apache.jackrabbit.spi.commons.logging.PathFactoryLogger",16,1.00,1.00,49,0.50,8391.15,17,1,5,20,6,131.79,12,56,1,2,131.79,0.00,0.50,0.06,0,30.00,1,1499.93,1,15,5,org.apache.jackrabbit.spi.commons.logging.AbstractLogger,0.00,4,1,16,0,4,1,1,3,370,1
"org.apache.jackrabbit.spi.commons.logging.PathFactoryLogger$Callable",1,0.00,1.00,3,0.02,230.79,1,0,5,1,0,134.59,0,3,0,1,134.59,0.00,0.00,0.00,0,0.00,1,70.51,0,1,0,java.lang.Object,0.00,0,0,1,0,0,0,0,0,20,0
"org.apache.jackrabbit.spi.commons.logging.PathFactoryLogger$Callable_0",1,0.00,1.00,3,0.02,230.79,1,0,5,1,0,134.59,0,3,0,1,134.59,0.00,0.00,0.00,0,0.00,1,70.51,0,1,0,java.lang.Object,0.00,0,0,1,0,0,0,0,0,20,0
"org.apache.jackrabbit.spi.commons.logging.PathFactoryLogger$Callable_1",1,0.00,1.00,3,0.03,250.00,1,0,5,1,0,134.32,0,3,0,1,134.32,0.00,0.00,0.00,0,0.00,1,76.00,0,1,0,java.lang.Object,0.00,0,0,1,0,0,0,0,0,21,0
"org.apache.jackrabbit.spi.commons.logging.PathFactoryLogger$SafeCallable",1,0.00,1.00,3,0.02,136.54,1,0,5,1,0,136.39,0,3,0,1,136.39,0.00,0.00,0.00,0,0.00,1,49.51,0,1,0,java.lang.Object,0.00,0,0,1,0,0,0,0,0,16,0
"org.apache.jackrabbit.spi.commons.logging.PathFactoryLogger$SafeCallable_10",1,0.00,1.00,3,0.01,121.62,1,0,5,1,0,136.78,0,3,0,1,136.78,0.00,0.00,0.00,0,0.00,1,44.54,0,1,0,java.lang.Object,0.00,0,0,1,0,0,0,0,0,15,0
"org.apache.jackrabbit.spi.commons.logging.PathFactoryLogger$SafeCallable_11",1,0.00,1.00,3,0.01,121.62,1,0,5,1,0,136.78,0,3,0,1,136.78,0.00,0.00,0.00,0,0.00,1,44.54,0,1,0,java.lang.Object,0.00,0,0,1,0,0,0,0,0,15,0
"org.apache.jackrabbit.spi.commons.logging.PathFactoryLogger$SafeCallable_2",1,0.00,1.00,3,0.02,151.81,1,0,5,1,0,136.03,0,3,0,1,136.03,0.00,0.00,0.00,0,0.00,1,54.60,0,1,0,java.lang.Object,0.00,0,0,1,0,0,0,0,0,17,0
"org.apache.jackrabbit.spi.commons.logging.PathFactoryLogger$SafeCallable_3",1,0.00,1.00,3,0.02,136.54,1,0,5,1,0,136.39,0,3,0,1,136.39,0.00,0.00,0.00,0,0.00,1,49.51,0,1,0,java.lang.Object,0.00,0,0,1,0,0,0,0,0,16,0
"org.apache.jackrabbit.spi.commons.logging.PathFactoryLogger$SafeCallable_4",1,0.00,1.00,3,0.02,136.54,1,0,5,1,0,136.39,0,3,0,1,136.39,0.00,0.00,0.00,0,0.00,1,49.51,0,1,0,java.lang.Object,0.00,0,0,1,0,0,0,0,0,16,0
"org.apache.jackrabbit.spi.commons.logging.PathFactoryLogger$SafeCallable_5",1,0.00,1.00,3,0.02,136.54,1,0,5,1,0,136.39,0,3,0,1,136.39,0.00,0.00,0.00,0,0.00,1,49.51,0,1,0,java.lang.Object,0.00,0,0,1,0,0,0,0,0,16,0
"org.apache.jackrabbit.spi.commons.logging.PathFactoryLogger$SafeCallable_6",1,0.00,1.00,3,0.02,151.81,1,0,5,1,0,136.03,0,3,0,1,136.03,0.00,0.00,0.00,0,0.00,1,54.60,0,1,0,java.lang.Object,0.00,0,0,1,0,0,0,0,0,17,0
"org.apache.jackrabbit.spi.commons.logging.PathFactoryLogger$SafeCallable_7",1,0.00,1.00,3,0.02,136.54,1,0,5,1,0,136.39,0,3,0,1,136.39,0.00,0.00,0.00,0,0.00,1,49.51,0,1,0,java.lang.Object,0.00,0,0,1,0,0,0,0,0,16,0
"org.apache.jackrabbit.spi.commons.logging.PathFactoryLogger$SafeCallable_8",1,0.00,1.00,3,0.01,121.62,1,0,5,1,0,136.78,0,3,0,1,136.78,0.00,0.00,0.00,0,0.00,1,44.54,0,1,0,java.lang.Object,0.00,0,0,1,0,0,0,0,0,15,0
"org.apache.jackrabbit.spi.commons.logging.PathFactoryLogger$SafeCallable_9",1,0.00,1.00,3,0.01,121.62,1,0,5,1,0,136.78,0,3,0,1,136.78,0.00,0.00,0.00,0,0.00,1,44.54,0,1,0,java.lang.Object,0.00,0,0,1,0,0,0,0,0,15,0
"org.apache.jackrabbit.spi.commons.logging.QValueFactoryLogger",15,1.00,1.13,58,0.62,13709.25,16,1,12,20,8,129.86,12,63,1,2,129.86,0.00,0.50,0.07,0,28.00,2,1856.81,1,14,7,org.apache.jackrabbit.spi.commons.logging.AbstractLogger,0.00,5,1,17,0,5,1,1,3,430,1
"org.apache.jackrabbit.spi.commons.logging.QValueFactoryLogger$Callable",1,0.00,1.00,3,0.02,211.89,1,0,12,1,0,134.88,0,3,0,1,134.88,0.00,0.00,0.00,0,0.00,1,65.11,0,1,0,java.lang.Object,0.00,0,0,1,0,0,0,0,0,19,0
"org.apache.jackrabbit.spi.commons.logging.QValueFactoryLogger$Callable_0",1,0.00,1.00,3,0.02,193.32,1,0,12,1,0,135.20,0,3,0,1,135.20,0.00,0.00,0.00,0,0.00,1,59.81,0,1,0,java.lang.Object,0.00,0,0,1,0,0,0,0,0,18,0
"org.apache.jackrabbit.spi.commons.logging.QValueFactoryLogger$Callable_1",1,0.00,1.00,3,0.02,193.32,1,0,12,1,0,135.20,0,3,0,1,135.20,0.00,0.00,0.00,0,0.00,1,59.81,0,1,0,java.lang.Object,0.00,0,0,1,0,0,0,0,0,18,0
"org.apache.jackrabbit.spi.commons.logging.QValueFactoryLogger$Callable_10",1,0.00,2.00,6,0.05,814.70,1,0,12,1,0,118.89,0,9,0,1,118.89,0.00,0.00,0.00,0,0.00,2,141.78,0,1,0,java.lang.Object,0.00,0,0,2,0,0,0,0,0,34,0
"org.apache.jackrabbit.spi.commons.logging.QValueFactoryLogger$Callable_11",1,0.00,1.00,3,0.02,193.32,1,0,12,1,0,135.20,0,3,0,1,135.20,0.00,0.00,0.00,0,0.00,1,59.81,0,1,0,java.lang.Object,0.00,0,0,1,0,0,0,0,0,18,0
"org.apache.jackrabbit.spi.commons.logging.QValueFactoryLogger$Callable_2",1,0.00,1.00,3,0.02,193.32,1,0,12,1,0,135.20,0,3,0,1,135.20,0.00,0.00,0.00,0,0.00,1,59.81,0,1,0,java.lang.Object,0.00,0,0,1,0,0,0,0,0,18,0
"org.apache.jackrabbit.spi.commons.logging.QValueFactoryLogger$Callable_3",1,0.00,1.00,3,0.02,193.32,1,0,12,1,0,135.20,0,3,0,1,135.20,0.00,0.00,0.00,0,0.00,1,59.81,0,1,0,java.lang.Object,0.00,0,0,1,0,0,0,0,0,18,0
"org.apache.jackrabbit.spi.commons.logging.QValueFactoryLogger$Callable_4",1,0.00,1.00,3,0.02,193.32,1,0,12,1,0,135.20,0,3,0,1,135.20,0.00,0.00,0.00,0,0.00,1,59.81,0,1,0,java.lang.Object,0.00,0,0,1,0,0,0,0,0,18,0
"org.apache.jackrabbit.spi.commons.logging.QValueFactoryLogger$Callable_5",1,0.00,1.00,3,0.02,193.32,1,0,12,1,0,135.20,0,3,0,1,135.20,0.00,0.00,0.00,0,0.00,1,59.81,0,1,0,java.lang.Object,0.00,0,0,1,0,0,0,0,0,18,0
"org.apache.jackrabbit.spi.commons.logging.QValueFactoryLogger$Callable_6",1,0.00,1.00,3,0.02,193.32,1,0,12,1,0,135.20,0,3,0,1,135.20,0.00,0.00,0.00,0,0.00,1,59.81,0,1,0,java.lang.Object,0.00,0,0,1,0,0,0,0,0,18,0
"org.apache.jackrabbit.spi.commons.logging.QValueFactoryLogger$Callable_7",1,0.00,1.00,3,0.02,193.32,1,0,12,1,0,135.20,0,3,0,1,135.20,0.00,0.00,0.00,0,0.00,1,59.81,0,1,0,java.lang.Object,0.00,0,0,1,0,0,0,0,0,18,0
"org.apache.jackrabbit.spi.commons.logging.QValueFactoryLogger$Callable_8",1,0.00,1.00,3,0.02,193.32,1,0,12,1,0,135.20,0,3,0,1,135.20,0.00,0.00,0.00,0,0.00,1,59.81,0,1,0,java.lang.Object,0.00,0,0,1,0,0,0,0,0,18,0
"org.apache.jackrabbit.spi.commons.logging.QValueFactoryLogger$Callable_9",1,0.00,2.00,6,0.05,814.70,1,0,12,1,0,118.89,0,9,0,1,118.89,0.00,0.00,0.00,0,0.00,2,141.78,0,1,0,java.lang.Object,0.00,0,0,2,0,0,0,0,0,34,0
"org.apache.jackrabbit.spi.commons.logging.RepositoryServiceLogger",68,1.00,1.04,215,3.05,58395.75,69,1,34,71,30,130.09,13,291,1,2,130.09,1.00,0.33,0.01,0,134.00,2,9156.52,1,41,29,org.apache.jackrabbit.spi.commons.logging.AbstractLogger,0.00,3,1,71,1,3,27,1,4,2080,1
"org.apache.jackrabbit.spi.commons.logging.RepositoryServiceLogger$Callable",1,0.00,1.00,3,0.02,175.12,1,0,34,1,0,135.54,0,4,0,1,135.54,0.00,0.00,0.00,0,0.00,1,54.60,0,1,0,java.lang.Object,0.00,0,0,1,0,0,0,0,0,17,0
"org.apache.jackrabbit.spi.commons.logging.RepositoryServiceLogger$Callable_0",1,0.00,1.00,3,0.02,175.12,1,0,34,1,0,135.54,0,4,0,1,135.54,0.00,0.00,0.00,0,0.00,1,54.60,0,1,0,java.lang.Object,0.00,0,0,1,0,0,0,0,0,17,0
"org.apache.jackrabbit.spi.commons.logging.RepositoryServiceLogger$Callable_1",1,0.00,1.00,3,0.02,175.12,1,0,34,1,0,135.54,0,4,0,1,135.54,0.00,0.00,0.00,0,0.00,1,54.60,0,1,0,java.lang.Object,0.00,0,0,1,0,0,0,0,0,17,0
"org.apache.jackrabbit.spi.commons.logging.RepositoryServiceLogger$Callable_10",1,0.00,1.00,3,0.02,244.46,1,0,34,2,0,134.40,0,4,0,1,134.40,0.00,0.00,0.00,0,0.00,1,74.42,0,1,0,java.lang.Object,0.00,1,0,1,0,1,0,0,0,21,0
"org.apache.jackrabbit.spi.commons.logging.RepositoryServiceLogger$Callable_11",1,0.00,1.00,3,0.02,244.46,1,0,34,2,0,134.40,0,4,0,1,134.40,0.00,0.00,0.00,0,0.00,1,74.42,0,1,0,java.lang.Object,0.00,1,0,1,0,1,0,0,0,21,0
"org.apache.jackrabbit.spi.commons.logging.RepositoryServiceLogger$Callable_12",1,0.00,1.00,3,0.02,244.46,1,0,34,2,0,134.40,0,4,0,1,134.40,0.00,0.00,0.00,0,0.00,1,74.42,0,1,0,java.lang.Object,0.00,1,0,1,0,1,0,0,0,21,0
"org.apache.jackrabbit.spi.commons.logging.RepositoryServiceLogger$Callable_13",1,0.00,1.00,3,0.02,244.46,1,0,34,2,0,134.40,0,4,0,1,134.40,0.00,0.00,0.00,0,0.00,1,74.42,0,1,0,java.lang.Object,0.00,1,0,1,0,1,0,0,0,21,0
"org.apache.jackrabbit.spi.commons.logging.RepositoryServiceLogger$Callable_14",1,0.00,1.00,3,0.02,244.46,1,0,34,2,0,134.40,0,4,0,1,134.40,0.00,0.00,0.00,0,0.00,1,74.42,0,1,0,java.lang.Object,0.00,1,0,1,0,1,0,0,0,21,0
"org.apache.jackrabbit.spi.commons.logging.RepositoryServiceLogger$Callable_15",1,0.00,1.00,3,0.03,283.82,1,0,34,2,0,133.89,0,4,0,1,133.89,0.00,0.00,0.00,0,0.00,1,85.66,0,1,0,java.lang.Object,0.00,1,0,1,0,1,0,0,0,23,0
"org.apache.jackrabbit.spi.commons.logging.RepositoryServiceLogger$Callable_16",1,0.00,1.00,3,0.02,244.46,1,0,34,2,0,134.40,0,4,0,1,134.40,0.00,0.00,0.00,0,0.00,1,74.42,0,1,0,java.lang.Object,0.00,1,0,1,0,1,0,0,0,21,0
"org.apache.jackrabbit.spi.commons.logging.RepositoryServiceLogger$Callable_17",1,0.00,1.00,3,0.02,244.46,1,0,34,2,0,134.40,0,4,0,1,134.40,0.00,0.00,0.00,0,0.00,1,74.42,0,1,0,java.lang.Object,0.00,1,0,1,0,1,0,0,0,21,0
"org.apache.jackrabbit.spi.commons.logging.RepositoryServiceLogger$Callable_18",1,0.00,1.00,4,0.03,258.13,1,0,34,2,0,129.55,0,5,0,1,129.55,0.00,0.00,0.00,0,0.00,1,78.32,0,1,0,java.lang.Object,0.00,1,0,1,0,1,0,0,0,22,0
"org.apache.jackrabbit.spi.commons.logging.RepositoryServiceLogger$Callable_19",1,0.00,1.00,4,0.03,318.49,1,0,34,2,0,128.83,0,5,0,1,128.83,0.00,0.00,0.00,0,0.00,1,95.57,0,1,0,java.lang.Object,0.00,1,0,1,0,1,0,0,0,25,0
"org.apache.jackrabbit.spi.commons.logging.RepositoryServiceLogger$Callable_2",1,0.00,1.00,3,0.02,175.12,1,0,34,1,0,135.54,0,4,0,1,135.54,0.00,0.00,0.00,0,0.00,1,54.60,0,1,0,java.lang.Object,0.00,0,0,1,0,0,0,0,0,17,0
"org.apache.jackrabbit.spi.commons.logging.RepositoryServiceLogger$Callable_20",1,0.00,1.00,4,0.03,318.49,1,0,34,2,0,128.83,0,5,0,1,128.83,0.00,0.00,0.00,0,0.00,1,95.57,0,1,0,java.lang.Object,0.00,1,0,1,0,1,0,0,0,25,0
"org.apache.jackrabbit.spi.commons.logging.RepositoryServiceLogger$Callable_21",1,0.00,1.00,4,0.03,339.09,1,0,34,2,0,128.62,0,5,0,1,128.62,0.00,0.00,0.00,0,0.00,1,101.45,0,1,0,java.lang.Object,0.00,1,0,1,0,1,0,0,0,26,0
"org.apache.jackrabbit.spi.commons.logging.RepositoryServiceLogger$Callable_22",1,0.00,1.00,4,0.03,298.12,1,0,34,2,0,129.06,0,5,0,1,129.06,0.00,0.00,0.00,0,0.00,1,89.75,0,1,0,java.lang.Object,0.00,1,0,1,0,1,0,0,0,24,0
"org.apache.jackrabbit.spi.commons.logging.RepositoryServiceLogger$Callable_23",1,0.00,1.00,4,0.04,359.92,1,0,34,2,0,128.41,0,6,0,1,128.41,0.00,0.00,0.00,0,0.00,1,107.40,0,1,0,java.lang.Object,0.00,1,0,1,0,1,0,0,0,27,0
"org.apache.jackrabbit.spi.commons.logging.RepositoryServiceLogger$Callable_24",1,0.00,1.00,3,0.02,244.46,1,0,34,2,0,134.40,0,4,0,1,134.40,0.00,0.00,0.00,0,0.00,1,74.42,0,1,0,java.lang.Object,0.00,1,0,1,0,1,0,0,0,21,0
"org.apache.jackrabbit.spi.commons.logging.RepositoryServiceLogger$Callable_25",1,0.00,1.00,3,0.03,283.82,1,0,34,2,0,133.89,0,4,0,1,133.89,0.00,0.00,0.00,0,0.00,1,85.66,0,1,0,java.lang.Object,0.00,1,0,1,0,1,0,0,0,23,0
"org.apache.jackrabbit.spi.commons.logging.RepositoryServiceLogger$Callable_26",1,0.00,1.00,3,0.03,324.22,1,0,34,2,0,133.43,0,4,0,1,133.43,0.00,0.00,0.00,0,0.00,1,97.21,0,1,0,java.lang.Object,0.00,1,0,1,0,1,0,0,0,25,0
"org.apache.jackrabbit.spi.commons.logging.RepositoryServiceLogger$Callable_27",1,0.00,1.00,4,0.03,278.00,1,0,34,2,0,129.30,0,5,0,1,129.30,0.00,0.00,0.00,0,0.00,1,84.00,0,1,0,java.lang.Object,0.00,1,0,1,0,1,0,0,0,23,0
"org.apache.jackrabbit.spi.commons.logging.RepositoryServiceLogger$Callable_28",1,0.00,1.00,4,0.03,278.00,1,0,34,2,0,129.30,0,5,0,1,129.30,0.00,0.00,0.00,0,0.00,1,84.00,0,1,0,java.lang.Object,0.00,1,0,1,0,1,0,0,0,23,0
"org.apache.jackrabbit.spi.commons.logging.RepositoryServiceLogger$Callable_29",1,0.00,1.00,3,0.02,244.46,1,0,34,2,0,134.40,0,4,0,1,134.40,0.00,0.00,0.00,0,0.00,1,74.42,0,1,0,java.lang.Object,0.00,1,0,1,0,1,0,0,0,21,0
"org.apache.jackrabbit.spi.commons.logging.RepositoryServiceLogger$Callable_3",1,0.00,1.00,3,0.02,175.12,1,0,34,1,0,135.54,0,4,0,1,135.54,0.00,0.00,0.00,0,0.00,1,54.60,0,1,0,java.lang.Object,0.00,0,0,1,0,0,0,0,0,17,0
"org.apache.jackrabbit.spi.commons.logging.RepositoryServiceLogger$Callable_30",1,0.00,1.00,4,0.03,278.00,1,0,34,2,0,129.30,0,5,0,1,129.30,0.00,0.00,0.00,0,0.00,1,84.00,0,1,0,java.lang.Object,0.00,1,0,1,0,1,0,0,0,23,0
"org.apache.jackrabbit.spi.commons.logging.RepositoryServiceLogger$Callable_31",1,0.00,1.00,3,0.02,244.46,1,0,34,2,0,134.40,0,4,0,1,134.40,0.00,0.00,0.00,0,0.00,1,74.42,0,1,0,java.lang.Object,0.00,1,0,1,0,1,0,0,0,21,0
"org.apache.jackrabbit.spi.commons.logging.RepositoryServiceLogger$Callable_32",1,0.00,1.00,4,0.03,298.12,1,0,34,2,0,129.06,0,5,0,1,129.06,0.00,0.00,0.00,0,0.00,1,89.75,0,1,0,java.lang.Object,0.00,1,0,1,0,1,0,0,0,24,0
"org.apache.jackrabbit.spi.commons.logging.RepositoryServiceLogger$Callable_33",1,0.00,1.00,4,0.03,318.49,1,0,34,2,0,128.83,0,5,0,1,128.83,0.00,0.00,0.00,0,0.00,1,95.57,0,1,0,java.lang.Object,0.00,1,0,1,0,1,0,0,0,25,0
"org.apache.jackrabbit.spi.commons.logging.RepositoryServiceLogger$Callable_34",1,0.00,1.00,4,0.03,298.12,1,0,34,2,0,129.06,0,5,0,1,129.06,0.00,0.00,0.00,0,0.00,1,89.75,0,1,0,java.lang.Object,0.00,1,0,1,0,1,0,0,0,24,0
"org.apache.jackrabbit.spi.commons.logging.RepositoryServiceLogger$Callable_35",1,0.00,1.00,3,0.03,283.82,1,0,34,2,0,133.89,0,4,0,1,133.89,0.00,0.00,0.00,0,0.00,1,85.66,0,1,0,java.lang.Object,0.00,1,0,1,0,1,0,0,0,23,0
"org.apache.jackrabbit.spi.commons.logging.RepositoryServiceLogger$Callable_36",1,0.00,1.00,3,0.03,303.89,1,0,34,2,0,133.65,0,4,0,1,133.65,0.00,0.00,0.00,0,0.00,1,91.40,0,1,0,java.lang.Object,0.00,1,0,1,0,1,0,0,0,24,0
"org.apache.jackrabbit.spi.commons.logging.RepositoryServiceLogger$Callable_37",1,0.00,1.00,4,0.03,318.49,1,0,34,2,0,128.83,0,5,0,1,128.83,0.00,0.00,0.00,0,0.00,1,95.57,0,1,0,java.lang.Object,0.00,1,0,1,0,1,0,0,0,25,0
"org.apache.jackrabbit.spi.commons.logging.RepositoryServiceLogger$Callable_38",1,0.00,1.00,4,0.03,339.09,1,0,34,2,0,128.62,0,5,0,1,128.62,0.00,0.00,0.00,0,0.00,1,101.45,0,1,0,java.lang.Object,0.00,1,0,1,0,1,0,0,0,26,0
"org.apache.jackrabbit.spi.commons.logging.RepositoryServiceLogger$Callable_39",1,0.00,1.00,4,0.03,318.49,1,0,34,2,0,128.83,0,5,0,1,128.83,0.00,0.00,0.00,0,0.00,1,95.57,0,1,0,java.lang.Object,0.00,1,0,1,0,1,0,0,0,25,0
"org.apache.jackrabbit.spi.commons.logging.RepositoryServiceLogger$Callable_4",1,0.00,1.00,3,0.02,211.89,1,0,34,1,0,134.88,0,4,0,1,134.88,0.00,0.00,0.00,0,0.00,1,65.11,0,1,0,java.lang.Object,0.00,0,0,1,0,0,0,0,0,19,0
"org.apache.jackrabbit.spi.commons.logging.RepositoryServiceLogger$Callable_40",1,0.00,1.00,3,0.02,244.46,1,0,34,2,0,134.40,0,4,0,1,134.40,0.00,0.00,0.00,0,0.00,1,74.42,0,1,0,java.lang.Object,0.00,1,0,1,0,1,0,0,0,21,0
"org.apache.jackrabbit.spi.commons.logging.RepositoryServiceLogger$Callable_41",1,0.00,1.00,4,0.03,278.00,1,0,34,2,0,129.30,0,5,0,1,129.30,0.00,0.00,0.00,0,0.00,1,84.00,0,1,0,java.lang.Object,0.00,1,0,1,0,1,0,0,0,23,0
"org.apache.jackrabbit.spi.commons.logging.RepositoryServiceLogger$Callable_42",1,0.00,1.00,3,0.02,244.46,1,0,34,2,0,134.40,0,4,0,1,134.40,0.00,0.00,0.00,0,0.00,1,74.42,0,1,0,java.lang.Object,0.00,1,0,1,0,1,0,0,0,21,0
"org.apache.jackrabbit.spi.commons.logging.RepositoryServiceLogger$Callable_43",1,0.00,1.00,3,0.03,264.00,1,0,34,2,0,134.13,0,4,0,1,134.13,0.00,0.00,0.00,0,0.00,1,80.00,0,1,0,java.lang.Object,0.00,1,0,1,0,1,0,0,0,22,0
"org.apache.jackrabbit.spi.commons.logging.RepositoryServiceLogger$Callable_44",1,0.00,1.00,3,0.02,225.21,1,0,34,2,0,134.68,0,4,0,1,134.68,0.00,0.00,0.00,0,0.00,1,68.92,0,1,0,java.lang.Object,0.00,1,0,1,0,1,0,0,0,20,0
"org.apache.jackrabbit.spi.commons.logging.RepositoryServiceLogger$Callable_45",1,0.00,1.00,3,0.03,283.82,1,0,34,2,0,133.89,0,4,0,1,133.89,0.00,0.00,0.00,0,0.00,1,85.66,0,1,0,java.lang.Object,0.00,1,0,1,0,1,0,0,0,23,0
"org.apache.jackrabbit.spi.commons.logging.RepositoryServiceLogger$Callable_46",1,0.00,1.00,3,0.03,344.79,1,0,34,2,0,133.22,0,4,0,1,133.22,0.00,0.00,0.00,0,0.00,1,103.08,0,1,0,java.lang.Object,0.00,1,0,1,0,1,0,0,0,26,0
"org.apache.jackrabbit.spi.commons.logging.RepositoryServiceLogger$Callable_47",1,0.00,1.00,3,0.03,344.79,1,0,34,2,0,133.22,0,5,0,1,133.22,0.00,0.00,0.00,0,0.00,1,103.08,0,1,0,java.lang.Object,0.00,1,0,1,0,1,0,0,0,26,0
"org.apache.jackrabbit.spi.commons.logging.RepositoryServiceLogger$Callable_48",1,0.00,1.00,3,0.02,244.46,1,0,34,2,0,134.40,0,4,0,1,134.40,0.00,0.00,0.00,0,0.00,1,74.42,0,1,0,java.lang.Object,0.00,1,0,1,0,1,0,0,0,21,0
"org.apache.jackrabbit.spi.commons.logging.RepositoryServiceLogger$Callable_49",1,0.00,2.00,7,0.06,1159.41,1,0,34,2,0,115.19,0,10,0,1,115.19,0.00,0.00,0.00,0,0.00,2,193.44,0,1,0,java.lang.Object,0.00,1,0,2,0,1,0,0,0,43,0
"org.apache.jackrabbit.spi.commons.logging.RepositoryServiceLogger$Callable_5",1,0.00,1.00,3,0.02,244.46,1,0,34,2,0,134.40,0,4,0,1,134.40,0.00,0.00,0.00,0,0.00,1,74.42,0,1,0,java.lang.Object,0.00,1,0,1,0,1,0,0,0,21,0
"org.apache.jackrabbit.spi.commons.logging.RepositoryServiceLogger$Callable_50",1,0.00,1.00,4,0.02,244.46,1,0,34,1,0,129.74,0,5,0,1,129.74,0.00,0.00,0.00,0,0.00,1,74.42,0,1,0,java.lang.Object,0.00,0,0,1,0,0,0,0,0,21,0
"org.apache.jackrabbit.spi.commons.logging.RepositoryServiceLogger$Callable_51",1,0.00,1.00,4,0.02,225.21,1,0,34,1,0,130.02,0,5,0,1,130.02,0.00,0.00,0.00,0,0.00,1,68.92,0,1,0,java.lang.Object,0.00,0,0,1,0,0,0,0,0,20,0
"org.apache.jackrabbit.spi.commons.logging.RepositoryServiceLogger$Callable_52",1,0.00,1.00,3,0.02,225.21,1,0,34,2,0,134.68,0,4,0,1,134.68,0.00,0.00,0.00,0,0.00,1,68.92,0,1,0,java.lang.Object,0.00,1,0,1,0,1,0,0,0,20,0
"org.apache.jackrabbit.spi.commons.logging.RepositoryServiceLogger$Callable_53",1,0.00,1.00,3,0.02,244.46,1,0,34,2,0,134.40,0,4,0,1,134.40,0.00,0.00,0.00,0,0.00,1,74.42,0,1,0,java.lang.Object,0.00,1,0,1,0,1,0,0,0,21,0
"org.apache.jackrabbit.spi.commons.logging.RepositoryServiceLogger$Callable_54",1,0.00,1.00,3,0.02,244.46,1,0,34,2,0,134.40,0,4,0,1,134.40,0.00,0.00,0.00,0,0.00,1,74.42,0,1,0,java.lang.Object,0.00,1,0,1,0,1,0,0,0,21,0
"org.apache.jackrabbit.spi.commons.logging.RepositoryServiceLogger$Callable_55",1,0.00,1.00,4,0.03,298.12,1,0,34,2,0,129.06,0,5,0,1,129.06,0.00,0.00,0.00,0,0.00,1,89.75,0,1,0,java.lang.Object,0.00,1,0,1,0,1,0,0,0,24,0
"org.apache.jackrabbit.spi.commons.logging.RepositoryServiceLogger$Callable_56",1,0.00,1.00,4,0.03,278.00,1,0,34,2,0,129.30,0,5,0,1,129.30,0.00,0.00,0.00,0,0.00,1,84.00,0,1,0,java.lang.Object,0.00,1,0,1,0,1,0,0,0,23,0
"org.apache.jackrabbit.spi.commons.logging.RepositoryServiceLogger$Callable_57",1,0.00,1.00,3,0.02,225.21,1,0,34,2,0,134.68,0,4,0,1,134.68,0.00,0.00,0.00,0,0.00,1,68.92,0,1,0,java.lang.Object,0.00,1,0,1,0,1,0,0,0,20,0
"org.apache.jackrabbit.spi.commons.logging.RepositoryServiceLogger$Callable_58",1,0.00,1.00,3,0.02,244.46,1,0,34,2,0,134.40,0,4,0,1,134.40,0.00,0.00,0.00,0,0.00,1,74.42,0,1,0,java.lang.Object,0.00,1,0,1,0,1,0,0,0,21,0
"org.apache.jackrabbit.spi.commons.logging.RepositoryServiceLogger$Callable_59",1,0.00,1.00,4,0.03,298.12,1,0,34,2,0,129.06,0,5,0,1,129.06,0.00,0.00,0.00,0,0.00,1,89.75,0,1,0,java.lang.Object,0.00,1,0,1,0,1,0,0,0,24,0
"org.apache.jackrabbit.spi.commons.logging.RepositoryServiceLogger$Callable_6",1,0.00,1.00,3,0.02,244.46,1,0,34,2,0,134.40,0,4,0,1,134.40,0.00,0.00,0.00,0,0.00,1,74.42,0,1,0,java.lang.Object,0.00,1,0,1,0,1,0,0,0,21,0
"org.apache.jackrabbit.spi.commons.logging.RepositoryServiceLogger$Callable_60",1,0.00,1.00,4,0.03,278.00,1,0,34,2,0,129.30,0,5,0,1,129.30,0.00,0.00,0.00,0,0.00,1,84.00,0,1,0,java.lang.Object,0.00,1,0,1,0,1,0,0,0,23,0
"org.apache.jackrabbit.spi.commons.logging.RepositoryServiceLogger$Callable_61",1,0.00,1.00,4,0.03,298.12,1,0,34,2,0,129.06,0,5,0,1,129.06,0.00,0.00,0.00,0,0.00,1,89.75,0,1,0,java.lang.Object,0.00,1,0,1,0,1,0,0,0,24,0
"org.apache.jackrabbit.spi.commons.logging.RepositoryServiceLogger$Callable_62",1,0.00,1.00,4,0.03,278.00,1,0,34,2,0,129.30,0,5,0,1,129.30,0.00,0.00,0.00,0,0.00,1,84.00,0,1,0,java.lang.Object,0.00,1,0,1,0,1,0,0,0,23,0
"org.apache.jackrabbit.spi.commons.logging.RepositoryServiceLogger$Callable_7",1,0.00,1.00,4,0.03,258.13,1,0,34,2,0,129.55,0,5,0,1,129.55,0.00,0.00,0.00,0,0.00,1,78.32,0,1,0,java.lang.Object,0.00,1,0,1,0,1,0,0,0,22,0
"org.apache.jackrabbit.spi.commons.logging.RepositoryServiceLogger$Callable_8",1,0.00,1.00,3,0.02,225.21,1,0,34,2,0,134.68,0,4,0,1,134.68,0.00,0.00,0.00,0,0.00,1,68.92,0,1,0,java.lang.Object,0.00,1,0,1,0,1,0,0,0,20,0
"org.apache.jackrabbit.spi.commons.logging.RepositoryServiceLogger$Callable_9",1,0.00,1.00,3,0.03,333.08,1,0,34,3,0,133.34,0,4,0,1,133.34,0.00,0.00,0.00,0,0.00,1,99.74,0,1,0,java.lang.Object,0.00,2,0,1,0,2,0,0,0,26,0
"org.apache.jackrabbit.spi.commons.logging.SessionInfoLogger",8,1.00,1.00,25,0.19,2459.58,9,1,2,10,5,183.61,13,28,2,2,133.61,0.00,0.50,0.12,0,14.00,1,559.66,1,4,3,org.apache.jackrabbit.spi.commons.logging.AbstractLogger,0.00,2,1,8,0,2,4,1,4,149,1
"org.apache.jackrabbit.spi.commons.logging.SessionInfoLogger$Callable",1,0.00,1.00,3,0.02,175.12,1,0,2,1,0,135.54,0,4,0,1,135.54,0.00,0.00,0.00,0,0.00,1,54.60,0,1,0,java.lang.Object,0.00,0,0,1,0,0,0,0,0,17,0
"org.apache.jackrabbit.spi.commons.logging.SessionInfoLogger$Callable_1",1,0.00,1.00,4,0.02,225.21,1,0,2,1,0,130.02,0,5,0,1,130.02,0.00,0.00,0.00,0,0.00,1,68.92,0,1,0,java.lang.Object,0.00,0,0,1,0,0,0,0,0,20,0
"org.apache.jackrabbit.spi.commons.logging.SessionInfoLogger$Callable_2",1,0.00,1.00,4,0.02,225.21,1,0,2,1,0,130.02,0,5,0,1,130.02,0.00,0.00,0.00,0,0.00,1,68.92,0,1,0,java.lang.Object,0.00,0,0,1,0,0,0,0,0,20,0
"org.apache.jackrabbit.spi.commons.logging.SessionInfoLogger$Callable_3",1,0.00,1.00,4,0.02,225.21,1,0,2,1,0,130.02,0,5,0,1,130.02,0.00,0.00,0.00,0,0.00,1,68.92,0,1,0,java.lang.Object,0.00,0,0,1,0,0,0,0,0,20,0
"org.apache.jackrabbit.spi.commons.logging.SessionInfoLogger$SafeCallable",1,0.00,1.00,3,0.01,121.62,1,0,2,1,0,136.78,0,4,0,1,136.78,0.00,0.00,0.00,0,0.00,1,44.54,0,1,0,java.lang.Object,0.00,0,0,1,0,0,0,0,0,15,0
"org.apache.jackrabbit.spi.commons.logging.SessionInfoLogger$SafeCallable_0",1,0.00,1.00,3,0.01,121.62,1,0,2,1,0,136.78,0,4,0,1,136.78,0.00,0.00,0.00,0,0.00,1,44.54,0,1,0,java.lang.Object,0.00,0,0,1,0,0,0,0,0,15,0
"org.apache.jackrabbit.spi.commons.logging.Slf4jLogWriter",10,0.78,1.50,44,0.50,9652.41,11,1,3,20,2,164.83,28,60,1,1,124.95,0.00,0.00,0.30,2,22.00,2,1490.25,0,3,1,java.lang.Object,0.00,10,0,15,0,10,7,1,7,344,1
"org.apache.jackrabbit.spi.commons.logging.Slf4jLogWriterProvider",8,0.00,1.12,18,0.15,1894.43,8,0,9,12,12,123.17,46,29,2,1,141.05,0.00,0.00,0.00,1,8.00,2,443.83,0,8,10,java.lang.Object,0.00,4,0,9,0,4,0,1,9,123,1
"org.apache.jackrabbit.spi.commons.logging.SpiLoggerFactory",9,0.00,3.33,76,0.71,25807.80,9,0,10,19,18,72.25,113,114,1,1,109.81,0.00,0.00,0.00,1,9.00,4,2125.10,0,8,17,java.lang.Object,0.00,10,0,30,0,10,1,0,11,463,2
"org.apache.jackrabbit.spi.commons.logging.SpiLoggerFactory$ServiceLogger",9,0.12,1.89,29,0.41,10943.88,10,1,10,9,11,128.76,0,59,0,3,128.76,0.00,0.67,0.89,0,0.00,2,1223.39,7,8,11,org.apache.jackrabbit.spi.commons.logging.RepositoryServiceLogger,0.15,0,2,17,0,0,1,0,0,282,2
"org.apache.jackrabbit.spi.commons.logging.WriterLogWriter",11,0.45,1.18,46,0.49,8435.76,13,2,3,22,2,165.67,29,62,1,1,125.79,0.00,0.00,0.09,3,20.00,2,1466.29,0,3,1,java.lang.Object,0.00,11,0,13,0,11,8,1,7,353,1
"org.apache.jackrabbit.spi.commons.logging.WriterLogWriterProvider",9,0.25,1.00,20,0.16,1702.48,10,1,8,12,10,123.97,53,30,0,1,141.84,0.00,0.00,0.78,1,0.00,1,490.20,0,8,10,java.lang.Object,0.00,3,0,9,0,3,1,1,11,138,1
"org.apache.jackrabbit.jcr.AbstractMoveTest",4,0.20,1.25,24,0.24,4392.37,9,5,9,11,9,167.98,7,30,8,4,117.98,3.00,0.23,0.35,1,6.00,2,719.55,2,0,1,org.apache.jackrabbit.test.AbstractJCRTest,0.30,7,3,5,9,7,4,0,5,164,1
"org.apache.jackrabbit.jcr.AbstractMoveTreeTest",5,0.22,1.40,39,0.43,9027.65,14,9,12,15,3,113.75,3,45,2,4,113.75,0.67,0.50,0.29,3,6.00,3,1280.30,2,0,1,org.apache.jackrabbit.test.AbstractJCRTest,0.29,10,3,7,2,10,5,0,1,268,1
"org.apache.jackrabbit.jcr.AbstractRepositoryConfig",3,0.17,1.00,10,0.09,1497.77,6,3,4,4,4,181.95,4,14,2,1,131.95,0.00,0.00,0.22,0,5.00,1,256.12,0,1,2,java.lang.Object,0.00,1,0,3,0,1,2,1,2,65,2
"org.apache.jackrabbit.jcr.AccessByRelativePathTest",14,0.00,1.64,67,0.80,18270.12,16,2,7,31,3,91.67,97,97,1,4,123.89,0.00,0.75,0.50,0,0.00,4,2385.13,0,0,2,org.apache.jackrabbit.test.AbstractJCRTest,0.00,17,3,23,0,17,14,0,18,517,1
"org.apache.jackrabbit.jcr.AddNewPropertyTest",5,0.25,1.80,26,0.29,5233.46,7,2,11,14,3,103.14,26,39,1,4,121.01,0.00,0.75,0.30,0,0.00,2,872.73,2,0,2,org.apache.jackrabbit.test.AbstractJCRTest,0.29,9,3,9,0,9,5,0,6,194,1
"org.apache.jackrabbit.jcr.AddPropertyTest",8,0.07,1.12,84,1.06,23618.54,10,2,9,25,5,106.34,1,100,1,4,106.34,0.00,0.75,0.44,1,0.00,2,3173.80,1,0,4,org.apache.jackrabbit.test.AbstractJCRTest,0.13,17,3,9,0,17,8,0,1,653,1
"org.apache.jackrabbit.jcr.ExternalModificationTest",16,0.45,1.81,228,3.53,100341.16,20,4,11,52,5,138.09,34,264,1,4,98.21,0.00,0.75,0.67,1,0.00,4,10577.24,2,0,4,org.apache.jackrabbit.test.AbstractJCRTest,0.21,36,3,29,0,36,16,0,34,1936,1
"org.apache.jackrabbit.jcr.GetPropertyTest",13,0.27,1.38,133,1.99,46709.31,18,5,13,59,4,145.51,29,159,1,4,105.62,0.00,0.75,0.45,0,0.00,4,5959.84,2,0,3,org.apache.jackrabbit.test.AbstractJCRTest,0.22,46,3,18,0,46,13,0,29,1156,1
"org.apache.jackrabbit.jcr.HierarchyNodeTest",4,0.43,2.50,54,0.83,29415.33,11,7,13,29,3,148.79,6,66,1,4,98.79,0.00,0.75,0.46,1,0.00,6,2489.18,2,0,2,org.apache.jackrabbit.test.AbstractJCRTest,0.30,25,3,10,0,25,4,0,4,462,1
"org.apache.jackrabbit.jcr.IsSameTest",19,1.00,1.26,199,2.85,65485.99,20,1,10,45,2,145.67,44,251,1,4,105.79,0.00,0.75,0.00,0,0.00,3,8535.71,0,0,1,org.apache.jackrabbit.test.AbstractJCRTest,0.00,26,3,24,0,26,19,0,23,1655,1
"org.apache.jackrabbit.jcr.ItemCache",2,0.00,1.00,3,0.01,59.70,2,0,2,2,4,117.09,15,4,3,2,159.39,0.00,0.50,0.00,0,2.00,1,41.60,0,1,1,,0.00,0,1,2,0,0,1,0,3,17,1
"org.apache.jackrabbit.jcr.ItemCacheImpl",9,0.12,2.67,64,0.81,21735.01,11,2,10,32,5,112.85,38,89,1,1,112.61,0.00,0.00,0.61,3,0.00,6,2434.22,0,1,4,java.lang.Object,0.00,23,0,24,0,23,8,2,17,494,1
"org.apache.jackrabbit.jcr.ItemImpl",32,0.01,2.12,173,2.09,64928.78,36,4,33,92,23,76.42,246,233,7,1,118.71,0.00,0.00,0.24,11,250.00,8,6259.63,0,9,16,java.lang.Object,0.00,60,0,68,4,60,23,2,78,1306,2
"org.apache.jackrabbit.jcr.ItemLifeCycleListener",3,0.00,1.00,4,0.02,80.99,3,0,1,3,6,109.73,29,5,6,1,159.73,0.00,0.00,0.00,0,3.00,1,67.16,0,0,0,,0.00,0,0,3,0,0,3,0,4,25,1
"org.apache.jackrabbit.jcr.ItemManager",11,0.00,1.00,12,0.10,582.92,11,0,11,11,18,109.32,92,13,15,1,157.42,0.00,0.00,0.00,0,11.00,1,311.10,0,5,3,,0.00,0,0,11,0,0,6,0,12,100,1
"org.apache.jackrabbit.jcr.ItemManagerImpl",18,0.09,2.50,125,1.43,33141.47,22,4,29,59,24,83.83,109,183,1,1,116.05,0.00,0.00,0.33,4,0.00,4,4292.49,0,6,24,java.lang.Object,0.00,41,0,45,0,41,12,3,57,912,1
"org.apache.jackrabbit.jcr.Jcr2SpiTestSuite",1,0.00,1.00,10,0.19,5006.69,1,0,1,9,8,104.80,4,12,1,2,104.56,0.00,0.50,0.00,0,1.00,1,564.55,0,0,7,junit.framework.TestSuite,0.00,8,1,1,0,8,1,0,2,131,1
"org.apache.jackrabbit.jcr.JcrLockManager",9,0.22,1.00,30,0.40,6085.53,13,4,8,23,6,113.04,45,40,1,1,130.92,0.00,0.00,0.44,0,0.00,1,1201.22,0,3,5,java.lang.Object,0.00,14,0,9,0,14,6,1,11,280,1
"org.apache.jackrabbit.jcr.JcrVersionManager",22,0.17,1.09,85,1.34,22893.69,27,5,23,58,10,150.04,77,106,1,1,129.42,0.00,0.00,0.36,2,0.00,2,4007.58,0,11,9,java.lang.Object,0.00,36,0,24,0,36,11,1,31,859,1
"org.apache.jackrabbit.jcr.LazyItemIterator",12,0.12,1.92,77,0.75,21377.87,19,7,21,29,10,68.12,99,104,4,1,116.22,0.00,0.00,0.25,1,12.00,6,2258.07,0,5,6,java.lang.Object,0.00,17,0,23,0,17,7,3,30,474,1
"org.apache.jackrabbit.jcr.LazyItemIteratorTest",4,0.00,2.25,41,0.44,15964.44,4,0,5,14,3,105.39,16,52,1,4,105.15,0.00,0.75,0.00,0,0.00,3,1315.73,1,0,2,org.apache.jackrabbit.test.AbstractJCRTest,0.15,10,3,9,0,10,4,0,11,269,1
"org.apache.jackrabbit.jcr.LoginTest",3,1.00,1.00,17,0.20,3213.67,4,1,5,10,2,121.07,1,27,1,4,121.07,0.00,0.75,0.00,0,0.00,1,597.38,0,0,1,org.apache.jackrabbit.test.AbstractJCRTest,0.00,7,3,3,0,7,3,0,1,136,1
"org.apache.jackrabbit.jcr.ManagerProvider",13,0.00,1.00,14,0.09,491.11,13,0,13,13,25,198.46,26,15,13,1,158.58,0.00,0.00,0.00,0,13.00,1,273.68,0,13,12,,0.00,0,0,13,0,0,0,0,4,97,1
"org.apache.jackrabbit.jcr.MixinModificationTest",4,1.00,3.00,55,0.70,24275.03,5,1,11,27,5,139.29,11,77,1,4,99.40,0.00,0.75,0.00,1,0.00,5,2100.19,0,0,4,org.apache.jackrabbit.test.AbstractJCRTest,0.00,23,3,12,0,23,4,0,11,397,1
"org.apache.jackrabbit.jcr.MoveCombinedTest",8,0.07,1.12,44,0.48,7260.81,10,2,6,24,2,121.61,1,54,1,5,121.61,0.00,0.80,0.44,0,0.00,2,1443.20,3,0,1,org.apache.jackrabbit.jcr2spi.AbstractMoveTest,0.43,16,4,9,0,16,8,0,1,323,1
"org.apache.jackrabbit.jcr.MoveMultipleTest",11,0.25,1.09,126,1.98,55317.97,13,2,8,40,3,103.22,47,142,1,5,102.99,0.00,0.80,0.27,0,0.00,2,5944.53,2,0,2,org.apache.jackrabbit.jcr2spi.AbstractMoveTest,0.26,29,4,12,0,29,11,0,21,1155,1
"org.apache.jackrabbit.jcr.MoveNewTreeTest",9,1.00,1.56,58,0.68,14168.96,10,1,8,28,2,156.58,18,74,1,5,116.70,0.00,0.80,0.00,0,0.00,4,2029.99,0,0,1,org.apache.jackrabbit.jcr2spi.AbstractMoveTreeTest,0.27,19,4,14,0,19,9,0,7,433,1
"org.apache.jackrabbit.jcr.MoveReferenceableTest",6,1.00,1.17,32,0.36,5797.77,7,1,5,18,3,121.62,25,40,1,5,121.38,0.00,0.80,0.00,0,0.00,2,1075.58,2,0,2,org.apache.jackrabbit.jcr2spi.AbstractMoveTest,0.30,12,4,7,0,12,6,0,12,240,1
"org.apache.jackrabbit.jcr.MoveSNSTest",9,0.04,2.00,72,0.80,16223.46,12,3,8,25,3,111.75,44,87,1,5,111.51,0.00,0.80,0.37,0,0.00,4,2394.83,3,0,2,org.apache.jackrabbit.jcr2spi.AbstractMoveTest,0.42,16,4,18,0,16,9,0,15,491,1
"org.apache.jackrabbit.jcr.MoveTest",13,1.00,2.23,95,1.19,30417.20,14,1,11,34,4,94.89,77,132,2,5,112.76,0.25,0.67,0.00,0,0.00,4,3578.63,1,0,2,org.apache.jackrabbit.jcr2spi.AbstractMoveTest,0.12,21,4,29,1,21,13,0,34,719,1
"org.apache.jackrabbit.jcr.MoveToNewTest",9,0.75,1.44,109,1.40,35622.12,13,4,7,40,3,152.33,14,128,1,4,102.33,0.00,0.75,0.92,0,0.00,2,4190.08,2,0,2,org.apache.jackrabbit.test.AbstractJCRTest,0.25,31,3,13,0,31,9,0,14,812,1
"org.apache.jackrabbit.jcr.MoveTreeTest",10,1.00,1.70,58,0.66,13739.39,11,1,5,25,2,120.09,8,75,1,5,120.09,0.00,0.80,0.00,0,0.00,3,1973.41,0,0,1,org.apache.jackrabbit.jcr2spi.AbstractMoveTreeTest,0.26,15,4,17,0,15,10,0,6,428,1
"org.apache.jackrabbit.jcr.MultiValuedPropertyTest",7,1.00,3.00,57,0.56,13656.42,8,1,8,18,4,68.86,51,92,1,4,111.15,0.00,0.75,0.00,0,0.00,3,1682.35,0,0,3,org.apache.jackrabbit.test.AbstractJCRTest,0.00,11,3,21,0,11,7,0,15,347,1
"org.apache.jackrabbit.jcr.NamespaceRegistryImpl",7,0.08,1.29,25,0.31,6483.23,9,2,7,19,2,130.02,32,37,1,1,129.78,0.00,0.00,0.57,0,0.00,2,930.45,0,4,1,java.lang.Object,0.00,12,0,9,0,12,3,1,11,219,1
"org.apache.jackrabbit.jcr.NamespaceStorage",5,0.00,1.00,6,0.06,404.62,5,0,5,5,2,155.97,3,7,2,1,155.97,0.00,0.00,0.00,0,5.00,1,185.88,0,3,0,,0.00,0,0,5,0,0,2,0,1,57,1
"org.apache.jackrabbit.jcr.NodeImpl",109,0.85,2.13,719,10.17,325908.96,110,1,68,299,45,96.56,614,963,7,2,114.43,2.00,0.25,0.16,37,0.00,7,30509.12,7,68,39,org.apache.jackrabbit.jcr2spi.ItemImpl,0.04,190,1,232,2,190,41,1,246,5959,1
"org.apache.jackrabbit.jcr.NodeOrderTest",7,0.08,1.57,53,0.70,18208.26,9,2,8,23,3,152.36,19,71,1,4,112.48,0.00,0.75,0.43,1,0.00,4,2098.54,2,0,2,org.apache.jackrabbit.test.AbstractJCRTest,0.27,16,3,11,0,16,7,0,5,435,1
"org.apache.jackrabbit.jcr.PropertyImpl",43,0.50,1.88,254,3.26,113963.84,45,2,29,98,16,118.06,191,327,2,2,117.82,0.00,0.50,0.01,13,103.00,9,9781.57,5,15,14,org.apache.jackrabbit.jcr2spi.ItemImpl,0.08,55,1,81,0,55,28,1,68,1980,1
"org.apache.jackrabbit.jcr.PropertyLengthTest",12,1.00,2.25,81,1.08,46479.55,13,1,12,42,3,113.53,3,109,0,4,113.53,0.00,0.75,0.08,2,22.00,13,3252.46,0,1,3,org.apache.jackrabbit.test.AbstractJCRTest,0.00,30,3,27,0,30,11,0,1,620,1
"org.apache.jackrabbit.jcr.RefreshFalseTest",6,0.00,1.83,48,0.56,10408.99,8,2,11,25,3,161.66,10,63,1,4,111.66,0.00,0.75,0.50,0,0.00,3,1683.38,2,0,2,org.apache.jackrabbit.test.AbstractJCRTest,0.28,19,3,11,0,19,6,0,8,347,1
"org.apache.jackrabbit.jcr.RefreshMovedTest",4,0.42,1.25,32,0.40,7361.40,8,4,7,20,2,93.68,23,41,1,4,111.55,0.00,0.75,0.56,0,0.00,2,1210.20,2,0,1,org.apache.jackrabbit.test.AbstractJCRTest,0.30,16,3,5,0,16,4,0,11,255,1
"org.apache.jackrabbit.jcr.RefreshTrueTest",6,0.00,1.67,52,0.63,13174.62,8,2,9,31,3,160.88,11,66,1,4,110.88,0.00,0.75,0.50,0,0.00,3,1894.42,2,0,2,org.apache.jackrabbit.test.AbstractJCRTest,0.28,25,3,10,0,25,6,0,9,390,1
"org.apache.jackrabbit.jcr.RemoveItemTest",11,0.07,1.73,60,0.51,7724.78,14,3,13,22,4,143.00,42,87,2,4,122.39,1.33,0.38,0.39,0,0.00,4,1542.07,2,1,2,org.apache.jackrabbit.test.AbstractJCRTest,0.24,11,3,19,4,11,10,0,18,364,2
"org.apache.jackrabbit.jcr.RemoveMovedNodeTest",7,1.00,1.00,54,0.60,11857.87,8,1,3,19,2,164.05,9,62,1,5,114.05,0.00,0.80,0.00,0,3.00,1,1806.34,3,0,1,org.apache.jackrabbit.jcr2spi.AbstractMoveTest,0.44,12,4,7,0,12,7,0,9,390,1
"org.apache.jackrabbit.jcr.RemoveNewNodeTest",6,0.00,2.17,39,0.35,6551.73,8,2,8,21,2,138.49,23,59,0,4,117.87,0.00,0.75,0.50,0,0.00,6,1064.05,2,0,2,org.apache.jackrabbit.test.AbstractJCRTest,0.28,15,3,13,0,15,6,0,12,242,1
"org.apache.jackrabbit.jcr.RemoveNodeTest",6,1.00,2.33,52,0.56,11026.74,7,1,9,25,5,93.54,30,76,3,5,111.41,0.50,0.57,0.00,0,0.00,3,1693.17,0,1,2,org.apache.jackrabbit.jcr2spi.RemoveItemTest,0.12,19,4,14,2,19,5,0,16,355,1
"org.apache.jackrabbit.jcr.RemovePropertyTest",5,1.00,2.60,40,0.41,8823.21,6,1,13,18,3,93.65,27,60,1,5,111.53,0.00,0.80,0.00,0,0.00,3,1241.37,0,1,2,org.apache.jackrabbit.jcr2spi.RemoveItemTest,0.13,13,4,13,0,13,4,0,13,268,1
"org.apache.jackrabbit.jcr.RemoveReferenceableNodeTest",3,0.00,2.33,23,0.24,5077.23,5,2,7,13,3,95.98,16,33,1,6,113.86,0.00,0.83,0.50,0,0.00,3,719.84,1,1,2,org.apache.jackrabbit.jcr2spi.RemoveNodeTest,0.14,10,5,7,0,10,2,0,8,156,1
"org.apache.jackrabbit.jcr.RemoveSNSTest",6,0.20,2.00,43,0.47,8147.64,9,3,7,19,3,96.77,32,60,1,6,114.65,0.00,0.83,0.50,0,0.00,3,1395.56,1,1,2,org.apache.jackrabbit.jcr2spi.RemoveNodeTest,0.26,13,5,12,0,13,5,0,14,294,1
"org.apache.jackrabbit.jcr.RenameTest",4,0.22,1.00,20,0.19,2634.01,7,3,3,10,2,122.73,3,25,1,5,122.73,0.00,0.80,0.50,0,0.00,1,574.05,2,0,1,org.apache.jackrabbit.jcr2spi.AbstractMoveTest,0.32,6,4,4,0,6,4,0,1,138,1
"org.apache.jackrabbit.jcr.ReorderMixedTest",1,1.00,1.00,8,0.11,1902.39,2,1,8,4,2,132.10,3,10,1,5,111.49,0.00,0.80,0.00,0,0.00,1,326.12,0,0,1,org.apache.jackrabbit.jcr2spi.ReorderTest,0.14,3,4,1,0,3,1,0,1,73,1
"org.apache.jackrabbit.jcr.ReorderMoveTest",13,0.25,1.38,120,2.02,64748.33,17,4,10,37,5,106.45,53,140,1,4,106.21,0.00,0.75,0.48,3,0.00,2,6046.91,2,2,4,org.apache.jackrabbit.test.AbstractJCRTest,0.22,24,3,18,0,24,11,0,25,1181,1
"org.apache.jackrabbit.jcr.ReorderNewAndSavedTest",3,1.00,1.00,18,0.25,4417.10,4,1,9,8,2,167.03,3,22,1,5,117.03,0.00,0.80,0.00,0,0.00,1,736.18,2,0,1,org.apache.jackrabbit.jcr2spi.ReorderTest,0.39,5,4,3,0,5,3,0,1,163,1
"org.apache.jackrabbit.jcr.ReorderNewSNSTest",3,1.00,1.67,21,0.28,5302.98,4,1,10,10,2,163.79,5,27,1,5,113.79,0.00,0.80,0.00,0,0.00,2,844.57,2,0,1,org.apache.jackrabbit.jcr2spi.ReorderTest,0.39,7,4,5,0,7,3,0,3,178,1
"org.apache.jackrabbit.jcr.ReorderNewTest",3,1.00,1.67,21,0.28,5077.53,4,1,10,10,2,163.93,5,27,1,5,113.93,0.00,0.80,0.00,0,0.00,2,838.07,2,0,1,org.apache.jackrabbit.jcr2spi.ReorderTest,0.39,7,4,5,0,7,3,0,3,176,1
"org.apache.jackrabbit.jcr.ReorderReferenceableSNSTest",1,1.00,3.00,17,0.21,9429.89,2,1,5,7,3,114.17,3,18,1,5,93.55,0.00,0.80,0.00,0,0.00,3,616.57,0,0,2,org.apache.jackrabbit.jcr2spi.ReorderTest,0.14,6,4,3,0,6,1,0,1,123,1
"org.apache.jackrabbit.jcr.ReorderSNSTest",3,1.00,1.00,27,0.37,8040.38,4,1,9,13,2,158.41,3,31,1,5,108.41,0.00,0.80,0.00,0,0.00,1,1110.44,1,0,1,org.apache.jackrabbit.jcr2spi.ReorderTest,0.13,10,4,3,0,10,3,0,1,242,1
"org.apache.jackrabbit.jcr.ReorderTest",12,0.44,1.50,83,1.07,28360.61,17,5,14,32,9,115.31,3,104,7,4,115.31,2.00,0.30,0.60,3,0.00,4,3210.95,2,1,2,org.apache.jackrabbit.test.AbstractJCRTest,0.23,20,3,18,6,20,11,0,1,690,1
"org.apache.jackrabbit.jcr.ReplaceNodeTest",4,0.33,2.25,33,0.41,9101.66,7,3,7,18,3,110.93,17,45,1,4,110.69,0.00,0.75,0.58,0,0.00,4,1219.56,2,0,2,org.apache.jackrabbit.test.AbstractJCRTest,0.30,14,3,9,0,14,4,0,15,252,1
"org.apache.jackrabbit.jcr.RepositoryImpl",9,0.08,1.78,53,0.63,20969.79,12,3,22,32,14,86.06,60,69,8,2,118.28,0.00,0.50,0.26,2,23.00,4,1883.60,0,7,6,org.apache.jackrabbit.commons.AbstractRepository,0.00,23,1,16,0,23,2,1,15,402,1
"org.apache.jackrabbit.jcr.RepositoryImpl$Factory",1,0.00,9.00,37,0.67,46999.74,3,2,22,16,2,125.21,1,46,0,1,75.21,0.00,0.00,1.00,0,0.00,9,2012.76,0,1,2,java.lang.Object,0.00,15,0,9,0,15,0,1,1,336,2
"org.apache.jackrabbit.jcr.RevertMoveTest",3,1.00,1.33,21,0.26,4661.49,4,1,4,15,2,96.41,17,27,1,5,114.28,0.00,0.80,0.00,0,1.00,2,794.18,1,0,1,org.apache.jackrabbit.jcr2spi.AbstractMoveTest,0.17,12,4,4,0,12,3,0,4,168,1
"org.apache.jackrabbit.jcr.SNSIndexTest",11,0.15,1.64,93,1.07,32000.58,19,8,9,26,3,149.81,31,116,1,4,109.92,0.00,0.75,0.26,2,37.00,3,3197.12,2,1,2,org.apache.jackrabbit.test.AbstractJCRTest,0.24,15,3,18,0,15,10,0,12,667,1
"org.apache.jackrabbit.jcr.SessionImpl",75,0.01,1.56,351,3.88,100348.21,88,13,82,188,61,124.06,308,478,13,2,123.82,1.00,0.33,0.07,18,3001.00,5,11644.91,3,45,53,org.apache.jackrabbit.commons.AbstractSession,0.02,113,1,117,1,113,30,2,112,2491,1
"org.apache.jackrabbit.jcr.SessionImpl$IdResolver",2,0.00,2.00,10,0.14,3241.88,2,0,82,8,4,140.11,7,17,0,1,119.49,0.00,0.00,0.00,0,2.00,2,412.78,0,1,4,java.lang.Object,0.00,6,0,4,0,6,1,1,3,90,2
"org.apache.jackrabbit.jcr.SessionListener",2,0.00,1.00,3,0.01,46.02,2,0,1,2,3,110.28,19,4,3,1,160.28,0.00,0.00,0.00,0,2.00,1,41.02,0,0,0,,0.00,0,0,2,0,0,2,0,3,17,1
"org.apache.jackrabbit.jcr.SingleValuedPropertyTest",1,1.00,3.00,9,0.10,2154.06,2,1,8,6,4,66.61,7,14,1,4,108.90,0.00,0.75,0.00,0,0.00,3,298.61,0,0,3,org.apache.jackrabbit.test.AbstractJCRTest,0.00,5,3,3,0,5,1,0,3,65,1
"org.apache.jackrabbit.jcr.TestAll",1,1.00,1.00,48,0.73,30425.36,2,1,5,4,44,52.84,14,50,1,2,72.98,0.00,0.50,0.00,0,1.00,1,2194.73,0,1,43,junit.framework.TestCase,0.00,3,1,1,0,3,0,0,12,381,1
"org.apache.jackrabbit.jcr.TestConnect",1,0.00,2.00,8,0.09,1553.91,1,0,3,5,1,132.64,3,8,0,4,112.02,0.00,0.75,0.00,0,0.00,2,261.63,0,0,1,org.apache.jackrabbit.test.AbstractJCRTest,0.00,4,3,2,0,4,1,0,1,59,1
"org.apache.jackrabbit.jcr.UpdateTest",10,0.33,3.20,101,1.30,41045.87,12,2,14,36,3,154.98,19,146,1,4,104.98,0.00,0.75,0.20,1,0.00,6,3907.22,1,1,2,org.apache.jackrabbit.test.AbstractJCRTest,0.12,26,3,32,0,26,9,0,17,753,1
"org.apache.jackrabbit.jcr.WorkspaceImpl",45,0.03,1.22,185,2.18,44239.45,55,10,61,100,44,145.54,173,260,4,1,124.93,0.00,0.00,0.13,7,0.00,3,6541.28,0,33,41,java.lang.Object,0.00,55,0,55,0,55,12,2,70,1391,1
"org.apache.jackrabbit.jcr.WorkspaceManager",46,0.05,1.63,244,2.73,75221.27,62,16,98,126,79,101.64,245,330,8,1,119.51,0.00,0.00,0.12,5,138.00,13,8190.31,0,26,72,java.lang.Object,0.00,80,0,75,0,80,20,3,63,1699,1
"org.apache.jackrabbit.jcr.WorkspaceManager$ChangePolling",2,1.00,5.00,29,0.39,17962.32,3,1,98,4,3,64.52,12,45,0,1,96.75,0.00,0.00,0.50,0,2.00,9,1160.92,0,0,3,java.lang.Object,0.00,2,0,10,0,2,2,1,6,209,2
"org.apache.jackrabbit.jcr.WorkspaceManager$NodeTypeStorage",4,0.00,1.00,9,0.10,1219.49,4,0,98,4,2,140.21,0,13,0,1,140.21,0.00,0.00,0.00,0,0.00,1,287.79,0,2,2,java.lang.Object,0.00,0,0,4,0,0,2,0,0,75,0
"org.apache.jackrabbit.jcr.WorkspaceManager$OperationVisitorImpl",30,0.00,1.40,138,2.02,43283.99,32,2,98,123,40,144.20,119,184,0,1,123.59,0.00,0.00,0.50,0,0.00,7,6048.88,0,0,40,java.lang.Object,0.00,93,0,42,0,93,30,1,35,1278,2
"org.apache.jackrabbit.jcr.WorkspaceMoveTest",4,0.00,2.50,29,0.35,10128.41,4,0,5,13,3,80.24,25,44,1,6,112.46,0.00,0.83,0.00,0,4.00,4,1051.31,2,0,2,org.apache.jackrabbit.jcr2spi.MoveTest,0.41,9,5,10,0,9,4,0,15,208,1
"org.apache.jackrabbit.jcr.XASession",1,0.00,1.00,2,0.01,44.19,1,0,2,1,1,173.10,19,3,1,2,146.81,0.00,0.50,0.00,0,1.00,1,26.09,0,1,0,,0.00,0,1,1,0,0,0,0,2,11,1
"org.apache.jackrabbit.jcr.XASessionImpl",2,1.00,1.00,7,0.06,760.70,3,1,5,3,5,84.41,20,11,2,3,132.88,0.00,0.67,0.50,0,2.00,1,178.68,0,1,4,org.apache.jackrabbit.jcr2spi.SessionImpl,0.00,1,2,2,0,1,1,1,5,48,1
"org.apache.jackrabbit.spi.commons.value.AbstractQValue",24,0.00,2.46,142,1.63,55157.47,27,3,13,51,9,100.38,135,196,5,1,118.25,0.00,0.00,0.33,0,0.00,6,4879.15,0,6,4,java.lang.Object,0.00,27,0,59,3,27,18,1,29,1028,2
"org.apache.jackrabbit.spi.commons.value.AbstractQValueFactory",1,4.00,4.00,16,0.35,15114.17,5,4,15,17,14,63.47,13,19,4,1,92.85,0.00,0.00,0.00,0,1.00,4,1047.89,0,1,10,java.lang.Object,0.00,16,0,4,3,16,0,1,5,198,2
"org.apache.jackrabbit.spi.commons.value.QValueFactoryImpl",14,1.00,2.07,71,0.93,36707.23,15,1,29,32,24,118.07,61,115,17,2,117.84,0.00,0.50,0.07,0,38.00,7,2799.17,0,13,7,org.apache.jackrabbit.spi.commons.value.AbstractQValueFactory,0.00,18,1,29,0,18,1,0,24,567,2
"org.apache.jackrabbit.spi.commons.value.QValueFactoryImpl$BinaryQValue",27,0.01,2.41,192,2.06,85679.48,33,6,29,72,6,79.48,184,272,0,1,111.70,0.00,0.00,0.15,4,120.00,5,6165.49,0,9,6,java.lang.Object,0.00,45,0,65,0,45,18,3,67,1264,2
"org.apache.jackrabbit.spi.commons.value.QValueFactoryImpl$DateQValue",4,0.00,1.50,16,0.12,2252.50,5,1,29,7,1,147.40,15,23,0,2,126.79,0.00,0.50,1.00,0,0.00,3,363.09,0,1,1,org.apache.jackrabbit.spi.commons.value.QValueImpl,0.00,3,1,6,0,3,3,0,3,94,2
"org.apache.jackrabbit.spi.commons.value.QValueFactoryImpl$QValueImpl",12,2.00,1.08,29,0.23,3945.46,14,2,29,18,5,189.93,12,44,0,2,139.93,0.00,0.50,0.00,1,22.00,2,681.46,0,3,5,org.apache.jackrabbit.spi.commons.value.AbstractQValue,0.00,6,1,13,0,6,9,1,6,189,2
"org.apache.jackrabbit.spi.commons.value.QValueFactoryImpl$QValueImpl$Binary",4,0.00,1.00,12,0.10,1875.99,4,0,29,9,0,132.17,0,18,0,1,132.17,0.00,0.00,0.00,1,4.00,1,297.91,0,1,0,java.lang.Object,0.00,5,0,4,0,5,3,0,0,76,0
"org.apache.jackrabbit.spi.commons.value.QValueTest",60,0.05,1.45,328,4.37,96025.23,65,5,29,126,9,169.61,65,444,0,2,119.61,0.00,0.50,0.25,2,0.00,4,13124.48,0,0,9,junit.framework.TestCase,0.00,66,1,87,0,66,60,0,43,2790,1
"org.apache.jackrabbit.spi.commons.value.QValueValue",15,0.06,1.67,71,0.79,21079.79,22,7,12,37,8,105.76,79,105,6,1,123.64,0.00,0.00,0.20,3,0.00,5,2381.81,0,6,2,java.lang.Object,0.00,22,0,25,0,22,9,1,26,528,2
"org.apache.jackrabbit.spi.commons.value.ValueFactoryQImpl",15,0.21,2.27,79,0.93,26217.03,17,2,20,25,22,139.82,54,122,13,1,119.20,0.00,0.00,0.70,1,0.00,8,2801.48,0,14,9,java.lang.Object,0.00,10,0,34,1,10,1,1,15,600,1
"org.apache.jackrabbit.spi.commons.value.ValueFormat",5,0.00,6.60,89,1.56,82733.58,5,0,12,37,41,41.45,48,149,34,1,91.45,0.00,0.00,0.00,1,5.00,11,4668.64,0,5,7,java.lang.Object,0.00,32,0,33,0,32,0,0,8,825,1
"org.apache.jackrabbit.spi.commons.value.ValueFormatTest",6,0.65,1.33,59,1.02,29930.12,10,4,26,32,19,156.22,10,67,0,2,106.22,0.00,0.50,0.79,0,0.00,2,3063.44,1,0,19,junit.framework.TestCase,0.00,26,1,8,0,26,6,0,4,582,1
"org.apache.jackrabbit.spi.commons.value.ValueFormatTest$IdentifierResolver",2,0.00,1.00,4,0.03,250.38,2,0,26,3,2,143.25,1,6,0,1,143.25,0.00,0.00,0.00,0,2.00,1,88.34,0,1,2,java.lang.Object,0.00,1,0,2,0,1,1,0,1,27,0
"org.apache.jackrabbit.webdav.jcr.search.SearchResourceImpl",12,0.21,2.92,139,2.20,118044.05,15,3,37,95,15,82.59,64,178,1,1,100.46,0.00,0.00,0.14,5,44.00,12,6609.77,0,6,14,java.lang.Object,0.00,83,0,35,0,83,6,1,23,1128,1
"org.apache.jackrabbit.webdav.jcr.search.SearchResourceImpl$PathValue",2,0.00,1.50,10,0.10,1969.99,2,0,37,4,0,121.26,0,16,0,2,121.26,0.00,0.50,0.00,0,2.00,2,288.32,0,1,0,org.apache.jackrabbit.webdav.jcr.search.SelectorValue,0.00,2,1,3,0,2,1,0,0,69,3
"org.apache.jackrabbit.webdav.jcr.search.SearchResourceImpl$PlainValue",2,0.00,1.00,5,0.05,522.26,2,0,37,3,0,140.74,0,10,0,2,140.74,0.00,0.50,0.00,0,2.00,1,138.56,0,1,0,org.apache.jackrabbit.webdav.jcr.search.SelectorValue,0.00,1,1,2,0,1,1,0,0,40,3
"org.apache.jackrabbit.webdav.jcr.search.SearchResourceImpl$RowValue",3,0.00,1.00,4,0.03,147.66,3,0,37,3,0,157.67,0,5,0,1,157.67,0.00,0.00,0.00,0,3.00,1,75.83,0,3,0,,0.00,0,0,3,0,0,0,0,0,27,1
"org.apache.jackrabbit.webdav.jcr.search.SearchResourceImpl$ScoreValue",2,0.00,1.50,10,0.09,1900.45,2,0,37,4,0,121.38,0,16,0,2,121.38,0.00,0.50,0.00,0,2.00,2,269.34,0,1,0,org.apache.jackrabbit.webdav.jcr.search.SelectorValue,0.00,2,1,3,0,2,1,0,0,66,3
"org.apache.jackrabbit.webdav.jcr.search.SearchResourceImpl$SelectorValue",3,0.17,1.00,12,0.09,1444.66,6,3,37,3,0,127.42,0,18,0,1,127.42,0.00,0.00,0.22,0,5.00,1,274.05,0,2,0,java.lang.Object,0.00,0,0,3,0,0,1,1,0,74,3
"org.apache.jackrabbit.webdav.jcr.search.SearchResultProperty",8,0.19,2.38,75,1.20,56827.94,14,6,17,39,8,56.40,84,99,2,2,104.88,0.00,0.50,0.33,1,8.00,6,3596.46,1,5,6,org.apache.jackrabbit.webdav.property.AbstractDavProperty,0.00,31,1,19,0,31,3,1,9,656,1
"org.apache.jackrabbit.spi.commons.batch.ChangeLog",1,0.00,1.00,2,0.01,98.52,1,0,2,1,4,114.69,13,3,3,2,144.07,0.00,0.50,0.00,0,1.00,1,42.51,0,1,1,,0.00,0,1,1,0,0,0,0,2,15,1
"org.apache.jackrabbit.spi.commons.batch.ChangeLogImpl",16,0.93,1.44,56,0.59,11024.03,17,1,10,34,12,180.77,16,77,3,1,130.77,0.00,0.00,0.12,2,40.00,4,1767.98,0,2,9,java.lang.Object,0.00,18,0,23,2,18,14,1,4,429,1
"org.apache.jackrabbit.spi.commons.batch.ConsolidatedBatchTest",9,0.02,1.67,44,2.37,417154.37,14,5,17,38,15,132.30,32,342,0,2,111.68,0.00,0.50,0.18,3,46.00,4,7107.91,0,7,15,junit.framework.TestCase,0.00,29,1,15,0,29,2,0,32,1379,1
"org.apache.jackrabbit.spi.commons.batch.ConsolidatedBatchTest$TestChangeLog",8,0.00,1.00,30,0.37,5564.16,8,0,17,15,5,130.82,0,40,0,2,130.82,0.00,0.50,0.00,1,8.00,1,1121.16,6,8,5,org.apache.jackrabbit.spi.commons.batch.ChangeLogImpl,0.00,7,1,8,0,7,0,0,0,257,1
"org.apache.jackrabbit.spi.commons.batch.ConsolidatingChangeLog",14,1.00,1.29,55,0.70,21619.20,15,1,12,32,18,148.65,50,78,7,2,128.03,0.00,0.50,0.07,1,26.00,3,2089.71,1,2,11,org.apache.jackrabbit.spi.commons.batch.ChangeLogImpl,0.00,18,1,18,0,18,12,0,10,461,1
"org.apache.jackrabbit.spi.commons.batch.ConsolidatingChangeLog$CancelableOperation",1,4.00,1.00,6,0.07,1096.68,5,4,12,1,0,151.42,20,7,0,2,118.03,0.00,0.50,0.00,0,1.00,1,210.05,0,0,0,,0.00,0,1,1,0,0,1,0,5,51,1
"org.apache.jackrabbit.spi.commons.batch.ConsolidatingChangeLog$CancelableOperations",12,0.00,1.00,34,0.42,10271.59,12,0,12,21,5,92.55,141,48,0,1,136.68,0.00,0.00,0.00,0,12.00,1,1250.25,0,11,5,java.lang.Object,0.00,9,0,12,0,9,1,0,29,311,3
"org.apache.jackrabbit.spi.commons.batch.ConsolidatingChangeLog$CancelableOperations$AddNode",2,0.00,2.50,11,0.14,3440.00,2,0,12,5,4,76.95,14,18,0,2,119.24,0.00,0.50,0.00,0,2.00,4,428.87,0,0,4,Operations.AddNode,0.00,3,1,5,0,3,2,1,1,95,2
"org.apache.jackrabbit.spi.commons.batch.ConsolidatingChangeLog$CancelableOperations$AddProperty",3,0.00,4.00,28,0.38,26335.39,3,0,12,7,5,71.81,20,39,0,2,104.03,0.00,0.50,0.00,0,3.00,10,1128.15,0,0,5,Operations.AddProperty,0.00,4,1,12,0,4,3,1,1,217,2
"org.apache.jackrabbit.spi.commons.batch.ConsolidatingChangeLog$CancelableOperations$Empty",1,0.00,1.00,3,0.03,299.58,1,0,12,1,0,154.32,3,5,0,2,133.70,0.00,0.50,0.00,0,1.00,1,79.56,0,0,0,Operations.Empty,0.00,0,1,1,0,0,1,1,1,23,2
"org.apache.jackrabbit.spi.commons.batch.ConsolidatingChangeLog$CancelableOperations$Move",2,0.00,1.00,5,0.04,427.53,2,0,12,2,2,191.42,3,8,0,2,141.42,0.00,0.50,0.00,0,2.00,1,125.11,0,0,2,Operations.Move,0.00,0,1,2,0,0,2,1,1,37,2
"org.apache.jackrabbit.spi.commons.batch.ConsolidatingChangeLog$CancelableOperations$Remove",2,0.00,1.00,5,0.03,328.57,2,0,12,2,1,192.32,3,8,0,2,142.32,0.00,0.50,0.00,0,2.00,1,99.76,0,0,1,Operations.Remove,0.00,0,1,2,0,0,2,1,1,31,2
"org.apache.jackrabbit.spi.commons.batch.ConsolidatingChangeLog$CancelableOperations$ReorderNodes",3,0.00,2.33,16,0.25,11077.58,3,0,12,8,3,116.88,13,26,0,2,116.64,0.00,0.50,0.00,0,3.00,5,762.74,0,0,3,Operations.ReorderNodes,0.00,5,1,7,0,5,3,1,1,162,2
"org.apache.jackrabbit.spi.commons.batch.ConsolidatingChangeLog$CancelableOperations$SetMixins",2,0.00,4.50,22,0.29,22747.13,2,0,12,6,4,67.65,12,30,0,2,99.87,0.00,0.50,0.00,0,2.00,8,883.04,0,0,4,Operations.SetMixins,0.00,4,1,9,0,4,2,1,1,173,2
"org.apache.jackrabbit.spi.commons.batch.ConsolidatingChangeLog$CancelableOperations$SetPrimaryType",2,0.00,3.50,16,0.21,10017.33,2,0,12,6,4,75.67,12,25,0,2,107.89,0.00,0.50,0.00,0,2.00,6,644.70,0,0,4,Operations.SetPrimaryType,0.00,4,1,7,0,4,2,1,1,136,2
"org.apache.jackrabbit.spi.commons.batch.ConsolidatingChangeLog$CancelableOperations$SetValue",3,0.00,2.33,16,0.20,8512.01,3,0,12,6,4,117.78,12,25,0,2,117.54,0.00,0.50,0.00,0,3.00,5,613.67,0,0,4,Operations.SetValue,0.00,3,1,7,0,3,3,1,1,136,2
"org.apache.jackrabbit.spi.commons.batch.ConsolidatingChangeLog$OperationsBackwardWithSentinel",3,0.67,1.67,19,0.16,2846.46,6,3,12,10,0,118.41,0,27,0,1,118.41,0.00,0.00,0.78,0,0.00,2,470.76,0,1,0,java.lang.Object,0.00,7,0,5,0,7,2,1,0,112,1
"org.apache.jackrabbit.spi.commons.batch.Operation",1,0.00,1.00,2,0.01,69.06,1,0,2,1,13,97.18,8,3,12,1,145.29,0.00,0.00,0.00,0,1.00,1,36.53,0,0,1,,0.00,0,0,1,0,0,1,0,2,13,1
"org.apache.jackrabbit.spi.commons.batch.Operations",14,0.00,1.14,38,0.42,7102.63,14,0,8,24,16,89.96,143,57,9,1,138.44,0.00,0.00,0.00,0,14.00,2,1258.19,0,11,7,java.lang.Object,0.00,10,0,16,0,10,3,0,31,321,2
"org.apache.jackrabbit.spi.commons.batch.Operations$AddNode",6,0.50,1.50,27,0.32,6484.56,10,4,8,9,5,164.44,12,46,0,1,124.56,0.00,0.00,0.67,1,0.00,4,956.06,0,1,5,java.lang.Object,0.00,3,0,9,0,3,5,1,2,238,2
"org.apache.jackrabbit.spi.commons.batch.Operations$AddProperty",8,0.21,1.50,35,0.38,7308.52,12,4,8,12,6,165.02,19,55,0,1,125.13,0.00,0.00,0.44,1,8.00,4,1135.65,0,1,6,java.lang.Object,0.00,4,0,12,0,4,7,1,3,278,2
"org.apache.jackrabbit.spi.commons.batch.Operations$Empty",5,1.00,1.20,13,0.09,1404.94,6,1,8,7,2,190.45,5,19,0,1,140.45,0.00,0.00,0.00,0,5.00,2,264.39,0,1,2,java.lang.Object,0.00,2,0,6,0,2,4,1,2,76,2
"org.apache.jackrabbit.spi.commons.batch.Operations$Move",6,0.40,1.50,25,0.26,5005.86,9,3,8,9,5,175.44,11,41,0,1,125.44,0.00,0.00,0.67,1,0.00,4,787.61,0,1,5,java.lang.Object,0.00,3,0,9,0,3,5,1,2,201,2
"org.apache.jackrabbit.spi.commons.batch.Operations$Remove",6,0.40,1.50,21,0.16,2395.98,7,1,8,9,4,182.62,9,31,0,1,132.62,0.00,0.00,0.67,1,0.00,4,474.24,0,1,4,java.lang.Object,0.00,3,0,9,0,3,5,1,2,127,2
"org.apache.jackrabbit.spi.commons.batch.Operations$ReorderNodes",6,0.40,1.50,25,0.26,5150.35,9,3,8,9,4,175.35,11,41,0,1,125.35,0.00,0.00,0.67,1,0.00,4,781.81,0,1,4,java.lang.Object,0.00,3,0,9,0,3,5,1,2,201,2
"org.apache.jackrabbit.spi.commons.batch.Operations$SetMixins",6,0.20,1.50,23,0.22,3680.79,8,2,8,10,5,181.16,10,36,0,1,131.16,0.00,0.00,0.67,1,0.00,4,646.37,0,1,5,java.lang.Object,0.00,4,0,9,0,4,5,1,2,166,2
"org.apache.jackrabbit.spi.commons.batch.Operations$SetPrimaryType",6,0.20,1.50,23,0.21,3504.50,8,2,8,10,5,181.32,10,36,0,1,131.32,0.00,0.00,0.67,1,0.00,4,627.91,0,1,5,java.lang.Object,0.00,4,0,9,0,4,5,1,2,163,2
"org.apache.jackrabbit.spi.commons.batch.Operations$SetValue",8,0.10,1.50,33,0.31,5613.04,11,3,8,12,5,165.92,17,50,0,1,126.04,0.00,0.00,0.42,1,8.00,4,931.50,0,1,5,java.lang.Object,0.00,4,0,12,0,4,7,1,3,234,2
"org.apache.jackrabbit.webdav.version.report.CompareBaselineReport",6,0.09,3.33,82,1.31,61861.25,15,9,19,42,15,65.35,38,98,0,1,97.57,0.00,0.00,0.19,2,14.00,6,3925.24,0,3,15,java.lang.Object,0.00,36,0,20,0,36,3,1,19,697,1
"org.apache.jackrabbit.webdav.version.report.ExpandPropertyReport",9,0.16,2.11,57,0.74,27496.84,13,4,22,32,18,70.23,103,76,1,1,114.36,0.00,0.00,0.11,5,29.00,6,2214.50,0,4,18,java.lang.Object,0.00,23,0,19,0,23,5,2,16,440,1
"org.apache.jackrabbit.webdav.version.report.ExpandPropertyReport$ExpandProperty",2,0.00,2.00,15,0.17,4134.50,3,1,22,10,7,80.99,12,18,0,2,113.21,0.00,0.50,1.00,0,0.00,3,512.91,0,1,7,org.apache.jackrabbit.webdav.property.AbstractDavProperty,0.00,8,1,4,0,8,1,0,3,105,1
"org.apache.jackrabbit.webdav.version.report.LatestActivityVersionReport",5,0.08,2.60,49,0.69,23986.75,11,6,16,30,14,58.09,43,61,0,1,106.20,0.00,0.00,0.23,1,13.00,6,2061.04,0,3,14,java.lang.Object,0.00,25,0,13,0,25,2,1,15,390,1
"org.apache.jackrabbit.webdav.version.report.LocateByHistoryReport",7,0.08,2.57,47,0.65,22105.22,11,4,17,30,15,66.09,60,68,1,1,114.20,0.00,0.00,0.18,3,18.00,7,1950.05,0,3,15,java.lang.Object,0.00,23,0,18,0,23,4,2,10,383,1
"org.apache.jackrabbit.webdav.version.report.Report",3,0.00,1.00,4,0.03,141.96,3,0,4,3,28,109.33,31,5,24,2,157.81,0.00,0.50,0.00,0,3.00,1,76.78,0,1,6,,0.00,0,1,3,0,0,2,0,4,27,1
"org.apache.jackrabbit.webdav.version.report.ReportInfo",12,0.03,2.33,81,0.99,28872.45,18,6,16,41,39,72.86,88,109,31,1,115.15,0.00,0.00,0.19,1,40.00,5,2956.08,0,5,9,java.lang.Object,0.00,29,0,28,0,29,7,1,14,603,1
"org.apache.jackrabbit.webdav.version.report.ReportType",9,0.01,2.11,58,0.81,30232.91,18,9,12,25,33,71.74,64,80,26,1,114.03,0.00,0.00,0.10,1,46.00,6,2422.50,0,6,12,java.lang.Object,0.00,16,0,19,0,16,3,2,12,488,1
"org.apache.jackrabbit.webdav.version.report.SupportedReportSetProperty",6,0.20,1.67,31,0.33,6620.43,8,2,9,15,9,78.56,44,39,4,2,120.85,0.00,0.50,0.33,1,0.00,3,1004.08,1,2,5,org.apache.jackrabbit.webdav.property.AbstractDavProperty,0.00,9,1,10,0,9,4,0,7,225,1
"org.apache.jackrabbit.webdav.version.report.VersionTreeReport",9,0.25,2.11,51,0.61,23132.33,12,3,13,27,12,69.80,75,69,1,1,117.90,0.00,0.00,0.11,5,23.00,6,1834.20,0,4,12,java.lang.Object,0.00,18,0,19,0,18,5,2,10,386,1
"org.apache.jackrabbit.core.integration.daily.DailyIntegrationTest",1,0.00,1.00,18,0.21,8111.89,1,0,16,3,14,75.52,5,20,0,2,93.39,0.00,0.50,0.00,0,1.00,1,642.19,0,1,14,junit.framework.TestCase,0.00,2,1,1,0,2,0,0,3,135,1
"org.apache.jackrabbit.core.integration.daily.RandomOperationTest",9,0.64,1.00,51,0.67,17794.87,16,7,4,14,4,119.21,39,62,1,5,118.97,0.00,0.80,0.71,0,0.00,1,2015.03,3,0,3,org.apache.jackrabbit.core.AbstractConcurrencyTest,0.13,5,4,9,0,5,9,0,9,432,1
"org.apache.jackrabbit.core.value.BLOBFileValue",12,0.00,1.42,34,0.33,11929.17,12,0,7,20,7,156.70,43,49,6,1,136.09,0.00,0.00,0.00,2,12.00,6,1000.31,0,4,1,java.lang.Object,0.00,8,0,17,4,8,8,1,9,228,1
"org.apache.jackrabbit.core.value.BLOBInDataStore",15,0.07,1.13,46,0.43,8488.38,19,4,8,28,8,181.50,24,65,3,2,131.50,0.00,0.50,0.18,1,54.00,2,1288.30,0,7,5,org.apache.jackrabbit.core.value.BLOBFileValue,0.59,13,1,17,0,13,8,0,8,319,0
"org.apache.jackrabbit.core.value.BLOBInMemory",13,0.05,1.62,68,0.78,45831.33,18,5,8,30,4,117.12,53,86,2,2,116.88,0.00,0.50,0.15,0,49.00,4,2338.61,0,5,2,org.apache.jackrabbit.core.value.BLOBFileValue,0.64,17,1,21,0,17,8,0,17,484,0
"org.apache.jackrabbit.core.value.BLOBInResource",10,0.03,1.60,40,0.40,10541.50,14,4,7,25,5,145.24,36,63,2,2,124.63,0.00,0.50,0.22,0,22.00,3,1194.60,0,3,3,org.apache.jackrabbit.core.value.BLOBFileValue,0.64,15,1,16,0,15,7,0,11,279,0
"org.apache.jackrabbit.core.value.BLOBInTempFile",13,0.02,1.54,59,0.58,16144.23,17,4,11,30,5,144.69,39,86,2,2,124.08,0.00,0.50,0.23,1,29.00,4,1737.49,0,4,3,org.apache.jackrabbit.core.value.BLOBFileValue,0.64,17,1,20,0,17,9,0,8,396,0
"org.apache.jackrabbit.core.value.BinaryValueImpl",3,0.50,1.33,10,0.08,1254.07,4,1,4,5,6,132.73,13,14,2,3,132.49,0.00,0.67,0.67,0,1.00,2,241.80,0,2,4,org.apache.jackrabbit.value.BinaryValue,0.00,2,2,4,0,2,1,1,3,65,0
"org.apache.jackrabbit.core.value.InternalValue",48,0.24,1.79,257,3.52,168860.10,52,4,31,112,80,117.10,216,393,57,2,116.87,0.00,0.50,0.02,5,428.00,12,10564.46,2,30,24,org.apache.jackrabbit.spi.commons.value.AbstractQValue,0.08,64,1,86,0,64,18,0,56,2083,1
"org.apache.jackrabbit.core.value.InternalValueFactory",14,0.31,1.43,56,0.90,42857.27,17,3,23,34,16,121.01,10,89,6,2,121.01,0.00,0.50,0.05,0,38.00,7,2696.00,0,13,11,org.apache.jackrabbit.spi.commons.value.AbstractQValueFactory,0.00,20,1,20,0,20,1,0,6,534,2
"org.apache.jackrabbit.core.value.InternalValueFactoryTest",2,1.00,1.00,8,0.11,1462.89,3,1,7,10,7,146.60,6,11,1,4,125.99,0.00,0.75,0.00,0,2.00,1,331.11,0,0,6,org.apache.jackrabbit.spi.QValueFactoryTest,0.16,8,3,2,0,8,2,0,2,76,1
"org.apache.jackrabbit.core.value.InternalValueTest",2,1.00,1.00,8,0.11,1462.89,3,1,7,10,7,146.60,6,11,1,4,125.99,0.00,0.75,0.00,0,2.00,1,331.11,0,0,6,org.apache.jackrabbit.spi.QValueTest,0.16,8,3,2,0,8,2,0,2,76,1
"org.apache.jackrabbit.core.value.TestAll",1,0.00,1.00,6,0.05,1283.53,1,0,3,3,2,75.20,7,8,0,2,117.50,0.00,0.50,0.00,0,1.00,1,150.40,0,1,2,junit.framework.TestCase,0.00,2,1,1,0,2,0,0,2,39,1
"org.apache.jackrabbit.core.value.ValueFactoryImpl",5,0.25,2.80,36,0.49,13963.16,7,2,14,19,11,132.72,16,55,2,2,112.10,0.00,0.50,0.30,1,7.00,4,1462.20,2,4,9,org.apache.jackrabbit.spi.commons.value.ValueFactoryQImpl,0.00,14,1,14,0,14,1,0,6,304,1
"org.apache.jackrabbit.jcr.AbstractLockTest",13,0.13,1.38,111,1.23,26281.55,18,5,10,45,4,111.44,52,140,2,4,111.21,0.67,0.50,0.32,0,0.00,3,3679.94,2,0,2,org.apache.jackrabbit.test.AbstractJCRTest,0.22,32,3,18,2,32,13,0,33,772,2
"org.apache.jackrabbit.jcr.DeepLockTest",15,0.13,1.40,72,0.76,12369.92,21,6,9,41,3,125.50,9,100,1,4,125.50,0.00,0.75,0.29,0,0.00,4,2280.90,2,0,2,org.apache.jackrabbit.test.AbstractJCRTest,0.21,26,3,21,0,26,15,0,7,513,1
"org.apache.jackrabbit.jcr.LockManagerImpl",18,0.01,2.72,167,2.05,70790.71,25,7,31,68,20,56.87,179,210,2,1,106.87,0.00,0.00,0.15,7,58.00,9,6137.44,0,5,18,java.lang.Object,0.00,50,0,49,0,50,13,2,80,1211,1
"org.apache.jackrabbit.jcr.LockManagerImpl$LockImpl",14,0.08,1.71,58,0.48,8502.76,17,3,31,27,2,108.63,78,83,0,1,126.50,0.00,0.00,0.26,4,18.00,4,1449.19,0,4,2,java.lang.Object,0.00,13,0,24,0,13,10,2,36,353,1
"org.apache.jackrabbit.jcr.LockManagerImpl$LockState",12,0.05,2.67,83,0.77,17207.43,16,4,31,28,11,117.13,52,117,0,1,116.89,0.00,0.00,0.29,5,28.00,5,2315.12,0,0,11,java.lang.Object,0.00,16,0,32,0,16,12,1,23,509,1
"org.apache.jackrabbit.jcr.LockManagerImpl$LockTokenListener",2,0.00,1.00,3,0.02,87.00,2,0,31,2,0,125.88,12,4,0,1,158.10,0.00,0.00,0.00,0,2.00,1,58.00,0,0,0,,0.00,0,0,2,0,0,2,0,2,21,1
"org.apache.jackrabbit.jcr.LockStateManager",9,0.00,1.00,10,0.11,512.49,9,0,4,9,6,107.18,85,13,5,1,157.18,0.00,0.00,0.00,0,9.00,1,315.25,0,4,1,,0.00,0,0,9,0,0,5,0,10,96,1
"org.apache.jackrabbit.jcr.OpenScopedLockTest",10,1.00,1.70,95,1.10,25813.85,11,1,6,40,2,129.03,39,125,1,5,108.42,0.00,0.80,0.00,0,0.00,3,3302.18,0,0,1,org.apache.jackrabbit.jcr2spi.lock.AbstractLockTest,0.11,30,4,17,0,30,10,0,28,667,1
"org.apache.jackrabbit.jcr.SessionScopedLockTest",1,1.00,1.00,4,0.03,505.97,2,1,2,2,2,147.86,3,6,1,5,127.25,0.00,0.80,0.00,0,1.00,1,99.65,0,0,1,org.apache.jackrabbit.jcr2spi.lock.AbstractLockTest,0.14,1,4,1,0,1,1,0,1,27,1
"org.apache.jackrabbit.jcr.TestAll",1,0.00,1.00,7,0.06,1740.69,1,0,3,3,4,134.57,3,9,1,2,113.96,0.00,0.50,0.00,0,1.00,1,186.48,0,1,3,junit.framework.TestCase,0.00,2,1,1,0,2,0,0,1,47,1
"org.apache.jackrabbit.core.integration.random.operation.AddNode",2,0.00,1.00,10,0.12,1988.59,4,2,5,6,2,141.94,6,13,1,2,121.32,0.00,0.50,0.50,0,2.00,1,355.19,2,1,1,org.apache.jackrabbit.core.integration.random.operation.Operation,0.12,4,1,2,0,4,1,0,2,84,1
"org.apache.jackrabbit.core.integration.random.operation.AddVersionLabel",2,1.00,1.00,11,0.15,2676.45,3,1,5,9,2,140.92,7,14,1,3,120.31,0.00,0.67,0.50,0,2.00,1,446.09,3,1,1,org.apache.jackrabbit.core.integration.random.operation.VersionOperation,0.17,7,2,2,0,7,1,0,2,98,1
"org.apache.jackrabbit.core.integration.random.operation.Checkin",2,1.00,1.50,10,0.12,2177.43,3,1,6,8,2,141.53,7,14,1,3,120.92,0.00,0.67,0.50,0,2.00,2,359.34,2,1,1,org.apache.jackrabbit.core.integration.random.operation.VersionOperation,0.17,6,2,3,0,6,1,0,2,83,1
"org.apache.jackrabbit.core.integration.random.operation.Checkout",2,1.00,1.50,10,0.12,2389.44,3,1,5,9,2,141.22,7,14,1,3,120.60,0.00,0.67,0.50,0,2.00,2,364.04,2,1,1,org.apache.jackrabbit.core.integration.random.operation.VersionOperation,0.17,7,2,3,0,7,1,0,2,84,1
"org.apache.jackrabbit.core.integration.random.operation.CreateNodes",4,0.07,2.50,42,0.46,18729.18,9,5,6,12,2,144.47,8,53,1,2,104.58,0.00,0.50,0.25,2,10.00,5,1368.71,3,1,1,org.apache.jackrabbit.core.integration.random.operation.Operation,0.11,8,1,10,0,8,3,0,3,282,1
"org.apache.jackrabbit.core.integration.random.operation.GetNode",2,0.00,1.00,6,0.04,420.31,2,0,3,2,2,155.53,6,9,1,2,134.91,0.00,0.50,0.00,0,2.00,1,127.23,2,1,1,org.apache.jackrabbit.core.integration.random.operation.Operation,0.12,0,1,2,0,0,1,0,2,37,1
"org.apache.jackrabbit.core.integration.random.operation.GetRandomNodes",2,1.00,1.50,13,0.11,2160.41,3,1,8,8,3,118.23,9,14,1,2,117.99,0.00,0.50,0.00,0,2.00,2,332.28,0,1,2,org.apache.jackrabbit.core.integration.random.operation.Operation,0.12,6,1,3,0,6,1,0,2,79,1
"org.apache.jackrabbit.core.integration.random.operation.GetRandomNodes$Iterator",3,0.00,1.33,10,0.09,1531.73,3,0,8,11,0,131.81,1,15,0,1,131.81,0.00,0.00,0.00,0,3.00,2,268.03,0,1,0,java.lang.Object,0.00,8,0,4,0,8,2,0,1,66,0
"org.apache.jackrabbit.core.integration.random.operation.Operation",14,0.06,1.14,42,0.35,6349.34,19,5,8,23,19,182.25,20,55,18,1,132.25,0.00,0.00,0.14,1,86.00,2,1045.54,0,8,1,java.lang.Object,0.00,9,0,16,20,9,6,0,5,263,2
"org.apache.jackrabbit.core.integration.random.operation.OperationFactory",12,0.12,2.25,65,0.89,33796.75,15,3,7,40,22,138.19,47,106,6,1,117.57,0.00,0.00,0.44,0,0.00,10,2678.69,0,11,18,java.lang.Object,0.00,28,0,27,0,28,1,0,16,531,1
"org.apache.jackrabbit.core.integration.random.operation.OperationSequence",2,1.00,1.50,13,0.13,3341.96,3,1,5,8,4,156.39,4,14,2,2,116.50,0.00,0.50,0.50,0,2.00,2,401.54,0,1,2,org.apache.jackrabbit.core.integration.random.operation.Operation,0.12,6,1,3,0,6,1,0,1,92,1
"org.apache.jackrabbit.core.integration.random.operation.RandomContentOperations",3,0.00,1.00,8,0.08,994.10,3,0,2,5,3,189.92,3,15,1,3,139.92,0.00,0.67,0.00,0,3.00,1,241.24,2,2,3,org.apache.jackrabbit.core.integration.random.operation.RandomOperations,0.14,2,2,3,0,2,1,0,1,64,1
"org.apache.jackrabbit.core.integration.random.operation.RandomOperations",5,0.17,1.20,23,0.21,4157.94,8,3,5,11,5,125.51,4,29,2,2,125.51,2.00,0.25,0.20,1,14.00,2,644.96,1,2,3,org.apache.jackrabbit.core.integration.random.operation.Operation,0.11,6,1,6,2,6,3,0,1,149,2
"org.apache.jackrabbit.core.integration.random.operation.RandomVersionOperations",3,0.00,1.00,8,0.08,994.10,3,0,2,5,3,189.92,3,15,1,3,139.92,0.00,0.67,0.00,0,3.00,1,241.24,2,2,3,org.apache.jackrabbit.core.integration.random.operation.RandomOperations,0.14,2,2,3,0,2,1,0,1,64,1
"org.apache.jackrabbit.core.integration.random.operation.Remove",2,0.00,2.00,18,0.18,3843.69,4,2,5,9,2,149.27,4,20,1,2,109.39,0.00,0.50,0.50,0,2.00,3,533.22,2,1,1,org.apache.jackrabbit.core.integration.random.operation.Operation,0.12,7,1,4,0,7,1,0,1,117,1
"org.apache.jackrabbit.core.integration.random.operation.RemoveVersion",2,1.00,1.50,11,0.14,2844.86,3,1,6,8,2,170.00,3,15,1,3,120.00,0.00,0.67,0.50,0,2.00,2,418.53,3,1,1,org.apache.jackrabbit.core.integration.random.operation.VersionOperation,0.17,6,2,3,0,6,1,0,1,93,1
"org.apache.jackrabbit.core.integration.random.operation.RemoveVersionLabel",2,1.00,1.50,13,0.17,4225.22,3,1,6,9,2,155.58,4,17,1,3,115.70,0.00,0.67,0.50,0,2.00,2,518.85,2,1,1,org.apache.jackrabbit.core.integration.random.operation.VersionOperation,0.17,7,2,3,0,7,1,0,1,110,1
"org.apache.jackrabbit.core.integration.random.operation.Restore",2,1.00,1.50,11,0.13,2583.51,3,1,6,7,1,170.33,3,15,0,3,120.33,0.00,0.67,0.50,0,2.00,2,393.99,3,1,1,org.apache.jackrabbit.core.integration.random.operation.VersionOperation,0.17,5,2,3,0,5,1,0,1,88,1
"org.apache.jackrabbit.core.integration.random.operation.Save",2,1.00,1.00,9,0.09,1357.97,3,1,5,6,2,176.24,3,12,1,2,126.24,0.00,0.50,0.50,0,2.00,1,264.96,2,1,1,org.apache.jackrabbit.core.integration.random.operation.Operation,0.12,4,1,2,0,4,1,0,1,66,1
"org.apache.jackrabbit.core.integration.random.operation.SetProperty",2,0.00,1.00,12,0.14,2497.38,4,2,5,6,2,157.47,4,15,1,2,117.59,0.00,0.50,0.50,0,2.00,1,427.64,3,1,1,org.apache.jackrabbit.core.integration.random.operation.Operation,0.12,4,1,2,0,4,1,0,1,97,1
"org.apache.jackrabbit.core.integration.random.operation.TraverseNodes",2,0.00,1.00,7,0.07,1012.53,2,0,5,7,5,181.91,3,10,1,2,131.91,0.00,0.50,0.00,0,2.00,1,209.96,2,1,4,org.apache.jackrabbit.core.integration.random.operation.Operation,0.12,5,1,2,0,5,1,0,1,54,1
"org.apache.jackrabbit.core.integration.random.operation.VersionOperation",2,0.00,3.00,17,0.21,6880.80,2,0,6,11,7,76.99,12,21,6,2,109.21,6.00,0.12,0.00,0,2.00,5,630.74,1,1,1,org.apache.jackrabbit.core.integration.random.operation.Operation,0.00,9,1,6,6,9,1,0,2,126,2
"org.apache.jackrabbit.core.integration.random.operation.XATransaction",2,0.00,1.00,14,0.14,2661.97,4,2,5,8,3,164.87,3,17,1,2,114.87,0.00,0.50,0.50,0,2.00,1,406.58,1,1,2,org.apache.jackrabbit.core.integration.random.operation.Operation,0.12,6,1,2,0,6,1,0,1,95,1
"org.apache.jackrabbit.commons.packaging.ContentPackage",1,0.00,1.00,2,0.01,51.00,1,0,3,1,2,146.32,0,3,2,1,146.32,0.00,0.00,0.00,0,1.00,1,34.00,0,1,0,,0.00,0,0,1,0,0,0,0,0,13,1
"org.apache.jackrabbit.commons.packaging.ContentPackageExporter",1,0.00,1.00,2,0.01,64.83,1,0,2,1,1,145.50,0,4,0,1,145.50,0.00,0.00,0.00,0,1.00,1,43.22,0,0,1,,0.00,0,0,1,0,0,1,0,0,15,1
"org.apache.jackrabbit.commons.packaging.FilterContentPackage",5,0.50,1.00,16,0.17,2430.33,7,2,11,9,3,132.05,3,22,1,1,132.05,0.00,0.00,0.10,0,8.00,1,517.24,0,1,2,java.lang.Object,0.00,4,0,5,0,4,4,1,1,127,1
"org.apache.jackrabbit.commons.packaging.FilterContentPackage$Content",1,2.00,1.00,6,0.05,724.49,3,2,11,1,1,119.45,0,8,0,1,119.45,0.00,0.00,0.00,0,1.00,1,142.24,0,0,1,java.lang.Object,0.00,0,0,1,0,0,1,0,0,39,2
"org.apache.jackrabbit.commons.packaging.FilterContentPackage$FilteringIterator",5,0.10,4.00,71,0.95,80215.49,15,10,11,20,1,95.05,22,94,0,1,94.81,0.00,0.00,0.02,3,8.00,13,2856.57,0,1,1,java.lang.Object,0.00,15,0,20,0,15,4,1,7,522,2
"org.apache.jackrabbit.spi.commons.name.HashCache",1,0.00,2.00,11,0.11,3326.52,3,2,0,3,2,153.75,26,14,2,1,104.26,0.00,0.00,1.00,0,0.00,2,321.65,0,1,0,java.lang.Object,0.00,2,0,2,0,2,0,0,4,74,1
"org.apache.jackrabbit.spi.commons.name.JcrName",5,0.10,1.20,66,1.04,39577.41,10,5,1,11,3,138.59,10,74,3,1,98.71,0.00,0.00,0.12,1,14.00,2,3116.41,0,2,0,java.lang.Object,0.00,6,0,6,0,6,3,0,8,587,2
"org.apache.jackrabbit.spi.commons.name.JcrPath",8,0.04,1.62,100,1.86,78014.13,15,7,1,17,5,139.10,19,114,5,1,99.22,0.00,0.00,0.18,3,28.00,5,5572.93,0,2,0,java.lang.Object,0.00,9,0,13,0,9,6,0,11,958,2
"org.apache.jackrabbit.spi.commons.name.MatchResult",9,0.09,1.56,40,0.33,6984.26,13,4,2,15,7,146.30,32,62,6,1,125.68,0.00,0.00,0.33,0,3.00,3,989.88,0,3,1,java.lang.Object,0.00,6,0,14,0,6,6,0,7,236,1
"org.apache.jackrabbit.spi.commons.name.Matcher",5,0.00,1.80,23,0.28,11724.73,5,0,2,15,5,79.58,36,33,2,1,121.87,0.00,0.00,0.00,1,5.00,5,826.13,0,3,3,java.lang.Object,0.00,10,0,9,0,10,2,0,6,175,2
"org.apache.jackrabbit.spi.commons.name.MatcherTest",3,0.00,2.00,34,0.63,24122.04,6,3,4,22,6,101.24,0,41,0,2,101.24,0.00,0.50,0.33,0,2.00,3,1901.36,0,0,6,junit.framework.TestCase,0.00,19,1,6,0,19,3,0,0,368,1
"org.apache.jackrabbit.spi.commons.name.NameConstants",0,0.00,0.00,115,4.77,256356.01,114,114,2,2,114,171.00,362,119,111,1,171.00,0.00,0.00,0.00,0,0.00,0,14317.24,0,0,3,java.lang.Object,0.00,2,0,0,0,2,0,0,123,1822,1
"org.apache.jackrabbit.spi.commons.name.NameFactoryImpl",4,0.17,2.50,24,0.33,13195.90,6,2,2,14,65,96.18,20,38,62,1,114.06,0.00,0.00,0.38,0,6.00,5,991.01,0,3,3,java.lang.Object,0.00,10,0,10,0,10,1,1,8,208,1
"org.apache.jackrabbit.spi.commons.name.NameFactoryImpl$NameImpl",9,0.19,1.78,47,0.43,12285.28,13,4,2,16,1,72.00,72,64,0,1,120.11,0.00,0.00,0.42,0,0.00,4,1291.34,1,5,1,java.lang.Object,0.00,7,0,16,0,7,4,1,25,307,2
"org.apache.jackrabbit.spi.commons.name.NameFactoryTest",4,0.67,2.50,40,0.49,16340.17,6,2,3,19,4,105.05,3,42,0,2,105.05,0.00,0.50,1.00,0,0.00,3,1460.22,0,0,4,junit.framework.TestCase,0.00,15,1,10,0,15,4,0,1,295,1
"org.apache.jackrabbit.spi.commons.name.NameFactoryTest$Name",3,0.00,1.00,7,0.04,335.86,3,0,3,4,0,143.64,0,10,0,1,143.64,0.00,0.00,0.00,0,3.00,1,115.95,0,2,0,java.lang.Object,0.00,1,0,3,0,1,1,0,0,36,0
"org.apache.jackrabbit.spi.commons.name.NameFactoryTest$Name_0",5,0.00,1.20,14,0.13,2404.91,5,0,3,9,0,138.61,0,20,0,1,138.61,0.00,0.00,0.00,0,5.00,2,389.62,0,3,0,java.lang.Object,0.00,4,0,6,0,4,2,0,0,100,0
"org.apache.jackrabbit.spi.commons.name.PathBuilder",13,0.12,1.23,39,0.37,6693.81,15,2,5,24,32,99.58,85,52,27,1,131.80,0.00,0.00,0.38,3,28.00,2,1095.05,0,1,5,java.lang.Object,0.00,11,0,16,0,11,12,0,16,282,2
"org.apache.jackrabbit.spi.commons.name.PathBuilderTest",6,0.13,5.17,115,1.80,117633.74,9,3,11,38,13,109.74,18,132,0,2,89.12,0.00,0.50,0.44,3,2.00,8,5406.26,0,3,13,junit.framework.TestCase,0.00,32,1,31,0,32,3,0,9,960,1
"org.apache.jackrabbit.spi.commons.name.PathBuilderTest$NamespaceResolver",2,0.00,1.00,5,0.02,262.00,2,0,11,2,0,143.10,0,7,0,1,143.10,0.00,0.00,0.00,0,2.00,1,68.00,0,2,0,java.lang.Object,0.00,0,0,2,0,0,0,0,0,24,0
"org.apache.jackrabbit.spi.commons.name.PathFactoryImpl",18,0.02,2.39,145,2.15,96500.47,32,14,10,51,56,107.98,75,186,50,1,107.75,0.00,0.00,0.09,2,126.00,10,6463.16,0,17,6,java.lang.Object,0.00,33,0,43,0,33,1,1,25,1233,1
"org.apache.jackrabbit.spi.commons.name.PathFactoryImpl$Builder",3,0.00,5.67,45,0.51,29423.68,5,2,10,14,2,46.82,31,57,0,1,95.30,0.00,0.00,0.50,0,1.00,11,1519.37,0,1,2,java.lang.Object,0.00,11,0,17,0,11,2,0,9,298,3
"org.apache.jackrabbit.spi.commons.name.PathFactoryImpl$Element",13,0.25,1.31,47,0.35,8107.80,15,2,10,21,2,113.26,73,66,0,1,131.13,0.00,0.00,0.27,1,43.00,3,1058.06,0,3,2,java.lang.Object,0.00,8,0,17,0,8,10,1,17,271,2
"org.apache.jackrabbit.spi.commons.name.PathFactoryImpl$IdentifierElement",6,0.60,1.50,27,0.24,6180.86,7,1,10,14,1,106.85,35,36,0,2,124.72,0.00,0.50,0.50,0,6.00,4,725.27,0,1,1,org.apache.jackrabbit.spi.commons.name.Element,0.00,8,1,9,0,8,5,0,6,177,3
"org.apache.jackrabbit.spi.commons.name.PathFactoryImpl$PathImpl",23,0.04,3.17,203,2.42,144850.09,28,5,10,66,1,107.37,109,266,0,1,107.13,0.00,0.00,0.17,9,71.00,10,7269.61,0,9,1,java.lang.Object,0.00,43,0,73,0,43,14,1,39,1415,3
"org.apache.jackrabbit.spi.commons.name.PathFactoryImpl$SpecialElement",5,0.31,1.60,23,0.19,3312.97,9,4,10,6,2,146.83,16,30,0,2,126.22,0.00,0.50,0.50,0,0.00,4,563.97,0,0,2,org.apache.jackrabbit.spi.commons.name.Element,0.00,1,1,8,0,1,5,0,4,137,3
"org.apache.jackrabbit.spi.commons.name.PathFactoryTest",17,0.03,2.65,181,2.44,97829.61,19,2,13,76,10,153.86,27,241,0,2,103.86,0.00,0.50,0.53,0,0.00,9,7307.73,2,1,10,junit.framework.TestCase,0.00,59,1,45,0,59,16,0,25,1387,1
"org.apache.jackrabbit.spi.commons.name.PathFactoryTest$NamespaceResolver",2,0.00,1.50,8,0.06,1022.92,2,0,13,4,1,127.12,0,11,0,1,127.12,0.00,0.00,0.00,0,2.00,2,176.73,0,2,1,java.lang.Object,0.00,2,0,3,0,2,0,0,0,47,0
"org.apache.jackrabbit.spi.commons.name.PathFactoryTest$ParentPathNameIndexDoNormalize",1,4.00,1.00,10,0.09,1247.10,5,4,13,1,2,109.32,0,13,0,1,109.32,0.00,0.00,0.00,0,1.00,1,257.30,0,0,2,java.lang.Object,0.00,0,0,1,0,0,1,0,0,65,2
"org.apache.jackrabbit.spi.commons.name.PathMap",5,0.12,2.40,49,0.50,18576.55,7,2,8,15,9,57.09,46,53,4,1,107.09,0.00,0.00,0.40,1,0.00,4,1485.54,0,0,5,java.lang.Object,0.00,10,0,12,0,10,5,0,9,315,1
"org.apache.jackrabbit.spi.commons.name.PathMap$Element",30,0.05,2.47,209,2.28,88963.27,36,6,8,69,4,82.20,205,270,0,1,114.42,0.00,0.00,0.21,8,290.00,8,6827.49,0,11,4,java.lang.Object,0.00,39,0,74,0,39,19,0,47,1433,3
"org.apache.jackrabbit.spi.commons.name.PathMap$ElementVisitor",1,0.00,1.00,2,0.01,30.51,1,0,8,1,0,148.32,4,3,0,1,148.08,0.00,0.00,0.00,0,1.00,1,25.51,0,0,0,,0.00,0,0,1,0,0,1,0,1,11,1
"org.apache.jackrabbit.spi.commons.name.PathTest",39,0.19,3.10,408,5.88,220002.73,42,3,14,90,12,103.90,30,462,0,2,103.90,0.00,0.50,0.52,0,0.00,6,17641.40,0,0,12,junit.framework.TestCase,0.00,51,1,121,0,51,39,0,20,3363,1
"org.apache.jackrabbit.spi.commons.name.PathTest$Equivalent",1,4.00,1.00,17,0.19,4857.47,5,4,14,2,0,96.07,0,20,0,1,96.07,0.00,0.00,0.00,0,1.00,1,570.64,0,0,0,java.lang.Object,0.00,1,0,1,0,1,1,0,0,140,2
"org.apache.jackrabbit.spi.commons.name.PathTest$JcrPathAndAncestor",1,4.00,1.00,44,0.75,37417.33,5,4,14,2,0,113.57,2,47,0,1,73.68,0.00,0.00,0.00,0,1.00,1,2242.26,0,0,0,java.lang.Object,0.00,1,0,1,0,1,1,0,2,437,2
"org.apache.jackrabbit.spi.commons.name.PathTest$NamespaceResolver",2,0.00,1.00,5,0.03,370.77,2,0,14,2,0,141.91,0,7,0,1,141.91,0.00,0.00,0.00,0,2.00,1,87.73,0,2,0,java.lang.Object,0.00,0,0,2,0,0,0,0,0,28,0
"org.apache.jackrabbit.spi.commons.name.PathTest$NotAncestor",1,3.00,1.00,54,0.83,62315.92,4,3,14,2,0,50.75,5,57,0,1,68.62,0.00,0.00,0.00,0,1.00,1,2487.19,0,0,0,java.lang.Object,0.00,1,0,1,0,1,1,0,5,509,2
"org.apache.jackrabbit.spi.commons.name.Pattern",11,0.00,1.73,50,0.50,13520.39,11,0,4,22,12,81.80,84,72,9,1,124.09,0.00,0.00,0.00,1,11.00,2,1511.36,0,9,3,java.lang.Object,0.00,11,0,19,5,11,2,0,19,358,2
"org.apache.jackrabbit.spi.commons.name.Pattern$AbstractNamePattern",2,0.00,2.50,12,0.15,5325.28,2,0,4,9,2,114.79,0,17,0,2,114.79,0.00,0.50,0.00,0,2.00,4,460.08,0,1,2,org.apache.jackrabbit.spi.commons.name.Pattern,0.00,7,1,5,0,7,1,0,0,97,3
"org.apache.jackrabbit.spi.commons.name.Pattern$Context",10,0.22,1.30,37,0.29,4793.68,14,4,4,15,2,132.03,0,51,0,1,132.03,0.00,0.00,0.45,0,0.00,2,868.17,0,5,2,java.lang.Object,0.00,5,0,13,0,5,5,0,0,222,2
"org.apache.jackrabbit.spi.commons.name.Pattern$NamePattern",3,0.50,1.00,9,0.08,1130.68,4,1,4,8,1,132.92,0,17,0,2,132.92,0.00,0.50,0.67,0,1.00,1,252.28,0,1,1,org.apache.jackrabbit.spi.commons.name.AbstractNamePattern,0.00,5,1,3,0,5,2,0,0,70,2
"org.apache.jackrabbit.spi.commons.name.Pattern$PathPattern",3,0.00,2.67,27,0.29,12144.27,5,2,4,14,2,106.77,0,37,0,2,106.77,0.00,0.50,0.50,0,2.00,6,867.41,0,2,2,org.apache.jackrabbit.spi.commons.name.Pattern,0.00,11,1,8,0,11,1,0,0,183,2
"org.apache.jackrabbit.spi.commons.name.Pattern$Pattern",2,0.00,1.00,5,0.03,266.33,2,0,4,3,0,143.04,0,7,0,1,143.04,0.00,0.00,0.00,0,2.00,1,75.19,0,1,0,java.lang.Object,0.00,1,0,2,0,1,1,0,0,25,0
"org.apache.jackrabbit.spi.commons.name.Pattern$Pattern_0",2,0.00,1.00,5,0.03,316.16,2,0,4,3,0,142.46,0,7,0,1,142.46,0.00,0.00,0.00,0,2.00,1,78.51,0,1,0,java.lang.Object,0.00,1,0,2,0,1,1,0,0,26,0
"org.apache.jackrabbit.spi.commons.name.Pattern$RegexPattern",3,0.12,1.00,18,0.26,4820.02,7,4,4,12,1,116.73,0,28,0,2,116.73,0.00,0.50,0.33,0,5.00,1,771.27,0,1,1,org.apache.jackrabbit.spi.commons.name.AbstractNamePattern,0.00,9,1,3,0,9,2,0,0,181,2
"org.apache.jackrabbit.spi.commons.name.Pattern$RepeatPattern",5,0.00,1.20,31,0.30,11190.96,9,4,4,12,1,115.55,0,43,0,2,115.55,0.00,0.50,0.25,0,10.00,2,894.07,0,2,1,org.apache.jackrabbit.spi.commons.name.Pattern,0.00,7,1,6,0,7,3,0,0,204,2
"org.apache.jackrabbit.spi.commons.name.Pattern$SelectPattern",3,0.25,1.33,13,0.15,3777.06,5,2,4,7,1,124.06,0,24,0,2,124.06,0.00,0.50,0.67,0,1.00,2,453.06,0,2,1,org.apache.jackrabbit.spi.commons.name.Pattern,0.00,4,1,4,0,4,1,0,0,115,2
"org.apache.jackrabbit.spi.commons.name.Pattern$SequencePattern",3,0.25,1.33,15,0.15,3163.24,5,2,4,9,1,121.06,0,27,0,2,121.06,0.00,0.50,0.67,0,1.00,2,450.10,0,2,1,org.apache.jackrabbit.spi.commons.name.Pattern,0.00,6,1,4,0,6,1,0,0,115,2
"org.apache.jackrabbit.spi.commons.name.PatternTest",14,0.05,1.50,181,3.36,139309.15,19,5,6,40,8,99.17,1,210,0,2,99.17,0.00,0.50,0.24,1,34.00,4,10091.86,0,1,8,junit.framework.TestCase,0.00,26,1,21,0,26,13,0,1,1983,1
"org.apache.jackrabbit.webdav.jcr.transaction.TransactionListener",2,0.00,1.00,3,0.02,111.87,2,0,1,2,5,109.13,17,4,4,1,157.24,0.00,0.00,0.00,0,2.00,1,74.58,0,0,1,,0.00,0,0,2,0,0,2,0,3,24,1
"org.apache.jackrabbit.webdav.jcr.transaction.TxLockManagerImpl",18,0.18,2.67,155,2.25,99563.72,21,3,32,73,24,59.14,183,209,4,1,107.61,0.00,0.00,0.17,8,106.00,9,6740.89,0,8,20,java.lang.Object,0.00,55,0,48,0,55,10,1,36,1293,1
"org.apache.jackrabbit.webdav.jcr.transaction.TxLockManagerImpl$AbstractTransaction",5,0.12,1.60,21,0.19,3492.44,7,2,32,12,4,165.92,12,30,0,2,126.04,0.00,0.50,0.40,1,9.00,4,562.78,0,3,4,org.apache.jackrabbit.webdav.jcr.transaction.TransactionMap,0.00,7,1,8,0,7,2,1,4,136,3
"org.apache.jackrabbit.webdav.jcr.transaction.TxLockManagerImpl$GlobalTransaction",8,0.57,1.62,36,0.43,9045.73,9,1,32,22,6,174.39,9,53,0,2,124.39,0.00,0.50,0.50,2,8.00,2,1285.72,1,2,6,org.apache.jackrabbit.webdav.jcr.transaction.AbstractTransaction,0.00,14,1,13,0,14,6,0,1,286,2
"org.apache.jackrabbit.webdav.jcr.transaction.TxLockManagerImpl$LocalTransaction",7,0.00,1.57,24,0.29,5433.15,7,0,32,17,7,130.34,1,39,0,2,130.34,0.00,0.50,0.00,1,12.00,3,876.77,0,2,7,org.apache.jackrabbit.webdav.jcr.transaction.AbstractTransaction,0.00,10,1,11,0,10,5,0,1,201,3
"org.apache.jackrabbit.webdav.jcr.transaction.TxLockManagerImpl$Transaction",8,0.00,1.00,9,0.04,170.51,8,0,32,8,4,160.77,35,10,0,1,160.54,0.00,0.00,0.00,0,8.00,1,129.51,0,3,4,,0.00,0,0,8,0,0,5,0,7,51,1
"org.apache.jackrabbit.webdav.jcr.transaction.TxLockManagerImpl$TransactionMap",2,0.00,1.50,8,0.07,1458.86,2,0,32,3,1,125.90,1,12,0,2,125.90,0.00,0.50,0.00,0,2.00,2,223.61,2,2,1,java.util.HashMap,0.00,1,1,3,0,1,0,0,1,59,2
"org.apache.jackrabbit.webdav.jcr.transaction.TxLockManagerImpl$XidImpl",4,1.00,1.00,10,0.06,728.11,5,1,32,5,0,142.21,18,15,0,1,141.97,0.00,0.00,0.25,0,6.00,1,190.21,0,0,0,java.lang.Object,0.00,1,0,4,0,1,4,1,5,57,2
"org.apache.jackrabbit.spi.commons.nodetype.compact.CompactNodeTypeDefReader",30,0.06,4.13,372,4.97,208288.80,37,7,36,127,25,50.17,293,483,6,1,100.17,0.00,0.00,0.20,18,46.00,18,14905.04,0,6,19,java.lang.Object,0.00,97,0,124,0,97,24,0,43,2768,1
"org.apache.jackrabbit.spi.commons.nodetype.compact.CompactNodeTypeDefTest",1,0.00,4.00,24,0.41,22944.50,2,1,11,20,7,105.47,3,27,0,2,84.86,0.00,0.50,1.00,0,0.00,4,1229.72,0,0,7,junit.framework.TestCase,0.00,19,1,4,0,19,1,0,3,209,1
"org.apache.jackrabbit.spi.commons.nodetype.compact.CompactNodeTypeDefWriter",24,0.01,3.50,253,3.37,158647.71,30,6,36,101,22,61.04,179,326,3,1,103.33,0.00,0.00,0.15,16,74.00,19,10120.94,0,3,19,java.lang.Object,0.00,77,0,84,0,77,21,0,35,1875,1
"org.apache.jackrabbit.spi.commons.nodetype.compact.Lexer",6,0.06,1.67,133,2.67,98182.77,64,58,5,19,3,69.75,34,146,2,1,87.62,0.00,0.00,0.07,1,0.00,5,8009.37,0,2,1,java.lang.Object,0.00,13,0,10,0,13,4,0,7,1296,1
"org.apache.jackrabbit.spi.commons.nodetype.compact.ParseException",6,0.20,1.67,46,0.43,15682.01,9,3,0,10,6,62.45,55,57,6,2,112.45,0.00,0.50,0.17,0,10.00,5,1299.94,2,2,0,java.lang.Exception,0.00,4,1,10,0,4,4,0,11,297,1
"org.apache.jackrabbit.spi.commons.nodetype.compact.QNodeTypeDefinitionsBuilder",2,0.00,1.00,7,0.05,477.65,2,0,15,2,12,114.33,29,9,2,1,134.48,0.00,0.00,0.00,0,2.00,1,150.04,0,1,10,java.lang.Object,0.00,0,0,2,1,0,1,0,7,46,2
"org.apache.jackrabbit.spi.commons.nodetype.compact.QNodeTypeDefinitionsBuilder$QItemDefinitionBuilder",12,0.05,1.00,31,0.17,1687.24,18,6,15,12,1,143.09,54,44,0,1,142.86,0.00,0.00,0.12,0,90.00,1,521.38,0,2,1,java.lang.Object,0.00,0,0,12,0,0,10,0,12,154,1
"org.apache.jackrabbit.spi.commons.nodetype.compact.QNodeTypeDefinitionsBuilder$QNodeDefinitionBuilder",7,0.06,1.00,17,0.10,1045.06,10,3,15,7,2,163.27,27,24,0,2,142.65,0.00,0.50,0.29,0,25.00,1,304.98,0,3,2,org.apache.jackrabbit.spi.commons.nodetype.compact.QItemDefinitionBuilder,0.00,0,1,7,0,0,4,0,7,90,2
"org.apache.jackrabbit.spi.commons.nodetype.compact.QNodeTypeDefinitionsBuilder$QNodeTypeDefinitionBuilder",21,0.05,1.00,49,0.31,3664.59,30,9,15,21,4,142.35,100,68,0,1,142.12,0.00,0.00,0.06,0,237.00,1,928.02,0,6,4,java.lang.Object,0.00,0,0,21,0,0,15,0,21,264,2
"org.apache.jackrabbit.spi.commons.nodetype.compact.QNodeTypeDefinitionsBuilder$QPropertyDefinitionBuilder",17,0.06,1.00,39,0.29,3685.43,24,7,15,18,6,123.50,87,56,0,2,141.38,0.00,0.50,0.08,0,155.00,1,860.99,0,6,6,org.apache.jackrabbit.spi.commons.nodetype.compact.QItemDefinitionBuilder,0.00,1,1,17,0,1,11,0,17,234,2
"org.apache.jackrabbit.spi.commons.nodetype.compact.QNodeTypeDefinitionsBuilderImpl",2,1.00,1.00,9,0.09,1260.37,3,1,18,5,18,78.39,17,12,1,2,126.50,0.00,0.50,0.50,0,2.00,1,257.45,0,1,17,org.apache.jackrabbit.spi.commons.nodetype.compact.QNodeTypeDefinitionsBuilder,0.50,3,1,2,0,3,1,0,4,63,1
"org.apache.jackrabbit.spi.commons.nodetype.compact.QNodeTypeDefinitionsBuilderImpl$QNodeDefinitionBuilderImpl",1,0.00,1.00,3,0.07,1155.05,1,0,18,11,2,129.08,0,14,0,2,129.08,0.00,0.50,0.00,0,1.00,1,214.32,0,1,2,org.apache.jackrabbit.spi.commons.nodetype.compact.QNodeDefinitionBuilder,0.00,10,1,1,0,10,0,0,0,52,1
"org.apache.jackrabbit.spi.commons.nodetype.compact.QNodeTypeDefinitionsBuilderImpl$QNodeTypeDefinitionBuilderImpl",3,0.00,1.00,7,0.10,1356.63,3,0,18,15,2,138.86,0,21,0,2,138.86,0.00,0.50,0.00,0,3.00,1,285.35,0,1,2,org.apache.jackrabbit.spi.commons.nodetype.compact.QNodeTypeDefinitionBuilder,0.00,12,1,3,0,12,2,0,0,73,1
"org.apache.jackrabbit.spi.commons.nodetype.compact.QNodeTypeDefinitionsBuilderImpl$QPropertyDefinitionBuilderImpl",3,0.00,1.00,7,0.17,2542.58,3,0,18,20,9,136.71,0,27,0,2,136.71,0.00,0.50,0.00,0,3.00,1,497.98,0,3,9,org.apache.jackrabbit.spi.commons.nodetype.compact.QPropertyDefinitionBuilder,0.00,17,1,3,0,17,0,0,0,115,1
"org.apache.jackrabbit.webdav.jcr.nodetype.ItemDefinitionImpl",9,0.05,1.22,41,0.40,8524.34,16,7,8,22,5,145.67,34,52,3,1,125.06,0.00,0.00,0.19,6,41.00,2,1212.75,0,4,2,java.lang.Object,0.00,13,0,11,2,13,5,3,11,268,2
"org.apache.jackrabbit.webdav.jcr.nodetype.NodeDefinitionImpl",9,0.03,1.44,50,0.47,14294.96,13,4,7,20,5,140.25,33,58,3,2,119.64,0.00,0.50,0.22,3,37.00,3,1400.79,1,7,2,org.apache.jackrabbit.webdav.jcr.nodetype.ItemDefinitionImpl,0.11,11,1,13,0,11,2,1,12,308,2
"org.apache.jackrabbit.webdav.jcr.nodetype.NodeTypeConstants",0,0.00,0.00,39,0.55,9649.74,38,38,2,0,8,171.00,62,40,6,1,171.00,0.00,0.00,0.00,0,0.00,0,1642.95,0,0,2,,0.00,0,0,0,0,0,0,0,34,255,1
"org.apache.jackrabbit.webdav.jcr.nodetype.NodeTypeProperty",8,0.00,2.50,62,0.76,21350.19,10,2,14,31,10,152.17,23,75,5,2,112.28,0.00,0.50,0.50,2,0.00,5,2265.72,1,3,5,org.apache.jackrabbit.webdav.property.AbstractDavProperty,0.00,23,1,20,0,23,5,1,6,458,1
"org.apache.jackrabbit.webdav.jcr.nodetype.PropertyDefinitionImpl",11,0.05,1.55,78,0.85,36609.58,19,8,9,29,5,132.25,42,88,3,2,111.64,0.00,0.50,0.17,7,73.00,6,2556.97,1,6,2,org.apache.jackrabbit.webdav.jcr.nodetype.ItemDefinitionImpl,0.10,18,1,17,0,18,5,1,17,492,2
"org.apache.jackrabbit.core.security.authorization.AbstractACLTemplateTest",16,0.23,1.88,111,1.47,49140.52,18,2,15,44,10,114.37,12,140,0,5,114.37,0.50,0.57,0.28,2,40.00,4,4406.92,2,2,10,org.apache.jackrabbit.test.api.security.AbstractAccessControlTest,0.11,28,4,30,2,28,14,0,10,871,2
"org.apache.jackrabbit.core.security.authorization.AbstractACLTemplateTest$AccessControlEntry",2,0.00,1.00,5,0.02,258.03,2,0,15,2,0,143.15,0,7,0,1,143.15,0.00,0.00,0.00,0,2.00,1,71.86,0,2,0,java.lang.Object,0.00,0,0,2,0,0,0,0,0,24,0
"org.apache.jackrabbit.core.security.authorization.AbstractACLTemplateTest$JackrabbitAccessControlEntry",6,0.00,1.17,15,0.10,1350.27,6,0,15,8,2,141.21,0,23,0,1,141.21,0.00,0.00,0.00,0,10.00,2,311.36,0,4,2,java.lang.Object,0.00,2,0,7,0,2,2,0,0,87,0
"org.apache.jackrabbit.core.security.authorization.AbstractACLTemplateTest$JackrabbitAccessControlEntry_0",6,0.00,1.00,13,0.06,647.10,6,0,15,6,0,143.76,0,19,0,1,143.76,0.00,0.00,0.00,0,10.00,1,192.95,0,4,0,java.lang.Object,0.00,0,0,6,0,0,2,0,0,62,0
"org.apache.jackrabbit.core.security.authorization.AbstractAccessControlProvider",9,0.02,1.56,44,0.44,10515.73,17,8,15,20,13,106.41,51,56,4,1,124.28,0.00,0.00,0.14,1,13.00,3,1313.38,0,1,9,java.lang.Object,0.00,11,0,14,4,11,8,2,13,282,2
"org.apache.jackrabbit.core.security.authorization.AbstractAccessControlProvider$CompiledPermissions",4,0.00,1.00,8,0.04,280.01,4,0,15,4,1,145.24,1,12,0,1,145.24,0.00,0.00,0.00,0,6.00,1,119.85,0,0,1,java.lang.Object,0.00,0,0,4,0,0,4,0,1,39,0
"org.apache.jackrabbit.core.security.authorization.AbstractAccessControlProvider$CompiledPermissions_0",4,0.00,1.50,14,0.09,1363.34,4,0,15,5,3,133.17,2,20,0,1,133.17,0.00,0.00,0.00,0,6.00,2,275.23,0,0,3,java.lang.Object,0.00,1,0,6,0,1,4,0,2,71,0
"org.apache.jackrabbit.core.security.authorization.AbstractCompiledPermissions",8,0.71,1.12,25,0.20,3951.26,9,1,3,14,5,132.20,36,36,3,1,131.96,0.00,0.00,0.38,2,14.00,2,595.58,0,0,2,java.lang.Object,0.00,6,0,9,4,6,8,1,12,156,2
"org.apache.jackrabbit.core.security.authorization.AbstractCompiledPermissions$Result",6,0.17,1.33,37,0.43,15396.08,12,6,3,8,2,165.06,6,49,0,1,115.06,0.00,0.00,0.31,0,10.00,3,1300.62,0,1,2,java.lang.Object,0.00,2,0,8,0,2,5,0,2,299,2
"org.apache.jackrabbit.core.security.authorization.AbstractEntryTest",11,0.60,1.73,105,1.46,53294.95,12,1,12,37,4,106.26,10,125,0,5,106.26,0.50,0.57,0.45,1,28.00,6,4390.41,3,2,4,org.apache.jackrabbit.test.api.security.AbstractAccessControlTest,0.12,26,4,19,2,26,9,0,8,864,2
"org.apache.jackrabbit.core.security.authorization.AbstractEntryTest$JackrabbitAccessControlEntry",6,0.00,1.00,13,0.07,667.99,6,0,12,7,1,143.65,0,19,0,1,143.65,0.00,0.00,0.00,0,10.00,1,209.42,0,4,1,java.lang.Object,0.00,1,0,6,0,1,2,0,0,65,0
"org.apache.jackrabbit.core.security.authorization.AbstractEntryTest$Principal",1,0.00,1.00,3,0.01,72.00,1,0,12,1,0,138.58,0,4,0,1,138.58,0.00,0.00,0.00,0,1.00,1,32.00,0,1,0,java.lang.Object,0.00,0,0,1,0,0,0,0,0,12,0
"org.apache.jackrabbit.core.security.authorization.AbstractEntryTest$Principal_0",1,0.00,1.00,3,0.01,72.00,1,0,12,1,0,138.58,0,4,0,1,138.58,0.00,0.00,0.00,0,1.00,1,32.00,0,1,0,java.lang.Object,0.00,0,0,1,0,0,0,0,0,12,0
"org.apache.jackrabbit.core.security.authorization.AbstractEntryTest$Privilege",5,0.00,1.00,11,0.05,564.06,5,0,12,5,0,143.61,0,16,0,1,143.61,0.00,0.00,0.00,0,5.00,1,159.73,0,3,0,java.lang.Object,0.00,0,0,5,0,0,2,0,0,52,0
"org.apache.jackrabbit.core.security.authorization.AbstractEvaluationTest",16,0.03,1.75,82,1.06,25632.10,23,7,22,46,11,119.56,4,108,4,5,119.56,3.25,0.22,0.12,5,82.00,6,3167.75,3,12,7,org.apache.jackrabbit.test.api.security.AbstractAccessControlTest,0.21,30,4,28,13,30,4,0,4,659,2
"org.apache.jackrabbit.core.security.authorization.AbstractLockManagementTest",6,0.00,1.83,62,0.83,18941.66,6,0,6,26,3,156.00,10,77,0,6,106.00,0.40,0.62,0.00,2,0.00,3,2484.83,3,2,3,org.apache.jackrabbit.core.security.authorization.AbstractEvaluationTest,0.00,20,5,11,2,20,4,0,10,488,2
"org.apache.jackrabbit.core.security.authorization.AbstractNodeTypeManagementTest",13,0.12,2.38,156,1.96,51014.76,15,2,11,46,4,122.86,43,215,1,6,102.24,0.40,0.62,0.62,1,0.00,3,5869.06,4,1,3,org.apache.jackrabbit.core.security.authorization.AbstractEvaluationTest,0.10,33,5,31,2,33,12,0,32,1148,2
"org.apache.jackrabbit.core.security.authorization.AbstractVersionManagementTest",7,0.50,2.14,96,1.34,35625.52,8,1,11,42,4,139.97,17,115,0,6,100.08,0.40,0.62,0.57,1,0.00,3,4032.68,4,1,4,org.apache.jackrabbit.core.security.authorization.AbstractEvaluationTest,0.00,35,5,15,2,35,6,0,17,740,2
"org.apache.jackrabbit.core.security.authorization.AbstractWriteTest",29,0.09,2.07,390,5.75,180321.68,37,8,23,94,12,50.93,303,486,1,6,99.41,0.60,0.56,0.21,2,0.00,8,17264.77,9,3,11,org.apache.jackrabbit.core.security.authorization.AbstractEvaluationTest,0.16,65,5,60,3,65,26,0,141,3187,2
"org.apache.jackrabbit.core.security.authorization.AbstractWriteTest$AccessControlPolicy",0,0.00,0.00,1,0.00,12.00,0,0,23,0,0,171.00,0,0,0,1,171.00,0.00,0.00,0.00,0,0.00,0,8.00,0,0,0,java.lang.Object,0.00,0,0,0,0,0,0,0,0,4,0
"org.apache.jackrabbit.core.security.authorization.AbstractWriteTest$AccessControlPolicy_0",0,0.00,0.00,1,0.00,12.00,0,0,23,0,0,171.00,0,0,0,1,171.00,0.00,0.00,0.00,0,0.00,0,8.00,0,0,0,java.lang.Object,0.00,0,0,0,0,0,0,0,0,4,0
"org.apache.jackrabbit.core.security.authorization.AccessControlConstants",0,0.00,0.00,13,0.27,7824.43,12,12,3,2,5,171.00,43,14,2,1,171.00,0.00,0.00,0.00,0,0.00,0,817.88,0,0,3,,0.00,2,0,0,0,2,0,0,16,157,1
"org.apache.jackrabbit.core.security.authorization.AccessControlEditor",6,0.00,1.00,7,0.08,438.82,6,0,7,6,9,165.45,106,8,8,1,156.32,0.00,0.00,0.00,0,6.00,1,243.42,0,4,1,,0.00,0,0,6,0,0,2,0,7,72,1
"org.apache.jackrabbit.core.security.authorization.AccessControlEntryImpl",11,0.07,1.91,73,0.86,32692.01,18,7,12,32,7,72.18,84,94,3,1,114.48,0.00,0.00,0.21,0,44.00,7,2565.43,0,4,4,java.lang.Object,0.00,21,0,21,2,21,7,1,26,518,2
"org.apache.jackrabbit.core.security.authorization.AccessControlEntryIterator",6,0.00,2.00,36,0.38,13083.83,10,4,10,20,3,115.52,4,46,2,1,115.52,0.00,0.00,0.25,0,10.00,5,1135.86,0,2,1,java.lang.Object,0.00,14,0,12,0,14,4,1,2,243,1
"org.apache.jackrabbit.core.security.authorization.AccessControlProvider",7,0.00,1.00,8,0.05,255.27,7,0,7,7,15,129.32,91,9,12,1,158.70,0.00,0.00,0.00,0,7.00,1,164.44,0,3,3,,0.00,0,0,7,0,0,4,0,8,57,1
"org.apache.jackrabbit.core.security.authorization.AccessControlProviderFactory",3,0.00,1.00,4,0.03,124.09,3,0,3,3,3,138.13,44,5,1,1,158.27,0.00,0.00,0.00,0,3.00,1,82.73,0,0,2,,0.00,0,0,3,0,0,3,0,4,29,1
"org.apache.jackrabbit.core.security.authorization.AccessControlProviderFactoryImpl",3,0.33,2.00,27,0.38,12620.27,6,3,12,18,9,58.60,24,35,1,1,106.71,0.00,0.00,0.56,0,1.00,3,1129.24,0,0,8,java.lang.Object,0.00,15,0,6,0,15,3,1,12,219,1
"org.apache.jackrabbit.core.security.authorization.AccessControlUtils",4,0.00,1.00,5,0.03,118.02,4,0,4,4,5,109.43,39,6,3,1,159.42,0.00,0.00,0.00,0,4.00,1,89.02,0,0,2,,0.00,0,0,4,0,0,4,0,5,33,1
"org.apache.jackrabbit.core.security.authorization.CompiledPermissions",4,0.00,1.00,5,0.03,132.09,4,0,2,4,10,110.56,43,6,9,1,159.04,0.00,0.00,0.00,0,4.00,1,90.73,0,0,1,,0.00,0,0,4,0,0,4,0,5,33,1
"org.apache.jackrabbit.core.security.authorization.JackrabbitAccessControlListTest",11,0.20,2.64,126,1.64,70507.52,12,1,18,43,10,101.95,4,141,1,5,101.95,0.00,0.80,0.82,1,0.00,5,4919.81,3,1,9,org.apache.jackrabbit.test.api.security.AbstractAccessControlTest,0.24,32,4,29,0,32,10,0,2,916,1
"org.apache.jackrabbit.core.security.authorization.NamedAccessControlPolicyImpl",2,1.00,1.50,8,0.06,957.77,3,1,2,3,1,167.23,5,12,1,1,127.34,0.00,0.00,0.50,0,2.00,2,176.29,0,1,0,java.lang.Object,0.00,1,0,3,0,1,1,1,3,47,2
"org.apache.jackrabbit.core.security.authorization.Permission",1,14.00,1.00,17,0.29,7230.87,15,14,0,1,32,94.24,16,19,32,1,94.71,0.00,0.00,0.00,0,1.00,1,865.54,0,0,0,java.lang.Object,0.00,0,0,1,0,0,1,0,2,170,2
"org.apache.jackrabbit.core.security.authorization.PrivilegeRegistry",8,0.16,5.88,172,2.81,168531.31,46,38,16,33,37,43.10,93,230,32,1,87.22,0.00,0.00,0.17,1,16.00,17,8438.27,0,3,5,java.lang.Object,0.00,25,0,47,0,25,5,0,17,1450,2
"org.apache.jackrabbit.core.security.authorization.PrivilegeRegistry$InternalPrivilege",5,0.21,2.20,47,0.43,14081.77,11,6,16,11,1,147.94,11,56,0,1,108.06,0.00,0.00,0.33,0,0.00,4,1288.56,0,0,1,java.lang.Object,0.00,6,0,11,0,6,5,0,3,267,2
"org.apache.jackrabbit.core.security.authorization.PrivilegeRegistry$PrivilegeImpl",8,0.00,1.88,49,0.44,12594.45,10,2,16,14,1,116.65,1,61,0,1,116.65,0.00,0.00,0.50,0,0.00,3,1318.97,0,3,1,java.lang.Object,0.00,6,0,15,0,6,5,1,1,296,1
"org.apache.jackrabbit.core.security.authorization.PrivilegeRegistryTest",20,0.11,1.50,157,2.56,104776.43,22,2,13,44,7,110.09,12,207,1,2,110.09,0.00,0.50,0.40,3,0.00,3,7676.82,1,2,6,junit.framework.TestCase,0.00,24,1,30,0,24,18,0,10,1528,1
"org.apache.jackrabbit.core.security.authorization.PrivilegeRegistryTest$NamespaceResolver",2,0.00,4.00,19,0.19,6281.66,2,0,13,9,1,107.55,0,23,0,1,107.55,0.00,0.00,0.00,0,2.00,4,577.97,0,2,1,java.lang.Object,0.00,7,0,8,0,7,0,0,0,130,0
"org.apache.jackrabbit.core.security.authorization.PrivilegeRegistryTest$Privilege",5,0.00,1.40,11,0.09,1724.93,5,0,13,6,0,139.71,0,16,0,1,139.71,0.00,0.00,0.00,0,5.00,2,267.08,0,3,0,java.lang.Object,0.00,1,0,7,0,1,2,0,0,75,0
"org.apache.jackrabbit.core.security.authorization.TestAll",1,0.00,1.00,6,0.05,1283.53,1,0,3,3,2,69.02,10,8,0,2,117.50,0.00,0.50,0.00,0,1.00,1,150.40,0,1,2,junit.framework.TestCase,0.00,2,1,1,0,2,0,0,2,39,1
"org.apache.jackrabbit.core.security.authorization.UnmodifiableAccessControlList",5,0.75,1.00,12,0.13,1749.03,6,1,7,9,2,107.52,30,22,2,1,139.74,0.00,0.00,0.40,0,7.00,1,376.42,0,1,0,java.lang.Object,0.00,4,0,5,0,4,4,1,7,99,1
"org.apache.jackrabbit.core.security.authorization.WorkspaceAccessManager",3,0.00,1.00,4,0.03,124.09,3,0,3,3,8,108.27,27,5,8,1,158.27,0.00,0.00,0.00,0,3.00,1,82.73,0,0,0,,0.00,0,0,3,0,0,3,0,4,29,1
"org.apache.jackrabbit.core.security.principal.AbstractPrincipalIterator",9,0.06,1.22,29,0.18,2708.20,13,4,5,12,3,183.64,17,40,2,1,133.64,0.00,0.00,0.19,2,24.00,2,530.79,0,3,1,java.lang.Object,0.00,3,0,11,2,3,6,1,5,143,1
"org.apache.jackrabbit.core.security.principal.AbstractPrincipalProvider",8,0.05,1.50,31,0.26,4858.90,11,3,3,16,2,98.97,52,43,1,1,131.19,0.00,0.00,0.38,2,0.00,3,787.39,0,2,1,java.lang.Object,0.00,8,0,12,1,8,6,1,13,191,2
"org.apache.jackrabbit.core.security.principal.AdminPrincipal",4,0.67,1.25,12,0.09,1370.38,5,1,0,6,10,183.19,5,18,9,1,133.19,0.00,0.00,0.50,0,4.00,2,259.40,0,1,1,java.lang.Object,0.00,2,0,5,1,2,3,1,1,71,1
"org.apache.jackrabbit.core.security.principal.DefaultPrincipalProvider",12,0.15,2.25,105,1.36,40432.62,18,6,22,50,15,60.87,120,158,2,2,109.35,0.00,0.50,0.31,1,8.00,5,4090.14,4,8,13,org.apache.jackrabbit.core.security.principal.AbstractPrincipalProvider,0.10,38,1,27,0,38,4,1,33,796,1
"org.apache.jackrabbit.core.security.principal.DefaultPrincipalProvider$PrincipalIteratorImpl",2,0.00,2.50,19,0.15,2979.26,4,2,22,6,2,130.82,6,26,0,2,110.21,0.00,0.50,0.50,0,2.00,4,460.36,0,1,2,org.apache.jackrabbit.core.security.principal.AbstractPrincipalIterator,0.18,4,1,5,0,4,1,0,4,104,1
"org.apache.jackrabbit.core.security.principal.DefaultPrincipalProviderTest",4,0.00,3.00,39,0.53,24708.35,5,1,9,28,10,155.30,6,49,1,5,105.30,0.00,0.80,1.00,0,0.00,8,1593.28,3,0,9,org.apache.jackrabbit.api.security.user.AbstractUserTest,0.26,24,4,12,0,24,4,0,4,313,1
"org.apache.jackrabbit.core.security.principal.EveryonePrincipal",9,0.38,1.00,20,0.16,2244.04,11,2,2,13,6,140.90,6,29,6,1,140.90,0.00,0.00,0.17,0,26.00,1,473.13,0,3,0,java.lang.Object,0.00,4,0,9,0,4,6,1,4,130,2
"org.apache.jackrabbit.core.security.principal.ItemBasedPrincipal",1,0.00,1.00,2,0.01,59.45,1,0,1,1,9,108.24,12,3,9,2,145.80,0.00,0.50,0.00,0,1.00,1,33.60,0,1,0,,0.00,0,1,1,0,0,0,0,2,13,1
"org.apache.jackrabbit.core.security.principal.JackrabbitPrincipal",0,0.00,0.00,1,0.01,31.02,0,0,1,0,2,171.00,4,2,2,2,171.00,0.00,0.50,0.00,0,0.00,0,15.51,0,0,0,,0.00,0,1,0,0,0,0,0,1,6,1
"org.apache.jackrabbit.core.security.principal.PrincipalImpl",5,0.12,1.60,19,0.17,2883.55,7,2,2,11,11,113.48,29,28,10,1,131.35,0.00,0.00,0.40,0,0.00,3,506.21,0,2,1,java.lang.Object,0.00,6,0,8,1,6,3,2,11,126,1
"org.apache.jackrabbit.core.security.principal.PrincipalIteratorAdapter",3,1.00,1.00,8,0.07,1284.33,4,1,7,5,7,96.76,23,13,4,2,139.05,0.00,0.50,0.00,0,3.00,1,219.48,1,1,3,org.apache.jackrabbit.commons.iterator.RangeIteratorDecorator,0.00,2,1,3,0,2,2,1,6,61,1
"org.apache.jackrabbit.core.security.principal.PrincipalManagerImpl",11,0.10,2.36,95,0.98,32512.65,14,3,12,28,7,67.49,82,107,2,1,109.78,0.00,0.00,0.24,4,30.00,4,2925.85,0,8,5,java.lang.Object,0.00,17,0,26,0,17,3,1,28,604,1
"org.apache.jackrabbit.core.security.principal.PrincipalManagerImpl$CheckedGroup",8,0.14,1.00,22,0.18,2427.85,10,2,12,18,1,140.22,1,31,0,1,140.22,0.00,0.00,0.38,0,0.00,1,526.25,0,2,1,java.lang.Object,0.00,10,0,8,0,10,6,1,1,145,1
"org.apache.jackrabbit.core.security.principal.PrincipalManagerImpl$CheckedGroup$Enumeration",2,0.00,1.00,5,0.03,231.25,2,0,12,4,0,143.52,0,7,0,1,143.52,0.00,0.00,0.00,0,2.00,1,81.08,0,1,0,java.lang.Object,0.00,2,0,2,0,2,1,0,0,26,0
"org.apache.jackrabbit.core.security.principal.PrincipalManagerImpl$CheckedIteratorEntry",1,2.00,1.00,6,0.04,570.78,3,2,12,1,1,120.27,0,8,0,1,120.27,0.00,0.00,0.00,0,1.00,1,130.51,0,0,1,java.lang.Object,0.00,0,0,1,0,0,1,0,0,37,2
"org.apache.jackrabbit.core.security.principal.PrincipalManagerImpl$CheckedPrincipalIterator",3,0.50,2.00,19,0.22,6272.82,4,1,12,11,2,165.67,5,27,0,2,115.67,0.00,0.50,0.67,0,0.00,4,658.45,0,1,2,org.apache.jackrabbit.core.security.principal.AbstractPrincipalIterator,0.17,8,1,6,0,8,2,0,3,145,1
"org.apache.jackrabbit.core.security.principal.PrincipalManagerImpl$ItemBasedCheckedGroup",2,0.00,1.50,7,0.06,958.48,2,0,12,4,2,132.00,0,11,0,2,132.00,0.00,0.50,0.00,0,2.00,2,187.63,0,1,2,org.apache.jackrabbit.core.security.principal.CheckedGroup,0.00,2,1,3,0,2,1,1,0,50,1
"org.apache.jackrabbit.core.security.principal.PrincipalProvider",8,0.00,1.00,9,0.05,148.55,8,0,4,8,13,112.53,83,10,12,1,161.01,0.00,0.00,0.00,0,8.00,1,143.55,0,5,1,,0.00,0,0,8,0,0,3,0,9,55,1
"org.apache.jackrabbit.core.security.principal.PrincipalProviderRegistry",4,0.00,1.00,5,0.02,91.92,4,0,2,4,6,112.17,33,6,5,1,160.28,0.00,0.00,0.00,0,4.00,1,69.12,0,4,1,,0.00,0,0,4,0,0,0,0,5,28,1
"org.apache.jackrabbit.core.security.principal.ProviderRegistryImpl",6,0.00,2.00,37,0.46,13813.27,9,3,9,22,6,83.12,37,57,2,1,115.34,0.00,0.00,0.33,1,2.00,6,1375.83,0,0,4,java.lang.Object,0.00,16,0,12,0,16,6,1,10,292,1
"org.apache.jackrabbit.core.security.principal.TestAll",1,0.00,1.00,5,0.04,864.35,1,0,3,3,1,73.32,10,7,0,2,121.80,0.00,0.50,0.00,0,1.00,1,115.51,0,1,1,junit.framework.TestCase,0.00,2,1,1,0,2,0,0,2,31,1
"org.apache.jackrabbit.JcrConstants",0,0.00,0.00,71,1.53,23803.38,70,70,1,0,18,171.00,217,72,18,1,171.00,0.00,0.00,0.00,0,0.00,0,4576.95,0,0,0,,0.00,0,0,0,0,0,0,0,71,634,1
