Name, No. Methods, LCOM, AVCC, NOS, HBUG, HEFF, UWCS, INST, PACK, RFC, CBO, MI, CCML, NLOC, F-IN, DIT, MINC, S-R, R-R, COH, LMC, LCOM2, MAXCC, HVOL, HIER, NQU, FOUT, Superclass, SIX, EXT, NSUP, TCC, NSUB, MPC, NCO, INTR, CCOM, HLTH, MOD
"org.apache.jackrabbit.core.xml.AbstractSAXEventGenerator",11,0.04,2.09,88,1.37,72560.47,24,13,11,35,12,58.59,115,121,2,1,107.07,0.00,0.00,0.11,6,44.00,11,4120.20,0,0,10,java.lang.Object,0.00,24,0,23,2,24,11,0,34,765,1
"org.apache.jackrabbit.core.xml.DocViewImportHandler",4,0.22,3.50,48,0.80,52423.16,7,3,10,25,8,80.16,23,64,1,2,98.03,0.00,0.50,0.50,0,0.00,10,2398.61,0,0,7,org.xml.sax.helpers.DefaultHandler,0.00,21,1,14,0,21,4,0,9,427,0
"org.apache.jackrabbit.core.xml.DocViewSAXEventGenerator",7,0.11,3.86,98,1.64,99005.98,13,6,19,49,15,46.77,71,146,2,2,95.25,0.00,0.50,0.26,0,4.00,15,4933.89,0,0,13,org.apache.jackrabbit.core.xml.AbstractSAXEventGenerator,0.00,42,1,27,0,42,7,0,37,812,1
"org.apache.jackrabbit.core.xml.ImportHandler",11,0.08,1.82,63,0.82,28056.74,19,8,6,34,7,100.09,59,88,1,2,117.96,0.00,0.50,0.19,0,24.00,6,2452.88,0,0,7,org.xml.sax.helpers.DefaultHandler,0.00,23,1,20,0,23,11,0,27,511,1
"org.apache.jackrabbit.core.xml.SysViewImportHandler",5,0.43,11.00,160,2.93,242574.72,12,7,17,55,12,57.26,72,211,1,2,77.40,0.00,0.50,0.49,1,0.00,26,8776.75,0,0,11,org.xml.sax.helpers.DefaultHandler,0.00,50,1,55,0,50,5,0,57,1375,0
"org.apache.jackrabbit.core.xml.SysViewImportHandler$ImportState",0,0.00,0.00,7,0.05,506.67,6,6,17,0,2,171.00,0,8,0,1,171.00,0.00,0.00,0.00,0,0.00,0,160.00,0,0,2,java.lang.Object,0.00,0,0,0,0,0,0,0,0,40,0
"org.apache.jackrabbit.core.xml.SysViewSAXEventGenerator",7,0.23,2.86,87,1.49,93989.36,18,11,14,39,15,49.89,59,123,2,2,98.00,0.00,0.50,0.29,0,3.00,12,4476.68,0,0,13,org.apache.jackrabbit.core.xml.AbstractSAXEventGenerator,0.00,32,1,20,0,32,7,0,28,751,1
"org.apache.jackrabbit.core.xml.SysViewSAXEventGenerator$Writer",3,0.00,1.33,7,0.07,1447.36,3,0,14,6,0,138.57,2,12,0,1,138.57,0.00,0.00,0.00,0,3.00,2,205.45,0,0,0,java.lang.Object,0.00,3,0,4,0,3,3,0,2,52,0
"org.apache.jackrabbit.core.jndi.BindableRepository",9,0.04,1.11,36,0.38,7097.40,15,6,12,24,5,146.32,35,52,3,1,125.71,0.00,0.00,0.20,1,7.00,2,1133.63,0,5,3,java.lang.Object,0.00,15,0,10,0,15,4,3,17,271,0
"org.apache.jackrabbit.core.jndi.BindableRepositoryFactory",2,1.00,2.50,16,0.24,8116.22,3,1,7,12,1,60.58,16,27,1,1,108.69,0.00,0.00,0.50,0,2.00,4,731.93,0,1,1,java.lang.Object,0.00,10,0,5,0,10,1,1,5,144,1
"org.apache.jackrabbit.core.jndi.RegistryHelper",3,0.00,1.33,10,0.11,2229.24,3,0,3,7,3,82.42,24,20,2,1,130.53,0.00,0.00,0.00,0,3.00,2,321.88,0,0,1,java.lang.Object,0.00,4,0,4,0,4,3,0,4,75,1
"org.apache.jackrabbit.test.search.AbstractQueryTest",2,0.00,4.00,41,0.49,19532.30,2,0,3,16,4,46.60,22,43,3,4,90.73,1.00,0.43,0.00,1,0.00,5,1473.89,0,0,1,org.apache.jackrabbit.test.AbstractJCRTest,0.00,14,3,8,3,14,2,0,4,264,1
"org.apache.jackrabbit.test.search.FulltextQueryTest",6,0.00,1.00,69,1.19,28607.16,6,0,3,15,2,103.19,3,76,1,5,103.19,0.00,0.80,0.00,0,0.00,1,3570.84,1,0,1,org.apache.jackrabbit.test.search.AbstractQueryTest,0.00,9,4,6,0,9,6,0,1,657,1
"org.apache.jackrabbit.test.search.SelectClauseTest",3,0.00,1.00,57,0.97,35959.20,3,0,4,10,2,141.18,3,61,1,5,91.18,0.00,0.80,0.00,0,0.00,1,2910.95,1,0,1,org.apache.jackrabbit.test.search.AbstractQueryTest,0.00,7,4,3,0,7,3,0,1,527,1
"org.apache.jackrabbit.test.search.SimpleQueryTest",12,0.00,1.00,219,3.86,151131.04,12,0,4,27,2,91.89,7,232,1,5,91.89,0.00,0.80,0.00,0,0.00,1,11588.89,1,0,1,org.apache.jackrabbit.test.search.AbstractQueryTest,0.00,15,4,12,0,15,12,0,5,2073,1
"org.apache.jackrabbit.test.search.TestAll",1,0.00,1.00,7,0.06,1740.69,1,0,3,3,3,65.48,10,9,0,2,113.96,0.00,0.50,0.00,0,1.00,1,186.48,0,1,3,junit.framework.TestCase,0.00,2,1,1,0,2,0,0,2,47,1
"org.apache.jackrabbit.core.config.AbstractConfig",4,0.13,3.00,61,0.88,37454.98,14,10,14,29,3,53.31,31,74,2,1,95.60,0.00,0.00,0.20,0,4.00,5,2627.32,0,3,1,java.lang.Object,0.00,25,0,12,2,25,1,1,10,486,1
"org.apache.jackrabbit.core.config.RepositoryConfig",12,0.08,2.17,111,1.50,65096.97,26,14,16,51,7,57.34,128,141,4,2,105.82,0.00,0.50,0.14,2,58.00,8,4504.58,0,9,3,org.apache.jackrabbit.core.config.AbstractConfig,0.00,39,1,26,0,39,3,0,39,823,1
"org.apache.jackrabbit.core.config.WorkspaceConfig",10,0.07,1.50,76,1.02,34573.52,23,13,15,41,10,63.04,103,95,8,2,111.52,0.00,0.50,0.14,1,58.00,4,3060.38,0,8,3,org.apache.jackrabbit.core.config.AbstractConfig,0.00,31,1,15,0,31,2,0,35,570,1
"org.apache.jackrabbit.core.search.jcrql.ASTAndExpr",3,0.00,1.00,7,0.05,490.78,3,0,0,4,4,192.34,3,11,3,2,142.34,0.00,0.50,0.00,0,3.00,1,151.60,0,1,3,org.apache.jackrabbit.core.search.jcrql.SimpleNode,0.00,1,1,3,0,1,2,0,1,46,1
"org.apache.jackrabbit.core.search.jcrql.ASTBracketExpr",3,0.00,1.00,7,0.05,490.78,3,0,0,4,4,192.34,3,11,3,2,142.34,0.00,0.50,0.00,0,3.00,1,151.60,0,1,3,org.apache.jackrabbit.core.search.jcrql.SimpleNode,0.00,1,1,3,0,1,2,0,1,46,1
"org.apache.jackrabbit.core.search.jcrql.ASTFromClause",3,0.00,1.00,7,0.05,490.78,3,0,0,4,4,192.34,3,11,3,2,142.34,0.00,0.50,0.00,0,3.00,1,151.60,0,1,3,org.apache.jackrabbit.core.search.jcrql.SimpleNode,0.00,1,1,3,0,1,2,0,1,46,1
"org.apache.jackrabbit.core.search.jcrql.ASTLocationClause",7,0.42,1.00,17,0.11,1129.61,9,2,0,8,4,142.38,3,25,3,2,142.38,0.00,0.50,0.14,0,17.00,1,331.40,0,2,3,org.apache.jackrabbit.core.search.jcrql.SimpleNode,0.00,1,1,7,0,1,5,0,1,98,1
"org.apache.jackrabbit.core.search.jcrql.ASTNodeType",5,1.00,1.00,12,0.08,818.27,6,1,0,6,4,142.34,3,18,3,2,142.34,0.00,0.50,0.20,0,8.00,1,241.61,0,2,3,org.apache.jackrabbit.core.search.jcrql.SimpleNode,0.00,1,1,5,0,1,3,0,1,72,1
"org.apache.jackrabbit.core.search.jcrql.ASTNotExpr",3,0.00,1.00,7,0.05,490.78,3,0,0,4,4,192.34,3,11,3,2,142.34,0.00,0.50,0.00,0,3.00,1,151.60,0,1,3,org.apache.jackrabbit.core.search.jcrql.SimpleNode,0.00,1,1,3,0,1,2,0,1,46,1
"org.apache.jackrabbit.core.search.jcrql.ASTOrExpr",3,0.00,1.00,7,0.05,490.78,3,0,0,4,4,192.34,3,11,3,2,142.34,0.00,0.50,0.00,0,3.00,1,151.60,0,1,3,org.apache.jackrabbit.core.search.jcrql.SimpleNode,0.00,1,1,3,0,1,2,0,1,46,1
"org.apache.jackrabbit.core.search.jcrql.ASTOrderClause",7,0.33,1.00,17,0.14,1765.50,9,2,2,12,4,140.86,3,25,3,2,140.86,0.00,0.50,0.21,0,18.00,1,421.37,0,2,3,org.apache.jackrabbit.core.search.jcrql.SimpleNode,0.00,5,1,7,0,5,5,0,1,118,1
"org.apache.jackrabbit.core.search.jcrql.ASTRelExpr",7,0.42,1.00,17,0.11,1129.61,9,2,0,8,4,142.38,3,25,3,2,142.38,0.00,0.50,0.14,0,17.00,1,331.40,0,2,3,org.apache.jackrabbit.core.search.jcrql.SimpleNode,0.00,1,1,7,0,1,5,0,1,98,1
"org.apache.jackrabbit.core.search.jcrql.ASTSelectClause",5,0.75,1.00,12,0.11,1368.95,6,1,2,10,4,140.58,3,18,3,2,140.58,0.00,0.50,0.40,0,7.00,1,319.59,0,2,3,org.apache.jackrabbit.core.search.jcrql.SimpleNode,0.00,5,1,5,0,5,3,0,1,90,1
"org.apache.jackrabbit.core.search.jcrql.ASTStatement",3,0.00,1.00,7,0.05,490.78,3,0,0,4,4,192.34,3,11,3,2,142.34,0.00,0.50,0.00,0,3.00,1,151.60,0,1,3,org.apache.jackrabbit.core.search.jcrql.SimpleNode,0.00,1,1,3,0,1,2,0,1,46,1
"org.apache.jackrabbit.core.search.jcrql.ASTTextsearchClause",5,1.00,1.00,12,0.08,818.27,6,1,0,6,4,142.34,3,18,3,2,142.34,0.00,0.50,0.20,0,8.00,1,241.61,0,2,3,org.apache.jackrabbit.core.search.jcrql.SimpleNode,0.00,1,1,5,0,1,3,0,1,72,1
"org.apache.jackrabbit.core.search.jcrql.ASTValue",8,0.29,1.00,19,0.13,1418.97,10,2,0,9,4,142.06,3,28,3,2,142.06,0.00,0.50,0.25,0,18.00,1,403.74,1,3,3,org.apache.jackrabbit.core.search.jcrql.SimpleNode,0.09,1,1,8,0,1,5,0,1,117,1
"org.apache.jackrabbit.core.search.jcrql.ASTWhereClause",3,0.00,1.00,7,0.05,490.78,3,0,0,4,4,192.34,3,11,3,2,142.34,0.00,0.50,0.00,0,3.00,1,151.60,0,1,3,org.apache.jackrabbit.core.search.jcrql.SimpleNode,0.00,1,1,3,0,1,2,0,1,46,1
"org.apache.jackrabbit.core.search.jcrql.JCRQLParser",41,0.15,7.05,862,10.32,802468.86,56,15,1,97,25,87.43,29,1378,17,1,87.43,0.00,0.00,0.21,14,0.00,22,30967.01,0,12,22,java.lang.Object,0.00,56,0,289,0,56,29,2,15,5408,1
"org.apache.jackrabbit.core.search.jcrql.JCRQLParserConstants",0,0.00,0.00,57,1.03,12077.10,56,56,0,0,2,171.00,0,126,2,1,171.00,0.00,0.00,0.00,0,0.00,0,3083.52,0,0,0,,0.00,0,0,0,0,0,0,0,0,409,1
"org.apache.jackrabbit.core.search.jcrql.JCRQLParserTokenManager",32,0.05,14.53,1062,17.42,3443767.85,89,57,0,43,5,74.12,0,1757,1,1,74.12,0.00,0.00,0.06,19,288.00,332,52246.95,0,2,4,java.lang.Object,0.00,11,0,465,0,11,30,1,0,7723,1
"org.apache.jackrabbit.core.search.jcrql.JCRQLParserTreeConstants",0,0.00,0.00,17,0.25,2943.54,16,16,0,0,2,171.00,0,34,2,1,171.00,0.00,0.00,0.00,0,0.00,0,763.14,0,0,0,,0.00,0,0,0,0,0,0,0,0,132,1
"org.apache.jackrabbit.core.search.jcrql.JCRQLParserVisitor",15,0.00,1.00,16,0.14,741.00,15,0,0,15,17,157.66,0,17,17,1,157.66,0.00,0.00,0.00,0,15.00,1,413.00,0,15,15,,0.00,0,0,15,0,0,0,0,0,139,1
"org.apache.jackrabbit.core.search.jcrql.JCRQLQueryBuilder",18,0.47,1.44,93,1.11,31272.01,20,2,4,62,31,119.33,15,129,2,1,119.33,0.00,0.00,0.06,0,34.00,6,3328.74,0,17,29,java.lang.Object,0.00,44,0,26,0,44,1,1,13,724,1
"org.apache.jackrabbit.core.search.jcrql.JJTJCRQLParserState",12,0.31,1.42,62,0.54,8821.02,17,5,0,24,2,162.16,24,80,1,1,122.28,0.00,0.00,0.48,3,0.00,3,1617.12,0,3,1,java.lang.Object,0.00,12,0,17,0,12,9,0,11,378,0
"org.apache.jackrabbit.core.search.jcrql.Node",8,0.00,1.00,9,0.05,232.01,8,0,0,8,4,180.10,29,10,3,1,159.48,0.00,0.00,0.00,0,8.00,1,149.27,0,3,1,,0.00,0,0,8,0,0,5,0,8,56,1
"org.apache.jackrabbit.core.search.jcrql.ParseException",5,0.30,3.20,90,1.00,70420.91,10,5,0,13,3,53.68,62,108,2,2,91.24,0.00,0.50,0.44,0,0.00,10,2991.26,1,2,1,java.lang.Exception,0.00,8,1,16,0,8,3,0,10,540,1
"org.apache.jackrabbit.core.search.jcrql.SimpleCharStream",28,0.14,2.07,209,2.39,155713.47,43,15,0,36,2,109.82,15,280,2,1,109.82,0.00,0.00,0.20,6,0.00,10,7172.58,0,1,0,java.lang.Object,0.00,8,0,58,0,8,27,0,4,1471,1
"org.apache.jackrabbit.core.search.jcrql.SimpleNode",14,0.08,1.57,52,0.45,12567.93,18,4,0,19,20,129.84,13,67,17,1,129.84,0.00,0.00,0.18,1,86.00,4,1351.11,0,6,4,java.lang.Object,0.00,5,0,22,14,5,8,1,4,324,1
"org.apache.jackrabbit.core.search.jcrql.Token",2,0.12,1.00,11,0.07,920.78,10,8,0,3,4,173.95,51,16,4,1,123.96,0.00,0.00,0.06,0,2.00,1,221.36,0,2,0,java.lang.Object,0.00,1,0,2,0,1,0,0,8,59,1
"org.apache.jackrabbit.core.search.jcrql.TokenMgrError",6,0.20,1.50,48,0.65,33386.70,11,5,0,14,1,65.43,47,69,1,2,107.73,0.00,0.50,0.03,1,10.00,3,1938.57,1,3,0,java.lang.Error,0.00,8,1,9,0,8,3,0,10,371,1
"org.apache.jackrabbit.core.AbstractAccessManager",4,0.00,1.00,8,0.07,852.19,4,0,4,4,1,123.56,22,14,1,1,141.43,0.00,0.00,0.00,1,4.00,1,217.29,0,1,0,java.lang.Object,0.00,0,0,4,2,0,3,1,7,61,1
"org.apache.jackrabbit.core.AbstractAccessManager$PermissionImpl",3,0.06,1.00,16,0.24,9173.57,11,8,4,5,0,117.48,1,28,0,1,117.48,0.00,0.00,0.08,0,5.00,1,714.93,0,1,0,java.lang.Object,0.00,2,0,3,0,2,2,1,1,153,2
"org.apache.jackrabbit.core.AccessManagerImpl",4,0.11,1.25,17,0.21,4564.24,7,3,6,9,14,92.19,24,24,8,2,124.41,1.00,0.33,0.25,1,6.00,2,631.61,0,0,6,org.apache.jackrabbit.core.AbstractAccessManager,0.00,5,1,5,1,5,4,0,7,143,1
"org.apache.jackrabbit.core.BLOBFileValue",16,0.08,2.88,123,1.35,46248.51,22,6,9,51,17,79.76,100,186,15,1,111.98,0.00,0.00,0.24,2,28.00,6,4049.91,0,4,2,java.lang.Object,0.00,35,0,46,0,35,12,1,37,838,1
"org.apache.jackrabbit.core.BaseException",10,0.67,1.40,35,0.24,5730.96,11,1,2,12,10,89.11,71,51,10,2,131.40,10.00,0.08,0.40,2,18.00,3,718.23,2,3,0,java.lang.Exception,0.00,2,1,14,10,2,7,0,12,193,2
"org.apache.jackrabbit.core.ChildrenCollectorFilter",5,0.12,4.60,60,0.59,35004.05,11,6,18,12,4,50.11,49,79,1,2,100.11,0.00,0.50,0.27,2,13.00,13,1756.48,0,0,3,TraversingItemVisitor.Default,0.00,7,1,23,0,7,5,0,12,371,0
"org.apache.jackrabbit.core.HierarchyManager",8,0.00,1.00,9,0.10,712.12,8,0,3,8,14,123.43,52,11,10,1,155.65,0.00,0.00,0.00,0,8.00,1,307.98,0,7,4,,0.00,0,0,8,0,0,1,0,9,91,1
"org.apache.jackrabbit.core.HierarchyManagerImpl",13,0.04,5.38,280,4.55,349073.44,17,4,6,84,19,38.31,106,361,2,1,86.41,0.00,0.00,0.29,5,0.00,13,13655.24,0,9,17,java.lang.Object,0.00,71,0,70,0,71,4,1,57,2298,1
"org.apache.jackrabbit.core.IllegalNameException",4,0.00,1.00,9,0.05,332.37,4,0,0,4,9,112.43,27,14,8,3,144.65,0.00,0.67,0.00,0,4.00,1,136.79,0,0,1,org.apache.jackrabbit.core.BaseException,0.00,0,2,4,0,0,4,0,5,46,1
"org.apache.jackrabbit.core.InternalValue",30,0.05,1.47,142,2.12,77815.72,32,2,9,78,41,121.81,120,240,30,1,121.57,0.00,0.00,0.45,1,38.00,7,6368.12,0,18,11,java.lang.Object,0.00,48,0,44,0,48,12,0,26,1272,1
"org.apache.jackrabbit.core.ItemId",2,0.50,1.00,6,0.04,572.65,4,2,1,2,16,101.63,13,8,16,1,133.86,0.00,0.00,0.25,0,2.00,1,127.08,0,0,0,java.lang.Object,0.00,0,0,2,2,0,2,1,2,35,2
"org.apache.jackrabbit.core.ItemImpl",43,0.04,3.56,545,8.04,596285.22,62,19,21,183,40,47.84,412,722,12,1,97.84,0.00,0.00,0.09,18,722.00,22,24116.80,0,13,34,java.lang.Object,0.00,140,0,153,2,140,30,2,217,4112,2
"org.apache.jackrabbit.core.ItemLifeCycleListener",4,0.00,1.00,5,0.03,156.54,4,0,0,4,5,109.98,41,6,4,1,158.46,0.00,0.00,0.00,0,4.00,1,104.36,0,0,2,,0.00,0,0,4,0,0,4,0,5,36,1
"org.apache.jackrabbit.core.ItemManager",26,0.06,2.50,205,2.69,86795.68,34,8,14,85,27,69.23,182,287,13,1,111.52,0.00,0.00,0.19,10,46.00,8,8076.98,0,14,18,java.lang.Object,0.00,59,0,65,0,59,12,1,64,1570,1
"org.apache.jackrabbit.core.MalformedPathException",4,0.00,1.00,9,0.05,332.37,4,0,0,4,20,112.43,27,14,19,3,144.65,0.00,0.67,0.00,0,4.00,1,136.79,0,0,1,org.apache.jackrabbit.core.BaseException,0.00,0,2,4,0,0,4,0,5,46,1
"org.apache.jackrabbit.core.NamespaceRegistryImpl",10,0.12,2.60,135,1.89,75752.29,33,23,12,43,21,50.57,80,171,18,1,98.68,0.00,0.00,0.15,2,0.00,8,5668.31,0,5,3,java.lang.Object,0.00,33,0,26,0,33,5,2,47,1061,1
"org.apache.jackrabbit.core.NamespaceResolver",2,0.00,1.00,3,0.02,147.00,2,0,1,2,31,108.20,17,4,31,1,156.30,0.00,0.00,0.00,0,2.00,1,62.00,0,2,0,,0.00,0,0,2,0,0,0,0,3,22,1
"org.apache.jackrabbit.core.NoPrefixDeclaredException",4,0.00,1.00,9,0.05,332.37,4,0,0,4,25,112.43,27,14,24,3,144.65,0.00,0.67,0.00,0,4.00,1,136.79,0,0,1,org.apache.jackrabbit.core.BaseException,0.00,0,2,4,0,0,4,0,5,46,1
"org.apache.jackrabbit.core.NodeId",7,0.25,1.71,28,0.21,4266.60,9,2,0,11,23,166.37,19,41,22,2,126.49,0.00,0.50,0.29,0,3.00,3,621.57,0,3,1,org.apache.jackrabbit.core.ItemId,0.22,4,1,12,0,4,4,0,4,157,1
"org.apache.jackrabbit.core.NodeImpl",108,0.19,3.24,1246,18.75,994768.90,111,3,18,366,54,58.37,859,1685,15,2,100.67,0.00,0.50,0.15,40,2488.00,24,56242.59,8,24,46,org.apache.jackrabbit.core.ItemImpl,0.09,258,1,350,0,258,84,1,405,9897,1
"org.apache.jackrabbit.core.Path",23,0.00,3.52,254,3.04,189054.89,30,7,7,73,30,51.04,223,307,26,1,101.04,0.00,0.00,0.14,5,81.00,15,9122.50,0,11,4,java.lang.Object,0.00,50,0,81,0,50,12,0,65,1728,2
"org.apache.jackrabbit.core.Path$CurrentElement",3,0.00,1.00,8,0.05,502.44,4,1,7,3,3,142.26,2,12,0,2,142.26,0.00,0.50,1.00,0,0.00,1,159.07,0,2,3,org.apache.jackrabbit.core.PathElement,0.00,0,1,3,0,0,1,0,2,46,2
"org.apache.jackrabbit.core.Path$ParentElement",3,0.00,1.00,8,0.05,502.44,4,1,7,3,3,142.26,2,12,0,2,142.26,0.00,0.50,1.00,0,0.00,1,159.07,0,2,3,org.apache.jackrabbit.core.PathElement,0.00,0,1,3,0,0,1,0,2,46,2
"org.apache.jackrabbit.core.Path$PathBuilder",14,0.08,1.36,50,0.53,15099.45,15,1,7,29,3,129.25,2,64,0,1,129.25,0.00,0.00,0.93,1,0.00,5,1584.29,0,1,3,java.lang.Object,0.00,15,0,19,0,15,13,1,2,371,3
"org.apache.jackrabbit.core.Path$PathElement",12,0.18,2.25,75,0.88,36851.03,14,2,7,31,3,154.21,25,103,0,1,114.33,0.00,0.00,0.33,1,34.00,9,2638.24,0,4,3,java.lang.Object,0.00,19,0,27,0,19,8,0,11,543,2
"org.apache.jackrabbit.core.Path$RootElement",4,1.00,1.00,10,0.06,562.44,5,1,7,4,3,192.86,4,15,0,2,142.86,0.00,0.50,0.25,0,6.00,1,183.07,0,2,3,org.apache.jackrabbit.core.PathElement,0.00,0,1,4,0,0,2,0,4,54,2
"org.apache.jackrabbit.core.PropertyId",8,0.00,1.88,39,0.38,11330.95,11,3,0,18,19,163.47,19,56,17,2,123.58,0.00,0.50,0.33,0,2.00,3,1134.70,0,4,2,org.apache.jackrabbit.core.ItemId,0.20,10,1,15,0,10,4,0,4,261,1
"org.apache.jackrabbit.core.PropertyImpl",35,0.07,4.31,481,6.51,297187.10,37,2,16,106,20,55.88,279,628,5,2,98.17,0.00,0.50,0.43,4,0.00,11,19535.92,3,13,18,org.apache.jackrabbit.core.ItemImpl,0.18,71,1,151,0,71,22,1,183,3537,1
"org.apache.jackrabbit.core.QName",12,0.05,2.50,88,1.01,40960.50,18,6,4,35,76,69.15,91,123,72,1,111.44,0.00,0.00,0.21,1,38.00,5,3020.84,1,7,4,java.lang.Object,0.00,23,0,30,0,23,5,3,28,622,1
"org.apache.jackrabbit.core.RepositoryImpl",20,0.10,4.00,299,4.36,222624.47,52,32,24,103,25,47.96,178,418,7,1,96.06,0.00,0.00,0.13,5,0.00,17,13065.89,0,15,21,java.lang.Object,0.00,83,0,80,0,83,5,2,91,2206,1
"org.apache.jackrabbit.core.RepositoryImpl$Thread",1,0.00,1.00,3,0.01,56.92,1,0,24,2,0,139.38,0,4,0,1,139.38,0.00,0.00,0.00,0,1.00,1,30.46,0,0,0,java.lang.Object,0.00,1,0,1,0,1,1,0,0,12,0
"org.apache.jackrabbit.core.SearchManager",8,0.21,4.00,112,1.87,109287.67,14,6,28,65,27,115.98,27,153,4,1,95.36,0.00,0.00,0.35,2,0.00,16,5603.10,0,0,23,java.lang.Object,0.00,57,0,32,0,57,8,1,18,960,1
"org.apache.jackrabbit.core.SessionImpl",33,0.05,2.00,228,3.14,175022.83,44,11,21,115,36,80.26,204,308,22,1,112.48,0.00,0.00,0.14,1,463.00,16,9420.94,0,11,20,java.lang.Object,0.00,82,0,66,1,82,22,1,82,1730,1
"org.apache.jackrabbit.core.SessionImpl$TransientNamespaceMappings",5,0.50,4.20,60,0.78,41729.93,9,4,21,28,2,57.24,36,82,0,1,99.53,0.00,0.00,0.65,0,0.00,9,2332.59,0,3,2,java.lang.Object,0.00,23,0,21,0,23,2,1,32,465,0
"org.apache.jackrabbit.core.SystemSession",1,1.00,1.00,7,0.08,1184.07,3,2,4,3,3,66.80,10,10,1,2,115.27,0.00,0.50,0.50,0,0.00,1,230.95,0,0,3,org.apache.jackrabbit.core.SessionImpl,0.00,2,1,1,0,2,1,0,3,55,0
"org.apache.jackrabbit.core.SystemSession$SystemAccessManqager",2,0.00,1.00,5,0.04,290.80,2,0,4,2,1,192.74,3,9,0,3,142.74,0.00,0.67,0.00,0,2.00,1,109.70,0,0,1,org.apache.jackrabbit.core.AccessManagerImpl,0.00,0,2,2,0,0,2,0,1,33,1
"org.apache.jackrabbit.core.Test",3,0.50,6.67,169,3.42,326197.30,5,2,14,73,4,21.56,33,186,0,1,65.69,0.00,0.00,0.17,2,4.00,15,10251.76,0,0,4,java.lang.Object,0.00,70,0,20,0,70,3,0,11,1376,1
"org.apache.jackrabbit.core.Test$TraversingItemVisitor.Default",2,0.00,4.50,31,0.43,22435.80,2,0,14,16,0,94.89,0,37,0,1,94.89,0.00,0.00,0.00,0,2.00,7,1275.86,1,0,0,java.lang.Object,0.00,14,0,9,0,14,2,0,0,231,0
"org.apache.jackrabbit.core.UnknownPrefixException",4,0.00,1.00,9,0.05,332.37,4,0,0,4,8,112.43,27,14,7,3,144.65,0.00,0.67,0.00,0,4.00,1,136.79,0,0,1,org.apache.jackrabbit.core.BaseException,0.00,0,2,4,0,0,4,0,5,46,1
"org.apache.jackrabbit.core.WorkspaceImpl",32,0.08,2.84,354,6.04,312289.72,41,9,29,139,37,52.02,324,548,4,1,100.50,0.00,0.00,0.19,11,138.00,9,18126.43,0,7,35,java.lang.Object,0.00,107,0,91,0,107,25,1,100,3129,1
"org.apache.jackrabbit.test.AbstractJCRTest",3,0.38,5.00,68,0.89,33830.58,16,13,5,23,7,51.08,37,79,4,3,88.64,6.50,0.12,0.33,0,0.00,8,2674.53,0,1,3,org.apache.jackrabbit.test.JUnitTest,0.00,20,2,15,13,20,2,0,17,491,2
"org.apache.jackrabbit.test.JUnitTest",0,0.00,0.00,3,0.05,1456.80,2,2,2,2,2,171.00,9,4,1,2,171.00,14.00,0.06,0.00,0,0.00,0,142.62,0,0,1,junit.framework.TestCase,0.00,2,1,0,14,2,0,0,3,33,2
"org.apache.jackrabbit.test.JackrabbitRepositoryStub",2,0.50,2.00,20,0.26,8300.64,6,4,6,10,3,94.69,30,26,0,2,105.05,0.00,0.50,0.50,0,2.00,3,770.88,0,1,3,org.apache.jackrabbit.test.RepositoryStub,0.22,8,1,4,0,8,1,0,8,153,1
"org.apache.jackrabbit.test.LogPrintWriter",12,0.12,1.25,44,0.36,5154.91,15,3,5,21,1,132.65,52,61,1,2,132.42,0.00,0.50,0.22,1,22.00,3,1069.76,2,0,0,java.io.PrintWriter,0.00,9,1,15,0,9,12,0,15,271,1
"org.apache.jackrabbit.test.LogPrintWriter$NullWriter",3,0.00,1.00,4,0.04,273.44,3,0,5,3,0,205.57,3,8,0,2,155.57,0.00,0.50,0.00,0,3.00,1,110.76,0,0,0,java.io.Writer,0.00,0,1,3,0,0,3,0,3,35,2
"org.apache.jackrabbit.test.RepositoryHelper",5,0.00,2.00,25,0.30,7643.83,5,0,3,13,3,119.69,3,41,1,1,119.69,0.00,0.00,0.00,0,5.00,2,903.41,0,5,2,java.lang.Object,0.00,8,0,10,0,8,0,0,1,201,1
"org.apache.jackrabbit.test.RepositoryStub",7,0.09,3.14,72,1.18,66505.38,27,20,10,25,5,57.98,82,102,4,1,102.11,0.00,0.00,0.13,0,21.00,15,3525.21,0,6,1,java.lang.Object,0.00,18,0,22,1,18,1,0,8,626,2
"org.apache.jackrabbit.test.RepositoryStubException",1,0.00,1.00,3,0.02,106.02,1,0,0,1,3,157.87,3,5,3,2,137.25,0.00,0.50,0.00,0,1.00,1,45.51,0,0,0,java.lang.Exception,0.00,0,1,1,0,0,1,0,1,16,1
"org.apache.jackrabbit.core.state.xml.XMLNodeState",6,1.00,1.17,22,0.17,2350.90,7,1,8,11,6,114.87,30,30,1,4,132.75,0.00,0.75,0.00,0,6.00,2,516.91,3,0,5,org.apache.jackrabbit.core.state.PersistentNodeState,0.15,5,3,7,0,5,6,0,14,132,0
"org.apache.jackrabbit.core.state.xml.XMLPersistenceManager",25,0.12,4.92,534,8.63,516091.55,50,25,19,161,23,49.77,301,706,0,1,87.33,0.00,0.00,0.15,9,0.00,12,25879.18,0,11,23,java.lang.Object,0.00,136,0,123,0,136,14,1,111,4242,1
"org.apache.jackrabbit.core.state.xml.XMLPropertyState",6,1.00,1.17,22,0.17,2313.96,7,1,8,11,6,133.04,29,30,1,4,132.80,0.00,0.75,0.00,0,6.00,2,504.54,3,0,5,org.apache.jackrabbit.core.state.PersistentPropertyState,0.24,5,3,7,0,5,6,0,14,129,0
"org.apache.jackrabbit.core.search.lucene.AbstractIndex",9,0.10,2.33,52,0.43,11580.49,14,5,8,19,2,170.25,12,77,2,1,120.25,0.00,0.00,0.29,3,4.00,7,1298.70,0,4,0,java.lang.Object,0.00,10,0,21,2,10,5,0,4,312,1
"org.apache.jackrabbit.core.search.lucene.DateField",5,0.12,1.80,34,0.43,14282.50,9,4,1,15,2,72.33,36,44,2,1,114.62,0.00,0.00,0.15,2,7.00,5,1285.31,0,3,0,java.lang.Object,0.00,10,0,9,0,10,2,0,11,274,0
"org.apache.jackrabbit.core.search.lucene.DoubleField",3,0.25,2.67,30,0.43,23099.17,5,2,0,14,2,103.10,13,39,2,1,102.87,0.00,0.00,0.33,0,4.00,4,1299.83,0,1,0,java.lang.Object,0.00,11,0,8,0,11,2,0,9,256,0
"org.apache.jackrabbit.core.search.lucene.FieldNames",0,0.00,0.00,7,0.08,1210.08,6,6,0,0,5,171.00,4,8,5,1,171.00,0.00,0.00,0.00,0,0.00,0,254.75,0,0,0,java.lang.Object,0.00,0,0,0,0,0,0,0,1,58,1
"org.apache.jackrabbit.core.search.lucene.FileSystemDirectory",13,0.22,1.85,68,0.82,21800.21,16,3,11,32,8,87.17,80,103,3,2,119.39,0.00,0.50,0.54,0,0.00,4,2472.22,0,5,5,org.apache.lucene.store.Directory,0.00,19,1,24,0,19,8,0,19,534,0
"org.apache.jackrabbit.core.search.lucene.FileSystemDirectory$Lock",4,0.00,2.00,22,0.20,3895.34,4,0,11,11,2,171.23,4,35,0,1,121.23,0.00,0.00,0.00,0,4.00,3,599.67,0,1,2,java.lang.Object,0.00,7,0,8,0,7,3,0,4,136,0
"org.apache.jackrabbit.core.search.lucene.FileSystemInputStream",6,0.13,2.00,38,0.37,10381.49,9,3,4,13,4,166.31,7,54,2,2,116.31,0.00,0.50,0.44,1,0.00,3,1102.56,1,1,2,org.apache.lucene.store.InputStream,0.00,7,1,12,0,7,5,0,4,251,0
"org.apache.jackrabbit.core.search.lucene.FileSystemOutputStream",5,0.12,1.40,21,0.20,3524.57,7,2,5,13,4,126.04,4,31,1,2,126.04,0.00,0.50,0.40,0,5.00,2,586.87,2,0,3,org.apache.lucene.store.OutputStream,0.00,8,1,7,0,8,5,0,1,147,0
"org.apache.jackrabbit.core.search.lucene.FilteredPropertyIterator",8,0.00,1.38,29,0.26,5562.87,12,4,6,13,1,130.75,3,43,1,1,130.75,0.00,0.00,0.25,1,12.00,3,765.87,0,2,0,java.lang.Object,0.00,5,0,11,0,5,6,1,2,185,0
"org.apache.jackrabbit.core.search.lucene.FilteredScorer",3,0.00,1.33,18,0.16,2430.96,7,4,7,8,2,81.44,38,23,1,2,119.00,0.00,0.50,0.25,0,1.00,2,476.86,0,1,1,org.apache.lucene.search.Scorer,0.00,5,1,4,0,5,2,0,9,117,0
"org.apache.jackrabbit.core.search.lucene.FilteredScorer$FilteredHitCollector",3,0.25,1.33,10,0.08,815.21,5,2,7,5,0,83.97,29,15,0,2,133.97,0.00,0.50,0.67,0,0.00,2,230.06,0,0,0,org.apache.lucene.search.HitCollector,0.00,2,1,4,0,2,3,0,7,64,1
"org.apache.jackrabbit.core.search.lucene.LocationStepQuery",1,0.00,1.00,3,0.01,116.47,1,0,1,1,0,176.82,2,5,0,2,136.93,0.00,0.50,0.00,0,1.00,1,43.31,0,1,0,org.apache.lucene.search.Query,0.00,0,1,1,0,0,0,0,1,15,0
"org.apache.jackrabbit.core.search.lucene.LongField",3,1.00,2.67,28,0.36,19368.12,4,1,0,12,2,105.41,14,38,2,1,105.18,0.00,0.00,0.33,0,4.00,4,1087.53,0,1,0,java.lang.Object,0.00,9,0,8,0,9,2,0,13,223,0
"org.apache.jackrabbit.core.search.lucene.LuceneQueryBuilder",14,0.06,3.57,183,2.57,114688.61,20,6,18,76,27,98.34,13,241,2,1,98.34,0.00,0.00,0.23,0,38.00,13,7708.32,0,13,25,java.lang.Object,0.00,62,0,50,0,62,1,1,12,1400,1
"org.apache.jackrabbit.core.search.lucene.MatchAllQuery",3,1.00,1.33,10,0.08,1056.56,4,1,3,6,2,90.79,23,15,1,2,133.08,0.00,0.50,0.33,0,4.00,2,230.02,0,2,1,org.apache.lucene.search.Query,0.00,3,1,4,0,3,1,0,4,62,0
"org.apache.jackrabbit.core.search.lucene.MatchAllScorer",4,0.28,2.75,39,0.46,15656.11,10,6,7,24,1,77.50,53,59,1,2,106.88,0.00,0.50,0.38,1,4.00,5,1381.16,0,1,0,org.apache.lucene.search.Scorer,0.00,20,1,11,0,20,3,0,13,286,0
"org.apache.jackrabbit.core.search.lucene.MatchAllWeight",7,0.06,1.00,26,0.24,3665.49,13,6,3,14,2,99.57,45,35,1,1,131.79,0.00,0.00,0.21,0,24.00,1,725.93,0,3,1,java.lang.Object,0.00,7,0,7,0,7,4,1,18,183,0
"org.apache.jackrabbit.core.search.lucene.NodeIndexer",4,0.08,5.75,78,1.48,85318.48,8,4,20,39,18,89.04,19,148,2,1,88.81,0.00,0.00,0.31,1,4.00,12,4442.09,0,2,16,java.lang.Object,0.00,35,0,23,0,35,2,0,17,740,1
"org.apache.jackrabbit.core.search.lucene.NodeIteratorImpl",8,0.00,1.38,29,0.28,6221.69,12,4,7,15,3,130.36,3,44,1,1,130.36,0.00,0.00,0.25,1,12.00,3,838.28,0,2,2,java.lang.Object,0.00,7,0,11,0,7,6,1,2,199,0
"org.apache.jackrabbit.core.search.lucene.PackageFilter",3,0.50,2.33,20,0.21,6589.20,6,3,4,11,4,86.08,39,25,2,2,115.46,0.00,0.50,0.67,0,0.00,5,633.80,0,1,2,org.apache.lucene.search.Filter,0.00,8,1,7,0,8,2,0,10,135,0
"org.apache.jackrabbit.core.search.lucene.PathFilter",2,0.50,3.00,22,0.27,10409.35,4,2,1,6,2,142.52,4,37,1,1,102.64,0.00,0.00,0.75,0,0.00,4,809.61,0,0,1,java.lang.Object,0.00,4,0,6,0,4,2,0,2,169,1
"org.apache.jackrabbit.core.search.lucene.PathFilterQuery",7,0.33,1.00,22,0.17,2581.02,9,2,3,10,3,90.70,54,31,2,2,132.99,0.00,0.50,0.21,1,10.00,1,512.29,1,4,1,org.apache.lucene.search.Query,0.00,3,1,7,0,3,3,0,11,141,0
"org.apache.jackrabbit.core.search.lucene.PathFilterQuery$FilteredWeight",7,0.08,1.43,23,0.20,3994.34,9,2,3,13,2,113.54,38,34,0,1,131.41,0.00,0.00,0.57,0,0.00,2,610.68,0,3,2,java.lang.Object,0.00,6,0,10,0,6,4,1,9,156,1
"org.apache.jackrabbit.core.search.lucene.PathQuery",3,0.12,4.33,48,0.65,30953.24,7,4,7,12,6,127.52,62,64,1,2,94.14,0.00,0.50,0.33,1,5.00,6,1942.57,0,0,5,org.apache.lucene.search.BooleanQuery,0.00,9,1,13,0,9,3,0,13,377,0
"org.apache.jackrabbit.core.search.lucene.PersistentIndex",3,1.00,1.00,9,0.10,1177.14,4,1,5,6,4,182.78,4,18,1,2,132.78,0.00,0.50,0.33,0,4.00,1,302.39,1,1,3,org.apache.jackrabbit.core.search.lucene.AbstractIndex,0.17,3,1,3,0,3,2,0,1,77,1
"org.apache.jackrabbit.core.search.lucene.PropertyIteratorImpl",9,0.02,2.11,49,0.44,12563.13,15,6,6,20,2,119.99,7,71,1,1,119.99,0.00,0.00,0.19,3,24.00,6,1310.72,0,2,1,java.lang.Object,0.00,11,0,19,0,11,7,1,6,295,0
"org.apache.jackrabbit.core.search.lucene.QueryImpl",8,0.19,2.75,76,1.27,48205.02,17,9,11,43,12,145.29,18,118,1,1,105.41,0.00,0.00,0.28,0,0.00,6,3816.58,0,5,11,java.lang.Object,0.00,35,0,22,0,35,3,1,13,706,1
"org.apache.jackrabbit.core.search.lucene.QueryResultImpl",3,0.25,1.00,13,0.13,2642.05,7,4,5,6,4,175.35,3,20,1,1,125.35,0.00,0.00,0.42,0,1.00,1,397.78,0,2,3,java.lang.Object,0.00,3,0,3,0,3,1,1,1,99,1
"org.apache.jackrabbit.core.search.lucene.SearchIndex",6,0.20,1.83,46,0.49,12736.75,11,5,11,25,5,80.92,36,72,1,1,113.14,0.00,0.00,0.37,0,0.00,3,1476.58,0,2,4,java.lang.Object,0.00,19,0,11,0,19,4,0,14,314,1
"org.apache.jackrabbit.core.search.lucene.VolatileIndex",2,0.00,1.50,13,0.11,3058.15,2,0,4,5,1,166.80,2,14,0,2,116.80,0.00,0.50,0.00,0,2.00,2,325.05,1,0,1,org.apache.jackrabbit.core.search.lucene.AbstractIndex,0.00,3,1,3,0,3,2,0,1,76,1
"org.apache.jackrabbit.core.search.lucene.WildcardQuery",2,0.00,1.00,5,0.04,351.31,2,0,5,3,2,192.09,2,8,1,2,142.09,0.00,0.50,0.00,0,2.00,1,106.33,0,1,1,org.apache.lucene.search.MultiTermQuery,0.00,1,1,2,0,1,1,0,1,32,0
"org.apache.jackrabbit.core.search.lucene.WildcardTermEnum",5,0.08,2.80,50,0.54,32337.20,8,3,5,19,1,153.45,7,66,1,2,103.45,0.00,0.50,0.40,0,6.00,9,1615.95,0,1,0,org.apache.lucene.search.FilteredTermEnum,0.00,14,1,14,0,14,4,0,6,323,0
"org.apache.jackrabbit.test.observation.AbstractObservationTest",10,0.39,1.40,44,0.58,14699.87,12,2,8,25,6,73.52,91,69,5,4,123.52,1.67,0.33,0.15,2,30.00,3,1741.18,1,0,1,org.apache.jackrabbit.test.AbstractJCRTest,0.31,15,3,14,5,15,10,0,13,376,2
"org.apache.jackrabbit.test.observation.EventResult",3,0.33,2.33,25,0.26,5516.70,6,3,8,14,5,73.85,36,35,5,1,111.41,0.00,0.00,0.56,0,0.00,3,788.38,0,1,0,java.lang.Object,0.00,11,0,7,0,11,2,1,10,171,1
"org.apache.jackrabbit.test.observation.NodeAddedTest",4,0.00,1.00,37,0.45,9089.13,4,0,4,9,3,91.10,21,42,1,5,108.97,0.00,0.80,0.00,0,0.00,1,1357.92,3,0,2,org.apache.jackrabbit.test.observation.AbstractObservationTest,0.00,5,4,4,0,5,4,0,2,273,1
"org.apache.jackrabbit.test.observation.NodeRemovedTest",3,0.00,1.00,34,0.40,8370.82,3,0,4,8,3,155.02,4,38,1,5,105.02,0.00,0.80,0.00,0,0.00,1,1202.22,3,0,2,org.apache.jackrabbit.test.observation.AbstractObservationTest,0.00,5,4,3,0,5,3,0,1,239,1
"org.apache.jackrabbit.test.observation.PropertyAddedTest",2,0.00,1.00,20,0.29,5792.40,2,0,4,7,3,146.32,4,26,1,5,106.44,0.00,0.80,0.00,0,0.00,1,864.61,3,0,2,org.apache.jackrabbit.test.observation.AbstractObservationTest,0.00,5,4,2,0,5,2,0,1,166,1
"org.apache.jackrabbit.test.observation.PropertyChangedTest",4,0.00,1.00,51,0.77,17540.22,4,0,4,11,3,152.06,6,56,1,5,102.06,0.00,0.80,0.00,0,0.00,1,2324.16,3,0,2,org.apache.jackrabbit.test.observation.AbstractObservationTest,0.00,7,4,4,0,7,4,0,3,440,1
"org.apache.jackrabbit.test.observation.PropertyRemovedTest",2,0.00,1.00,26,0.34,7323.78,2,0,4,8,3,141.27,4,29,1,5,101.38,0.00,0.80,0.00,0,0.00,1,1032.11,3,0,2,org.apache.jackrabbit.test.observation.AbstractObservationTest,0.00,6,4,2,0,6,2,0,1,199,1
"org.apache.jackrabbit.test.observation.TestAll",1,0.00,1.00,9,0.09,2740.87,1,0,3,3,5,59.86,10,11,0,2,108.33,0.00,0.50,0.00,0,1.00,1,261.86,0,1,5,junit.framework.TestCase,0.00,2,1,1,0,2,0,0,2,63,1
"org.apache.jackrabbit.core.nodetype.BooleanConstraint",4,0.67,2.25,28,0.32,8714.71,5,1,11,13,6,113.00,1,40,1,2,113.00,0.00,0.50,0.50,1,0.00,3,950.72,0,0,6,org.apache.jackrabbit.core.nodetype.ValueConstraint,0.00,9,1,9,0,9,4,0,1,203,0
"org.apache.jackrabbit.core.nodetype.ChildItemDef",18,0.01,1.22,49,0.48,14541.82,26,8,3,20,9,136.83,7,76,7,1,136.83,0.00,0.00,0.11,0,126.00,5,1443.60,1,3,2,java.lang.Object,0.00,2,0,22,2,2,15,1,5,351,1
"org.apache.jackrabbit.core.nodetype.ChildNodeDef",9,0.12,1.33,26,0.25,6663.10,12,3,2,11,15,157.72,27,41,13,2,137.11,0.00,0.50,0.22,0,25.00,4,739.42,1,2,3,org.apache.jackrabbit.core.nodetype.ChildItemDef,0.07,2,1,12,0,2,7,0,9,182,1
"org.apache.jackrabbit.core.nodetype.DateConstraint",3,0.62,7.00,70,1.00,74580.83,7,4,11,20,6,135.14,5,96,1,2,85.14,0.00,0.50,0.67,0,0.00,10,2989.35,0,0,6,org.apache.jackrabbit.core.nodetype.ValueConstraint,0.00,17,1,21,0,17,3,0,5,548,0
"org.apache.jackrabbit.core.nodetype.EffectiveNodeType",33,0.04,4.12,439,6.06,489515.53,40,7,9,98,16,64.05,203,531,8,1,96.27,0.00,0.00,0.19,8,224.00,22,18172.15,0,18,9,java.lang.Object,0.00,65,0,136,0,65,15,1,94,3353,1
"org.apache.jackrabbit.core.nodetype.InvalidConstraintException",4,0.00,1.00,9,0.05,332.37,4,0,1,4,10,112.43,27,14,9,3,144.65,0.00,0.67,0.00,0,4.00,1,136.79,0,0,1,org.apache.jackrabbit.core.BaseException,0.00,0,2,4,0,0,4,0,5,46,1
"org.apache.jackrabbit.core.nodetype.InvalidNodeTypeDefException",4,0.00,1.00,9,0.05,332.37,4,0,1,4,3,112.43,27,14,2,3,144.65,0.00,0.67,0.00,0,4.00,1,136.79,0,0,1,org.apache.jackrabbit.core.BaseException,0.00,0,2,4,0,0,4,0,5,46,1
"org.apache.jackrabbit.core.nodetype.ItemDefImpl",9,0.10,1.33,35,0.30,5029.90,14,5,7,22,7,131.74,36,50,2,1,131.50,0.00,0.00,0.29,0,0.00,3,893.83,0,3,5,java.lang.Object,0.00,13,0,12,3,13,6,1,14,222,1
"org.apache.jackrabbit.core.nodetype.NameConstraint",3,0.50,2.33,19,0.22,5574.21,4,1,11,10,6,98.16,15,28,0,2,116.04,0.00,0.50,0.67,0,0.00,3,660.78,0,0,6,org.apache.jackrabbit.core.nodetype.ValueConstraint,0.00,7,1,7,0,7,3,0,3,145,0
"org.apache.jackrabbit.core.nodetype.NodeDefId",6,0.20,2.17,43,0.45,19749.36,8,2,3,23,12,132.21,18,54,10,1,111.60,0.00,0.00,0.33,0,0.00,5,1349.99,0,2,2,java.lang.Object,0.00,17,0,13,0,17,4,1,4,280,1
"org.apache.jackrabbit.core.nodetype.NodeDefImpl",5,0.12,2.00,34,0.35,14238.47,7,2,6,11,12,114.85,24,44,7,2,114.61,1.00,0.33,0.60,0,0.00,4,1062.39,0,3,6,org.apache.jackrabbit.core.nodetype.ItemDefImpl,0.00,6,1,10,1,6,2,1,10,226,1
"org.apache.jackrabbit.core.nodetype.NodeTypeConflictException",4,0.00,1.00,9,0.05,332.37,4,0,1,4,6,112.43,27,14,5,3,144.65,0.00,0.67,0.00,0,4.00,1,136.79,0,0,1,org.apache.jackrabbit.core.BaseException,0.00,0,2,4,0,0,4,0,5,46,1
"org.apache.jackrabbit.core.nodetype.NodeTypeDef",16,0.05,1.38,71,0.56,22924.82,23,7,4,22,9,105.74,82,85,6,1,123.61,0.00,0.00,0.19,1,104.00,7,1673.16,1,5,3,java.lang.Object,0.00,6,0,22,0,6,11,1,17,392,1
"org.apache.jackrabbit.core.nodetype.NodeTypeDefStore",11,0.17,7.55,356,7.31,1110268.94,38,27,19,130,14,24.99,99,431,1,1,74.98,0.00,0.00,0.20,4,10.00,51,21932.59,0,3,13,java.lang.Object,0.00,119,0,83,0,119,8,0,70,3171,0
"org.apache.jackrabbit.core.nodetype.NodeTypeDefStore$NamespaceResolver",2,0.00,2.00,9,0.10,3415.52,2,0,19,7,0,122.93,0,13,0,1,122.93,0.00,0.00,0.00,0,2.00,2,310.53,0,2,0,java.lang.Object,0.00,5,0,4,0,5,0,0,0,74,0
"org.apache.jackrabbit.core.nodetype.NodeTypeImpl",27,0.25,2.44,209,2.43,87144.63,32,5,9,72,23,79.42,186,253,12,1,111.64,0.00,0.00,0.44,4,0.00,9,7285.97,0,2,12,java.lang.Object,0.00,45,0,66,0,45,25,1,54,1488,1
"org.apache.jackrabbit.core.nodetype.NodeTypeManagerImpl",13,0.07,1.77,79,0.87,23968.58,18,5,13,38,25,116.36,64,95,12,1,116.13,0.00,0.00,0.26,1,5.00,3,2611.07,0,3,16,java.lang.Object,0.00,25,0,23,0,25,10,2,24,560,1
"org.apache.jackrabbit.core.nodetype.NodeTypeManagerImpl$RootNodeDefinition",3,0.00,1.00,7,0.04,283.17,3,0,13,3,4,164.83,11,11,0,3,144.22,0.00,0.67,0.00,0,3.00,1,122.35,0,2,4,org.apache.jackrabbit.core.nodetype.NodeDefImpl,0.35,0,2,3,0,0,1,0,5,39,2
"org.apache.jackrabbit.core.nodetype.NodeTypeRegistry",24,0.05,6.50,645,9.86,1069172.59,51,27,17,161,37,51.80,335,773,21,1,81.18,0.00,0.00,0.09,9,98.00,46,29582.81,0,2,18,java.lang.Object,0.00,137,0,156,0,137,22,0,150,4758,1
"org.apache.jackrabbit.core.nodetype.NodeTypeRegistry$EffectiveNodeTypeCache",10,0.11,1.40,42,0.40,7548.04,12,2,17,25,2,165.69,28,57,0,1,125.80,0.00,0.00,0.60,1,0.00,4,1203.63,0,1,2,java.lang.Object,0.00,15,0,14,0,15,9,0,15,291,1
"org.apache.jackrabbit.core.nodetype.NodeTypeRegistry$WeightedKey",16,0.07,1.31,54,0.45,9470.87,18,2,17,34,1,171.19,38,69,0,1,131.31,0.00,0.00,0.44,2,0.00,3,1349.54,0,6,1,java.lang.Object,0.00,18,0,21,0,18,10,1,11,350,1
"org.apache.jackrabbit.core.nodetype.NodeTypeRegistryListener",2,0.00,1.00,3,0.02,70.95,2,0,1,2,3,110.69,17,4,2,1,158.79,0.00,0.00,0.00,0,2.00,1,47.30,0,0,1,,0.00,0,0,2,0,0,2,0,3,18,1
"org.apache.jackrabbit.core.nodetype.NumericConstraint",5,0.19,5.00,82,1.10,72104.51,9,4,11,24,6,142.96,5,113,1,2,92.96,0.00,0.50,0.40,1,0.00,9,3301.62,0,0,6,org.apache.jackrabbit.core.nodetype.ValueConstraint,0.00,19,1,25,0,19,5,0,5,612,0
"org.apache.jackrabbit.core.nodetype.PathConstraint",3,0.50,2.33,19,0.22,5574.21,4,1,11,10,6,98.16,15,28,0,2,116.04,0.00,0.50,0.67,0,0.00,3,660.78,0,0,6,org.apache.jackrabbit.core.nodetype.ValueConstraint,0.00,7,1,7,0,7,3,0,3,145,0
"org.apache.jackrabbit.core.nodetype.PropDef",11,0.08,1.18,31,0.28,6172.66,15,4,3,12,15,158.70,33,49,12,2,138.08,0.00,0.50,0.18,0,40.00,3,842.11,1,2,3,org.apache.jackrabbit.core.nodetype.ChildItemDef,0.07,1,1,13,0,1,9,0,11,210,1
"org.apache.jackrabbit.core.nodetype.PropDefId",6,0.20,2.00,35,0.35,11749.12,8,2,1,20,10,158.73,17,47,9,1,118.84,0.00,0.00,0.33,0,0.00,4,1061.91,0,2,1,java.lang.Object,0.00,14,0,12,0,14,4,1,3,235,1
"org.apache.jackrabbit.core.nodetype.PropertyDefImpl",6,0.00,1.83,33,0.34,12951.53,8,2,6,14,10,118.77,24,42,5,2,118.53,0.00,0.50,0.50,0,0.00,5,1032.96,1,2,6,org.apache.jackrabbit.core.nodetype.ItemDefImpl,0.00,8,1,11,0,8,4,1,8,222,1
"org.apache.jackrabbit.core.nodetype.ReferenceConstraint",4,0.67,1.50,15,0.15,2308.33,5,1,11,7,7,83.26,35,22,1,2,131.36,0.00,0.50,0.50,0,4.00,2,454.65,0,1,7,org.apache.jackrabbit.core.nodetype.ValueConstraint,0.00,3,1,6,0,3,3,0,4,108,0
"org.apache.jackrabbit.core.nodetype.StringConstraint",3,0.50,2.33,24,0.30,9118.02,4,1,11,13,6,109.69,1,36,1,2,109.69,0.00,0.50,0.67,0,0.00,3,894.98,0,0,6,org.apache.jackrabbit.core.nodetype.ValueConstraint,0.00,10,1,7,0,10,3,0,1,187,0
"org.apache.jackrabbit.core.nodetype.ValueConstraint",4,0.50,1.25,21,0.31,12268.53,6,2,11,12,18,157.30,11,37,13,1,117.42,0.00,0.00,0.12,0,6.00,2,937.66,0,2,10,java.lang.Object,0.00,8,0,5,7,8,2,0,7,190,2
"org.apache.jackrabbit.core.version.GenericVersionSelector",15,0.12,1.53,53,0.52,16963.40,19,4,5,23,2,86.77,108,78,1,1,129.06,0.00,0.00,0.13,0,64.00,5,1573.92,0,7,1,java.lang.Object,0.00,8,0,23,0,8,8,1,20,366,1
"org.apache.jackrabbit.core.version.InternalFreeze",1,0.00,1.00,2,0.01,54.24,1,0,1,1,4,96.11,9,3,3,1,146.11,0.00,0.00,0.00,0,1.00,1,27.12,0,1,1,java.lang.Object,0.00,0,0,1,2,0,0,0,2,11,2
"org.apache.jackrabbit.core.version.InternalFrozenNode",9,0.06,4.11,107,1.81,137758.67,15,6,12,56,17,50.40,94,139,5,2,98.87,0.00,0.50,0.22,0,41.00,16,5431.99,0,7,13,org.apache.jackrabbit.core.version.InternalFreeze,0.20,47,1,37,0,47,2,0,32,903,1
"org.apache.jackrabbit.core.version.InternalFrozenVersionHistory",3,0.50,1.00,10,0.11,1685.48,4,1,5,10,9,83.44,24,15,2,2,131.55,0.00,0.50,0.67,0,1.00,1,342.03,0,2,7,org.apache.jackrabbit.core.version.InternalFreeze,0.50,7,1,3,0,7,1,0,5,82,1
"org.apache.jackrabbit.core.version.InternalVersion",18,0.05,1.78,94,0.99,23082.65,25,7,10,51,12,78.03,126,109,7,1,120.32,0.00,0.00,0.19,2,162.00,3,2955.56,0,8,7,java.lang.Object,0.00,33,0,32,0,33,10,0,32,646,2
"org.apache.jackrabbit.core.version.InternalVersionHistory",15,0.11,2.13,143,2.11,81122.84,21,6,16,61,14,57.73,133,164,5,1,105.83,0.00,0.00,0.27,4,36.00,6,6318.19,0,2,11,java.lang.Object,0.00,46,0,32,0,46,13,0,45,1165,1
"org.apache.jackrabbit.core.version.NodeWrapper",70,0.01,1.00,142,1.41,18349.57,71,1,15,122,4,161.34,214,213,2,1,140.73,0.00,0.00,0.99,0,0.00,1,4232.12,0,31,2,java.lang.Object,0.00,52,0,70,2,52,39,1,70,1131,1
"org.apache.jackrabbit.core.version.PersistentNode",27,0.11,2.26,219,3.09,115176.73,31,4,12,105,31,60.43,221,278,6,1,108.54,0.00,0.00,0.35,9,0.00,5,9259.54,0,14,25,java.lang.Object,0.00,78,0,61,0,78,13,0,52,1794,1
"org.apache.jackrabbit.core.version.PersistentProperty",4,0.33,1.00,10,0.06,711.87,5,1,3,7,6,109.83,27,15,3,1,142.05,0.00,0.00,0.75,0,0.00,1,176.46,0,2,3,java.lang.Object,0.00,3,0,4,0,3,2,0,6,55,1
"org.apache.jackrabbit.core.version.VersionHistoryImpl",9,0.12,1.56,30,0.42,9966.39,10,1,8,23,12,129.36,39,45,3,2,129.13,0.00,0.50,0.89,0,0.00,4,1264.82,1,5,9,org.apache.jackrabbit.core.version.NodeWrapper,0.03,14,1,14,0,14,4,1,12,290,1
"org.apache.jackrabbit.core.version.VersionImpl",11,0.10,1.27,42,0.43,10788.10,12,1,7,24,8,129.82,45,52,5,2,129.59,0.00,0.50,0.91,0,0.00,2,1280.66,1,5,4,org.apache.jackrabbit.core.version.NodeWrapper,0.02,13,1,14,0,13,6,1,14,305,1
"org.apache.jackrabbit.core.version.VersionIteratorImpl",9,0.00,1.56,39,0.34,7381.99,13,4,8,21,3,107.62,50,52,1,1,125.49,0.00,0.00,0.25,2,16.00,3,1009.89,0,2,2,java.lang.Object,0.00,12,0,14,0,12,7,1,14,237,1
"org.apache.jackrabbit.core.version.VersionManager",6,0.04,3.33,97,1.79,99400.16,25,19,12,47,19,110.72,113,115,7,1,92.58,0.00,0.00,0.09,1,18.00,8,5355.22,0,5,16,java.lang.Object,0.00,41,0,20,0,41,1,0,38,949,1
"org.apache.jackrabbit.core.version.VersionSelector",1,0.00,1.00,2,0.01,69.06,1,0,3,1,2,107.72,12,3,2,1,145.29,0.00,0.00,0.00,0,1.00,1,36.53,0,1,0,,0.00,0,0,1,0,0,0,0,2,13,1
"org.apache.jackrabbit.core.observation.DispatchAction",3,0.25,1.00,10,0.05,504.44,5,2,1,3,2,85.68,27,14,1,1,135.68,0.00,0.00,0.33,0,5.00,1,154.86,0,1,1,java.lang.Object,0.00,0,0,3,0,0,2,0,6,48,0
"org.apache.jackrabbit.core.observation.EventConsumer",7,0.22,4.00,70,1.01,34756.26,13,6,12,36,12,74.89,97,104,4,1,104.27,0.00,0.00,0.36,0,0.00,9,3028.21,0,2,8,java.lang.Object,0.00,29,0,28,0,29,5,0,27,562,0
"org.apache.jackrabbit.core.observation.EventFilter",4,0.19,3.50,55,0.63,35027.21,13,9,6,17,10,147.39,97,72,4,1,98.11,0.00,0.00,0.25,0,6.00,11,1879.66,0,2,6,java.lang.Object,0.00,13,0,14,1,13,2,0,24,356,0
"org.apache.jackrabbit.core.observation.EventFilter$BlockAllFilter",2,0.00,1.00,5,0.03,264.06,2,0,6,2,2,143.31,8,8,0,2,143.07,0.00,0.50,0.00,0,2.00,1,97.53,0,0,2,org.apache.jackrabbit.core.observation.EventFilter,0.33,0,1,2,0,0,2,0,2,32,3
"org.apache.jackrabbit.core.observation.EventImpl",10,0.11,1.70,53,0.58,17337.29,14,4,5,29,6,77.01,74,76,3,1,119.30,0.00,0.00,0.35,5,0.00,4,1733.02,0,6,3,java.lang.Object,0.00,19,0,17,0,19,4,1,18,383,2
"org.apache.jackrabbit.core.observation.EventListenerIteratorImpl",9,0.06,1.78,44,0.35,7284.61,13,4,7,19,2,93.29,61,61,1,1,125.51,0.00,0.00,0.19,3,21.00,4,1048.79,0,2,1,java.lang.Object,0.00,10,0,16,0,10,7,1,15,251,0
"org.apache.jackrabbit.core.observation.EventState",18,0.00,1.67,90,1.01,31500.87,27,9,5,28,10,70.79,184,178,7,1,119.27,0.00,0.00,0.11,2,130.00,6,3044.76,0,14,3,java.lang.Object,0.00,10,0,30,0,10,4,0,29,672,0
"org.apache.jackrabbit.core.observation.EventStateCollection",6,0.07,3.17,83,1.40,116619.56,12,6,9,41,17,46.93,64,118,5,1,95.41,0.00,0.00,0.22,1,14.00,13,4185.94,0,1,13,java.lang.Object,0.00,35,0,19,0,35,5,0,23,700,2
"org.apache.jackrabbit.core.observation.FilteredEventIterator",9,0.02,1.67,41,0.37,9757.59,15,6,7,19,5,92.30,62,61,1,1,124.52,0.00,0.00,0.19,2,24.00,5,1118.03,0,2,4,java.lang.Object,0.00,10,0,15,0,10,7,1,17,257,0
"org.apache.jackrabbit.core.observation.ObservationManagerFactory",9,0.07,2.11,72,0.82,18463.45,18,9,16,37,11,61.06,81,94,3,1,111.06,0.00,0.00,0.17,2,31.00,4,2465.67,0,3,9,java.lang.Object,0.00,28,0,19,0,28,6,1,24,504,2
"org.apache.jackrabbit.core.observation.ObservationManagerFactory$SessionLocalObservationManager",4,0.00,2.75,50,0.59,30556.01,6,2,16,13,9,49.93,36,83,0,1,99.93,0.00,0.00,0.50,0,0.00,5,1783.14,0,1,9,java.lang.Object,0.00,9,0,11,0,9,3,1,16,327,0
"org.apache.jackrabbit.core.observation.SynchronousEventListener",0,0.00,0.00,1,0.01,31.02,0,0,1,0,0,171.00,8,2,0,2,171.00,0.00,0.50,0.00,0,0.00,0,15.51,0,0,0,,0.00,0,1,0,0,0,0,0,1,6,1
"org.apache.jackrabbit.core.util.uuid.Bytes",8,0.00,2.38,59,0.79,50837.57,8,0,0,9,1,67.04,61,78,1,1,109.33,0.00,0.00,0.00,1,8.00,9,2379.21,0,0,0,java.lang.Object,0.00,1,0,19,0,1,8,0,9,516,2
"org.apache.jackrabbit.core.util.uuid.Constants",0,0.00,0.00,33,0.42,8853.20,32,32,0,1,2,171.00,114,34,2,1,171.00,0.00,0.00,0.00,0,0.00,0,1267.81,0,0,0,,0.00,1,0,0,0,1,0,0,39,209,1
"org.apache.jackrabbit.core.util.uuid.UUID",21,0.01,2.14,141,1.74,69659.41,29,8,4,54,16,76.51,271,176,14,1,114.07,0.00,0.00,0.14,2,0.00,7,5209.89,0,4,3,java.lang.Object,0.00,33,0,45,0,33,17,3,75,1052,1
"org.apache.jackrabbit.core.util.uuid.VersionFourGenerator",6,0.10,2.17,38,0.38,15041.75,10,4,4,10,3,85.65,80,53,2,1,115.03,0.00,0.00,0.17,1,10.00,7,1127.04,0,4,2,java.lang.Object,0.00,4,0,13,0,4,2,1,23,239,2
"org.apache.jackrabbit.core.fs.local.FileUtil",3,0.00,5.00,45,0.58,43930.82,3,0,4,21,1,61.73,19,55,1,1,93.96,0.00,0.00,0.00,2,3.00,10,1739.07,0,0,0,java.lang.Object,0.00,18,0,15,0,18,3,0,8,316,2
"org.apache.jackrabbit.core.fs.local.LocalFileSystem",25,0.17,2.28,181,2.33,94602.52,28,3,13,56,7,131.73,81,240,2,1,111.11,0.00,0.00,0.49,0,0.00,6,6976.78,0,8,5,java.lang.Object,0.00,31,0,57,0,31,17,1,28,1431,1
"org.apache.jackrabbit.core.fs.local.LocalFileSystem$FileFilter",1,0.00,1.00,3,0.02,173.90,1,0,13,2,0,135.56,0,4,0,1,135.56,0.00,0.00,0.00,0,1.00,1,52.97,0,0,0,java.lang.Object,0.00,1,0,1,0,1,1,0,0,17,0
"org.apache.jackrabbit.core.fs.local.LocalFileSystem$FileFilter_0",1,0.00,1.00,3,0.02,173.90,1,0,13,2,0,135.56,0,4,0,1,135.56,0.00,0.00,0.00,0,1.00,1,52.97,0,0,0,java.lang.Object,0.00,1,0,1,0,1,1,0,0,17,0
"org.apache.jackrabbit.core.fs.local.RAFOutputStream",9,0.12,1.11,39,0.37,7311.79,15,6,3,14,2,93.38,58,50,1,3,125.60,0.00,0.67,0.28,2,17.00,2,1095.68,0,0,1,org.apache.jackrabbit.core.fs.RandomAccessOutputStream,0.30,5,2,10,0,5,9,0,16,260,0
"org.apache.jackrabbit.core.util.Base64",11,0.12,2.27,108,1.78,229742.97,15,4,1,18,4,58.91,84,135,4,1,101.20,0.00,0.00,0.14,2,39.00,8,5351.38,0,0,0,java.lang.Object,0.00,7,0,25,0,7,11,0,23,993,1
"org.apache.jackrabbit.core.util.ChildrenCollector",3,0.17,1.67,15,0.15,2436.59,6,3,5,4,1,79.61,21,23,1,2,121.90,0.00,0.50,0.44,0,1.00,2,463.16,0,0,0,TraversingItemVisitor.Default,0.00,1,1,5,0,1,3,0,4,111,1
"org.apache.jackrabbit.core.util.IteratorHelper",12,0.05,1.08,35,0.23,2998.97,16,4,5,17,3,141.11,50,50,3,1,140.87,0.00,0.00,0.21,1,46.00,2,677.55,0,5,0,java.lang.Object,0.00,5,0,13,0,5,7,4,16,191,1
"org.apache.jackrabbit.core.util.Text",4,1.00,1.75,24,0.32,12449.79,5,1,3,12,1,65.86,41,34,1,1,114.34,0.00,0.00,0.25,2,6.00,2,952.16,0,4,0,java.lang.Object,0.00,8,0,7,0,8,0,0,6,201,1
"org.apache.jackrabbit.core.util.ValueHelper",5,0.00,6.80,108,2.04,249971.32,5,0,5,26,6,46.67,63,212,2,1,84.23,0.00,0.00,0.00,1,5.00,17,6131.18,0,4,4,java.lang.Object,0.00,21,0,34,0,21,1,0,36,1016,1
"org.apache.jackrabbit.core.search.AndQueryNode",5,0.00,1.80,27,0.23,5558.59,5,0,1,11,6,88.58,34,34,4,3,120.81,0.00,0.67,0.00,0,5.00,5,691.85,1,3,3,org.apache.jackrabbit.core.search.NAryQueryNode,0.43,6,2,9,0,6,2,0,7,155,1
"org.apache.jackrabbit.core.search.Constants",0,0.00,0.00,12,0.15,1918.59,11,11,0,0,5,171.00,37,13,5,1,171.00,0.00,0.00,0.00,0,0.00,0,451.43,0,0,0,,0.00,0,0,0,0,0,0,0,12,92,1
"org.apache.jackrabbit.core.search.ExactQueryNode",6,0.20,1.33,21,0.17,3329.03,8,2,0,9,4,99.30,41,30,3,2,131.53,1.00,0.33,0.33,0,10.00,2,521.93,0,5,2,org.apache.jackrabbit.core.search.QueryNode,0.36,3,1,8,1,3,1,0,10,133,1
"org.apache.jackrabbit.core.search.NAryQueryNode",4,0.67,1.25,17,0.17,4326.28,5,1,3,11,6,76.49,32,20,4,2,124.60,3.00,0.20,0.50,0,4.00,2,517.18,0,1,2,org.apache.jackrabbit.core.search.QueryNode,0.00,7,1,5,3,7,3,0,6,124,2
"org.apache.jackrabbit.core.search.NamespaceMappings",6,0.28,2.67,64,0.85,34476.21,11,5,16,37,9,66.31,76,89,3,1,103.87,0.00,0.00,0.43,2,0.00,4,2557.35,0,3,6,java.lang.Object,0.00,31,0,16,0,31,3,1,19,495,1
"org.apache.jackrabbit.core.search.NodeTypeQueryNode",2,0.00,1.00,5,0.05,521.66,2,0,1,4,7,98.45,15,8,4,3,140.74,0.00,0.67,0.00,0,2.00,1,150.76,0,1,4,org.apache.jackrabbit.core.search.ExactQueryNode,0.00,2,2,2,0,2,1,0,6,42,1
"org.apache.jackrabbit.core.search.NotQueryNode",5,0.00,1.20,13,0.11,1553.82,5,0,0,9,5,122.23,28,22,3,3,140.10,0.00,0.67,0.00,0,8.00,2,324.67,0,3,3,org.apache.jackrabbit.core.search.NAryQueryNode,0.43,4,2,6,0,4,2,0,7,90,1
"org.apache.jackrabbit.core.search.OrQueryNode",5,0.00,1.80,27,0.24,6397.89,5,0,1,11,5,88.10,34,34,3,3,120.32,0.00,0.67,0.00,0,5.00,5,725.92,1,3,3,org.apache.jackrabbit.core.search.NAryQueryNode,0.43,6,2,9,0,6,2,0,7,160,1
"org.apache.jackrabbit.core.search.OrderQueryNode",6,0.20,1.50,31,0.25,8166.94,8,2,0,11,6,77.86,45,38,5,2,120.15,0.00,0.50,0.33,0,10.00,4,760.40,0,4,2,org.apache.jackrabbit.core.search.QueryNode,0.36,5,1,9,0,5,2,0,10,174,1
"org.apache.jackrabbit.core.search.PathQueryNode",8,0.06,1.75,47,0.47,17336.13,15,7,0,17,7,68.53,73,61,6,2,118.53,0.00,0.50,0.20,0,28.00,5,1406.04,0,5,2,org.apache.jackrabbit.core.search.QueryNode,0.31,9,1,14,0,9,3,0,20,299,1
"org.apache.jackrabbit.core.search.QueryManagerImpl",5,0.20,1.00,18,0.25,4598.73,10,5,11,11,5,87.57,38,32,1,1,129.86,0.00,0.00,0.36,1,5.00,1,763.68,0,4,4,java.lang.Object,0.00,6,0,5,0,6,1,1,11,175,1
"org.apache.jackrabbit.core.search.QueryNode",5,1.00,1.00,9,0.05,561.35,6,1,0,5,14,104.86,45,12,13,1,154.85,0.00,0.00,0.20,0,8.00,1,154.76,0,4,1,java.lang.Object,0.00,0,0,5,12,0,1,0,7,52,2
"org.apache.jackrabbit.core.search.QueryNodeVisitor",11,0.00,1.00,12,0.10,546.60,11,0,0,11,14,157.64,3,13,14,1,157.64,0.00,0.00,0.00,0,11.00,1,305.00,0,11,11,,0.00,0,0,11,0,0,0,0,1,103,1
"org.apache.jackrabbit.core.search.QueryParser",2,0.00,1.50,7,0.06,1446.38,2,0,3,4,3,82.12,21,12,1,1,130.59,0.00,0.00,0.00,0,2.00,2,176.47,0,0,2,java.lang.Object,0.00,2,0,3,0,2,2,0,3,43,1
"org.apache.jackrabbit.core.search.QueryRootNode",13,0.06,1.31,49,0.45,11186.07,19,6,3,27,12,97.81,87,64,6,2,130.03,0.00,0.50,0.12,0,78.00,5,1357.29,0,8,7,org.apache.jackrabbit.core.search.QueryNode,0.22,14,1,17,0,14,5,0,21,314,1
"org.apache.jackrabbit.core.search.RangeQueryNode",12,0.02,1.00,38,0.29,3872.11,17,5,1,13,4,85.34,97,53,2,2,133.45,0.00,0.50,0.22,0,46.00,1,859.93,0,5,3,org.apache.jackrabbit.core.search.QueryNode,0.24,1,1,12,0,1,7,1,18,223,1
"org.apache.jackrabbit.core.search.RelationQueryNode",14,0.00,1.86,85,0.85,26768.17,21,7,4,25,5,67.88,120,103,3,2,115.99,0.00,0.50,0.14,0,114.00,13,2558.26,0,6,3,org.apache.jackrabbit.core.search.QueryNode,0.21,11,1,26,0,11,8,1,23,523,1
"org.apache.jackrabbit.core.search.TextsearchQueryNode",5,0.75,1.00,13,0.09,944.90,6,1,0,6,5,109.62,32,19,4,2,141.84,0.00,0.50,0.40,0,7.00,1,260.54,0,4,2,org.apache.jackrabbit.core.search.QueryNode,0.40,1,1,5,0,1,1,0,8,75,1
"org.apache.jackrabbit.core.jndi.provider.DummyContext",34,0.42,1.41,121,1.23,26112.70,36,2,4,57,2,151.02,113,169,2,2,130.40,0.00,0.50,0.09,14,198.00,3,3702.92,1,21,0,java.util.Hashtable,0.00,23,1,48,0,23,13,2,39,879,0
"org.apache.jackrabbit.core.jndi.provider.DummyContext$BindingEnum",2,0.00,1.00,6,0.05,692.27,2,0,4,5,0,133.21,0,9,0,2,133.21,0.00,0.50,0.00,0,2.00,1,143.20,0,1,0,org.apache.jackrabbit.core.jndi.provider.NamingEnum,0.00,3,1,2,0,3,1,0,0,41,0
"org.apache.jackrabbit.core.jndi.provider.DummyContext$FlatNameParser",1,0.00,1.00,7,0.06,832.71,2,1,4,3,0,137.09,3,10,0,1,116.48,0.00,0.00,1.00,0,0.00,1,180.99,0,1,0,java.lang.Object,0.00,2,0,1,0,2,0,1,1,49,1
"org.apache.jackrabbit.core.jndi.provider.DummyContext$NamingEnum",6,0.20,1.00,17,0.13,1732.88,8,2,4,13,0,140.39,0,24,0,1,140.39,0.00,0.00,0.33,2,6.00,1,398.94,0,2,0,java.lang.Object,0.00,7,0,6,0,7,4,1,0,110,0
"org.apache.jackrabbit.core.jndi.provider.DummyInitialContextFactory",1,0.00,1.00,3,0.02,257.67,1,0,4,2,1,101.99,6,5,0,1,134.22,0.00,0.00,0.00,0,1.00,1,71.02,0,1,1,java.lang.Object,0.00,1,0,1,0,1,0,1,2,21,1
"org.apache.jackrabbit.core.fs.BasedFileSystem",22,0.02,1.32,61,0.67,13866.82,24,2,2,46,6,158.28,72,92,3,1,137.66,0.00,0.00,0.48,1,0.00,6,2015.61,0,6,3,java.lang.Object,0.00,24,0,29,0,24,16,1,25,502,1
"org.apache.jackrabbit.core.fs.FileSystem",20,2.00,1.00,23,0.22,1581.24,22,2,2,20,17,107.95,176,25,15,1,156.05,0.00,0.00,0.00,0,20.00,1,662.13,0,5,2,,0.00,0,0,20,0,0,15,0,23,205,1
"org.apache.jackrabbit.core.fs.FileSystemException",4,0.00,1.00,9,0.05,332.37,4,0,1,4,15,112.43,27,14,14,3,144.65,0.00,0.67,0.00,0,4.00,1,136.79,0,0,1,org.apache.jackrabbit.core.BaseException,0.00,0,2,4,0,0,4,0,5,46,1
"org.apache.jackrabbit.core.fs.FileSystemPathUtil",7,0.08,2.00,73,0.77,33719.21,11,4,2,23,3,62.25,54,78,2,1,104.54,0.00,0.00,0.18,1,23.00,4,2310.87,0,6,1,java.lang.Object,0.00,16,0,14,0,16,1,0,11,470,2
"org.apache.jackrabbit.core.fs.FileSystemResource",18,0.26,1.50,58,0.55,14658.11,20,2,3,35,16,130.42,79,89,12,1,130.19,0.00,0.00,0.75,2,0.00,5,1654.76,0,7,4,java.lang.Object,0.00,17,0,27,0,17,11,0,19,404,1
"org.apache.jackrabbit.core.fs.RandomAccessOutputStream",1,0.00,1.00,2,0.02,132.18,1,0,2,1,5,98.94,11,3,5,2,143.07,1.00,0.33,0.00,0,1.00,1,52.87,0,0,0,java.io.OutputStream,0.00,0,1,1,1,0,1,0,2,17,2
"org.apache.jackrabbit.test.api.AddNodeTest",8,0.00,1.75,44,0.50,9546.30,8,0,7,19,2,102.70,43,65,1,4,120.57,0.00,0.75,0.00,0,0.00,3,1491.37,0,0,1,org.apache.jackrabbit.test.AbstractJCRTest,0.00,11,3,14,0,11,8,0,14,326,1
"org.apache.jackrabbit.test.api.GetAncestorTest",4,0.00,1.50,17,0.17,2453.04,5,1,2,10,2,84.21,28,28,1,4,126.50,0.00,0.75,1.00,0,0.00,2,508.44,1,0,1,org.apache.jackrabbit.test.AbstractJCRTest,0.57,6,3,6,0,6,4,0,6,121,1
"org.apache.jackrabbit.test.api.RootNodeTest",4,0.00,1.25,13,0.11,1167.16,5,1,4,11,2,133.97,18,20,1,4,133.74,0.00,0.75,1.00,0,0.00,2,336.67,1,0,1,org.apache.jackrabbit.test.AbstractJCRTest,0.57,7,3,5,0,7,4,0,5,88,1
"org.apache.jackrabbit.test.api.TestAll",1,0.00,1.00,7,0.06,1740.69,1,0,3,3,3,69.83,11,9,0,2,113.96,0.00,0.50,0.00,0,1.00,1,186.48,0,1,3,junit.framework.TestCase,0.00,2,1,1,0,2,0,0,2,47,1
"org.apache.jackrabbit.core.state.ItemState",27,0.04,1.67,141,1.51,46313.96,43,16,10,51,16,87.12,171,187,15,1,119.34,0.00,0.00,0.10,2,280.00,4,4542.89,0,4,2,java.lang.Object,0.00,24,0,45,6,24,23,2,52,949,2
"org.apache.jackrabbit.core.state.ItemStateCache",11,0.10,1.09,33,0.30,4326.35,13,2,7,27,5,100.53,76,46,3,1,132.75,0.00,0.00,0.59,0,0.00,2,904.32,0,2,2,java.lang.Object,0.00,16,0,12,3,16,9,0,16,234,1
"org.apache.jackrabbit.core.state.ItemStateException",4,0.00,1.00,9,0.05,332.37,4,0,1,4,27,112.43,27,14,26,3,144.65,0.50,0.50,0.00,0,4.00,1,136.79,0,0,1,org.apache.jackrabbit.core.BaseException,0.00,0,2,4,1,0,4,0,5,46,1
"org.apache.jackrabbit.core.state.ItemStateListener",4,0.00,1.00,5,0.03,129.91,4,0,0,4,3,116.81,31,6,3,1,159.10,0.00,0.00,0.00,0,4.00,1,86.61,0,0,1,,0.00,0,0,4,0,0,4,0,5,32,1
"org.apache.jackrabbit.core.state.ItemStateProvider",4,0.00,1.00,5,0.04,203.83,4,0,1,4,17,139.68,23,8,13,1,157.56,0.00,0.00,0.00,0,4.00,1,113.74,0,0,4,,0.00,0,0,4,0,0,4,0,5,38,1
"org.apache.jackrabbit.core.state.NoSuchItemStateException",4,0.00,1.00,9,0.05,332.37,4,0,0,4,12,112.43,27,14,11,4,144.65,0.00,0.75,0.00,0,4.00,1,136.79,0,0,1,org.apache.jackrabbit.core.state.ItemStateException,0.00,0,3,4,0,0,4,0,5,46,1
"org.apache.jackrabbit.core.state.NodeReferences",8,0.05,1.00,21,0.15,1628.25,11,3,4,15,7,123.72,42,30,5,1,141.59,0.00,0.00,0.29,0,0.00,1,443.76,0,2,2,java.lang.Object,0.00,7,0,8,0,7,6,1,11,124,1
"org.apache.jackrabbit.core.state.NodeState",40,0.01,1.85,207,2.21,52567.64,48,8,8,84,22,88.01,274,281,18,2,120.23,2.00,0.25,0.13,0,712.00,5,6644.73,2,15,4,org.apache.jackrabbit.core.state.ItemState,0.03,44,1,74,2,44,25,0,55,1449,1
"org.apache.jackrabbit.core.state.NodeState$ChildEntry",2,1.00,1.00,6,0.04,425.80,3,1,8,2,1,134.87,0,9,0,1,134.87,0.00,0.00,0.50,0,2.00,1,110.47,0,1,1,java.lang.Object,0.00,0,0,2,0,0,1,1,0,33,3
"org.apache.jackrabbit.core.state.NodeState$ChildNodeEntries",8,0.14,1.88,52,0.56,23638.94,10,2,8,29,1,164.50,9,65,0,1,114.50,0.00,0.00,0.62,2,0.00,6,1694.20,0,2,1,java.lang.Object,0.00,21,0,15,0,21,6,1,9,360,2
"org.apache.jackrabbit.core.state.NodeState$ChildNodeEntry",6,0.20,1.83,29,0.28,6991.91,9,3,8,12,1,124.25,2,42,0,2,124.25,0.00,0.50,0.50,0,0.00,3,851.19,0,2,1,org.apache.jackrabbit.core.state.ChildEntry,0.00,6,1,11,0,6,4,0,2,199,2
"org.apache.jackrabbit.core.state.NodeState$PropertyEntry",4,1.00,1.75,17,0.13,2706.49,5,1,8,7,1,126.12,1,25,0,2,126.12,0.00,0.50,0.25,0,6.00,3,385.87,0,1,1,org.apache.jackrabbit.core.state.ChildEntry,0.00,3,1,7,0,3,3,0,1,99,2
"org.apache.jackrabbit.core.state.PersistableItemState",3,0.00,1.00,4,0.02,129.91,3,0,0,3,6,158.35,12,5,5,1,158.11,0.00,0.00,0.00,0,3.00,1,66.95,0,0,1,,0.00,0,0,3,0,0,3,0,4,25,1
"org.apache.jackrabbit.core.state.PersistenceManager",16,0.00,1.00,17,0.16,916.57,16,0,2,16,11,157.39,77,21,7,1,157.16,0.00,0.00,0.00,0,16.00,1,479.46,0,6,7,,0.00,0,0,16,0,0,10,0,18,151,1
"org.apache.jackrabbit.core.state.PersistentItemStateManager",16,0.18,2.12,116,1.40,38975.52,19,3,9,57,22,80.41,101,165,4,2,112.63,0.00,0.50,0.17,6,68.00,10,4195.45,5,0,18,org.apache.jackrabbit.core.state.ItemStateCache,0.00,41,1,34,0,41,16,2,43,847,1
"org.apache.jackrabbit.core.state.PersistentNodeState",6,2.00,1.00,13,0.13,1733.50,8,2,4,8,13,140.63,25,17,9,3,140.39,0.50,0.50,0.00,0,10.00,1,389.69,0,0,5,org.apache.jackrabbit.core.state.NodeState,0.00,2,2,6,1,2,6,1,9,103,2
"org.apache.jackrabbit.core.state.PersistentPropertyState",6,2.00,1.00,13,0.13,1629.32,8,2,4,8,12,140.84,24,17,8,3,140.60,0.50,0.50,0.00,0,10.00,1,375.50,0,0,5,org.apache.jackrabbit.core.state.PropertyState,0.00,2,2,6,1,2,6,1,9,100,2
"org.apache.jackrabbit.core.state.PropertyState",12,0.07,1.67,81,0.88,35922.08,17,5,9,40,24,96.61,69,98,17,2,114.48,2.00,0.25,0.27,0,20.00,6,2632.59,0,3,7,org.apache.jackrabbit.core.state.ItemState,0.05,28,1,20,2,28,9,0,21,521,1
"org.apache.jackrabbit.core.state.ReferenceManager",4,0.67,2.75,37,0.45,14983.94,7,3,5,19,9,64.74,31,52,4,1,107.03,0.00,0.00,0.83,1,0.00,4,1340.76,0,0,5,java.lang.Object,0.00,15,0,11,0,15,4,0,14,275,1
"org.apache.jackrabbit.core.state.SessionItemStateManager",23,0.10,3.13,206,2.61,141679.09,27,4,5,78,20,58.73,235,268,1,1,107.21,0.00,0.00,0.35,4,0.00,16,7838.77,0,7,19,java.lang.Object,0.00,55,0,72,0,55,16,1,82,1435,1
"org.apache.jackrabbit.core.state.SessionItemStateManager$PathComparator",1,0.00,8.00,26,0.31,19573.92,1,0,5,7,2,41.65,7,32,0,1,83.94,0.00,0.00,0.00,0,0.00,8,920.27,0,0,2,java.lang.Object,0.00,6,0,8,0,6,1,1,3,168,1
"org.apache.jackrabbit.core.state.TransientItemStateManager",21,0.20,2.00,133,1.31,34026.64,23,2,8,49,12,98.67,116,183,1,2,116.54,0.00,0.50,0.31,5,100.00,10,3944.32,7,2,11,org.apache.jackrabbit.core.state.ItemStateCache,0.00,28,1,42,0,28,19,1,46,866,0
"org.apache.jackrabbit.core.state.TransientItemStateManager$Attic",1,0.00,1.00,3,0.02,128.90,1,0,8,1,1,136.58,0,5,0,2,136.58,0.00,0.50,0.00,0,1.00,1,49.93,0,0,1,org.apache.jackrabbit.core.state.ItemStateCache,0.00,0,1,1,0,0,1,0,0,18,0
