Name, No. Methods, LCOM, AVCC, NOS, HBUG, HEFF, UWCS, INST, PACK, RFC, CBO, MI, CCML, NLOC, F-IN, DIT, MINC, S-R, R-R, COH, LMC, LCOM2, MAXCC, HVOL, HIER, NQU, FOUT, Superclass, SIX, EXT, NSUP, TCC, NSUB, MPC, NCO, INTR, CCOM, HLTH, MOD
"org.apache.jackrabbit.webdav.version.ActivityResource",0,0.00,0.00,5,0.11,3438.72,4,4,1,1,4,171.00,66,6,2,2,171.00,0.00,0.50,0.00,0,0.00,0,320.95,0,0,2,,0.00,1,1,0,0,1,0,0,5,70,1
"org.apache.jackrabbit.webdav.version.BaselineResource",1,2.00,1.00,4,0.06,1353.17,3,2,3,2,5,74.93,51,5,1,2,123.88,0.00,0.50,0.00,0,1.00,1,183.88,0,1,4,,0.00,1,1,1,0,1,0,0,4,45,1
"org.apache.jackrabbit.webdav.version.DeltaVConstants",0,0.00,0.00,44,0.95,21563.97,43,43,3,1,34,171.00,275,45,31,1,171.00,0.00,0.00,0.00,0,0.00,0,2837.36,0,0,3,,0.00,1,0,0,0,1,0,0,38,428,1
"org.apache.jackrabbit.webdav.version.DeltaVResource",4,2.00,1.00,7,0.06,480.39,6,2,5,4,17,172.76,73,8,11,2,154.62,0.00,0.50,0.00,0,4.00,1,183.94,0,2,7,,0.00,0,1,4,0,0,2,0,8,55,1
"org.apache.jackrabbit.webdav.version.DeltaVServletRequest",6,0.00,1.00,7,0.04,244.95,6,0,3,6,8,110.21,48,8,1,2,158.31,0.00,0.50,0.00,0,6.00,1,125.38,0,5,7,,0.00,0,1,6,0,0,1,0,7,46,1
"org.apache.jackrabbit.webdav.version.LabelInfo",9,0.03,2.11,67,0.79,33295.91,17,8,9,20,18,78.98,61,84,12,1,111.21,0.00,0.00,0.15,0,38.00,5,2377.15,0,2,6,java.lang.Object,0.00,11,0,19,0,11,7,2,7,473,1
"org.apache.jackrabbit.webdav.version.LabelSetProperty",3,0.50,1.33,14,0.15,3137.24,5,2,6,6,6,124.93,12,19,2,2,124.70,0.00,0.50,0.17,0,4.00,2,446.46,1,2,4,org.apache.jackrabbit.webdav.property.AbstractDavProperty,0.00,3,1,4,0,3,1,0,3,103,1
"org.apache.jackrabbit.webdav.version.MergeInfo",8,0.05,2.12,49,0.62,19315.97,11,3,13,30,17,67.06,71,66,9,1,115.16,0.00,0.00,0.38,0,0.00,4,1851.50,0,5,8,java.lang.Object,0.00,22,0,17,0,22,3,2,10,383,1
"org.apache.jackrabbit.webdav.version.OptionsInfo",5,0.38,2.00,26,0.33,8088.32,7,2,13,21,15,71.02,51,35,8,1,119.50,0.00,0.00,0.20,0,11.00,3,1000.82,0,2,7,java.lang.Object,0.00,16,0,10,0,16,3,1,7,215,1
"org.apache.jackrabbit.webdav.version.OptionsResponse",4,0.33,2.50,35,0.54,18422.10,6,2,13,28,12,70.69,49,44,6,1,108.25,0.00,0.00,0.25,0,4.00,4,1622.66,0,3,6,java.lang.Object,0.00,24,0,10,0,24,1,2,5,321,1
"org.apache.jackrabbit.webdav.version.OptionsResponse$Entry",1,3.00,1.00,8,0.07,1245.95,4,3,13,1,1,112.94,0,10,0,1,112.94,0.00,0.00,0.00,0,1.00,1,199.22,0,0,1,java.lang.Object,0.00,0,0,1,0,0,1,0,0,53,2
"org.apache.jackrabbit.webdav.version.SupportedMethodSetProperty",3,0.50,1.33,15,0.17,3977.70,5,2,6,7,4,120.51,12,20,1,2,120.27,0.00,0.50,0.17,0,5.00,2,517.57,1,2,3,org.apache.jackrabbit.webdav.property.AbstractDavProperty,0.00,4,1,4,0,4,1,1,3,116,1
"org.apache.jackrabbit.webdav.version.UpdateInfo",9,0.27,3.33,87,1.28,69797.25,17,8,13,34,17,56.39,77,115,9,1,104.50,0.00,0.00,0.36,0,0.00,8,3827.35,0,7,8,java.lang.Object,0.00,25,0,30,0,25,2,2,13,698,1
"org.apache.jackrabbit.webdav.version.VersionControlledResource",7,16.00,1.00,24,0.51,19334.90,23,16,3,8,17,92.39,294,25,9,2,126.10,0.00,0.50,0.00,0,7.00,1,1526.92,0,3,8,,0.00,1,1,7,0,1,4,0,24,299,1
"org.apache.jackrabbit.webdav.version.VersionHistoryResource",1,3.00,1.00,5,0.08,1613.67,4,3,3,2,15,90.69,41,6,11,2,119.67,0.00,0.50,0.00,0,1.00,1,236.61,0,1,5,,0.00,1,1,1,0,1,0,0,5,55,1
"org.apache.jackrabbit.webdav.version.VersionResource",2,11.00,1.00,14,0.32,11920.17,13,11,2,3,16,159.64,164,15,12,2,109.75,0.00,0.50,0.00,0,2.00,1,962.56,0,0,5,,0.00,1,1,2,0,1,2,0,14,189,1
"org.apache.jackrabbit.webdav.version.VersionableResource",1,1.00,1.00,3,0.02,174.22,2,1,1,1,4,123.49,38,4,3,2,135.55,0.00,0.50,0.00,0,1.00,1,64.62,0,0,1,,0.00,0,1,1,0,0,1,0,3,20,1
"org.apache.jackrabbit.webdav.version.WorkspaceResource",0,0.00,0.00,4,0.08,2307.76,3,3,1,1,3,171.00,61,5,1,2,171.00,0.00,0.50,0.00,0,0.00,0,240.81,0,0,2,,0.00,1,1,0,0,1,0,0,4,54,1
"org.apache.jackrabbit.spi.commons.conversion.CachingNameResolver",4,0.00,1.50,20,0.19,4650.67,6,2,2,9,5,72.22,43,28,1,1,120.69,0.00,0.00,0.50,0,4.00,2,573.35,0,2,4,java.lang.Object,0.00,5,0,6,0,5,2,1,8,140,1
"org.apache.jackrabbit.spi.commons.conversion.CachingPathResolver",5,0.12,1.60,26,0.27,8037.78,7,2,2,11,6,75.44,58,35,1,1,119.57,0.00,0.00,0.40,1,7.00,3,795.60,0,3,5,java.lang.Object,0.00,6,0,8,0,6,2,1,10,185,1
"org.apache.jackrabbit.spi.commons.conversion.DefaultNamePathResolver",11,0.30,1.18,33,0.35,5720.26,13,2,10,23,55,131.78,3,46,38,1,131.78,0.00,0.00,0.23,0,40.00,2,1052.48,0,5,17,java.lang.Object,0.00,12,0,13,1,12,6,1,1,260,1
"org.apache.jackrabbit.spi.commons.conversion.DummyIdentifierResolver",6,0.17,1.83,59,0.76,43706.28,12,6,7,19,7,104.85,5,70,2,1,104.85,0.00,0.00,0.31,0,0.00,4,2292.62,0,4,5,java.lang.Object,0.00,13,0,11,0,13,2,1,3,431,0
"org.apache.jackrabbit.spi.commons.conversion.DummyNamespaceResolver",2,0.00,1.00,5,0.03,335.40,2,0,2,2,9,94.15,17,8,8,1,142.25,0.00,0.00,0.00,0,2.00,1,85.37,0,2,1,java.lang.Object,0.00,0,0,2,0,0,0,1,3,28,1
"org.apache.jackrabbit.spi.commons.conversion.GenerationalCache",5,0.16,2.40,39,0.45,16199.18,13,8,3,16,2,91.49,71,52,2,1,111.63,0.00,0.00,0.25,1,13.00,6,1347.19,0,1,0,java.lang.Object,0.00,11,0,12,0,11,4,0,14,285,0
"org.apache.jackrabbit.spi.commons.conversion.IdentifierResolver",2,0.00,1.00,3,0.02,126.12,2,0,1,2,13,206.83,3,4,11,1,156.83,0.00,0.00,0.00,0,2.00,1,65.06,0,1,2,,0.00,0,0,2,0,0,1,0,1,22,1
"org.apache.jackrabbit.spi.commons.conversion.IllegalNameException",2,0.00,1.00,5,0.03,221.18,2,0,0,2,41,99.55,22,8,40,3,143.68,0.00,0.67,0.00,0,2.00,1,88.69,0,0,1,org.apache.jackrabbit.spi.commons.conversion.NameException,0.00,0,2,2,0,0,2,0,3,29,1
"org.apache.jackrabbit.spi.commons.conversion.MalformedPathException",2,0.00,1.00,5,0.03,221.18,2,0,0,2,49,95.20,21,8,48,3,143.68,0.00,0.67,0.00,0,2.00,1,88.69,0,0,1,org.apache.jackrabbit.spi.commons.conversion.NameException,0.00,0,2,2,0,0,2,0,3,29,1
"org.apache.jackrabbit.spi.commons.conversion.NameException",2,0.00,1.00,5,0.03,221.18,2,0,1,2,58,95.57,16,8,58,2,143.68,2.00,0.25,0.00,0,2.00,1,88.69,0,0,0,javax.jcr.RepositoryException,0.00,0,1,2,2,0,2,0,3,29,1
"org.apache.jackrabbit.spi.commons.conversion.NameParser",3,0.25,13.67,112,1.63,213341.67,9,6,5,14,15,107.08,60,136,9,1,73.69,0.00,0.00,0.33,1,4.00,37,4883.02,0,2,6,java.lang.Object,0.00,11,0,41,0,11,1,0,27,783,1
"org.apache.jackrabbit.spi.commons.conversion.NameParserTest",4,0.25,6.00,160,2.82,156167.70,8,4,10,21,8,24.67,38,167,0,2,74.67,0.00,0.50,0.44,0,2.00,9,8452.96,0,0,8,junit.framework.TestCase,0.00,17,1,24,0,17,4,0,31,1339,1
"org.apache.jackrabbit.spi.commons.conversion.NameParserTest$TestNamespaceResolver",2,0.00,2.00,11,0.16,6808.90,2,0,10,5,0,116.95,0,20,0,1,116.95,0.00,0.00,0.00,0,2.00,2,481.49,0,2,0,java.lang.Object,0.00,3,0,4,0,3,0,1,0,104,1
"org.apache.jackrabbit.spi.commons.conversion.NamePathResolver",0,0.00,0.00,1,0.01,39.30,0,0,0,0,166,171.00,5,2,166,3,171.00,0.00,0.67,0.00,0,0.00,0,19.65,0,0,0,,0.00,0,2,0,0,0,0,0,1,7,1
"org.apache.jackrabbit.spi.commons.conversion.NameResolver",2,0.00,1.00,3,0.02,93.79,2,0,2,2,59,109.36,20,4,57,1,157.84,0.00,0.00,0.00,0,2.00,1,62.53,0,2,2,,0.00,0,0,2,0,0,0,0,3,22,1
"org.apache.jackrabbit.spi.commons.conversion.ParsingNameResolver",3,0.00,1.33,14,0.15,2984.06,5,2,4,8,19,87.31,37,19,13,1,124.87,0.00,0.00,0.50,0,1.00,2,438.87,0,2,6,java.lang.Object,0.00,5,0,4,0,5,1,1,7,105,1
"org.apache.jackrabbit.spi.commons.conversion.ParsingNameResolverTest",4,0.67,2.00,40,0.35,5630.86,5,1,4,13,6,76.52,25,52,0,2,108.74,0.00,0.50,0.50,2,4.00,3,1051.48,0,0,6,junit.framework.TestCase,0.00,9,1,8,0,9,4,0,6,237,1
"org.apache.jackrabbit.spi.commons.conversion.ParsingPathResolver",5,0.17,2.40,38,0.51,26538.48,8,3,3,18,19,61.46,54,46,11,1,109.94,0.00,0.00,0.47,0,2.00,8,1527.05,0,3,8,java.lang.Object,0.00,13,0,12,0,13,2,1,10,303,1
"org.apache.jackrabbit.spi.commons.conversion.ParsingPathResolverTest",8,0.07,1.88,108,1.02,19226.48,12,4,8,28,11,123.29,26,123,0,2,102.68,0.00,0.50,0.31,2,0.00,3,3048.83,1,0,11,junit.framework.TestCase,0.00,20,1,15,0,20,8,0,10,620,1
"org.apache.jackrabbit.spi.commons.conversion.PathParser",7,0.06,10.00,173,2.98,551890.17,18,11,6,29,12,124.37,154,248,2,1,80.42,0.00,0.00,0.14,1,12.00,62,8939.57,0,6,10,java.lang.Object,0.00,22,0,70,0,22,1,0,29,1368,1
"org.apache.jackrabbit.spi.commons.conversion.PathParserTest",9,0.28,4.33,203,3.02,163044.46,14,5,10,42,13,126.94,19,210,0,2,87.06,0.00,0.50,0.44,0,0.00,9,9068.50,0,0,13,junit.framework.TestCase,0.00,33,1,39,0,33,9,0,17,1625,1
"org.apache.jackrabbit.spi.commons.conversion.PathResolver",3,0.00,1.00,4,0.04,165.36,3,0,2,3,35,107.29,29,5,32,1,157.29,0.00,0.00,0.00,0,3.00,1,110.24,0,3,3,,0.00,0,0,3,0,0,0,0,4,35,1
"org.apache.jackrabbit.spi.commons.query.xpath.QueryBuilder",4,0.00,1.00,9,0.10,1268.78,4,0,6,7,5,140.31,16,18,0,1,140.07,0.00,0.00,0.00,0,4.00,1,294.46,0,3,5,java.lang.Object,0.00,3,0,4,0,3,1,1,5,78,1
"org.apache.jackrabbit.spi.commons.query.xpath.QueryFormat",18,0.10,5.06,344,5.09,367259.37,21,3,30,90,27,128.87,44,401,4,1,88.99,0.00,0.00,0.43,3,0.00,23,15274.50,0,16,24,java.lang.Object,0.00,72,0,91,0,72,2,2,15,2602,0
"org.apache.jackrabbit.spi.commons.query.xpath.QueryFormat$DefaultQueryNodeVisitor",1,0.00,1.00,4,0.03,474.00,1,0,30,2,1,127.47,0,5,0,1,127.47,0.00,0.00,0.00,0,1.00,1,92.00,0,1,1,java.lang.Object,0.00,1,0,1,0,1,0,0,0,25,0
"org.apache.jackrabbit.spi.commons.query.xpath.QueryFormatTest",4,1.00,1.00,13,0.15,2210.37,5,1,13,10,9,131.61,3,19,0,2,131.61,0.00,0.50,0.25,1,6.00,1,442.22,0,0,9,junit.framework.TestCase,0.00,6,1,4,0,6,4,0,1,105,1
"org.apache.jackrabbit.spi.commons.query.xpath.QueryFormatTest$DummyNamespaceResolver",2,0.00,2.00,11,0.09,1781.25,2,0,13,4,1,121.54,0,15,0,1,121.54,0.00,0.00,0.00,0,2.00,2,269.61,2,2,1,java.lang.Object,0.00,2,0,4,0,2,0,0,0,68,0
"org.apache.jackrabbit.spi.commons.query.xpath.SimpleNode",20,0.06,1.45,68,0.59,15165.52,25,5,0,27,2,130.44,17,90,2,1,130.44,0.00,0.00,0.14,3,204.00,4,1780.14,0,5,0,java.lang.Object,0.00,7,0,29,0,7,15,1,6,430,1
"org.apache.jackrabbit.spi.commons.query.xpath.XPathOrderByTest",6,0.40,1.00,45,0.77,13289.30,8,2,13,26,11,113.13,4,53,0,2,113.13,0.00,0.50,0.83,1,0.00,1,2296.14,0,0,11,junit.framework.TestCase,0.00,20,1,6,0,20,6,0,1,446,1
"org.apache.jackrabbit.spi.commons.query.xpath.XPathQueryBuilder",19,0.06,9.42,579,10.95,987252.27,60,41,38,143,35,77.78,313,765,4,1,78.25,0.00,0.00,0.08,11,60.00,58,32853.19,0,12,32,java.lang.Object,0.00,124,0,179,0,124,7,2,116,4916,1
"org.apache.jackrabbit.spi.commons.query.xpath.XPathQueryBuilder$DefaultQueryNodeVisitor",1,0.00,2.00,7,0.11,2802.00,1,0,38,5,2,112.17,0,11,0,1,112.17,0.00,0.00,0.00,0,0.00,2,318.00,0,1,2,java.lang.Object,0.00,4,0,2,0,4,0,0,0,66,0
"org.apache.jackrabbit.commons.iterator.AccessControlPolicyIteratorAdapter",4,1.00,1.00,10,0.08,1359.33,5,1,6,6,4,97.55,29,17,2,2,139.84,0.00,0.50,0.00,0,4.00,1,249.48,1,1,2,org.apache.jackrabbit.commons.iterator.RangeIteratorDecorator,0.00,2,1,4,0,2,3,1,7,71,1
"org.apache.jackrabbit.commons.iterator.EventIteratorAdapter",5,0.00,1.00,11,0.07,631.05,5,0,6,6,2,111.00,31,18,0,2,143.23,0.00,0.50,0.00,0,5.00,1,213.56,1,1,2,org.apache.jackrabbit.commons.iterator.RangeIteratorDecorator,0.00,1,1,5,0,1,4,1,7,67,1
"org.apache.jackrabbit.commons.iterator.EventListenerIteratorAdapter",4,1.00,1.00,10,0.08,1307.38,5,1,6,6,3,97.68,29,17,1,2,139.97,0.00,0.50,0.00,0,4.00,1,239.29,1,1,2,org.apache.jackrabbit.commons.iterator.RangeIteratorDecorator,0.00,2,1,4,0,2,3,1,7,69,1
"org.apache.jackrabbit.commons.iterator.FilteredRangeIterator",10,0.13,2.10,56,0.50,14928.37,17,7,4,17,2,71.66,84,77,1,1,119.76,0.00,0.00,0.26,1,14.00,4,1504.41,0,1,1,java.lang.Object,0.00,7,0,21,0,7,9,1,19,338,1
"org.apache.jackrabbit.commons.iterator.FilteredRangeIteratorTest",3,0.00,1.00,33,0.41,9467.33,4,1,5,14,2,154.60,5,38,0,2,104.60,0.00,0.50,1.00,0,0.00,1,1239.27,0,0,2,junit.framework.TestCase,0.00,11,1,3,0,11,3,0,1,265,1
"org.apache.jackrabbit.commons.iterator.FilteringNodeIterator",9,0.06,1.44,36,0.25,4778.44,13,4,4,13,3,147.61,35,50,2,1,127.00,0.00,0.00,0.19,2,28.00,3,746.18,0,3,1,java.lang.Object,0.00,4,0,13,1,4,6,1,13,192,1
"org.apache.jackrabbit.commons.iterator.FrozenNodeIteratorAdapter",2,0.00,1.50,7,0.07,1174.42,2,0,5,6,3,131.54,9,12,2,2,131.31,0.00,0.50,0.00,0,2.00,2,213.91,1,1,1,org.apache.jackrabbit.commons.iterator.RangeIteratorAdapter,0.00,4,1,3,0,4,1,1,2,55,1
"org.apache.jackrabbit.commons.iterator.LazyIteratorChain",7,0.11,1.43,28,0.30,10155.39,10,3,3,14,2,144.18,24,40,2,1,123.56,0.00,0.00,0.24,1,13.00,3,910.43,0,2,0,java.lang.Object,0.00,7,0,10,0,7,5,1,5,227,1
"org.apache.jackrabbit.commons.iterator.NodeIterable",2,1.00,1.00,6,0.05,702.81,3,1,3,2,1,84.68,20,10,1,1,133.15,0.00,0.00,0.50,0,2.00,1,152.48,0,1,0,java.lang.Object,0.00,0,0,2,0,0,1,1,4,42,1
"org.apache.jackrabbit.commons.iterator.NodeIteratorAdapter",4,1.00,1.00,10,0.08,1359.33,5,1,6,6,11,97.55,29,17,9,2,139.84,0.00,0.50,0.00,0,4.00,1,249.48,1,1,2,org.apache.jackrabbit.commons.iterator.RangeIteratorDecorator,0.00,2,1,4,0,2,3,1,7,71,1
"org.apache.jackrabbit.commons.iterator.NodeTypeIteratorAdapter",4,1.00,1.00,10,0.09,1471.53,5,1,6,6,6,97.28,29,17,4,2,139.57,0.00,0.50,0.00,0,4.00,1,265.50,1,1,2,org.apache.jackrabbit.commons.iterator.RangeIteratorDecorator,0.00,2,1,4,0,2,3,1,7,74,1
"org.apache.jackrabbit.commons.iterator.PropertyIterable",2,1.00,1.00,6,0.05,702.81,3,1,3,2,1,84.68,20,10,1,1,133.15,0.00,0.00,0.50,0,2.00,1,152.48,0,1,0,java.lang.Object,0.00,0,0,2,0,0,1,1,4,42,1
"org.apache.jackrabbit.commons.iterator.PropertyIteratorAdapter",4,1.00,1.00,10,0.08,1307.38,5,1,6,6,4,97.68,29,17,2,2,139.97,0.00,0.50,0.00,0,4.00,1,239.29,1,1,2,org.apache.jackrabbit.commons.iterator.RangeIteratorDecorator,0.00,2,1,4,0,2,3,1,7,69,1
"org.apache.jackrabbit.commons.iterator.RangeIteratorAdapter",9,0.06,1.78,45,0.34,8853.83,13,4,5,16,16,73.12,75,63,16,1,121.23,0.00,0.00,0.31,1,8.00,3,1033.45,0,1,0,java.lang.Object,0.00,7,0,16,2,7,8,1,16,249,1
"org.apache.jackrabbit.commons.iterator.RangeIteratorDecorator",7,0.17,1.00,16,0.11,1357.60,8,1,2,13,10,109.53,48,25,10,1,141.76,0.00,0.00,0.86,0,0.00,1,328.05,0,1,0,java.lang.Object,0.00,6,0,7,10,6,6,1,11,98,1
"org.apache.jackrabbit.commons.iterator.RowIterable",2,1.00,1.00,6,0.05,702.81,3,1,3,2,1,84.68,20,10,1,1,133.15,0.00,0.00,0.50,0,2.00,1,152.48,0,1,0,java.lang.Object,0.00,0,0,2,0,0,1,1,4,42,1
"org.apache.jackrabbit.commons.iterator.RowIteratorAdapter",4,1.00,1.00,10,0.08,1307.38,5,1,6,6,3,97.68,29,17,1,2,139.97,1.00,0.33,0.00,0,4.00,1,239.29,1,1,2,org.apache.jackrabbit.commons.iterator.RangeIteratorDecorator,0.00,2,1,4,1,2,3,1,7,69,1
"org.apache.jackrabbit.commons.iterator.VersionIteratorAdapter",4,1.00,1.00,10,0.08,1307.38,5,1,6,6,3,97.68,29,17,1,2,139.97,0.00,0.50,0.00,0,4.00,1,239.29,1,1,2,org.apache.jackrabbit.commons.iterator.RangeIteratorDecorator,0.00,2,1,4,0,2,3,1,7,69,1
"org.apache.jackrabbit.webdav.jcr.lock.JcrActiveLock",12,0.23,1.50,39,0.39,7576.46,14,2,10,27,8,98.84,75,61,2,2,131.06,0.00,0.50,0.29,1,32.00,3,1170.85,0,4,6,org.apache.jackrabbit.webdav.lock.AbstractActiveLock,0.00,15,1,18,0,15,8,2,17,280,1
"org.apache.jackrabbit.webdav.jcr.lock.SessionScopedLockEntry",2,1.00,1.00,6,0.05,693.12,3,1,7,3,6,100.98,12,9,1,2,133.20,0.00,0.50,0.00,0,2.00,1,144.92,0,2,5,org.apache.jackrabbit.webdav.lock.AbstractLockEntry,0.00,1,1,2,0,1,0,0,3,40,1
"org.apache.jackrabbit.rmi.repository.AbstractRemoteRepositoryFactory",3,1.00,1.00,7,0.05,651.65,4,1,4,4,6,91.37,29,12,3,1,141.37,0.00,0.00,0.33,1,4.00,1,164.24,0,2,3,java.lang.Object,0.00,1,0,3,3,1,1,1,5,48,2
"org.apache.jackrabbit.rmi.repository.JNDIRemoteRepository",3,0.00,1.00,7,0.07,644.73,3,0,5,6,4,92.93,32,12,0,2,141.40,0.00,0.50,0.00,0,3.00,1,198.98,0,0,4,org.apache.jackrabbit.rmi.repository.ProxyRepository,0.00,3,1,3,0,3,3,0,4,56,1
"org.apache.jackrabbit.rmi.repository.JNDIRemoteRepositoryFactory",2,0.00,2.50,17,0.20,7096.78,4,2,5,6,5,71.58,24,33,2,2,109.15,0.00,0.50,0.50,0,2.00,4,588.79,0,1,3,org.apache.jackrabbit.rmi.repository.AbstractRemoteRepositoryFactory,0.40,4,1,5,0,4,1,0,5,126,1
"org.apache.jackrabbit.rmi.repository.ProxyRepository",11,0.50,1.45,36,0.34,5404.81,12,1,7,20,4,81.92,99,59,3,1,131.92,0.00,0.00,0.55,1,5.00,2,1020.49,0,8,1,java.lang.Object,0.00,9,0,16,3,9,3,1,14,258,1
"org.apache.jackrabbit.rmi.repository.ProxyRepository$HashSet<String>",0,0.00,0.00,49,0.58,17111.25,0,0,7,0,0,171.00,0,49,0,1,171.00,0.00,0.00,0.00,0,0.00,0,1741.26,0,0,0,java.lang.Object,0.00,0,0,0,0,0,0,0,0,296,0
"org.apache.jackrabbit.rmi.repository.RMIRemoteRepository",2,0.00,1.00,5,0.04,344.94,2,0,2,4,4,98.03,22,8,0,2,142.16,0.00,0.50,0.00,0,2.00,1,116.05,0,0,4,org.apache.jackrabbit.rmi.repository.ProxyRepository,0.00,2,1,2,0,2,2,0,3,35,1
"org.apache.jackrabbit.rmi.repository.RMIRemoteRepositoryFactory",2,1.00,3.00,12,0.15,4793.84,3,1,7,4,5,66.63,21,22,2,2,115.11,0.00,0.50,0.50,0,2.00,5,459.98,0,1,3,org.apache.jackrabbit.rmi.repository.AbstractRemoteRepositoryFactory,0.40,2,1,6,0,2,1,0,4,104,1
"org.apache.jackrabbit.rmi.repository.RepositoryFactory",1,0.00,1.00,2,0.01,29.60,1,0,2,1,2,98.19,9,3,2,1,148.18,0.00,0.00,0.00,0,1.00,1,21.85,0,1,0,,0.00,0,0,1,0,0,0,0,2,10,0
"org.apache.jackrabbit.rmi.repository.RmiRepositoryFactory",5,1.00,3.80,53,0.74,30475.11,6,1,19,26,2,103.58,0,99,0,1,103.58,0.00,0.00,0.20,4,8.00,6,2220.15,0,5,2,java.lang.Object,0.00,21,0,19,0,21,0,1,0,424,1
"org.apache.jackrabbit.rmi.repository.URLRemoteRepository",3,0.00,1.00,7,0.06,533.15,3,0,4,6,4,93.58,30,11,0,2,142.05,0.00,0.50,0.00,0,3.00,1,169.83,0,0,4,org.apache.jackrabbit.rmi.repository.ProxyRepository,0.00,3,1,3,0,3,3,0,4,50,1
"org.apache.jackrabbit.rmi.repository.URLRemoteRepositoryFactory",2,1.00,3.00,19,0.24,11468.48,3,1,6,9,5,57.08,20,39,2,2,105.55,0.00,0.50,0.50,0,2.00,5,734.95,0,1,3,org.apache.jackrabbit.rmi.repository.AbstractRemoteRepositoryFactory,0.40,7,1,6,0,7,1,0,4,147,1
"org.apache.jackrabbit.core.integration.benchmark.ItemStateCacheSyncTest",3,0.50,3.00,71,0.89,49820.12,9,6,13,26,2,107.33,9,70,0,2,86.72,0.00,0.50,0.50,0,0.00,4,2679.80,0,0,2,junit.framework.TestCase,0.00,23,1,9,0,23,3,0,3,474,1
"org.apache.jackrabbit.core.integration.benchmark.ItemStateCacheSyncTest$Lookup",1,0.00,5.00,15,0.14,4910.71,1,0,13,5,0,97.69,0,21,0,1,97.69,0.00,0.00,0.00,0,0.00,5,411.43,0,0,0,java.lang.Object,0.00,4,0,5,0,4,1,1,0,82,1
"org.apache.jackrabbit.core.integration.benchmark.ItemStateCacheSyncTest$Traverse",2,0.00,1.50,6,0.05,624.27,2,0,13,3,0,133.47,0,9,0,1,133.47,0.00,0.00,0.00,0,2.00,2,143.58,0,0,0,java.lang.Object,0.00,1,0,3,0,1,2,1,0,39,1
"org.apache.jackrabbit.core.integration.benchmark.SimpleBench",4,0.00,2.50,45,0.56,22062.17,7,3,7,24,2,102.48,3,49,1,1,102.48,0.00,0.00,0.33,2,6.00,5,1677.37,0,0,1,java.lang.Object,0.00,20,0,10,0,20,4,0,1,308,1
"org.apache.jackrabbit.core.data.db.DbDataRecord",4,0.22,1.00,17,0.15,2286.82,7,3,5,7,5,127.07,19,22,1,2,126.83,0.00,0.50,0.50,0,0.00,1,444.33,1,1,5,org.apache.jackrabbit.core.data.AbstractDataRecord,0.00,3,1,4,0,3,3,0,5,113,1
"org.apache.jackrabbit.core.data.db.DbDataStore",46,0.02,2.00,331,4.49,238023.14,81,35,34,111,19,61.97,381,457,6,1,110.07,0.00,0.00,0.05,13,1018.00,15,13479.79,0,20,15,java.lang.Object,0.00,65,0,92,1,65,26,2,92,2376,1
"org.apache.jackrabbit.core.data.db.DbInputStream",12,0.09,1.92,61,0.48,11217.21,16,4,7,22,6,103.51,63,86,3,2,121.38,0.00,0.50,0.17,3,32.00,4,1441.81,0,0,4,org.apache.commons.io.input.AutoCloseInputStream,0.00,10,1,23,0,10,12,0,17,345,1
"org.apache.jackrabbit.core.data.db.DerbyDataStore",2,0.00,1.50,8,0.09,1854.45,2,0,5,5,4,107.21,10,15,0,2,125.08,0.00,0.50,0.00,0,2.00,2,267.93,2,1,4,org.apache.jackrabbit.core.data.db.DbDataStore,0.04,3,1,3,0,3,1,0,3,64,1
"org.apache.jackrabbit.core.data.db.TempFileInputStream",12,0.32,1.42,42,0.36,6355.37,14,2,10,25,2,171.56,30,60,2,2,131.67,0.00,0.50,0.21,2,28.00,2,1079.78,0,0,0,org.apache.commons.io.input.AutoCloseInputStream,0.00,13,1,17,0,13,12,0,6,270,1
"org.apache.jackrabbit.rmi.server.principal.ServerGroup",4,0.00,2.00,17,0.20,6712.31,4,0,8,10,5,122.99,0,26,1,3,122.99,0.00,0.67,0.00,1,4.00,5,608.65,2,1,4,org.apache.jackrabbit.rmi.server.principal.ServerPrincipal,0.00,6,3,8,0,6,3,1,0,137,1
"org.apache.jackrabbit.rmi.server.principal.ServerGroup$Iterator<Principal>",3,0.50,1.00,8,0.07,1010.36,4,1,8,7,0,139.87,0,11,0,1,139.87,0.00,0.00,0.67,0,1.00,1,218.04,0,1,0,java.lang.Object,0.00,4,0,3,0,4,2,0,0,59,0
"org.apache.jackrabbit.rmi.server.principal.ServerPrincipal",3,0.50,1.00,9,0.07,890.70,4,1,5,4,6,154.35,9,14,3,2,133.73,1.00,0.33,0.67,0,1.00,1,198.68,0,2,3,org.apache.jackrabbit.rmi.server.ServerObject,0.00,1,2,3,1,1,1,1,1,55,1
"org.apache.jackrabbit.rmi.server.principal.ServerPrincipalIterator",2,0.00,1.00,5,0.06,875.57,2,0,6,4,4,138.97,1,10,1,3,138.97,0.00,0.67,0.00,0,2.00,1,189.80,1,1,3,org.apache.jackrabbit.rmi.server.iterator.ServerIterator,0.00,2,3,2,0,2,1,0,1,49,1
"org.apache.jackrabbit.core.util.db.CheckSchemaOperation",4,0.17,2.00,31,0.37,11000.16,10,6,9,18,13,64.13,33,41,11,1,112.23,0.00,0.00,0.29,0,6.00,4,1119.99,0,2,2,java.lang.Object,0.00,14,0,8,0,14,2,0,9,236,1
"org.apache.jackrabbit.core.util.db.ConnectionFactory",12,0.09,3.50,132,1.82,81073.76,19,7,16,62,16,51.71,112,193,14,1,101.71,0.00,0.00,0.23,5,40.00,7,5459.77,0,9,2,java.lang.Object,0.00,50,0,42,0,50,3,0,24,1048,2
"org.apache.jackrabbit.core.util.db.ConnectionFactoryTest",17,0.17,1.18,95,1.21,22611.49,25,8,9,46,4,120.29,3,121,1,2,120.29,0.00,0.50,0.29,3,0.00,4,3639.04,0,2,3,junit.framework.TestCase,0.00,29,1,20,0,29,15,0,1,786,1
"org.apache.jackrabbit.core.util.db.ConnectionHelper",17,0.01,2.29,165,1.75,63742.06,25,8,9,59,21,58.96,152,210,18,1,107.07,0.00,0.00,0.13,3,72.00,6,5239.62,0,6,3,java.lang.Object,0.00,42,0,39,3,42,11,0,20,1052,1
"org.apache.jackrabbit.core.util.db.ConnectionHelper$RetryManager",2,0.00,3.50,23,0.24,11101.78,2,0,9,5,0,102.38,1,32,0,1,102.38,0.00,0.00,0.00,1,2.00,6,719.62,0,0,0,java.lang.Object,0.00,3,0,7,0,3,2,0,1,135,2
"org.apache.jackrabbit.core.util.db.ConnectionHelper$RetryManager<Integer>",1,0.00,1.00,3,0.03,292.80,1,0,9,2,0,133.78,0,5,0,1,133.78,0.00,0.00,0.00,0,1.00,1,80.57,0,1,0,java.lang.Object,0.00,1,0,1,0,1,0,0,0,23,0
"org.apache.jackrabbit.core.util.db.ConnectionHelper$RetryManager<ResultSet>",1,0.00,1.00,3,0.03,329.13,1,0,9,2,0,133.38,0,5,0,1,133.38,0.00,0.00,0.00,0,1.00,1,91.65,0,1,0,java.lang.Object,0.00,1,0,1,0,1,0,0,0,25,0
"org.apache.jackrabbit.core.util.db.ConnectionHelper$RetryManager<Void>",1,0.00,1.00,4,0.03,326.03,1,0,9,2,0,128.75,0,6,0,1,128.75,0.00,0.00,0.00,0,1.00,1,89.98,0,1,0,java.lang.Object,0.00,1,0,1,0,1,0,0,0,25,0
"org.apache.jackrabbit.core.util.db.DataSourceWrapper",9,0.04,1.11,24,0.23,3427.03,12,3,4,15,1,139.66,38,34,1,1,139.42,0.00,0.00,0.30,0,0.00,2,675.34,0,3,0,java.lang.Object,0.00,6,0,10,0,6,6,1,10,181,1
"org.apache.jackrabbit.core.util.db.DatabaseAware",1,0.00,1.00,2,0.01,30.51,1,0,0,1,4,99.98,8,3,3,1,148.08,0.00,0.00,0.00,0,1.00,1,25.51,0,0,1,,0.00,0,0,1,0,0,1,0,2,11,1
"org.apache.jackrabbit.core.util.db.DbUtility",4,1.00,2.75,24,0.27,7814.89,5,1,6,13,18,83.60,26,41,18,1,115.83,0.00,0.00,0.25,2,6.00,7,804.81,0,0,0,java.lang.Object,0.00,9,0,11,0,9,4,0,5,181,2
"org.apache.jackrabbit.core.util.db.DerbyConnectionHelper",2,0.00,3.00,25,0.31,11074.42,4,2,6,15,5,71.63,26,37,3,2,101.01,0.00,0.50,0.50,0,2.00,5,917.83,0,0,2,org.apache.jackrabbit.core.util.db.ConnectionHelper,0.00,13,1,6,0,13,2,0,16,175,2
"org.apache.jackrabbit.core.util.db.Oracle10R1ConnectionHelper",5,0.19,2.60,62,0.96,57078.79,9,4,14,32,6,56.28,39,84,2,3,98.57,0.00,0.67,0.40,2,5.00,7,2872.93,1,2,4,org.apache.jackrabbit.core.util.db.OracleConnectionHelper,0.12,27,2,13,0,27,3,0,12,521,2
"org.apache.jackrabbit.core.util.db.OracleConnectionHelper",3,1.00,1.67,14,0.20,4361.72,4,1,6,12,6,75.41,26,25,4,2,123.52,1.00,0.33,0.33,0,4.00,3,589.93,0,0,2,org.apache.jackrabbit.core.util.db.ConnectionHelper,0.00,9,1,5,1,9,3,0,8,127,1
"org.apache.jackrabbit.core.util.db.ResultSetWrapper",3,0.50,1.67,18,0.21,5108.28,6,3,6,11,3,98.54,15,23,2,1,116.41,0.00,0.00,0.67,0,1.00,2,637.89,0,2,1,java.lang.Object,0.00,8,0,5,0,8,1,1,3,142,2
"org.apache.jackrabbit.core.util.db.StreamWrapper",3,0.25,1.00,10,0.06,634.95,5,2,1,3,7,155.50,9,14,7,1,134.89,0.00,0.00,0.33,0,5.00,1,177.36,0,1,0,java.lang.Object,0.00,0,0,3,0,0,2,0,1,52,1
"org.apache.jackrabbit.core.util.db.TestAll",1,0.00,1.00,5,0.04,864.35,1,0,3,3,1,73.70,8,7,0,2,121.80,0.00,0.50,0.00,0,1.00,1,115.51,0,1,1,junit.framework.TestCase,0.00,2,1,1,0,2,0,0,2,31,1
"org.apache.jackrabbit.client.RepositoryFactoryImpl",1,0.00,5.00,14,0.22,11214.18,3,2,4,8,1,145.98,25,26,1,1,95.99,0.00,0.00,1.00,0,0.00,5,660.85,0,1,0,java.lang.Object,0.00,7,0,5,0,7,0,1,4,125,1
"org.apache.jackrabbit.client.RepositoryFactoryImplTest",8,0.00,1.62,56,0.79,21735.23,9,1,63,25,32,152.21,16,82,0,2,112.32,0.00,0.50,1.00,0,0.00,3,2381.08,0,0,32,junit.framework.TestCase,0.00,17,1,13,0,17,8,0,10,481,1
"org.apache.jackrabbit.client.RepositoryFactoryImplTest$RepositoryConfigImpl",5,1.00,1.00,12,0.07,1096.67,6,1,63,6,3,141.34,0,18,0,1,141.34,0.00,0.00,0.00,0,5.00,1,213.15,0,2,3,java.lang.Object,0.00,1,0,5,0,1,3,1,0,64,3
"org.apache.jackrabbit.client.RepositoryFactoryImplTest$RepositoryServiceFactoryImpl",2,1.00,2.00,6,0.05,1067.18,3,1,63,3,2,131.57,0,9,0,1,131.57,0.00,0.00,0.00,0,2.00,3,164.01,0,1,2,java.lang.Object,0.00,1,0,4,0,1,1,1,0,44,3
"org.apache.jackrabbit.client.RepositoryFactoryImplTest$RepositoryServiceImpl",69,1.00,1.00,114,1.60,16216.13,70,1,63,71,23,152.33,26,184,0,1,152.33,0.00,0.00,0.00,0,69.00,1,4814.00,0,41,23,java.lang.Object,0.00,2,0,69,0,2,28,1,26,1185,3
"org.apache.jackrabbit.client.RepositoryFactoryTest",1,1.00,2.00,9,0.09,1928.73,2,1,6,7,0,77.15,6,12,0,2,109.37,0.00,0.50,0.00,0,1.00,2,284.87,0,0,0,junit.framework.TestCase,0.00,6,1,2,0,6,1,0,2,65,1
"org.apache.jackrabbit.test.api.util.ISO9075",6,0.20,3.67,74,1.07,65439.96,9,3,2,26,3,48.65,58,94,1,1,98.65,0.00,0.00,0.17,2,18.00,9,3206.82,0,3,2,java.lang.Object,0.00,20,0,22,0,20,3,0,21,621,1
"org.apache.jackrabbit.test.api.util.TestAll",1,0.00,1.00,4,0.03,457.63,1,0,3,2,1,90.03,12,6,1,2,127.59,0.00,0.50,0.00,0,1.00,1,76.45,0,1,0,junit.framework.TestCase,0.00,1,1,1,0,1,0,0,3,23,1
"org.apache.jackrabbit.test.api.util.Text",32,0.30,2.88,292,4.20,276756.27,35,3,7,65,1,55.68,336,378,1,1,104.16,0.00,0.00,0.04,8,88.00,13,12598.02,0,27,0,java.lang.Object,0.00,33,0,92,0,33,5,0,49,2436,1
"org.apache.jackrabbit.test.api.util.XMLChar",21,0.03,1.95,724,20.15,1282085.56,30,9,1,23,1,117.51,615,757,1,1,76.03,0.00,0.00,0.08,4,61.00,6,60456.28,0,0,0,java.lang.Object,0.00,2,0,41,0,2,21,0,463,6924,1
"org.apache.jackrabbit.core.persistence.obj.ObjectPersistenceManager",19,0.21,3.32,245,3.14,130348.98,27,8,26,71,19,100.49,77,337,1,2,100.26,0.00,0.50,0.32,4,0.00,7,9420.80,1,7,18,org.apache.jackrabbit.core.persistence.AbstractPersistenceManager,0.00,52,1,63,0,52,12,0,33,1746,1
"org.apache.jackrabbit.webdav.transaction.TransactionConstants",0,0.00,0.00,13,0.24,5843.66,12,12,4,3,12,171.00,76,14,8,1,171.00,0.00,0.00,0.00,0,0.00,0,724.21,0,0,4,,0.00,3,0,0,0,3,0,0,16,138,1
"org.apache.jackrabbit.webdav.transaction.TransactionDavServletRequest",2,0.00,1.00,3,0.02,87.74,2,0,2,2,5,113.94,23,4,2,2,158.07,0.00,0.50,0.00,0,2.00,1,46.77,0,2,3,,0.00,0,1,2,0,0,0,0,3,18,1
"org.apache.jackrabbit.webdav.transaction.TransactionInfo",4,0.00,1.75,23,0.28,8103.38,6,2,8,13,14,70.28,41,30,9,1,118.76,0.00,0.00,0.50,0,0.00,3,836.00,0,1,5,java.lang.Object,0.00,9,0,7,0,9,3,2,7,178,1
"org.apache.jackrabbit.webdav.transaction.TransactionResource",3,1.00,1.00,5,0.04,358.34,4,1,2,3,16,104.64,28,6,13,2,154.64,0.00,0.50,0.00,0,3.00,1,133.70,0,1,4,,0.00,0,1,3,0,0,2,0,4,40,1
"org.apache.jackrabbit.webdav.transaction.TxActiveLock",4,0.17,2.00,23,0.24,7053.97,6,2,4,12,10,76.91,30,35,5,3,119.20,0.00,0.67,0.38,0,2.00,5,729.54,2,2,5,org.apache.jackrabbit.webdav.lock.DefaultActiveLock,0.45,8,2,8,0,8,2,1,7,159,1
"org.apache.jackrabbit.webdav.transaction.TxLockEntry",3,0.25,1.33,12,0.08,1314.56,5,2,5,4,5,79.57,26,17,1,2,127.67,0.00,0.50,0.33,0,2.00,2,249.39,0,2,4,org.apache.jackrabbit.webdav.lock.AbstractLockEntry,0.00,1,1,4,0,1,1,1,4,65,2
"org.apache.jackrabbit.webdav.transaction.TxLockManager",2,0.00,1.00,3,0.03,184.31,2,0,5,2,9,145.17,30,5,3,2,155.53,0.00,0.50,0.00,0,2.00,1,101.67,0,1,7,,0.00,0,1,2,0,0,1,0,3,30,1
"org.apache.jackrabbit.core.query.lucene.AbstractExcerpt",7,0.04,3.43,101,1.43,92580.00,11,4,22,53,10,45.51,66,136,4,1,95.51,0.00,0.00,0.29,3,7.00,9,4299.49,0,5,6,java.lang.Object,0.00,46,0,24,4,46,2,1,26,754,2
"org.apache.jackrabbit.core.query.lucene.AbstractExcerpt$TermPositionVector",8,0.43,1.50,34,0.32,9904.63,9,1,22,13,0,124.09,0,40,0,1,124.09,0.00,0.00,0.62,0,0.00,2,970.58,0,3,0,java.lang.Object,0.00,5,0,12,0,5,5,0,0,233,0
"org.apache.jackrabbit.core.query.lucene.AbstractIndex",24,0.04,3.00,222,2.49,103010.08,40,16,22,93,12,58.44,211,306,2,1,106.55,0.00,0.00,0.10,11,232.00,9,7484.49,0,7,10,java.lang.Object,0.00,69,0,72,2,69,17,0,64,1483,1
"org.apache.jackrabbit.core.query.lucene.AbstractIndex$LoggingPrintStream",3,0.50,1.00,10,0.08,928.25,4,1,22,8,0,133.59,2,17,0,2,133.59,0.00,0.50,0.67,0,1.00,1,239.79,0,0,0,java.io.PrintStream,0.00,5,1,3,0,5,3,0,2,65,3
"org.apache.jackrabbit.core.query.lucene.AbstractIndex$LoggingPrintStream$OutputStream",1,0.00,1.00,2,0.01,41.48,1,0,22,1,0,147.03,0,0,0,1,147.03,0.00,0.00,0.00,0,1.00,1,27.65,0,0,0,java.lang.Object,0.00,0,0,1,0,0,1,0,0,11,0
"org.apache.jackrabbit.core.query.lucene.AbstractIndex$Runnable",1,0.00,3.00,13,0.15,4089.01,1,0,22,6,0,150.75,1,19,0,1,100.75,0.00,0.00,0.00,0,0.00,3,443.58,0,0,0,java.lang.Object,0.00,5,0,3,0,5,1,0,1,87,0
"org.apache.jackrabbit.core.query.lucene.AbstractNamespaceMappings",3,0.50,1.67,12,0.12,2265.88,4,1,6,7,9,93.54,18,22,2,1,125.76,0.00,0.00,0.67,0,1.00,2,363.78,0,2,7,java.lang.Object,0.00,4,0,5,2,4,1,2,9,88,2
"org.apache.jackrabbit.core.query.lucene.AbstractQueryHits",3,0.00,1.67,8,0.06,831.12,3,0,1,4,6,90.42,27,14,5,1,140.42,0.00,0.00,0.00,0,3.00,3,174.03,0,0,1,java.lang.Object,0.00,1,0,5,4,1,3,1,4,48,2
"org.apache.jackrabbit.core.query.lucene.AbstractQueryImpl",9,0.04,1.11,30,0.33,6340.86,15,6,13,22,10,80.75,82,44,6,1,130.75,0.00,0.00,0.13,0,35.00,2,988.97,0,3,5,java.lang.Object,0.00,13,0,10,2,13,6,1,16,234,2
"org.apache.jackrabbit.core.query.lucene.AbstractScoreDocComparator",5,0.12,2.40,41,0.44,28285.23,7,2,7,12,6,65.27,36,51,4,1,107.56,0.00,0.00,0.40,1,7.00,5,1331.91,0,0,2,java.lang.Object,0.00,7,0,12,4,7,5,1,6,286,1
"org.apache.jackrabbit.core.query.lucene.AbstractWeight",3,1.00,2.00,27,0.29,21786.43,4,1,5,7,6,54.84,27,28,4,1,104.84,0.00,0.00,0.33,1,4.00,4,870.41,0,2,2,java.lang.Object,0.00,4,0,6,4,4,1,1,5,177,1
"org.apache.jackrabbit.core.query.lucene.AggregateRule",3,0.00,1.00,4,0.03,214.15,3,0,4,3,7,118.84,37,8,4,1,156.40,0.00,0.00,0.00,0,3.00,1,97.22,0,3,3,,0.00,0,0,3,0,0,0,0,4,33,1
"org.apache.jackrabbit.core.query.lucene.AggregateRuleImpl",8,0.05,3.62,100,1.41,50825.67,14,6,24,48,18,71.12,106,126,1,1,100.50,0.00,0.00,0.12,0,20.00,6,4231.87,0,5,17,java.lang.Object,0.00,40,0,29,0,40,3,1,18,791,0
"org.apache.jackrabbit.core.query.lucene.AggregateRuleImpl$AbstractInclude",3,0.25,4.33,46,0.59,28462.89,5,2,24,16,6,85.12,47,58,0,1,95.47,0.00,0.00,0.67,1,1.00,6,1764.84,0,1,6,java.lang.Object,0.00,13,0,13,0,13,2,0,16,327,2
"org.apache.jackrabbit.core.query.lucene.AggregateRuleImpl$NodeInclude",2,0.00,1.00,7,0.08,2014.11,2,0,24,5,4,81.45,16,10,0,2,129.55,0.00,0.50,0.00,1,2.00,1,240.58,0,1,4,org.apache.jackrabbit.core.query.lucene.AbstractInclude,0.00,3,1,2,0,3,1,0,2,61,2
"org.apache.jackrabbit.core.query.lucene.AggregateRuleImpl$PropertyInclude",2,1.00,2.00,15,0.21,6963.48,3,1,24,13,6,111.66,8,21,0,2,111.43,0.00,0.50,0.50,0,2.00,3,640.75,0,1,6,org.apache.jackrabbit.core.query.lucene.AbstractInclude,0.00,11,1,4,0,11,1,0,1,134,2
"org.apache.jackrabbit.core.query.lucene.CachingIndexReader",7,0.09,4.29,114,1.60,83946.99,18,11,21,47,11,119.91,135,159,4,2,93.63,0.00,0.50,0.17,2,30.00,14,4796.71,2,2,8,org.apache.lucene.index.FilterIndexReader,0.00,40,1,30,0,40,5,0,47,847,0
"org.apache.jackrabbit.core.query.lucene.CachingIndexReader$CacheInitializer",5,0.08,5.00,89,1.20,89155.93,8,3,21,31,4,42.78,50,126,0,1,91.25,0.00,0.00,0.40,2,0.00,13,3612.47,0,0,4,java.lang.Object,0.00,26,0,25,0,26,5,1,20,616,1
"org.apache.jackrabbit.core.query.lucene.CachingIndexReader$CacheInitializer$TermDocsCollector",1,0.00,4.00,12,0.15,4679.64,1,0,21,7,1,141.41,2,16,0,1,101.52,0.00,0.00,0.00,0,0.00,4,446.69,0,0,1,java.lang.Object,0.00,6,0,4,0,6,1,0,2,87,0
"org.apache.jackrabbit.core.query.lucene.CachingIndexReader$CacheInitializer$TermDocsCollector_0",1,0.00,3.00,13,0.15,4928.96,1,0,21,8,1,140.00,2,16,0,1,100.12,0.00,0.00,0.00,0,1.00,3,450.80,0,0,1,java.lang.Object,0.00,7,0,3,0,7,1,0,2,89,0
"org.apache.jackrabbit.core.query.lucene.CachingIndexReader$CacheInitializer$TermDocsCollector_1",1,0.00,3.00,8,0.09,2236.11,1,0,21,6,1,110.68,0,11,0,1,110.68,0.00,0.00,0.00,0,1.00,3,272.40,0,0,1,java.lang.Object,0.00,5,0,3,0,5,1,0,0,59,0
"org.apache.jackrabbit.core.query.lucene.CachingIndexReader$NodeInfo",1,3.00,1.00,7,0.05,645.29,4,3,21,1,1,117.35,0,9,0,1,117.35,0.00,0.00,0.00,0,1.00,1,143.40,0,0,1,java.lang.Object,0.00,0,0,1,0,0,1,0,0,40,3
"org.apache.jackrabbit.core.query.lucene.CachingIndexReader$TermDocsCollector_2",1,0.00,1.00,2,0.01,64.83,1,0,21,1,0,97.40,8,3,0,1,145.50,0.00,0.00,0.00,0,1.00,1,43.22,0,0,0,,0.00,0,0,1,0,0,1,0,1,15,1
"org.apache.jackrabbit.core.query.lucene.CachingMultiIndexReader",11,0.06,2.36,93,1.15,56404.92,16,5,8,39,14,65.61,82,120,5,2,107.90,0.00,0.50,0.25,2,35.00,6,3436.57,1,2,9,org.apache.lucene.index.MultiReader,0.00,28,1,26,0,28,9,2,30,689,2
"org.apache.jackrabbit.core.query.lucene.CachingMultiIndexReader$OffsetReader",1,2.00,1.00,6,0.04,488.07,3,2,8,1,1,83.24,12,8,0,1,120.80,0.00,0.00,0.00,0,1.00,1,128.00,0,0,1,java.lang.Object,0.00,0,0,1,0,0,1,0,3,37,3
"org.apache.jackrabbit.core.query.lucene.CaseTermQuery",2,1.00,1.00,10,0.09,1352.89,3,1,11,3,3,104.77,11,13,2,2,122.64,2.00,0.25,0.00,0,2.00,1,265.13,0,1,1,org.apache.lucene.search.MultiTermQuery,0.00,1,1,2,2,1,1,1,3,67,1
"org.apache.jackrabbit.core.query.lucene.CaseTermQuery$CaseTermEnum",4,0.00,2.75,54,0.90,83601.20,4,0,11,37,3,115.81,15,71,0,2,95.19,0.00,0.50,0.00,0,6.00,8,2698.96,0,0,3,org.apache.lucene.search.FilteredTermEnum,0.00,33,1,11,0,33,4,0,15,440,2
"org.apache.jackrabbit.core.query.lucene.CaseTermQuery$CaseTermEnum$TermEnum",5,0.25,1.40,14,0.10,1314.07,6,1,11,8,0,140.64,1,21,0,1,140.64,0.00,0.00,0.80,1,0.00,2,291.93,0,1,0,java.lang.Object,0.00,3,0,7,0,3,4,0,1,81,0
"org.apache.jackrabbit.core.query.lucene.CaseTermQuery$Lower",1,0.00,1.00,3,0.02,110.15,1,0,11,1,1,137.12,0,5,0,3,137.12,0.00,0.67,0.00,0,0.00,1,52.46,0,0,1,org.apache.jackrabbit.core.query.lucene.CaseTermQuery,0.00,0,2,1,0,0,1,0,0,18,2
"org.apache.jackrabbit.core.query.lucene.CaseTermQuery$Upper",1,0.00,1.00,3,0.02,110.15,1,0,11,1,1,137.12,0,5,0,3,137.12,0.00,0.67,0.00,0,0.00,1,52.46,0,0,1,org.apache.jackrabbit.core.query.lucene.CaseTermQuery,0.00,0,2,1,0,0,1,0,0,18,2
"org.apache.jackrabbit.core.query.lucene.ChainedTermEnumTest",2,0.00,2.50,33,0.51,18813.20,2,0,15,22,1,134.47,4,39,1,2,94.58,0.00,0.50,0.00,1,2.00,3,1528.38,0,1,0,junit.framework.TestCase,0.00,20,1,5,0,20,1,0,2,272,1
"org.apache.jackrabbit.core.query.lucene.ChildAxisQuery",11,0.04,1.64,70,0.76,20258.22,21,10,32,29,23,67.67,116,103,3,2,116.15,0.00,0.50,0.14,1,18.00,6,2268.86,0,6,20,org.apache.lucene.search.Query,0.00,18,1,18,0,18,5,1,32,476,0
"org.apache.jackrabbit.core.query.lucene.ChildAxisQuery$ChildAxisScorer",8,0.04,2.75,71,0.93,51420.80,12,4,32,26,10,74.87,49,103,0,2,107.09,0.00,0.50,0.28,2,14.00,12,2800.56,0,1,10,org.apache.lucene.search.Scorer,0.00,18,1,22,0,18,7,0,22,528,1
"org.apache.jackrabbit.core.query.lucene.ChildAxisQuery$ChildAxisScorer$HitCollector",1,0.00,1.00,3,0.02,233.39,1,0,32,2,0,134.55,0,4,0,1,134.55,0.00,0.00,0.00,0,1.00,1,74.42,0,0,0,java.lang.Object,0.00,1,0,1,0,1,1,0,0,21,0
"org.apache.jackrabbit.core.query.lucene.ChildAxisQuery$ChildAxisScorer$HitCollector_0",1,0.00,4.00,12,0.13,4173.13,2,1,32,6,0,141.80,2,16,0,1,101.92,0.00,0.00,1.00,0,0.00,4,402.24,0,0,0,java.lang.Object,0.00,5,0,4,0,5,1,0,2,86,0
"org.apache.jackrabbit.core.query.lucene.ChildAxisQuery$ChildAxisWeight",7,1.00,1.14,18,0.18,3200.51,8,1,32,13,3,139.03,33,28,0,1,138.79,0.00,0.00,0.14,0,12.00,2,527.64,0,3,3,java.lang.Object,0.00,6,0,8,0,6,4,1,8,132,1
"org.apache.jackrabbit.core.query.lucene.ChildAxisQuery$ChildrenCalculator",3,2.00,1.00,8,0.06,715.65,5,2,32,3,2,98.76,22,11,0,1,141.05,0.00,0.00,0.00,0,3.00,1,180.64,0,1,2,java.lang.Object,0.00,0,0,3,0,0,2,0,5,53,2
"org.apache.jackrabbit.core.query.lucene.ChildAxisQuery$HierarchyResolvingChildrenCalculator",3,0.50,2.67,29,0.33,17813.81,4,1,32,11,4,87.59,16,34,0,2,105.46,0.00,0.50,0.67,0,1.00,6,994.13,0,1,4,org.apache.jackrabbit.core.query.lucene.ChildrenCalculator,0.00,8,1,8,0,8,2,0,5,196,2
"org.apache.jackrabbit.core.query.lucene.ChildAxisQuery$SimpleChildrenCalculator",3,1.00,3.00,38,0.54,27319.86,4,1,32,19,9,67.09,19,47,0,2,99.31,0.00,0.50,0.33,0,5.00,7,1606.78,0,1,9,org.apache.jackrabbit.core.query.lucene.ChildrenCalculator,0.00,16,1,9,0,16,2,0,8,275,2
"org.apache.jackrabbit.core.query.lucene.ChildNodesQueryHits",4,0.22,2.50,31,0.27,7090.84,7,3,4,10,8,65.58,34,44,2,2,113.68,0.00,0.50,0.50,1,0.00,4,811.64,0,1,6,org.apache.jackrabbit.core.query.lucene.AbstractQueryHits,0.29,6,1,10,0,6,3,0,9,182,1
"org.apache.jackrabbit.core.query.lucene.CloseableHits",3,0.00,1.00,4,0.02,82.26,3,0,1,3,0,127.45,19,5,0,1,159.68,0.00,0.00,0.00,0,3.00,1,57.51,0,0,0,,0.00,0,0,3,0,0,3,0,4,23,1
"org.apache.jackrabbit.core.query.lucene.CommittableIndexReader",3,0.00,1.00,10,0.06,658.19,4,1,4,4,3,86.66,24,14,3,2,134.77,0.00,0.50,1.00,0,0.00,1,185.77,1,0,0,org.apache.lucene.index.FilterIndexReader,0.00,1,1,3,0,1,3,0,7,53,0
"org.apache.jackrabbit.core.query.lucene.ConsistencyCheck",6,0.12,5.00,113,1.70,147372.02,11,5,14,51,12,59.85,80,140,3,1,89.23,0.00,0.00,0.30,0,6.00,13,5096.11,0,3,10,java.lang.Object,0.00,45,0,30,0,45,3,0,23,874,1
"org.apache.jackrabbit.core.query.lucene.ConsistencyCheck$MissingAncestor",3,1.00,2.00,19,0.25,8396.74,4,1,14,7,4,154.55,8,27,0,2,114.67,0.00,0.50,0.33,0,4.00,4,749.16,0,0,4,org.apache.jackrabbit.core.query.lucene.ConsistencyCheckError,0.57,4,1,6,0,4,3,0,2,152,1
"org.apache.jackrabbit.core.query.lucene.ConsistencyCheck$MultipleEntries",3,0.00,1.67,15,0.18,4493.62,3,0,14,6,4,140.42,11,22,0,2,119.80,0.00,0.50,0.00,0,4.00,3,538.57,0,0,4,org.apache.jackrabbit.core.query.lucene.ConsistencyCheckError,0.57,3,1,5,0,3,3,0,4,115,1
"org.apache.jackrabbit.core.query.lucene.ConsistencyCheck$NodeDeleted",3,0.00,1.00,8,0.06,546.87,3,0,14,3,2,181.85,8,12,0,2,141.97,0.00,0.50,0.00,0,4.00,1,172.60,0,0,2,org.apache.jackrabbit.core.query.lucene.ConsistencyCheckError,0.57,0,1,3,0,0,3,0,2,50,1
"org.apache.jackrabbit.core.query.lucene.ConsistencyCheck$UnknownParent",3,0.00,1.00,7,0.06,591.07,3,0,14,3,2,181.59,7,11,0,2,141.70,0.00,0.50,0.00,0,4.00,1,174.04,0,0,2,org.apache.jackrabbit.core.query.lucene.ConsistencyCheckError,0.57,0,1,3,0,0,3,0,2,50,1
"org.apache.jackrabbit.core.query.lucene.ConsistencyCheckError",4,0.50,1.00,10,0.06,644.89,6,2,2,4,7,124.52,21,13,6,1,142.39,0.00,0.00,0.12,0,6.00,1,185.83,0,1,1,java.lang.Object,0.00,0,0,4,4,0,3,0,6,57,2
"org.apache.jackrabbit.core.query.lucene.DateField",5,0.12,1.80,34,0.43,14324.50,9,4,1,15,3,72.32,38,44,3,1,114.61,0.00,0.00,0.15,2,7.00,5,1290.31,0,3,0,java.lang.Object,0.00,10,0,9,0,10,2,0,11,275,1
"org.apache.jackrabbit.core.query.lucene.DecimalConvertTest",3,0.00,4.00,75,0.99,51696.59,3,0,6,23,3,105.79,11,74,1,3,85.17,0.00,0.67,0.00,1,3.00,6,2979.81,0,0,2,org.apache.jackrabbit.test.JUnitTest,0.00,20,2,12,0,20,3,0,9,561,1
"org.apache.jackrabbit.core.query.lucene.DecimalField",4,0.00,3.50,52,0.80,51157.70,4,0,2,23,4,59.26,49,65,4,1,96.82,0.00,0.00,0.00,2,4.00,7,2411.17,0,4,0,java.lang.Object,0.00,19,0,14,0,19,0,0,8,452,1
"org.apache.jackrabbit.core.query.lucene.DefaultHTMLExcerpt",1,0.00,1.00,3,0.06,906.92,1,0,2,2,3,100.53,13,10,1,2,129.91,0.00,0.50,0.00,0,1.00,1,181.93,0,1,2,org.apache.jackrabbit.core.query.lucene.AbstractExcerpt,0.00,1,1,1,0,1,0,0,2,41,1
"org.apache.jackrabbit.core.query.lucene.DefaultHighlighter",6,0.00,7.67,194,3.23,642791.62,14,8,13,52,5,45.40,82,269,4,1,74.78,0.00,0.00,0.12,3,10.00,35,9691.09,0,5,1,java.lang.Object,0.00,46,0,46,1,46,1,0,24,1527,1
"org.apache.jackrabbit.core.query.lucene.DefaultHighlighter$FragmentInfo",7,0.27,1.43,35,0.30,5921.32,12,5,13,14,0,121.79,0,46,0,1,121.79,0.00,0.00,0.43,0,0.00,3,889.48,0,1,0,java.lang.Object,0.00,7,0,10,0,7,6,0,0,207,2
"org.apache.jackrabbit.core.query.lucene.DefaultHighlighter$FragmentInfoPositionSorter",1,0.00,3.00,7,0.08,2924.08,1,0,13,2,0,111.93,0,11,0,1,111.93,0.00,0.00,0.00,0,1.00,3,250.84,0,0,0,java.lang.Object,0.00,1,0,3,0,1,1,1,0,58,2
"org.apache.jackrabbit.core.query.lucene.DefaultHighlighter$FragmentInfoScoreSorter",1,0.00,4.00,7,0.10,4963.66,1,0,13,3,0,110.05,0,11,0,1,110.05,0.00,0.00,0.00,0,1.00,4,313.15,0,0,0,java.lang.Object,0.00,2,0,4,0,2,1,1,0,71,2
"org.apache.jackrabbit.core.query.lucene.DefaultHighlighter$TermVectorOffsetInfoSorter",1,0.00,3.00,7,0.08,2924.08,1,0,13,2,0,111.93,0,11,0,1,111.93,0.00,0.00,0.00,0,1.00,3,250.84,0,0,0,java.lang.Object,0.00,1,0,3,0,1,1,1,0,58,2
"org.apache.jackrabbit.core.query.lucene.DefaultQueryHits",3,0.25,1.33,13,0.09,1391.20,5,2,3,7,2,85.19,22,18,0,2,127.48,0.00,0.50,0.33,0,5.00,2,284.65,0,0,2,org.apache.jackrabbit.core.query.lucene.AbstractQueryHits,0.33,4,1,4,0,4,3,0,6,77,1
"org.apache.jackrabbit.core.query.lucene.DefaultRedoLog",10,0.07,1.90,61,0.69,18934.29,18,8,15,34,7,67.54,104,86,3,1,116.02,0.00,0.00,0.19,2,34.00,6,2084.30,0,1,4,java.lang.Object,0.00,24,0,19,0,24,9,1,22,434,0
"org.apache.jackrabbit.core.query.lucene.DefaultRedoLog$ActionCollector",1,0.00,1.00,3,0.02,141.06,1,0,15,1,0,136.28,0,4,0,1,136.28,0.00,0.00,0.00,0,0.00,1,51.02,0,0,0,java.lang.Object,0.00,0,0,1,0,0,1,0,0,16,0
"org.apache.jackrabbit.core.query.lucene.DefaultRedoLog$ActionCollector_0",1,0.00,1.00,3,0.02,165.64,1,0,15,2,0,135.73,0,4,0,1,135.73,0.00,0.00,0.00,0,1.00,1,61.77,0,0,0,java.lang.Object,0.00,1,0,1,0,1,1,0,0,19,0
"org.apache.jackrabbit.core.query.lucene.DefaultRedoLog$ActionCollector_1",1,0.00,1.00,2,0.01,42.34,1,0,15,1,0,196.96,1,3,0,1,146.96,0.00,0.00,0.00,0,1.00,1,30.34,0,0,0,,0.00,0,0,1,0,0,1,0,1,12,0
"org.apache.jackrabbit.core.query.lucene.DefaultRedoLogFactory",1,0.00,1.00,3,0.04,424.58,1,0,1,4,5,153.12,3,5,1,1,132.51,0.00,0.00,0.00,0,1.00,1,107.51,0,1,4,java.lang.Object,0.00,3,0,1,0,3,0,1,1,29,1
"org.apache.jackrabbit.core.query.lucene.DefaultXMLExcerpt",1,0.00,1.00,3,0.05,775.69,1,0,2,2,2,120.09,15,10,0,2,130.45,0.00,0.50,0.00,0,1.00,1,142.89,0,1,2,org.apache.jackrabbit.core.query.lucene.AbstractExcerpt,0.00,1,1,1,0,1,0,0,2,35,1
"org.apache.jackrabbit.core.query.lucene.DerefQuery",5,0.11,1.20,35,0.32,6431.82,12,7,16,11,6,77.39,64,43,3,2,114.95,0.00,0.50,0.23,0,7.00,2,954.34,0,3,3,org.apache.lucene.search.Query,0.00,6,1,6,0,6,2,0,18,221,0
"org.apache.jackrabbit.core.query.lucene.DerefQuery$DerefScorer",7,0.04,2.29,52,0.61,28745.47,11,4,16,28,1,68.54,53,66,0,2,110.83,0.00,0.50,0.29,1,7.00,10,1816.54,0,1,1,org.apache.lucene.search.Scorer,0.00,21,1,16,0,21,6,0,18,347,1
"org.apache.jackrabbit.core.query.lucene.DerefQuery$DerefScorer$HitCollector",1,0.00,1.00,3,0.02,168.11,1,0,16,1,0,135.68,0,4,0,1,135.68,0.00,0.00,0.00,0,0.00,1,63.51,0,0,0,java.lang.Object,0.00,0,0,1,0,0,1,0,0,19,0
"org.apache.jackrabbit.core.query.lucene.DerefQuery$DerefScorer$HitCollector_0",1,0.00,1.00,3,0.02,168.11,1,0,16,2,0,135.68,0,4,0,1,135.68,0.00,0.00,0.00,0,1.00,1,63.51,0,0,0,java.lang.Object,0.00,1,0,1,0,1,1,0,0,19,0
"org.apache.jackrabbit.core.query.lucene.DerefQuery$DerefWeight",7,1.00,1.14,18,0.17,3015.11,8,1,16,13,2,139.23,33,27,0,1,139.00,0.00,0.00,0.14,0,12.00,2,510.33,0,3,2,java.lang.Object,0.00,6,0,8,0,6,4,1,8,129,1
"org.apache.jackrabbit.core.query.lucene.DescendantSelfAxisQuery",12,0.02,1.83,82,0.95,45181.84,18,6,20,41,14,63.68,119,104,5,2,113.68,0.00,0.50,0.15,1,28.00,7,2852.94,0,4,9,org.apache.lucene.search.Query,0.00,29,1,22,0,29,8,1,31,566,0
"org.apache.jackrabbit.core.query.lucene.DescendantSelfAxisQuery$AbstractQueryHits",3,0.00,3.00,25,0.22,6444.86,4,1,20,11,3,110.82,1,38,0,1,110.82,0.00,0.00,1.00,1,0.00,4,668.08,0,1,3,java.lang.Object,0.00,8,0,9,0,8,2,0,1,145,0
"org.apache.jackrabbit.core.query.lucene.DescendantSelfAxisQuery$DescendantSelfAxisScorer",9,0.00,3.11,88,1.02,75221.18,15,6,20,20,2,56.15,73,118,0,2,104.26,0.00,0.50,0.17,2,18.00,11,3046.40,0,1,2,org.apache.lucene.search.Scorer,0.00,11,1,28,0,11,8,0,28,612,1
"org.apache.jackrabbit.core.query.lucene.DescendantSelfAxisQuery$DescendantSelfAxisScorer$HitCollector",1,0.00,1.00,3,0.02,168.11,1,0,20,1,0,135.68,0,4,0,1,135.68,0.00,0.00,0.00,0,0.00,1,63.51,0,0,0,java.lang.Object,0.00,0,0,1,0,0,1,0,0,19,0
"org.apache.jackrabbit.core.query.lucene.DescendantSelfAxisQuery$DescendantSelfAxisWeight",7,1.00,1.00,18,0.16,2655.34,8,1,20,11,2,139.70,34,26,0,1,139.46,0.00,0.00,0.14,0,12.00,1,484.57,0,3,2,java.lang.Object,0.00,4,0,7,0,4,4,1,9,126,1
"org.apache.jackrabbit.core.query.lucene.DocId",7,0.50,1.14,28,0.25,6190.53,9,2,5,12,14,81.18,78,34,12,1,125.31,0.00,0.00,0.07,1,12.00,2,763.24,0,5,2,java.lang.Object,0.00,5,0,8,4,5,2,0,15,190,1
"org.apache.jackrabbit.core.query.lucene.DocId$DocId",3,0.00,1.00,7,0.04,353.76,3,0,5,3,2,125.58,16,11,0,1,143.46,0.00,0.00,0.00,0,4.00,1,124.63,0,1,2,java.lang.Object,0.00,0,0,3,0,0,2,0,3,38,0
"org.apache.jackrabbit.core.query.lucene.DocId$MultiUUIDDocId",5,0.75,1.60,32,0.29,9189.66,6,1,5,11,3,98.29,27,35,0,2,116.16,0.00,0.50,0.40,0,7.00,2,862.88,0,2,3,org.apache.jackrabbit.core.query.lucene.DocId,0.33,6,1,8,0,6,3,0,6,199,3
"org.apache.jackrabbit.core.query.lucene.DocId$PlainDocId",5,0.25,1.20,16,0.13,2202.37,6,1,5,7,2,132.58,22,23,0,2,132.34,0.00,0.50,0.80,0,0.00,2,380.78,0,2,2,org.apache.jackrabbit.core.query.lucene.DocId,0.33,2,1,6,0,2,3,0,6,101,3
"org.apache.jackrabbit.core.query.lucene.DocId$UUIDDocId",5,0.08,1.80,30,0.28,9856.36,8,3,5,9,4,73.60,35,41,0,2,115.89,0.00,0.50,0.27,0,7.00,5,834.35,0,2,4,org.apache.jackrabbit.core.query.lucene.DocId,0.33,4,1,9,0,4,3,0,9,183,3
"org.apache.jackrabbit.core.query.lucene.DocNumberCache",4,0.33,4.00,65,0.87,48298.26,12,8,3,22,6,73.48,57,82,6,1,93.62,0.00,0.00,0.38,0,0.00,6,2608.92,0,0,1,java.lang.Object,0.00,18,0,16,0,18,4,0,18,479,1
"org.apache.jackrabbit.core.query.lucene.DocNumberCache$Entry",1,2.00,1.00,6,0.04,467.31,3,2,3,1,0,88.73,6,8,0,1,120.95,0.00,0.00,0.00,0,1.00,1,121.08,0,0,0,java.lang.Object,0.00,0,0,1,0,0,1,0,2,35,3
"org.apache.jackrabbit.core.query.lucene.DocOrderScoreNodeIterator",9,0.02,1.78,53,0.62,28482.42,14,5,13,32,8,85.01,61,72,1,1,117.23,0.00,0.00,0.22,2,0.00,7,1863.78,0,1,7,java.lang.Object,0.00,23,0,16,0,23,8,1,20,376,0
"org.apache.jackrabbit.core.query.lucene.DocOrderScoreNodeIterator$Comparator<ScoreNode",1,0.00,14.00,59,0.91,109982.73,1,0,13,13,2,64.17,16,70,0,1,64.64,0.00,0.00,0.00,0,0.00,14,2726.72,0,0,2,java.lang.Object,0.00,12,0,14,0,12,1,0,16,438,0
"org.apache.jackrabbit.core.query.lucene.DocOrderScoreNodeIterator$SortFailedException",0,0.00,0.00,1,0.01,72.00,0,0,13,0,0,171.00,0,2,0,2,171.00,0.00,0.50,0.00,0,0.00,0,24.00,0,0,0,java.lang.RuntimeException,0.00,0,1,0,0,0,0,0,0,8,3
"org.apache.jackrabbit.core.query.lucene.DoubleField",3,0.25,2.67,30,0.44,23224.30,5,2,0,14,3,103.08,13,39,3,1,102.85,0.00,0.00,0.33,0,4.00,4,1306.56,0,1,0,java.lang.Object,0.00,11,0,8,0,11,2,0,9,257,1
"org.apache.jackrabbit.core.query.lucene.DynamicPooledExecutor",3,0.00,2.00,19,0.21,3711.70,5,2,4,12,1,67.46,27,29,1,1,117.46,0.00,0.00,0.50,1,1.00,3,622.07,0,0,0,java.lang.Object,0.00,9,0,6,0,9,3,1,7,140,1
"org.apache.jackrabbit.core.query.lucene.EmptyTermDocs",9,1.00,1.00,16,0.09,1099.40,10,1,3,10,3,154.57,6,26,3,1,154.57,0.00,0.00,0.00,0,9.00,1,280.83,0,0,0,java.lang.Object,0.00,1,0,9,0,1,9,1,2,89,0
"org.apache.jackrabbit.core.query.lucene.ExcerptProvider",2,1.00,1.00,4,0.05,442.93,3,1,5,4,9,103.74,25,7,6,1,141.30,0.00,0.00,0.00,0,2.00,1,156.78,0,1,4,,0.00,2,0,2,0,2,1,0,4,43,1
"org.apache.jackrabbit.core.query.lucene.FieldNames",5,0.05,1.00,25,0.43,9770.13,20,15,0,9,53,145.29,99,32,52,1,119.01,0.00,0.00,0.03,0,8.00,1,1297.32,0,2,1,java.lang.Object,0.00,4,0,5,0,4,3,0,21,264,1
"org.apache.jackrabbit.core.query.lucene.FieldSelectors",1,0.00,1.00,6,0.04,827.95,1,0,2,3,10,86.77,6,8,10,1,118.99,0.00,0.00,0.00,0,1.00,1,111.61,0,0,0,java.lang.Object,0.00,2,0,1,0,2,1,0,2,32,1
"org.apache.jackrabbit.core.query.lucene.FieldSelectors$FieldSelector",1,0.00,2.00,6,0.04,694.86,1,0,2,1,1,87.21,6,8,0,1,119.43,0.00,0.00,0.00,0,1.00,2,118.36,0,1,1,java.lang.Object,0.00,0,0,2,0,0,0,0,1,31,0
"org.apache.jackrabbit.core.query.lucene.FieldSelectors$FieldSelector_0",1,0.00,3.00,8,0.06,1379.74,1,0,2,1,1,80.11,6,10,0,1,112.33,0.00,0.00,0.00,0,1.00,3,178.97,0,1,1,java.lang.Object,0.00,0,0,3,0,0,0,0,1,45,0
"org.apache.jackrabbit.core.query.lucene.FileBasedNamespaceMappings",5,0.40,2.20,51,0.63,26205.60,10,5,14,25,4,74.85,66,67,1,2,104.23,0.00,0.50,0.52,2,0.00,4,1883.20,0,2,3,org.apache.jackrabbit.core.query.lucene.AbstractNamespaceMappings,0.00,20,1,11,0,20,3,0,16,376,1
"org.apache.jackrabbit.core.query.lucene.FilterMultiColumnQuery",2,3.00,1.50,12,0.14,3300.22,5,3,5,6,8,72.42,23,20,1,1,116.54,0.00,0.00,0.00,0,2.00,2,414.03,0,0,7,java.lang.Object,0.00,4,0,3,0,4,2,1,6,95,1
"org.apache.jackrabbit.core.query.lucene.FilterMultiColumnQuery$FilterMultiColumnQueryHits",3,0.00,2.00,16,0.18,4675.65,3,0,5,5,1,119.63,0,25,0,1,119.63,0.00,0.00,0.00,1,4.00,3,536.01,1,1,1,java.lang.Object,0.00,2,0,6,0,2,2,0,0,120,0
"org.apache.jackrabbit.core.query.lucene.FilterMultiColumnQueryHits",6,0.20,1.00,14,0.10,1306.45,7,1,2,11,6,141.60,29,21,3,1,141.36,0.00,0.00,0.83,0,0.00,1,298.29,0,2,3,java.lang.Object,0.00,5,0,6,1,5,4,1,8,88,1
"org.apache.jackrabbit.core.query.lucene.ForeignSegmentDocId",6,0.27,1.33,25,0.19,4603.75,9,3,2,7,6,83.47,45,34,5,2,125.76,0.00,0.50,0.11,0,18.00,3,564.51,0,1,2,org.apache.jackrabbit.core.query.lucene.DocId,0.31,1,1,8,0,1,5,0,10,140,1
"org.apache.jackrabbit.core.query.lucene.HierarchyResolver",1,0.00,1.00,2,0.02,121.51,1,0,1,1,18,176.74,20,3,18,1,143.36,0.00,0.00,0.00,0,1.00,1,48.04,0,0,0,,0.00,0,0,1,0,0,1,0,2,17,1
"org.apache.jackrabbit.core.query.lucene.HighlightingExcerptProvider",1,0.00,1.00,2,0.01,78.30,1,0,1,1,2,107.30,12,3,2,2,144.86,0.00,0.50,0.00,0,1.00,1,40.55,0,1,0,,0.00,0,1,1,0,0,0,0,2,15,1
"org.apache.jackrabbit.core.query.lucene.IDField",5,0.50,1.00,18,0.13,1642.13,7,2,4,6,4,133.39,3,24,2,2,133.39,0.00,0.50,0.10,0,8.00,1,383.98,0,3,2,org.apache.lucene.document.AbstractField,0.00,1,1,5,0,1,2,0,1,101,1
"org.apache.jackrabbit.core.query.lucene.IDFieldTest",1,0.00,3.00,19,0.23,9931.90,1,0,3,7,3,112.19,3,18,0,2,91.57,0.00,0.50,0.00,0,1.00,3,686.76,0,0,3,junit.framework.TestCase,0.00,6,1,3,0,6,1,0,1,133,1
"org.apache.jackrabbit.core.query.lucene.IOCounters",2,0.00,2.00,13,0.15,3672.12,3,1,0,7,5,83.89,13,18,4,1,116.11,0.00,0.00,1.00,0,0.00,2,448.24,0,0,1,java.lang.Object,0.00,5,0,4,0,5,2,0,4,101,1
"org.apache.jackrabbit.core.query.lucene.IndexDeletionPolicyImpl",5,0.08,2.80,46,0.57,18834.42,8,3,5,22,1,157.01,7,59,1,1,107.01,0.00,0.00,0.40,2,2.00,7,1721.12,0,0,1,java.lang.Object,0.00,17,0,14,0,17,5,1,5,340,1
"org.apache.jackrabbit.core.query.lucene.IndexFormatVersion",5,0.25,1.40,21,0.23,5345.91,9,4,2,11,18,80.48,55,29,17,1,124.61,0.00,0.00,0.05,1,8.00,3,689.22,0,2,1,java.lang.Object,0.00,6,0,7,0,6,3,0,10,162,1
"org.apache.jackrabbit.core.query.lucene.IndexHistory",5,0.10,4.40,70,1.00,41986.21,10,5,8,35,3,76.86,70,99,1,1,97.00,0.00,0.00,0.28,1,2.00,9,2986.49,0,1,2,java.lang.Object,0.00,30,0,22,0,30,4,0,19,554,0
"org.apache.jackrabbit.core.query.lucene.IndexInfo",5,0.38,1.20,16,0.11,1459.64,7,2,0,6,3,115.87,27,24,3,1,133.75,0.00,0.00,0.20,0,11.00,2,319.65,1,2,0,java.lang.Object,0.00,1,0,6,0,1,3,1,8,90,1
"org.apache.jackrabbit.core.query.lucene.IndexInfos",19,0.02,2.05,143,1.66,62535.84,28,9,18,74,6,69.32,140,186,3,1,111.61,0.00,0.00,0.13,6,113.00,4,4992.27,1,6,3,java.lang.Object,0.00,55,0,39,0,55,13,1,35,986,0
"org.apache.jackrabbit.core.query.lucene.IndexListener",1,0.00,1.00,2,0.01,30.51,1,0,1,1,4,99.60,10,3,4,1,148.08,0.00,0.00,0.00,0,1.00,1,25.51,0,0,0,,0.00,0,0,1,0,0,1,0,2,11,1
"org.apache.jackrabbit.core.query.lucene.IndexMerger",10,0.08,3.10,113,1.47,90357.22,22,12,15,50,4,63.18,129,146,2,1,100.74,0.00,0.00,0.16,1,14.00,13,4420.67,0,0,3,java.lang.Object,0.00,40,0,31,0,40,10,1,52,797,0
"org.apache.jackrabbit.core.query.lucene.IndexMerger$Index",3,0.25,2.00,15,0.15,5434.41,5,2,15,4,0,71.01,24,20,0,1,119.11,0.00,0.00,0.67,0,1.00,4,449.18,0,1,0,java.lang.Object,0.00,1,0,6,0,1,2,1,5,108,3
"org.apache.jackrabbit.core.query.lucene.IndexMerger$IndexBucket",3,0.00,1.00,13,0.11,1836.84,7,4,15,3,0,76.60,28,17,0,2,126.60,0.00,0.50,0.25,0,5.00,1,336.19,0,0,0,java.util.ArrayList,0.00,0,1,3,0,0,3,0,6,87,3
"org.apache.jackrabbit.core.query.lucene.IndexMerger$Merge",1,1.00,1.00,5,0.05,1051.93,2,1,15,2,0,88.91,6,7,0,1,121.13,0.00,0.00,0.00,0,1.00,1,164.30,0,0,0,java.lang.Object,0.00,1,0,1,0,1,1,0,1,44,3
"org.apache.jackrabbit.core.query.lucene.IndexMerger$Worker",6,0.10,2.67,74,0.96,52394.24,10,4,15,26,4,51.38,50,100,0,1,99.48,0.00,0.00,0.33,0,6.00,10,2884.24,0,0,4,java.lang.Object,0.00,20,0,16,0,20,6,2,19,486,1
"org.apache.jackrabbit.core.query.lucene.IndexMigration",1,0.00,5.00,39,0.64,37961.40,2,1,25,31,7,112.25,30,62,2,1,75.22,0.00,0.00,1.00,0,0.00,5,1911.30,0,0,6,java.lang.Object,0.00,30,0,5,0,30,1,0,10,312,1
"org.apache.jackrabbit.core.query.lucene.IndexMigration$MigrationIndexReader",5,0.25,2.40,46,0.73,25992.71,6,1,25,32,2,105.94,1,63,0,2,105.94,0.00,0.50,0.80,1,0.00,4,2187.64,1,3,2,org.apache.lucene.index.FilterIndexReader,0.00,27,1,12,0,27,2,0,1,417,2
"org.apache.jackrabbit.core.query.lucene.IndexMigration$MigrationIndexReader$ChainedTermEnum",5,0.00,2.40,36,0.28,8336.99,6,1,25,14,0,113.90,4,46,0,2,113.90,0.00,0.50,1.00,0,0.00,5,841.68,0,1,0,org.apache.lucene.index.TermEnum,0.00,9,1,12,0,9,4,0,4,195,2
"org.apache.jackrabbit.core.query.lucene.IndexMigration$MigrationIndexReader$Comparator<String>",1,0.00,1.00,5,0.05,1054.02,1,0,25,3,0,121.12,0,6,0,1,121.12,0.00,0.00,0.00,0,0.00,1,155.65,0,0,0,java.lang.Object,0.00,2,0,1,0,2,1,0,0,41,0
"org.apache.jackrabbit.core.query.lucene.IndexMigration$MigrationIndexReader$MigrationTermEnum",3,1.00,1.67,16,0.14,2804.10,4,1,25,8,1,121.42,0,22,0,2,121.42,0.00,0.50,0.33,0,4.00,3,409.86,1,2,1,FilterTermEnum,0.00,5,1,5,0,5,1,0,0,98,2
"org.apache.jackrabbit.core.query.lucene.IndexMigration$MigrationIndexReader$MigrationTermPositions",3,1.00,1.67,17,0.19,4678.09,4,1,25,11,1,119.67,0,23,0,2,119.67,0.00,0.50,0.33,0,4.00,2,584.98,1,0,1,FilterTermPositions,0.00,8,1,5,0,8,3,0,0,134,2
"org.apache.jackrabbit.core.query.lucene.IndexMigrationTest",3,0.50,1.00,21,0.44,12553.00,4,1,11,23,9,150.84,6,29,1,2,110.96,0.00,0.50,0.67,1,1.00,1,1332.15,0,2,8,junit.framework.TestCase,0.00,20,1,3,0,20,1,0,2,258,1
"org.apache.jackrabbit.core.query.lucene.IndexingAggregateTest",5,0.00,2.00,107,1.57,66630.84,5,0,13,38,2,128.92,10,111,1,6,89.04,0.00,0.83,0.00,2,2.00,3,4702.09,2,1,1,org.apache.jackrabbit.core.query.AbstractIndexingTest,0.00,33,5,10,0,33,4,0,7,819,1
"org.apache.jackrabbit.core.query.lucene.IndexingAggregateTest$NodeCreationCallback",1,0.00,2.00,6,0.08,1456.97,1,0,13,5,0,166.90,1,9,0,1,116.90,0.00,0.00,0.00,0,1.00,2,250.76,0,0,0,java.lang.Object,0.00,4,0,2,0,4,1,0,1,53,0
"org.apache.jackrabbit.core.query.lucene.IndexingAggregateTest$NodeCreationCallback_0",1,0.00,1.00,2,0.02,99.33,1,0,13,1,0,144.04,0,3,0,1,144.04,0.00,0.00,0.00,0,1.00,1,49.66,0,0,0,,0.00,0,0,1,0,0,1,0,0,16,2
"org.apache.jackrabbit.core.query.lucene.IndexingConfiguration",8,1.00,1.00,10,0.07,296.14,9,1,5,8,10,108.65,79,11,5,1,158.65,0.00,0.00,0.00,0,8.00,1,216.52,0,2,5,,0.00,0,0,8,0,0,6,0,10,72,1
"org.apache.jackrabbit.core.query.lucene.IndexingConfigurationEntityResolver",1,0.00,3.00,15,0.17,4177.38,2,1,8,5,2,49.89,10,27,2,1,98.36,0.00,0.00,1.00,0,0.00,3,518.92,0,1,0,java.lang.Object,0.00,4,0,3,0,4,0,1,3,115,1
"org.apache.jackrabbit.core.query.lucene.IndexingConfigurationImpl",17,0.01,4.00,244,3.76,219042.75,27,10,46,99,33,47.09,170,314,2,1,95.56,0.00,0.00,0.11,4,127.00,12,11267.98,0,4,31,java.lang.Object,0.00,82,0,68,0,82,13,2,47,1905,1
"org.apache.jackrabbit.core.query.lucene.IndexingConfigurationImpl$IndexingRule",12,0.07,1.67,61,0.64,12755.78,17,5,46,27,5,72.87,105,82,0,1,120.98,0.00,0.00,0.13,1,64.00,5,1906.58,0,2,5,java.lang.Object,0.00,15,0,20,0,15,10,0,20,432,1
"org.apache.jackrabbit.core.query.lucene.IndexingConfigurationImpl$NamePattern",3,0.25,1.67,20,0.23,6674.96,5,2,46,11,5,65.50,29,29,0,1,115.50,0.00,0.00,0.33,0,5.00,3,701.82,0,0,5,java.lang.Object,0.00,8,0,5,0,8,3,0,8,146,3
"org.apache.jackrabbit.core.query.lucene.IndexingConfigurationImpl$PathExpression",2,0.78,8.50,53,0.72,43734.57,11,9,46,16,6,41.26,14,75,0,1,83.55,0.00,0.00,0.50,0,2.00,16,2162.92,0,0,6,java.lang.Object,0.00,14,0,17,0,14,2,0,6,387,1
"org.apache.jackrabbit.core.query.lucene.IndexingConfigurationImpl$PathExpression$AbstractIteratorDecorator",1,0.00,2.00,8,0.10,2622.23,1,0,46,4,2,110.23,0,13,0,1,110.23,0.00,0.00,0.00,0,0.00,2,299.27,1,1,2,java.lang.Object,0.00,3,0,2,0,3,0,0,0,67,0
"org.apache.jackrabbit.core.query.lucene.IndexingConfigurationImpl$PathExpression$Iterator",3,0.50,1.67,15,0.14,4023.53,4,1,46,6,2,120.18,0,22,0,1,120.18,0.00,0.00,0.67,0,1.00,3,417.74,0,1,2,java.lang.Object,0.00,3,0,5,0,3,2,0,0,101,0
"org.apache.jackrabbit.core.query.lucene.IndexingConfigurationImpl$PropertyConfig",1,3.00,1.00,8,0.05,744.82,4,3,46,1,0,70.57,11,12,0,1,114.70,0.00,0.00,0.00,0,1.00,1,162.52,0,0,0,java.lang.Object,0.00,0,0,1,0,0,1,0,3,46,1
"org.apache.jackrabbit.core.query.lucene.IndexingConfigurationImplTest",7,0.08,1.00,49,0.73,15365.30,9,2,16,39,10,163.16,8,62,1,5,113.16,0.00,0.80,0.57,2,0.00,1,2185.58,2,2,9,org.apache.jackrabbit.core.query.AbstractQueryTest,0.11,32,4,7,0,32,5,0,6,430,1
"org.apache.jackrabbit.core.query.lucene.IndexingQueue",8,0.25,2.38,68,0.87,27081.43,12,4,13,44,12,61.21,67,98,6,1,109.32,0.00,0.00,0.47,1,0.00,6,2603.56,0,3,7,java.lang.Object,0.00,36,0,19,0,36,5,0,18,504,0
"org.apache.jackrabbit.core.query.lucene.IndexingQueueStore",6,0.23,2.33,43,0.55,18496.51,13,7,10,25,4,61.81,59,61,3,1,111.81,0.00,0.00,0.33,1,0.00,6,1663.36,0,1,1,java.lang.Object,0.00,19,0,14,0,19,5,0,17,331,0
"org.apache.jackrabbit.core.query.lucene.IndexingQueueTest",5,0.08,2.20,99,1.42,44486.40,8,3,14,44,8,92.25,21,109,1,6,92.02,0.00,0.83,0.40,2,0.00,4,4274.96,1,0,7,org.apache.jackrabbit.core.query.AbstractIndexingTest,0.00,39,5,11,0,39,5,0,15,727,1
"org.apache.jackrabbit.core.query.lucene.IndexingQueueTest$FilenameFilter",1,0.00,1.00,3,0.02,217.60,1,0,14,2,0,134.79,0,4,0,1,134.79,0.00,0.00,0.00,0,1.00,1,68.92,0,0,0,java.lang.Object,0.00,1,0,1,0,1,1,0,0,20,0
"org.apache.jackrabbit.core.query.lucene.IndexingQueueTest$Runnable",1,0.00,2.00,5,0.04,649.19,1,0,14,3,0,122.62,0,8,0,1,122.62,0.00,0.00,0.00,0,1.00,2,122.69,0,0,0,java.lang.Object,0.00,2,0,2,0,2,1,0,0,31,0
"org.apache.jackrabbit.core.query.lucene.JackrabbitAnalyzer",4,0.17,2.00,19,0.21,5020.84,6,2,5,8,4,91.76,27,30,3,2,123.98,0.00,0.50,0.62,0,0.00,3,618.50,0,2,1,org.apache.lucene.analysis.Analyzer,0.00,4,1,8,0,4,2,0,6,145,1
"org.apache.jackrabbit.core.query.lucene.JackrabbitIndexReader",7,0.08,1.29,23,0.22,4396.84,9,2,4,13,5,98.89,47,35,1,2,131.11,0.00,0.50,0.43,0,0.00,3,647.64,0,2,4,org.apache.lucene.index.FilterIndexReader,0.00,6,1,9,0,6,5,2,13,165,2
"org.apache.jackrabbit.core.query.lucene.JackrabbitIndexSearcher",7,0.17,1.57,33,0.36,8950.89,10,3,10,16,20,75.87,56,57,11,2,123.97,0.00,0.50,0.19,1,18.00,4,1077.42,1,2,11,org.apache.lucene.search.IndexSearcher,0.00,9,1,11,0,9,5,1,14,242,1
"org.apache.jackrabbit.core.query.lucene.JackrabbitParser",8,0.10,3.00,93,1.36,66916.91,11,3,25,35,3,68.79,49,131,3,1,101.01,0.00,0.00,0.25,2,28.00,14,4069.92,0,1,0,java.lang.Object,0.00,27,0,24,0,27,7,1,12,705,0
"org.apache.jackrabbit.core.query.lucene.JackrabbitQuery",1,0.00,1.00,2,0.02,108.21,1,0,4,1,7,191.02,23,6,5,1,143.75,0.00,0.00,0.00,0,1.00,1,56.11,0,0,3,,0.00,0,0,1,0,0,1,0,2,17,1
"org.apache.jackrabbit.core.query.lucene.JackrabbitQueryParser",7,1.00,4.29,94,1.12,71051.03,8,1,7,29,5,55.27,51,119,2,2,97.56,0.00,0.50,0.14,3,12.00,10,3360.56,2,6,3,org.apache.lucene.queryParser.QueryParser,0.00,22,1,30,0,22,1,0,16,649,1
"org.apache.jackrabbit.core.query.lucene.JackrabbitTermQuery",2,1.00,1.00,7,0.06,950.69,3,1,9,3,8,152.74,7,10,8,2,132.12,0.00,0.50,0.00,0,2.00,1,193.97,1,1,0,org.apache.lucene.search.TermQuery,0.00,1,1,2,0,1,1,0,2,51,1
"org.apache.jackrabbit.core.query.lucene.JackrabbitTermQuery$JackrabbitTermWeight",7,0.17,1.00,18,0.15,1923.03,9,2,9,12,2,161.18,21,27,0,2,140.57,0.00,0.50,0.36,0,0.00,1,447.93,0,3,2,org.apache.jackrabbit.core.query.lucene.AbstractWeight,0.00,5,1,7,0,5,4,0,7,122,1
"org.apache.jackrabbit.core.query.lucene.JoinQuery",2,0.67,1.00,18,0.22,4259.46,8,6,6,5,11,118.33,34,31,1,1,109.19,0.00,0.00,0.50,0,2.00,1,671.79,0,0,10,java.lang.Object,0.00,3,0,2,0,3,2,1,9,149,1
"org.apache.jackrabbit.core.query.lucene.LazyTextExtractorField",8,0.19,1.50,27,0.29,4941.88,11,3,16,15,4,98.91,55,47,2,2,131.13,0.00,0.50,0.17,0,14.00,3,859.24,0,3,2,org.apache.lucene.document.AbstractField,0.00,7,1,12,0,7,5,0,13,196,1
"org.apache.jackrabbit.core.query.lucene.LazyTextExtractorField$ParsingTask",4,0.13,1.75,27,0.33,7168.55,9,5,16,15,1,116.23,0,47,0,2,116.23,0.00,0.50,0.30,1,4.00,3,992.34,0,0,1,org.xml.sax.helpers.DefaultHandler,0.00,11,1,7,0,11,4,1,0,215,1
"org.apache.jackrabbit.core.query.lucene.LengthSortComparator",2,0.50,1.50,11,0.13,2501.28,4,2,8,7,7,72.34,17,19,2,1,120.44,0.00,0.00,0.25,0,2.00,2,396.61,0,1,5,java.lang.Object,0.00,5,0,3,0,5,1,1,3,88,1
"org.apache.jackrabbit.core.query.lucene.LengthSortComparator$Comparator",2,0.00,1.50,15,0.21,5473.36,3,1,8,7,4,162.32,3,19,0,2,112.32,0.00,0.50,1.00,0,0.00,2,630.48,1,1,4,org.apache.jackrabbit.core.query.lucene.AbstractScoreDocComparator,0.00,5,1,3,0,5,1,0,1,130,2
"org.apache.jackrabbit.core.query.lucene.LocalNameQuery",4,0.17,1.25,14,0.13,2196.73,6,2,5,9,3,99.35,25,20,0,2,131.58,0.00,0.50,0.38,0,4.00,2,403.93,0,2,3,org.apache.lucene.search.Query,0.00,5,1,5,0,5,2,0,7,100,1
"org.apache.jackrabbit.core.query.lucene.LocalNameRangeQuery",3,0.00,1.67,17,0.14,3618.12,3,0,1,4,2,72.44,24,25,0,3,120.54,0.00,0.67,0.00,1,3.00,2,405.77,0,2,2,org.apache.jackrabbit.core.query.lucene.RangeQuery,0.00,1,2,5,0,1,1,0,4,98,1
"org.apache.jackrabbit.core.query.lucene.LongField",3,1.00,2.67,28,0.37,21108.14,4,1,0,12,4,105.12,14,38,4,1,104.88,0.00,0.00,0.33,0,4.00,4,1112.35,0,1,0,java.lang.Object,0.00,9,0,8,0,9,2,0,13,226,1
"org.apache.jackrabbit.core.query.lucene.LowerCaseSortComparator",2,0.50,1.00,8,0.08,1259.07,4,2,6,4,1,84.21,15,13,1,1,126.50,0.00,0.00,0.25,0,2.00,1,248.32,0,1,0,java.lang.Object,0.00,2,0,2,0,2,1,1,4,63,1
"org.apache.jackrabbit.core.query.lucene.LowerCaseSortComparator$Comparator",4,1.00,1.25,14,0.12,2154.60,5,1,6,8,1,131.64,3,20,0,1,131.64,0.00,0.00,0.25,1,6.00,2,346.90,0,1,1,java.lang.Object,0.00,4,0,5,0,4,3,1,1,92,3
"org.apache.jackrabbit.core.query.lucene.LuceneQueryBuilder",19,0.09,8.63,569,10.72,1515674.95,33,14,56,153,61,39.79,228,792,2,1,77.35,0.00,0.00,0.15,0,57.00,61,32159.65,0,18,59,java.lang.Object,0.00,134,0,164,0,134,1,1,137,4863,1
"org.apache.jackrabbit.core.query.lucene.LuceneQueryBuilder$DefaultQueryNodeVisitor",1,0.00,3.00,7,0.09,2263.54,1,0,56,3,2,112.81,0,9,0,1,112.81,0.00,0.00,0.00,0,1.00,3,260.17,0,1,2,java.lang.Object,0.00,2,0,3,0,2,0,0,0,59,0
"org.apache.jackrabbit.core.query.lucene.LuceneQueryFactory",5,0.00,1.00,6,0.05,297.29,5,0,7,5,13,114.74,39,7,7,1,157.03,0.00,0.00,0.00,0,5.00,1,150.65,0,3,6,,0.00,0,0,5,0,0,2,0,6,49,1
"org.apache.jackrabbit.core.query.lucene.LuceneQueryFactoryImpl",6,0.10,3.50,93,1.49,81718.93,14,8,32,58,25,45.81,63,132,1,1,94.29,0.00,0.00,0.21,1,6.00,9,4480.53,0,5,24,java.lang.Object,0.00,52,0,21,0,52,1,1,24,778,1
"org.apache.jackrabbit.core.query.lucene.LuceneQueryFactoryImpl$DefaultQOMTreeVisitor",2,0.00,1.00,5,0.06,686.72,2,0,32,5,3,139.80,0,8,0,1,139.80,0.00,0.00,0.00,0,2.00,1,165.31,0,2,3,java.lang.Object,0.00,3,0,2,0,3,0,0,0,44,0
"org.apache.jackrabbit.core.query.lucene.LuceneQueryHits",5,0.25,1.60,20,0.22,4251.99,7,2,6,15,6,125.60,24,33,1,1,125.36,0.00,0.00,0.30,1,7.00,3,669.11,0,0,5,java.lang.Object,0.00,10,0,8,0,10,5,1,8,157,1
"org.apache.jackrabbit.core.query.lucene.MatchAllDocsQuery",1,0.00,3.00,8,0.11,2371.32,1,0,4,5,9,68.19,7,18,3,2,110.48,0.00,0.50,0.00,0,1.00,3,326.99,0,1,6,org.apache.lucene.search.MatchAllDocsQuery,0.00,4,1,3,0,4,0,1,2,69,1
"org.apache.jackrabbit.core.query.lucene.MatchAllQuery",4,1.00,1.25,11,0.09,1304.15,5,1,4,7,2,107.71,26,17,1,2,139.93,0.00,0.50,0.25,0,6.00,2,260.16,0,2,1,org.apache.lucene.search.Query,0.00,3,1,5,0,3,2,0,5,71,0
"org.apache.jackrabbit.core.query.lucene.MatchAllScorer",8,0.03,1.62,52,0.66,30865.36,13,5,12,31,4,71.33,58,75,2,2,113.62,0.00,0.50,0.22,3,24.00,5,1980.47,0,1,2,org.apache.lucene.search.Scorer,0.00,23,1,13,0,23,7,0,19,392,0
"org.apache.jackrabbit.core.query.lucene.MatchAllWeight",7,0.03,1.00,25,0.23,3450.88,12,5,7,14,3,89.71,49,34,1,2,132.00,0.00,0.50,0.23,0,24.00,1,685.25,0,3,2,org.apache.jackrabbit.core.query.lucene.AbstractWeight,0.00,7,1,7,0,7,4,0,18,174,0
"org.apache.jackrabbit.core.query.lucene.MoreLikeThis",39,0.00,1.82,249,3.02,133599.69,61,22,28,88,2,69.87,429,309,1,1,114.00,0.00,0.00,0.05,6,698.00,8,9069.54,0,16,1,java.lang.Object,0.00,49,0,71,0,49,23,0,88,1772,2
"org.apache.jackrabbit.core.query.lucene.MoreLikeThis$FreqQ",2,0.00,1.00,9,0.10,2686.20,2,0,28,4,0,123.91,0,12,0,2,123.91,0.00,0.50,0.00,0,2.00,1,293.69,0,0,0,org.apache.lucene.util.PriorityQueue,0.00,2,1,2,0,2,2,0,0,73,2
"org.apache.jackrabbit.core.query.lucene.MoreLikeThis$Int",1,0.00,1.00,4,0.02,114.30,2,1,28,1,0,132.34,0,6,0,1,132.34,0.00,0.00,1.00,0,0.00,1,49.65,0,0,0,java.lang.Object,0.00,0,0,1,0,0,1,0,0,17,2
"org.apache.jackrabbit.core.query.lucene.MultiColumnQuery",1,0.00,1.00,2,0.02,145.26,1,0,1,1,11,113.36,13,6,8,1,142.74,0.00,0.00,0.00,0,1.00,1,61.30,0,0,3,,0.00,0,0,1,0,0,1,0,2,18,1
"org.apache.jackrabbit.core.query.lucene.MultiColumnQueryAdapter",3,0.25,1.33,16,0.18,4587.82,5,2,5,7,7,71.68,26,21,2,1,119.78,0.00,0.00,0.33,0,4.00,2,528.03,0,1,5,java.lang.Object,0.00,4,0,4,0,4,2,1,6,120,1
"org.apache.jackrabbit.core.query.lucene.MultiColumnQueryHits",2,0.00,1.00,3,0.02,92.91,2,0,2,2,25,109.77,16,4,23,2,157.87,0.00,0.50,0.00,0,2.00,1,49.36,0,2,2,,0.00,0,1,2,0,0,0,0,3,19,1
"org.apache.jackrabbit.core.query.lucene.MultiColumnQueryResult",3,0.25,1.33,12,0.19,3599.88,5,2,5,7,12,92.01,18,25,1,2,124.23,0.00,0.50,0.33,0,5.00,2,556.78,1,1,11,org.apache.jackrabbit.core.query.lucene.QueryResultImpl,0.27,4,1,4,0,4,2,0,7,119,1
"org.apache.jackrabbit.core.query.lucene.MultiIndex",41,0.06,3.17,499,6.58,258107.58,70,29,33,222,44,63.00,515,692,17,1,100.56,0.00,0.00,0.10,17,483.00,9,19745.98,0,12,33,java.lang.Object,0.00,181,0,130,0,181,29,0,161,3474,1
"org.apache.jackrabbit.core.query.lucene.MultiIndex$Action",7,0.04,2.71,66,0.97,59485.37,27,20,33,21,1,93.88,107,78,0,1,104.23,0.00,0.00,0.01,0,17.00,13,2900.18,0,2,1,java.lang.Object,0.00,14,0,19,0,14,5,0,28,527,3
"org.apache.jackrabbit.core.query.lucene.MultiIndex$AddIndex",4,0.67,1.25,20,0.22,4555.28,5,1,33,16,2,78.52,29,26,0,2,120.81,0.00,0.50,0.50,0,4.00,2,653.13,0,2,2,org.apache.jackrabbit.core.query.lucene.Action,0.00,12,1,5,0,12,2,0,6,156,2
"org.apache.jackrabbit.core.query.lucene.MultiIndex$AddNode",5,0.08,1.60,27,0.35,8238.83,8,3,33,19,3,71.38,40,39,0,2,119.49,0.00,0.50,0.27,0,7.00,4,1049.13,0,2,3,org.apache.jackrabbit.core.query.lucene.Action,0.00,14,1,8,0,14,3,0,9,236,2
"org.apache.jackrabbit.core.query.lucene.MultiIndex$Commit",4,0.00,1.00,9,0.09,930.52,4,0,33,8,1,123.26,21,14,0,2,141.13,0.00,0.50,0.00,0,4.00,1,258.76,0,2,1,org.apache.jackrabbit.core.query.lucene.Action,0.00,4,1,4,0,4,2,0,4,72,2
"org.apache.jackrabbit.core.query.lucene.MultiIndex$CreateIndex",6,0.40,1.17,25,0.23,4219.21,7,1,33,17,2,93.86,38,33,0,2,126.09,0.00,0.50,0.67,0,0.00,2,688.76,0,3,2,org.apache.jackrabbit.core.query.lucene.Action,0.00,11,1,7,0,11,3,0,8,172,2
"org.apache.jackrabbit.core.query.lucene.MultiIndex$DeleteIndex",4,0.67,1.50,22,0.20,4070.81,5,1,33,14,1,78.86,28,28,0,2,121.15,0.00,0.50,0.50,0,4.00,3,597.00,0,2,1,org.apache.jackrabbit.core.query.lucene.Action,0.00,10,1,6,0,10,2,0,6,145,2
"org.apache.jackrabbit.core.query.lucene.MultiIndex$DeleteNode",4,0.17,2.25,34,0.46,16217.49,6,2,33,24,5,60.61,35,43,0,2,108.71,0.00,0.50,0.38,0,4.00,6,1381.59,0,2,5,org.apache.jackrabbit.core.query.lucene.Action,0.00,20,1,9,0,20,2,0,11,279,2
"org.apache.jackrabbit.core.query.lucene.MultiIndex$Start",4,0.00,1.00,9,0.08,897.29,4,0,33,7,1,123.39,21,14,0,2,141.26,0.00,0.50,0.00,0,4.00,1,249.35,0,2,1,org.apache.jackrabbit.core.query.lucene.Action,0.00,3,1,4,0,3,2,0,4,70,2
"org.apache.jackrabbit.core.query.lucene.MultiIndex$Timer.Task",1,0.00,1.00,4,0.02,107.10,1,0,33,3,0,172.44,2,5,0,1,132.56,0.00,0.00,0.00,0,1.00,1,53.55,0,0,0,java.lang.Object,0.00,2,0,1,0,2,1,0,2,18,0
"org.apache.jackrabbit.core.query.lucene.MultiIndex$VolatileCommit",4,0.67,1.00,20,0.19,3565.26,5,1,33,14,3,89.47,26,25,0,2,121.70,0.00,0.50,0.50,0,4.00,1,574.63,0,2,3,org.apache.jackrabbit.core.query.lucene.Action,0.00,10,1,4,0,10,2,0,5,141,2
"org.apache.jackrabbit.core.query.lucene.MultiIndexReader",3,0.00,1.00,4,0.03,125.60,3,0,3,3,12,110.12,25,5,11,2,158.23,0.00,0.50,0.00,0,3.00,1,77.70,0,2,2,,0.00,0,1,3,0,0,1,0,4,28,1
"org.apache.jackrabbit.core.query.lucene.MultiScorer",7,0.38,2.29,49,0.48,25055.01,11,4,4,12,1,63.20,56,64,1,2,111.30,0.00,0.50,0.57,1,0.00,5,1432.10,0,1,0,org.apache.lucene.search.Scorer,0.00,5,1,16,0,5,6,0,21,318,0
"org.apache.jackrabbit.core.query.lucene.NSRegistryBasedNamespaceMappings",3,0.50,1.67,13,0.14,3648.06,4,1,2,8,3,91.91,19,23,1,2,124.13,0.00,0.50,0.67,0,1.00,2,429.64,0,2,2,org.apache.jackrabbit.core.query.lucene.AbstractNamespaceMappings,0.00,5,1,5,0,5,1,0,6,100,1
"org.apache.jackrabbit.core.query.lucene.NamePathResolverImpl",2,0.50,1.00,10,0.12,1948.29,4,2,14,7,19,121.63,9,13,5,2,121.39,0.00,0.50,0.25,0,2.00,1,348.86,0,1,14,org.apache.jackrabbit.spi.commons.conversion.DefaultNamePathResolver,0.00,5,1,2,0,5,1,0,3,82,1
"org.apache.jackrabbit.core.query.lucene.NamePathResolverImpl$NameResolverImpl",3,0.50,1.33,12,0.13,3087.74,4,1,14,8,4,74.75,28,17,0,1,124.75,0.00,0.00,0.67,0,1.00,2,403.98,0,2,4,java.lang.Object,0.00,5,0,4,0,5,1,1,5,96,2
"org.apache.jackrabbit.core.query.lucene.NameQuery",5,0.00,1.40,23,0.30,8635.93,8,3,9,16,13,90.75,33,38,6,2,122.97,0.00,0.50,0.33,0,2.00,3,907.39,0,3,7,org.apache.lucene.search.Query,0.00,11,1,7,0,11,2,0,11,193,1
"org.apache.jackrabbit.core.query.lucene.NameRangeQuery",8,0.20,2.75,65,0.83,27487.23,13,5,9,30,7,66.94,56,92,0,2,109.23,0.00,0.50,0.38,2,0.00,5,2501.33,0,7,7,org.apache.lucene.search.Query,0.00,22,1,22,0,22,1,0,15,515,1
"org.apache.jackrabbit.core.query.lucene.NamespaceMappings",2,0.00,1.00,3,0.02,108.19,2,0,4,2,26,108.87,20,4,22,2,157.35,0.00,0.50,0.00,0,2.00,1,66.09,0,2,4,,0.00,0,1,2,0,0,0,0,3,23,1
"org.apache.jackrabbit.core.query.lucene.NodeIndexer",39,0.01,2.77,284,4.49,180993.20,52,13,31,112,27,61.89,399,468,1,1,110.37,0.00,0.00,0.09,23,693.00,28,13481.31,0,7,26,java.lang.Object,0.00,73,0,108,0,73,32,0,85,2524,1
"org.apache.jackrabbit.core.query.lucene.NodeIteratorImpl",10,0.02,1.60,53,0.42,8042.09,17,7,10,20,6,79.65,74,73,1,1,121.94,0.00,0.00,0.16,3,42.00,2,1255.39,0,2,5,java.lang.Object,0.00,10,0,16,0,10,8,1,19,297,0
"org.apache.jackrabbit.core.query.lucene.NodeIteratorImpl$FetchNext",1,0.00,3.00,11,0.15,4741.21,1,0,10,4,5,142.84,2,18,0,1,102.95,0.00,0.00,0.00,0,0.00,3,459.61,0,1,5,java.lang.Object,0.00,3,0,3,0,3,0,1,2,90,1
"org.apache.jackrabbit.core.query.lucene.NodeTraversingQueryHits",3,0.50,1.67,15,0.15,2775.03,4,1,10,8,6,71.45,29,23,3,2,121.45,0.00,0.50,0.67,0,1.00,2,446.78,0,1,3,org.apache.jackrabbit.core.query.lucene.AbstractQueryHits,0.00,5,1,5,0,5,2,0,6,106,1
"org.apache.jackrabbit.core.query.lucene.NodeTraversingQueryHits$TraversingNodeIterator",5,0.08,2.40,34,0.36,12123.83,8,3,10,17,0,82.90,33,47,0,1,115.12,0.00,0.00,0.40,1,1.00,7,1080.88,0,1,0,java.lang.Object,0.00,12,0,12,0,12,4,1,12,228,1
"org.apache.jackrabbit.core.query.lucene.NotQuery",5,0.38,1.20,19,0.14,2558.77,7,2,9,9,3,89.54,35,26,3,2,131.83,0.00,0.50,0.20,0,7.00,2,417.85,0,3,0,org.apache.lucene.search.Query,0.00,4,1,6,0,4,2,0,10,110,0
"org.apache.jackrabbit.core.query.lucene.NotQuery$NotQueryScorer",6,0.00,2.00,35,0.32,15909.81,9,3,9,10,0,99.94,31,48,0,2,117.81,0.00,0.50,0.33,1,6.00,5,969.11,0,1,0,org.apache.lucene.search.Scorer,0.00,4,1,12,0,4,5,0,12,221,1
"org.apache.jackrabbit.core.query.lucene.NotQuery$NotQueryWeight",7,1.00,1.00,16,0.12,1428.89,8,1,9,10,1,162.20,25,24,0,1,141.58,0.00,0.00,0.14,0,12.00,1,362.03,0,3,1,java.lang.Object,0.00,3,0,7,0,3,4,1,8,101,1
"org.apache.jackrabbit.core.query.lucene.OffsetCharSequence",8,0.14,2.00,53,0.53,17562.25,11,3,0,21,5,83.28,53,61,4,1,115.50,0.00,0.00,0.46,2,2.00,4,1586.48,0,2,1,java.lang.Object,0.00,13,0,16,0,13,6,3,14,356,1
"org.apache.jackrabbit.core.query.lucene.Ordering",4,0.33,1.25,17,0.17,4280.88,6,2,15,8,22,82.34,31,27,9,1,124.63,0.00,0.00,0.25,0,8.00,2,511.10,0,3,13,java.lang.Object,0.00,4,0,5,0,4,1,0,7,117,1
"org.apache.jackrabbit.core.query.lucene.Ordering$DefaultTraversingQOMTreeVisitor",8,0.00,1.00,27,0.54,11183.93,8,0,15,28,13,128.43,0,50,0,1,128.43,0.00,0.00,0.00,0,0.00,1,1619.97,0,8,13,java.lang.Object,0.00,20,0,8,0,20,0,0,0,342,0
"org.apache.jackrabbit.core.query.lucene.ParentAxisQuery",5,0.10,1.20,31,0.27,5211.12,10,5,16,12,8,74.04,55,39,3,2,118.17,0.00,0.50,0.28,0,2.00,2,816.83,0,3,5,org.apache.lucene.search.Query,0.00,7,1,6,0,7,2,0,15,195,0
"org.apache.jackrabbit.core.query.lucene.ParentAxisQuery$ParentAxisScorer",7,0.10,2.00,51,0.58,23948.06,14,7,16,21,4,63.38,56,66,0,2,111.49,0.00,0.50,0.22,1,0.00,7,1733.01,0,1,4,org.apache.lucene.search.Scorer,0.00,14,1,14,0,14,6,0,17,350,1
"org.apache.jackrabbit.core.query.lucene.ParentAxisQuery$ParentAxisScorer$HitCollector",1,0.00,8.00,20,0.21,9799.40,2,1,16,1,0,140.56,1,26,0,1,90.56,0.00,0.00,1.00,0,0.00,8,624.93,0,0,0,java.lang.Object,0.00,0,0,8,0,0,1,0,1,125,0
"org.apache.jackrabbit.core.query.lucene.ParentAxisQuery$ParentAxisWeight",7,1.00,1.00,17,0.14,2128.10,8,1,16,11,2,140.45,33,26,0,1,140.22,0.00,0.00,0.14,0,12.00,1,429.11,0,3,2,java.lang.Object,0.00,4,0,7,0,4,4,1,8,115,1
"org.apache.jackrabbit.core.query.lucene.PerQueryCache",5,0.12,1.20,17,0.17,4035.34,7,2,2,13,7,82.16,43,24,7,1,130.27,0.00,0.00,0.40,0,9.00,2,519.65,0,3,0,java.lang.Object,0.00,8,0,6,0,8,2,0,9,133,0
"org.apache.jackrabbit.core.query.lucene.PerQueryCache$Key",3,0.25,1.33,13,0.12,2678.31,5,2,2,6,0,93.02,18,18,0,1,125.24,0.00,0.00,0.67,0,1.00,2,353.55,0,0,0,java.lang.Object,0.00,3,0,4,0,3,3,0,5,92,3
"org.apache.jackrabbit.core.query.lucene.PersistentIndex",11,0.15,1.36,56,0.58,16350.48,15,4,10,30,15,77.58,87,82,9,2,119.88,0.00,0.50,0.11,1,52.00,3,1751.68,5,2,8,org.apache.jackrabbit.core.query.lucene.AbstractIndex,0.06,19,1,15,0,19,9,0,19,370,0
"org.apache.jackrabbit.core.query.lucene.PredicateDerefQuery",5,0.11,1.20,35,0.32,6678.71,12,7,16,11,6,77.26,64,43,3,2,114.82,0.00,0.50,0.23,0,7.00,2,958.80,0,3,3,org.apache.lucene.search.Query,0.00,6,1,6,0,6,2,0,18,222,1
"org.apache.jackrabbit.core.query.lucene.PredicateDerefQuery$DerefScorer",7,0.07,2.29,53,0.64,29024.29,12,5,16,27,1,68.51,53,69,0,2,110.80,0.00,0.50,0.26,1,7.00,10,1915.58,0,1,1,org.apache.lucene.search.Scorer,0.00,20,1,16,0,20,6,0,18,372,1
"org.apache.jackrabbit.core.query.lucene.PredicateDerefQuery$DerefScorer$HitCollector",1,0.00,1.00,3,0.02,168.11,1,0,16,1,0,135.68,0,4,0,1,135.68,0.00,0.00,0.00,0,0.00,1,63.51,0,0,0,java.lang.Object,0.00,0,0,1,0,0,1,0,0,19,0
"org.apache.jackrabbit.core.query.lucene.PredicateDerefQuery$DerefScorer$HitCollector_0",1,0.00,1.00,3,0.02,168.11,1,0,16,2,0,135.68,0,4,0,1,135.68,0.00,0.00,0.00,0,1.00,1,63.51,0,0,0,java.lang.Object,0.00,1,0,1,0,1,1,0,0,19,0
"org.apache.jackrabbit.core.query.lucene.PredicateDerefQuery$DerefWeight",7,1.00,1.14,18,0.17,3015.11,8,1,16,13,2,139.23,33,27,0,1,139.00,0.00,0.00,0.14,0,12.00,2,510.33,0,3,2,java.lang.Object,0.00,6,0,8,0,6,4,1,8,129,1
"org.apache.jackrabbit.core.query.lucene.PropertiesSynonymProvider",5,0.25,2.80,60,0.79,34102.83,12,7,8,23,4,62.75,63,79,0,1,100.32,0.00,0.00,0.34,2,2.00,4,2371.22,0,2,4,java.lang.Object,0.00,18,0,14,0,18,3,1,16,465,1
"org.apache.jackrabbit.core.query.lucene.PropertyMetaData",4,0.67,1.00,10,0.07,986.94,5,1,0,5,3,108.71,26,15,3,1,140.93,0.00,0.00,0.50,0,4.00,1,211.47,0,1,0,java.lang.Object,0.00,1,0,4,0,1,3,0,6,63,2
"org.apache.jackrabbit.core.query.lucene.QueryHits",1,0.00,1.00,2,0.01,59.45,1,0,1,1,13,97.32,10,3,12,2,145.80,0.00,0.50,0.00,0,1.00,1,33.60,0,1,1,,0.00,0,1,1,0,0,0,0,2,13,1
"org.apache.jackrabbit.core.query.lucene.QueryHitsAdapter",6,0.10,1.17,20,0.15,2970.46,8,2,2,10,5,114.07,31,28,1,1,131.95,0.00,0.00,0.42,0,2.00,2,456.94,0,2,4,java.lang.Object,0.00,4,0,7,0,4,4,1,9,123,1
"org.apache.jackrabbit.core.query.lucene.QueryHitsQuery",5,1.00,1.20,16,0.14,1840.49,6,1,17,8,5,100.73,34,25,1,2,132.95,0.00,0.50,0.20,0,8.00,2,414.53,0,2,4,org.apache.lucene.search.Query,0.00,3,1,6,0,3,3,1,13,105,1
"org.apache.jackrabbit.core.query.lucene.QueryHitsQuery$QueryHitsQueryScorer",6,0.07,1.67,38,0.43,11724.69,9,3,17,23,2,98.07,33,55,0,2,115.94,0.00,0.50,0.39,0,2.00,3,1275.70,0,1,2,org.apache.lucene.search.Scorer,0.00,17,1,10,0,17,5,0,9,261,1
"org.apache.jackrabbit.core.query.lucene.QueryHitsQuery$QueryHitsQueryWeight",7,1.00,1.00,15,0.10,1100.81,8,1,17,9,1,163.09,26,23,0,1,142.47,0.00,0.00,0.14,0,12.00,1,313.30,0,3,1,java.lang.Object,0.00,2,0,7,0,2,4,1,8,91,1
"org.apache.jackrabbit.core.query.lucene.QueryImpl",5,0.00,3.00,61,1.22,62850.34,8,3,30,51,24,60.65,60,89,1,2,98.21,0.00,0.50,0.33,1,2.00,8,3649.26,0,3,24,org.apache.jackrabbit.core.query.lucene.AbstractQueryImpl,0.14,46,1,15,0,46,2,0,15,625,1
"org.apache.jackrabbit.core.query.lucene.QueryImpl$DefaultQueryNodeVisitor",2,0.00,1.00,6,0.06,831.24,2,0,30,4,2,132.58,0,8,0,1,132.58,0.00,0.00,0.00,0,2.00,1,166.23,0,2,2,java.lang.Object,0.00,2,0,2,0,2,0,0,0,44,0
"org.apache.jackrabbit.core.query.lucene.QueryObjectModelImpl",5,0.50,2.40,45,0.80,38303.81,6,1,21,43,21,54.62,46,71,1,2,104.62,0.00,0.50,0.60,2,2.00,6,2408.58,1,1,21,org.apache.jackrabbit.core.query.lucene.AbstractQueryImpl,0.14,38,1,12,0,38,4,0,13,402,1
"org.apache.jackrabbit.core.query.lucene.QueryObjectModelImpl$DefaultTraversingQOMTreeVisitor",1,0.00,1.00,4,0.03,313.32,1,0,21,3,1,128.89,0,5,0,1,128.89,0.00,0.00,0.00,0,1.00,1,78.31,0,1,1,java.lang.Object,0.00,2,0,1,0,2,0,0,0,23,0
"org.apache.jackrabbit.core.query.lucene.QueryObjectModelImpl$DefaultTraversingQOMTreeVisitor_0",1,0.00,2.00,6,0.07,2183.60,1,0,21,4,1,115.52,0,8,0,1,115.52,0.00,0.00,0.00,0,1.00,2,214.82,1,1,1,java.lang.Object,0.00,3,0,2,0,3,0,0,0,48,0
"org.apache.jackrabbit.core.query.lucene.QueryResultImpl",12,0.08,2.67,108,1.45,69220.37,26,14,16,48,17,68.00,153,159,3,1,105.56,0.00,0.00,0.14,3,34.00,8,4345.89,0,6,14,java.lang.Object,0.00,36,0,32,2,36,6,1,38,812,2
"org.apache.jackrabbit.core.query.lucene.QueryResultImpl$LazyScoreNodeIteratorImpl",9,0.08,2.67,67,0.59,23955.20,12,3,16,15,2,112.51,38,93,0,1,112.28,0.00,0.00,0.26,3,34.00,7,1781.92,0,2,2,java.lang.Object,0.00,6,0,24,0,6,7,1,17,375,2
"org.apache.jackrabbit.core.query.lucene.RangeQuery",8,0.10,2.62,56,0.70,25444.63,14,6,20,24,5,63.20,86,75,4,2,111.67,1.00,0.33,0.25,1,16.00,7,2088.18,0,4,1,org.apache.lucene.search.Query,0.00,16,1,21,1,16,4,1,23,435,1
"org.apache.jackrabbit.core.query.lucene.RangeQuery$RangeQueryScorer",8,0.14,3.25,110,1.58,136180.60,14,6,20,48,3,45.86,74,135,0,2,95.86,0.00,0.50,0.29,2,4.00,14,4751.42,0,1,3,org.apache.lucene.search.Scorer,0.00,40,1,26,0,40,7,0,32,810,2
"org.apache.jackrabbit.core.query.lucene.RangeQuery$RangeQueryWeight",7,0.00,1.00,14,0.09,874.93,7,0,20,10,2,143.49,29,22,0,2,143.26,0.00,0.50,0.00,0,12.00,1,279.09,0,3,2,org.apache.jackrabbit.core.query.lucene.AbstractWeight,0.00,3,1,7,0,3,4,0,7,84,1
"org.apache.jackrabbit.core.query.lucene.RangeScan",4,0.17,1.25,15,0.12,1762.46,6,2,4,7,3,172.22,9,21,3,2,132.33,0.00,0.50,0.38,0,4.00,2,351.15,0,0,0,org.apache.lucene.search.FilteredTermEnum,0.00,3,1,5,0,3,4,0,2,90,0
"org.apache.jackrabbit.core.query.lucene.ReadOnlyIndexReader",15,0.14,1.20,50,0.41,6786.72,18,3,5,29,12,84.14,121,69,7,3,132.25,0.00,0.67,0.20,1,71.00,3,1225.13,2,3,5,org.apache.jackrabbit.core.query.lucene.RefCountingIndexReader,0.00,14,2,18,0,14,12,0,26,314,0
"org.apache.jackrabbit.core.query.lucene.ReadOnlyIndexReader$FilteredTermDocs",4,0.00,3.00,34,0.31,23034.05,4,0,5,7,0,107.68,17,41,0,2,107.45,0.00,0.50,0.00,0,6.00,7,920.64,0,0,0,FilterTermDocs,0.00,3,1,12,0,3,4,0,7,202,1
"org.apache.jackrabbit.core.query.lucene.ReadOnlyIndexReader$FilteredTermPositions",5,0.00,1.00,11,0.10,1357.37,5,0,5,9,0,161.22,17,18,0,2,140.61,0.00,0.50,0.00,0,5.00,1,314.15,0,0,0,org.apache.jackrabbit.core.query.lucene.FilteredTermDocs,0.00,4,1,5,0,4,5,1,5,89,2
"org.apache.jackrabbit.core.query.lucene.Recovery",3,0.12,6.33,70,0.99,119569.76,7,4,6,26,3,101.69,55,79,2,1,83.55,0.00,0.00,0.33,0,5.00,16,2973.22,0,0,2,java.lang.Object,0.00,23,0,19,0,23,3,0,23,522,0
"org.apache.jackrabbit.core.query.lucene.RedoLog",6,0.00,1.00,7,0.04,258.13,6,0,2,6,5,115.84,42,8,5,1,158.13,0.00,0.00,0.00,0,6.00,1,128.29,0,1,0,,0.00,0,0,6,0,0,5,0,7,46,1
"org.apache.jackrabbit.core.query.lucene.RedoLogFactory",1,0.00,1.00,2,0.01,69.06,1,0,1,1,4,107.72,12,3,3,1,145.29,0.00,0.00,0.00,0,1.00,1,36.53,0,0,2,,0.00,0,0,1,0,0,1,0,2,13,1
"org.apache.jackrabbit.core.query.lucene.RefCountingIndexReader",5,0.50,1.20,13,0.09,968.84,6,1,3,7,4,162.33,18,22,2,2,141.72,2.00,0.25,0.60,0,2.00,2,262.24,0,0,2,org.apache.lucene.index.FilterIndexReader,0.00,2,1,6,2,2,5,1,7,74,1
"org.apache.jackrabbit.core.query.lucene.ReleaseableIndexReader",1,0.00,1.00,2,0.01,51.30,1,0,1,1,2,102.18,11,3,2,1,146.30,0.00,0.00,0.00,0,1.00,1,27.65,0,0,0,,0.00,0,0,1,0,0,1,0,2,11,1
"org.apache.jackrabbit.core.query.lucene.RowIteratorImpl",8,0.03,1.12,43,0.57,15340.67,21,13,34,23,19,98.91,116,63,1,1,119.05,0.00,0.00,0.05,1,0.00,2,1715.70,0,2,18,java.lang.Object,0.00,15,0,9,0,15,6,1,24,338,0
"org.apache.jackrabbit.core.query.lucene.RowIteratorImpl$RowImpl",20,0.12,2.60,153,1.88,63661.97,24,4,34,58,9,63.20,208,215,0,1,111.67,0.00,0.00,0.14,10,186.00,13,5645.37,0,12,9,java.lang.Object,0.00,38,0,52,0,38,8,1,34,1105,0
"org.apache.jackrabbit.core.query.lucene.ScoreNode",7,0.06,1.43,36,0.32,9045.50,10,3,5,17,53,88.12,47,49,51,1,120.34,0.00,0.00,0.29,0,15.00,3,960.96,0,2,2,java.lang.Object,0.00,10,0,10,0,10,5,0,10,222,2
"org.apache.jackrabbit.core.query.lucene.ScoreNodeIterator",1,0.00,1.00,2,0.01,53.60,1,0,1,1,7,97.68,10,3,6,2,146.15,0.00,0.50,0.00,0,1.00,1,29.70,0,0,1,,0.00,0,1,1,0,0,1,0,2,12,1
"org.apache.jackrabbit.core.query.lucene.ScoreNodeIteratorImpl",2,0.00,1.00,5,0.04,425.59,2,0,2,3,4,162.05,7,10,1,2,141.44,0.00,0.50,0.00,0,2.00,1,122.57,1,1,3,org.apache.jackrabbit.commons.iterator.RangeIteratorAdapter,0.00,1,1,2,0,1,1,1,2,37,1
"org.apache.jackrabbit.core.query.lucene.SearchIndex",112,0.00,1.99,699,9.02,423845.44,173,61,69,307,78,71.35,856,1034,22,2,113.64,1.00,0.33,0.02,15,9292.00,15,27048.69,2,40,63,org.apache.jackrabbit.core.query.AbstractQueryHandler,0.03,195,1,223,1,195,72,0,203,4973,1
"org.apache.jackrabbit.core.query.lucene.SearchIndex$CombinedIndexReader",9,0.06,2.33,71,0.70,35621.67,11,2,69,19,6,131.57,34,85,0,2,110.95,0.00,0.50,0.56,1,0.00,5,2091.14,0,2,6,org.apache.lucene.index.MultiReader,0.00,10,1,21,0,10,7,2,14,458,3
"org.apache.jackrabbit.core.query.lucene.SearchIndex$Comparator<Fieldable>",1,0.00,1.00,3,0.04,489.31,1,0,69,4,0,132.02,0,4,0,1,132.02,0.00,0.00,0.00,0,1.00,1,121.23,0,0,0,java.lang.Object,0.00,3,0,1,0,3,1,0,0,33,0
"org.apache.jackrabbit.core.query.lucene.SearchIndex$FilterMultiColumnQueryHits",1,0.00,1.00,6,0.06,650.81,1,0,69,4,2,119.82,0,11,0,1,119.82,0.00,0.00,0.00,0,1.00,1,175.29,1,0,2,java.lang.Object,0.00,3,0,1,0,3,1,0,0,44,0
"org.apache.jackrabbit.core.query.lucene.SearchIndex$FilterMultiColumnQueryHits_0",1,0.00,1.00,6,0.05,623.51,1,0,69,4,2,119.96,0,10,0,1,119.96,0.00,0.00,0.00,0,1.00,1,161.64,1,0,2,java.lang.Object,0.00,3,0,1,0,3,1,0,0,41,0
"org.apache.jackrabbit.core.query.lucene.SearchIndex$HitCollector",1,0.00,1.00,3,0.02,168.11,1,0,69,2,0,135.68,0,4,0,1,135.68,0.00,0.00,0.00,0,1.00,1,63.51,0,0,0,java.lang.Object,0.00,1,0,1,0,1,1,0,0,19,0
"org.apache.jackrabbit.core.query.lucene.SharedFieldCache",5,0.38,3.40,81,1.27,107134.57,7,2,11,46,9,43.22,53,116,2,1,91.70,0.00,0.00,0.20,2,7.00,11,3800.89,0,4,7,java.lang.Object,0.00,41,0,17,0,41,1,0,12,648,1
"org.apache.jackrabbit.core.query.lucene.SharedFieldCache$Key",3,0.50,1.33,15,0.16,3616.70,6,3,11,7,0,141.21,10,22,0,1,120.60,0.00,0.00,0.67,0,1.00,2,469.53,0,0,0,java.lang.Object,0.00,4,0,4,0,4,3,0,3,120,1
"org.apache.jackrabbit.core.query.lucene.SharedFieldCache$ValueIndex",4,0.00,2.75,36,0.37,14366.11,8,4,11,7,0,107.41,19,44,0,1,107.18,0.00,0.00,0.25,1,8.00,3,1100.72,0,2,0,java.lang.Object,0.00,3,0,11,0,3,2,0,7,238,2
"org.apache.jackrabbit.core.query.lucene.SharedFieldSortComparator",3,0.20,1.67,26,0.31,7885.89,8,5,17,12,15,119.40,52,44,2,2,110.27,0.00,0.50,0.07,0,4.00,3,929.04,0,2,13,org.apache.lucene.search.SortComparator,0.00,9,1,5,0,9,1,0,11,193,1
"org.apache.jackrabbit.core.query.lucene.SharedFieldSortComparator$CompoundScoreDocComparator",2,1.00,2.00,12,0.09,2110.57,3,1,17,3,1,168.01,3,19,0,2,118.01,0.00,0.50,0.00,0,2.00,3,283.70,0,1,1,org.apache.jackrabbit.core.query.lucene.AbstractScoreDocComparator,0.00,1,1,4,0,1,1,0,1,70,2
"org.apache.jackrabbit.core.query.lucene.SharedFieldSortComparator$RelPathScoreDocComparator",2,1.00,3.00,25,0.36,12430.77,3,1,17,12,10,121.23,7,35,0,2,100.62,0.00,0.50,0.50,0,2.00,5,1091.86,1,1,10,org.apache.jackrabbit.core.query.lucene.AbstractScoreDocComparator,0.00,10,1,6,0,10,1,0,1,196,2
"org.apache.jackrabbit.core.query.lucene.SharedFieldSortComparator$SimpleScoreDocComparator",2,0.00,1.50,15,0.21,5271.11,3,1,17,7,4,112.68,9,19,0,2,112.44,0.00,0.50,1.00,0,0.00,2,619.98,1,1,4,org.apache.jackrabbit.core.query.lucene.AbstractScoreDocComparator,0.00,5,1,3,0,5,1,0,2,128,2
"org.apache.jackrabbit.core.query.lucene.SharedIndexReader",5,0.00,1.00,11,0.08,954.75,5,0,4,8,5,93.70,41,17,2,3,141.81,0.00,0.67,0.00,1,5.00,1,241.95,0,3,3,org.apache.jackrabbit.core.query.lucene.RefCountingIndexReader,0.00,3,2,5,0,3,2,0,6,72,0
"org.apache.jackrabbit.core.query.lucene.SimilarityQuery",3,0.00,1.67,23,0.26,8023.94,5,2,7,15,3,94.50,17,31,1,2,112.37,0.00,0.50,0.50,0,1.00,3,774.53,0,2,2,org.apache.lucene.search.Query,0.00,12,1,5,0,12,1,0,6,160,1
"org.apache.jackrabbit.core.query.lucene.SimpleExcerptProvider",2,0.00,4.00,28,0.44,27510.64,3,1,12,18,11,47.23,17,38,1,1,95.34,0.00,0.00,1.00,0,0.00,7,1325.51,0,1,10,java.lang.Object,0.00,16,0,8,0,16,1,1,5,227,1
"org.apache.jackrabbit.core.query.lucene.SingleColumnQueryResult",3,0.17,1.33,14,0.21,4298.44,6,3,6,7,10,91.40,20,27,1,2,123.62,0.00,0.50,0.44,0,2.00,2,644.25,1,0,9,org.apache.jackrabbit.core.query.lucene.QueryResultImpl,0.27,4,1,4,0,4,3,0,7,137,1
"org.apache.jackrabbit.core.query.lucene.SingleTermDocs",9,0.31,1.11,27,0.19,3693.09,11,2,4,10,2,132.84,39,38,2,1,132.60,0.00,0.00,0.22,0,22.00,2,567.23,0,0,0,java.lang.Object,0.00,1,0,10,0,1,9,1,12,152,0
"org.apache.jackrabbit.core.query.lucene.SingletonTokenStream",3,0.25,1.33,19,0.18,3617.64,5,2,4,14,3,69.54,26,24,2,2,117.64,0.00,0.50,0.33,0,4.00,2,537.86,0,1,1,org.apache.lucene.analysis.TokenStream,0.00,11,1,4,0,11,2,0,6,128,2
"org.apache.jackrabbit.core.query.lucene.SlowQueryHandler",2,0.00,1.50,9,0.09,1156.28,3,1,2,6,3,147.31,7,14,1,3,126.70,0.00,0.67,1.00,0,0.00,2,258.32,2,0,2,org.apache.jackrabbit.core.query.lucene.SearchIndex,0.02,4,2,3,0,4,2,0,4,63,1
"org.apache.jackrabbit.core.query.lucene.SortedLuceneQueryHits",5,0.23,1.60,45,0.62,18099.08,16,11,11,21,6,69.71,64,57,1,2,107.27,0.00,0.50,0.27,1,8.00,3,1861.29,0,0,6,org.apache.jackrabbit.core.query.lucene.AbstractQueryHits,0.50,16,1,8,0,16,5,0,20,362,2
"org.apache.jackrabbit.core.query.lucene.SortedMultiColumnQueryHits",3,1.00,2.33,21,0.27,7645.93,4,1,12,11,7,64.35,25,35,1,2,112.46,0.00,0.50,0.33,1,4.00,3,801.71,0,1,6,org.apache.jackrabbit.core.query.lucene.FilterMultiColumnQueryHits,0.44,8,1,7,0,8,2,0,7,165,1
"org.apache.jackrabbit.core.query.lucene.SortedMultiColumnQueryHits$ScoreNodeComparator",2,1.00,6.00,54,0.76,47371.17,9,7,12,18,3,91.88,35,63,0,1,82.75,0.00,0.00,0.64,0,0.00,9,2276.57,0,0,3,java.lang.Object,0.00,16,0,12,0,16,2,1,10,413,3
"org.apache.jackrabbit.core.query.lucene.SpellChecker",3,0.00,1.00,4,0.02,95.00,3,0,3,3,4,109.18,27,5,2,1,159.18,0.00,0.00,0.00,0,3.00,1,66.00,0,1,2,,0.00,0,0,3,0,0,2,0,4,25,1
"org.apache.jackrabbit.core.query.lucene.SpellSuggestion",2,0.00,1.50,11,0.07,1082.74,4,2,2,3,7,85.75,24,15,5,1,123.31,0.00,0.00,0.50,0,2.00,2,217.74,0,1,2,java.lang.Object,0.00,1,0,3,0,1,1,0,5,59,0
"org.apache.jackrabbit.core.query.lucene.SynonymProvider",2,0.00,1.00,3,0.02,87.19,2,0,2,2,6,113.96,23,4,5,1,158.09,0.00,0.00,0.00,0,2.00,1,52.09,0,1,1,,0.00,0,0,2,0,0,1,0,3,20,1
"org.apache.jackrabbit.core.query.lucene.TermDocsCache",2,0.60,8.00,64,1.04,98842.04,7,5,13,31,2,126.69,49,84,1,1,77.41,0.00,0.00,0.50,0,2.00,15,3117.98,0,1,1,java.lang.Object,0.00,29,0,16,0,29,1,0,19,513,1
"org.apache.jackrabbit.core.query.lucene.TermDocsCache$CacheEntry",1,1.00,3.00,6,0.08,2188.07,3,2,13,1,0,115.42,0,8,0,1,115.42,0.00,0.00,0.50,0,0.00,3,246.12,0,0,0,java.lang.Object,0.00,0,0,3,0,0,1,1,0,58,3
"org.apache.jackrabbit.core.query.lucene.TermDocsCache$CachedTermDocs",9,0.08,1.33,34,0.28,6726.12,12,3,13,11,0,151.12,33,44,0,1,130.51,0.00,0.00,0.26,0,18.00,2,833.71,0,0,0,java.lang.Object,0.00,2,0,12,0,2,9,1,11,204,3
"org.apache.jackrabbit.core.query.lucene.TermDocsCache$LinkedHashMap<String,String>",1,1.00,1.00,4,0.05,740.50,2,1,13,2,0,125.94,0,5,0,1,125.94,0.00,0.00,0.00,0,1.00,1,142.42,0,0,0,java.lang.Object,0.00,1,0,1,0,1,1,0,0,36,0
"org.apache.jackrabbit.core.query.lucene.TestAll",1,0.00,1.00,10,0.10,3050.43,1,0,4,3,7,57.78,10,12,0,2,106.26,0.00,0.50,0.00,0,1.00,1,305.37,0,1,7,junit.framework.TestCase,0.00,2,1,1,0,2,0,0,2,71,1
"org.apache.jackrabbit.core.query.lucene.TransformConstants",0,0.00,0.00,4,0.03,265.97,3,3,0,0,5,171.00,12,5,5,1,171.00,0.00,0.00,0.00,0,0.00,0,85.11,0,0,0,,0.00,0,0,0,0,0,0,0,4,23,1
"org.apache.jackrabbit.core.query.lucene.Transformable",1,0.00,1.00,2,0.01,51.70,1,0,0,1,2,116.90,13,3,2,2,146.28,0.00,0.50,0.00,0,1.00,1,33.60,0,0,0,,0.00,0,1,1,0,0,1,0,2,13,1
"org.apache.jackrabbit.core.query.lucene.UpperCaseSortComparator",2,0.50,1.00,8,0.08,1259.07,4,2,6,4,1,84.21,15,13,1,1,126.50,0.00,0.00,0.25,0,2.00,1,248.32,0,1,0,java.lang.Object,0.00,2,0,2,0,2,1,1,4,63,1
"org.apache.jackrabbit.core.query.lucene.UpperCaseSortComparator$Comparator",4,1.00,1.25,14,0.12,2154.60,5,1,6,8,1,131.64,3,20,0,1,131.64,0.00,0.00,0.25,1,6.00,2,346.90,0,1,1,java.lang.Object,0.00,4,0,5,0,4,3,1,1,92,3
"org.apache.jackrabbit.core.query.lucene.Util",11,0.90,4.00,138,1.94,99804.05,12,1,16,63,39,50.78,110,217,32,1,99.26,0.00,0.00,0.18,2,25.00,11,5823.49,0,5,7,java.lang.Object,0.00,52,0,44,0,52,6,0,19,1102,1
"org.apache.jackrabbit.core.query.lucene.VolatileIndex",9,0.03,1.56,46,0.46,10039.34,13,4,8,23,7,72.72,73,61,2,2,120.83,0.00,0.50,0.22,1,20.00,4,1394.78,6,0,5,org.apache.jackrabbit.core.query.lucene.AbstractIndex,0.18,14,1,14,0,14,9,0,16,312,0
"org.apache.jackrabbit.core.query.lucene.WeightedHTMLExcerpt",1,0.00,1.00,3,0.06,906.92,1,0,2,2,2,156.19,19,10,0,2,129.91,0.00,0.50,0.00,0,1.00,1,181.93,0,1,2,org.apache.jackrabbit.core.query.lucene.AbstractExcerpt,0.00,1,1,1,0,1,0,0,2,41,1
"org.apache.jackrabbit.core.query.lucene.WeightedHighlighter",6,1.00,4.83,107,1.80,217694.31,7,1,13,42,4,51.27,76,155,3,2,88.83,0.00,0.50,0.17,3,14.00,17,5400.26,1,3,1,org.apache.jackrabbit.core.query.lucene.DefaultHighlighter,0.00,36,1,29,0,36,3,0,20,914,1
"org.apache.jackrabbit.core.query.lucene.WeightedHighlighter$FragmentInfo",6,0.28,1.83,42,0.35,13174.48,11,5,13,13,0,113.02,2,51,0,1,113.02,0.00,0.00,0.43,0,0.00,6,1046.84,0,1,0,java.lang.Object,0.00,7,0,11,0,7,5,0,2,224,2
"org.apache.jackrabbit.core.query.lucene.WeightedHighlighter$FragmentInfoPriorityQueue",2,0.00,1.50,9,0.10,3704.31,2,0,13,5,0,143.33,7,13,0,2,122.72,0.00,0.50,0.00,0,2.00,2,300.01,0,0,0,org.apache.lucene.util.PriorityQueue,0.00,3,1,3,0,3,2,0,1,74,2
"org.apache.jackrabbit.core.query.lucene.WeightedXMLExcerpt",1,0.00,1.00,3,0.05,775.69,1,0,2,2,2,169.75,21,10,0,2,130.45,0.00,0.50,0.00,0,1.00,1,142.89,0,1,2,org.apache.jackrabbit.core.query.lucene.AbstractExcerpt,0.00,1,1,1,0,1,0,0,2,35,1
"org.apache.jackrabbit.core.query.lucene.WildcardQuery",7,0.06,1.29,32,0.32,6114.84,13,6,20,15,4,81.19,80,43,3,2,125.32,0.00,0.50,0.12,0,18.00,2,961.75,0,3,1,org.apache.lucene.search.Query,0.00,8,1,9,0,8,4,1,17,226,1
"org.apache.jackrabbit.core.query.lucene.WildcardQuery$Term",1,0.00,1.00,3,0.03,322.26,1,0,20,2,1,133.45,0,4,0,1,133.45,0.00,0.00,0.00,0,0.00,1,93.17,0,1,1,java.lang.Object,0.00,1,0,1,0,1,0,0,0,25,0
"org.apache.jackrabbit.core.query.lucene.WildcardQuery$WildcardQueryScorer",7,0.19,1.86,56,0.61,19678.28,13,6,20,25,2,77.79,47,72,0,2,110.01,0.00,0.50,0.33,1,0.00,5,1844.88,0,1,2,org.apache.lucene.search.Scorer,0.00,18,1,13,0,18,6,0,16,368,2
"org.apache.jackrabbit.core.query.lucene.WildcardQuery$WildcardQueryWeight",7,0.00,1.00,14,0.09,897.38,7,0,20,10,2,143.41,29,22,0,2,143.17,0.00,0.50,0.00,0,12.00,1,281.24,0,3,2,org.apache.jackrabbit.core.query.lucene.AbstractWeight,0.00,3,1,7,0,3,4,0,7,84,1
"org.apache.jackrabbit.core.query.lucene.WildcardTermEnum",4,0.28,2.75,42,0.54,26090.12,10,6,11,21,7,74.05,55,59,3,2,103.43,0.00,0.50,0.38,0,2.00,6,1610.87,0,0,4,org.apache.lucene.search.FilteredTermEnum,0.00,17,1,11,0,17,4,1,17,307,0
"org.apache.jackrabbit.core.query.lucene.WildcardTermEnum$LowerUpperCaseTermEnum",6,0.13,3.33,67,1.15,116868.22,9,3,11,40,3,80.22,34,91,0,2,98.10,0.00,0.50,0.44,1,0.00,13,3453.30,0,1,3,org.apache.lucene.index.TermEnum,0.00,34,1,20,0,34,5,0,17,567,1
"org.apache.jackrabbit.value.AbstractValueFactory",15,0.00,1.93,62,0.66,24773.11,15,0,11,37,14,123.29,61,95,1,1,123.05,0.00,0.00,0.00,1,15.00,13,1988.99,0,12,13,java.lang.Object,0.00,22,0,29,1,22,3,1,17,424,2
"org.apache.jackrabbit.value.BaseValue",11,0.23,1.73,43,0.46,9937.19,14,3,11,21,14,111.93,63,85,12,1,129.80,0.00,0.00,0.12,1,34.00,3,1367.99,0,6,2,java.lang.Object,0.00,10,0,19,13,10,5,1,15,314,2
"org.apache.jackrabbit.value.BinaryImpl",6,0.35,3.00,72,0.76,42372.62,10,4,12,24,5,50.18,57,95,4,1,100.18,0.00,0.00,0.54,0,0.00,5,2294.30,0,1,1,java.lang.Object,0.00,18,0,18,0,18,5,1,24,453,1
"org.apache.jackrabbit.value.BinaryValue",9,0.21,2.44,54,0.61,21690.80,12,3,8,20,7,82.91,59,90,5,2,115.13,1.00,0.33,0.52,0,0.00,4,1834.69,0,3,2,org.apache.jackrabbit.value.BaseValue,0.30,11,1,22,1,11,6,0,13,395,1
"org.apache.jackrabbit.value.BinaryValueTest",1,0.00,1.00,5,0.07,1102.26,2,1,1,6,1,91.59,13,7,0,2,120.97,0.00,0.50,1.00,0,0.00,1,203.23,0,0,1,junit.framework.TestCase,0.00,5,1,1,0,5,1,0,11,50,1
"org.apache.jackrabbit.value.BooleanValue",11,0.30,1.55,41,0.35,8730.23,13,2,5,16,4,112.40,60,68,3,2,130.27,0.00,0.50,0.23,0,40.00,5,1046.42,0,4,1,org.apache.jackrabbit.value.BaseValue,0.55,5,1,17,0,5,7,0,14,259,1
"org.apache.jackrabbit.value.DateValue",10,0.11,2.20,58,0.54,15540.28,12,2,6,19,6,77.32,72,90,4,2,119.61,0.00,0.50,0.40,0,0.00,5,1630.81,0,4,2,org.apache.jackrabbit.value.BaseValue,0.57,9,1,22,0,9,6,0,13,366,1
"org.apache.jackrabbit.value.DecimalValue",10,0.17,2.00,51,0.46,12751.66,12,2,6,20,3,102.44,58,82,2,2,120.31,0.00,0.50,0.35,0,6.00,5,1380.64,0,4,1,org.apache.jackrabbit.value.BaseValue,0.57,10,1,20,0,10,6,0,14,319,1
"org.apache.jackrabbit.value.DoubleValue",11,0.15,1.91,54,0.48,13105.13,13,2,6,21,3,106.30,63,86,2,2,124.17,0.00,0.50,0.36,0,19.00,5,1444.78,0,4,1,org.apache.jackrabbit.value.BaseValue,0.55,10,1,21,0,10,7,0,15,336,1
"org.apache.jackrabbit.value.LongValue",11,0.15,1.91,54,0.48,12997.97,13,2,6,21,3,106.33,63,86,2,2,124.20,0.00,0.50,0.36,0,19.00,5,1428.25,0,4,1,org.apache.jackrabbit.value.BaseValue,0.55,10,1,21,0,10,7,0,15,333,1
"org.apache.jackrabbit.value.NameValue",10,0.39,1.60,38,0.33,8917.52,12,2,5,13,3,97.64,62,64,2,2,129.86,0.00,0.50,0.15,0,30.00,5,989.22,0,4,1,org.apache.jackrabbit.value.BaseValue,0.57,3,1,16,0,3,6,0,13,243,1
"org.apache.jackrabbit.value.PathValue",10,0.39,1.60,38,0.33,8917.52,12,2,5,13,3,97.64,63,64,2,2,129.86,0.00,0.50,0.15,0,30.00,5,989.22,0,4,1,org.apache.jackrabbit.value.BaseValue,0.57,3,1,16,0,3,6,0,13,243,1
"org.apache.jackrabbit.value.ReferenceValue",11,0.35,1.73,46,0.42,11965.37,13,2,8,17,3,92.28,71,77,2,2,124.50,0.00,0.50,0.18,0,39.00,5,1258.82,0,4,1,org.apache.jackrabbit.value.BaseValue,0.55,6,1,19,0,6,7,0,14,298,1
"org.apache.jackrabbit.value.StringValue",4,0.17,2.25,23,0.19,6243.19,6,2,2,6,7,77.30,31,32,6,2,119.59,0.00,0.50,0.38,0,6.00,5,573.39,0,1,1,org.apache.jackrabbit.value.BaseValue,0.13,2,1,9,0,2,3,0,6,136,1
"org.apache.jackrabbit.value.URIValue",10,0.39,1.70,40,0.37,10774.04,12,2,7,16,3,92.32,61,68,2,2,124.54,0.00,0.50,0.15,0,30.00,5,1108.12,0,4,1,org.apache.jackrabbit.value.BaseValue,0.57,6,1,17,0,6,6,0,13,265,1
"org.apache.jackrabbit.value.ValueFactoryImpl",4,1.00,1.00,7,0.05,668.32,5,1,2,5,3,135.62,20,12,2,2,153.49,0.00,0.50,0.25,0,6.00,1,160.01,0,1,1,org.apache.jackrabbit.value.AbstractValueFactory,0.00,1,1,4,0,1,3,0,7,48,1
"org.apache.jackrabbit.value.ValueHelper",13,0.00,6.38,265,4.62,857124.64,13,0,21,54,21,93.22,225,485,17,1,84.09,0.00,0.00,0.00,2,13.00,36,13863.59,0,11,4,java.lang.Object,0.00,41,0,83,0,41,2,0,101,2336,1
"org.apache.jackrabbit.value.ValueHelper$FileInputStream",1,0.00,1.00,4,0.02,230.72,1,0,21,3,0,179.93,1,5,0,1,129.93,0.00,0.00,0.00,0,1.00,1,72.55,0,0,0,java.lang.Object,0.00,2,0,1,0,2,1,0,1,22,0
"org.apache.jackrabbit.value.WeakReferenceValue",11,0.35,1.73,46,0.42,11965.37,13,2,8,17,3,92.28,71,77,2,2,124.50,0.00,0.50,0.18,0,39.00,5,1258.82,0,4,1,org.apache.jackrabbit.value.BaseValue,0.55,6,1,19,0,6,7,0,14,298,1
"org.apache.jackrabbit.standalone.Main",11,0.08,2.64,146,2.18,79331.60,17,6,29,84,8,98.84,8,197,1,1,98.84,0.00,0.00,0.24,8,0.00,12,6525.24,0,0,7,java.lang.Object,0.00,73,0,29,0,73,11,0,4,1126,1
"org.apache.jackrabbit.standalone.Main$Thread",1,0.00,2.00,9,0.06,785.12,1,0,29,3,0,112.45,0,12,0,1,112.45,0.00,0.00,0.00,0,0.00,2,173.67,0,0,0,java.lang.Object,0.00,2,0,2,0,2,1,0,0,43,0
"org.apache.jackrabbit.core.config.AccessManagerConfig",1,0.00,1.00,3,0.02,106.02,1,0,0,1,8,126.90,15,5,7,2,137.25,0.00,0.50,0.00,0,1.00,1,45.51,0,0,1,org.apache.jackrabbit.core.config.BeanConfig,0.00,0,1,1,0,0,1,0,2,16,1
"org.apache.jackrabbit.core.config.BeanConfig",13,0.03,2.85,97,1.80,108704.28,21,8,14,53,22,58.35,117,172,19,1,108.35,0.00,0.00,0.10,4,82.00,11,5402.78,0,5,3,java.lang.Object,0.00,40,0,37,6,40,8,0,21,987,1
"org.apache.jackrabbit.core.config.ClusterConfig",4,0.11,1.00,14,0.10,1401.44,7,3,4,5,12,83.17,37,20,9,1,133.16,0.00,0.00,0.25,0,10.00,1,305.19,0,2,3,java.lang.Object,0.00,1,0,4,0,1,2,1,8,84,1
"org.apache.jackrabbit.core.config.ConfigurationEntityResolver",2,0.67,3.00,32,0.39,12477.88,5,3,7,9,3,145.43,53,69,3,1,95.95,0.00,0.00,0.67,0,0.00,5,1161.24,0,1,0,java.lang.Object,0.00,7,0,6,0,7,1,1,12,245,1
"org.apache.jackrabbit.core.config.ConfigurationErrorHandler",4,1.00,1.00,11,0.13,1631.34,5,1,5,9,3,139.45,17,16,3,1,139.21,0.00,0.00,0.25,1,6.00,1,396.21,0,0,0,java.lang.Object,0.00,5,0,4,0,5,4,1,4,101,1
"org.apache.jackrabbit.core.config.ConfigurationException",2,0.00,1.00,5,0.03,221.18,2,0,1,2,20,101.39,14,8,20,2,143.68,0.00,0.50,0.00,0,2.00,1,88.69,0,0,0,javax.jcr.RepositoryException,0.00,0,1,2,0,0,2,0,3,29,1
"org.apache.jackrabbit.core.config.ConfigurationParser",15,0.11,2.07,92,1.21,42472.68,20,5,16,40,7,77.06,184,142,2,1,114.62,0.00,0.00,0.09,7,72.00,6,3617.09,0,14,5,java.lang.Object,0.00,25,0,31,1,25,1,0,26,725,1
"org.apache.jackrabbit.core.config.DataSourceConfig",2,0.00,2.00,19,0.26,7228.71,10,8,6,10,6,64.94,15,24,5,1,107.23,0.00,0.00,0.12,0,0.00,3,780.94,0,1,1,java.lang.Object,0.00,8,0,4,0,8,1,0,4,162,1
"org.apache.jackrabbit.core.config.DataSourceConfig$DataSourceDefinition",11,0.05,2.18,64,0.84,31926.55,21,10,6,21,1,138.09,36,93,0,1,117.48,0.00,0.00,0.15,2,78.00,10,2527.15,0,7,1,java.lang.Object,0.00,10,0,24,0,10,4,0,12,502,3
"org.apache.jackrabbit.core.config.DataSourceConfigTest",11,0.43,1.64,65,0.66,11365.57,14,3,3,30,3,171.08,15,92,1,2,121.08,0.00,0.50,0.73,0,0.00,2,1990.27,0,0,2,junit.framework.TestCase,0.00,19,1,18,0,19,11,0,10,448,1
"org.apache.jackrabbit.core.config.ImportConfig",3,0.25,1.67,15,0.17,4852.64,5,2,6,10,12,159.43,6,21,9,1,119.54,0.00,0.00,0.33,0,5.00,3,503.06,0,1,3,java.lang.Object,0.00,7,0,5,2,7,2,0,2,112,1
"org.apache.jackrabbit.core.config.LoginModuleConfig",2,5.00,1.00,11,0.11,1531.20,7,5,1,2,12,161.52,43,14,10,2,122.22,0.00,0.50,0.00,0,2.00,1,320.70,2,1,2,org.apache.jackrabbit.core.config.BeanConfig,0.00,0,1,2,0,0,1,0,8,79,1
"org.apache.jackrabbit.core.config.PersistenceManagerConfig",1,0.00,1.00,3,0.02,106.02,1,0,0,1,6,126.90,15,5,5,2,137.25,0.00,0.50,0.00,0,1.00,1,45.51,0,0,1,org.apache.jackrabbit.core.config.BeanConfig,0.00,0,1,1,0,0,1,0,2,16,1
"org.apache.jackrabbit.core.config.RepositoryConfig",38,0.01,2.16,284,3.82,170003.31,58,20,48,123,47,66.42,451,451,25,1,110.55,0.00,0.00,0.06,7,974.00,16,11446.36,0,30,24,java.lang.Object,0.00,85,0,82,0,85,8,3,85,2116,1
"org.apache.jackrabbit.core.config.RepositoryConfigTest",14,0.21,2.21,134,1.81,49858.44,17,3,12,66,10,157.25,27,213,1,2,107.25,0.00,0.50,0.52,0,0.00,4,5439.32,0,0,9,junit.framework.TestCase,0.00,52,1,31,0,52,14,0,12,1074,1
"org.apache.jackrabbit.core.config.RepositoryConfigTest$InputStream",1,0.00,1.00,3,0.02,208.76,1,0,12,2,0,134.94,0,4,0,1,134.94,0.00,0.00,0.00,0,1.00,1,52.97,0,0,0,java.lang.Object,0.00,1,0,1,0,1,1,0,0,17,0
"org.apache.jackrabbit.core.config.RepositoryConfigurationParser",24,0.02,2.00,241,3.59,117219.28,67,43,33,80,40,137.87,485,324,4,2,104.49,0.00,0.50,0.04,17,340.00,7,10775.05,7,14,37,org.apache.jackrabbit.core.config.ConfigurationParser,0.00,56,1,48,0,56,10,0,97,1922,1
"org.apache.jackrabbit.core.config.RepositoryConfigurationParser$DataStoreFactory",1,0.00,3.00,14,0.17,5799.75,1,0,33,8,2,98.36,0,16,0,1,98.36,0.00,0.00,0.00,0,0.00,3,504.09,0,1,2,java.lang.Object,0.00,7,0,3,0,7,0,0,0,96,0
"org.apache.jackrabbit.core.config.RepositoryConfigurationParser$FileSystemFactory",1,0.00,2.00,7,0.06,1893.80,1,0,33,4,2,113.51,0,11,0,1,113.51,0.00,0.00,0.00,0,1.00,2,188.94,0,1,2,java.lang.Object,0.00,3,0,2,0,3,0,0,0,44,0
"org.apache.jackrabbit.core.config.RepositoryConfigurationParser$ISMLockingFactory",1,0.00,2.00,7,0.07,1516.14,1,0,33,5,2,114.27,0,9,0,1,114.27,0.00,0.00,0.00,0,0.00,2,196.02,0,1,2,java.lang.Object,0.00,4,0,2,0,4,0,0,0,44,0
"org.apache.jackrabbit.core.config.RepositoryConfigurationParser$JournalFactory",1,0.00,3.00,10,0.12,4578.08,1,0,33,6,5,154.62,1,16,0,1,104.62,0.00,0.00,0.00,0,0.00,3,364.72,0,1,5,java.lang.Object,0.00,5,0,3,0,5,0,0,1,73,0
"org.apache.jackrabbit.core.config.RepositoryConfigurationParser$QueryHandlerFactory",1,0.00,3.00,13,0.18,7229.45,1,0,33,8,4,138.69,2,23,0,1,98.81,0.00,0.00,0.00,0,0.00,3,549.31,0,1,4,java.lang.Object,0.00,7,0,3,0,7,0,0,2,102,0
"org.apache.jackrabbit.core.config.RepositoryConfigurationParser$RepositoryLockMechanismFactory",1,0.00,3.00,12,0.15,5312.64,1,0,33,8,3,101.16,0,14,0,1,101.16,0.00,0.00,0.00,0,0.00,3,449.72,0,1,3,java.lang.Object,0.00,7,0,3,0,7,0,0,0,87,0
"org.apache.jackrabbit.core.config.SearchConfig",2,1.00,1.50,10,0.08,1356.60,3,1,4,3,3,93.16,27,15,0,2,122.54,0.00,0.50,0.50,0,2.00,2,226.00,0,1,3,org.apache.jackrabbit.core.config.BeanConfig,0.00,1,1,3,0,1,1,1,4,59,1
"org.apache.jackrabbit.core.config.SecurityConfig",5,0.06,1.00,18,0.12,1475.38,9,4,0,5,7,83.75,46,27,4,1,133.75,0.00,0.00,0.20,0,17.00,1,349.39,0,4,3,java.lang.Object,0.00,0,0,5,0,0,1,0,10,96,1
"org.apache.jackrabbit.core.config.SecurityConfigTest",9,0.09,2.33,154,2.95,129432.73,23,14,34,65,25,132.05,23,275,0,4,92.17,0.00,0.75,0.15,1,0.00,6,8856.79,2,1,25,org.apache.jackrabbit.test.AbstractJCRTest,0.23,56,3,21,0,56,8,0,20,1562,1
"org.apache.jackrabbit.core.config.SecurityManagerConfig",6,0.04,1.33,27,0.28,6570.21,11,5,2,11,9,76.44,53,41,7,2,124.54,0.00,0.50,0.17,0,26.00,3,832.15,0,2,2,org.apache.jackrabbit.core.config.BeanConfig,0.00,5,1,8,0,5,4,0,9,185,1
"org.apache.jackrabbit.core.config.TestAll",1,0.00,1.00,7,0.06,1740.69,1,0,3,3,3,76.39,12,9,0,2,113.96,0.00,0.50,0.00,0,1.00,1,186.48,0,1,3,junit.framework.TestCase,0.00,2,1,1,0,2,0,0,2,47,1
"org.apache.jackrabbit.core.config.UserManagerConfig",2,0.50,5.00,20,0.32,18820.43,4,2,4,8,8,111.17,34,30,5,2,102.04,0.00,0.50,0.25,0,2.00,9,965.97,2,1,3,org.apache.jackrabbit.core.config.BeanConfig,0.00,6,1,10,0,6,1,0,4,183,1
"org.apache.jackrabbit.core.config.VersioningConfig",5,0.06,1.00,18,0.14,2030.63,9,4,6,8,9,84.18,52,27,4,1,132.66,0.00,0.00,0.20,0,17.00,1,416.81,0,3,5,java.lang.Object,0.00,3,0,5,0,3,2,2,10,112,1
"org.apache.jackrabbit.core.config.WorkspaceConfig",12,0.02,1.08,45,0.38,5864.00,21,9,8,15,22,82.01,116,70,12,1,132.01,0.00,0.00,0.09,0,108.00,2,1142.50,0,6,10,java.lang.Object,0.00,3,0,13,0,3,6,3,22,277,1
"org.apache.jackrabbit.core.config.WorkspaceConfigTest",4,0.22,3.25,62,1.08,43762.21,10,6,17,43,13,115.67,14,102,1,2,95.05,0.00,0.50,0.33,1,0.00,6,3253.43,0,1,12,junit.framework.TestCase,0.00,39,1,13,0,39,3,0,7,597,1
"org.apache.jackrabbit.core.config.WorkspaceSecurityConfig",2,1.00,1.00,6,0.03,334.48,3,1,0,2,7,117.82,11,9,6,1,135.69,0.00,0.00,0.50,0,2.00,1,95.56,0,0,1,java.lang.Object,0.00,0,0,2,0,0,2,0,4,30,1
"org.apache.jackrabbit.webdav.client.TestAll",1,0.00,1.00,6,0.05,1283.53,1,0,4,3,2,117.50,0,8,0,2,117.50,0.00,0.50,0.00,0,1.00,1,150.40,0,1,2,junit.framework.TestCase,0.00,2,1,1,0,2,0,0,0,39,1
"org.apache.jackrabbit.webdav.client.XmlRequestEntityTest",1,0.00,1.00,13,0.19,3331.12,1,0,11,16,2,101.71,0,15,1,2,101.71,0.00,0.50,0.00,0,1.00,1,565.53,0,0,1,junit.framework.TestCase,0.00,15,1,1,0,15,1,0,0,108,1
"org.apache.jackrabbit.core.persistence.AbstractPersistenceManager",10,0.00,1.90,38,0.36,11596.64,10,0,8,16,12,96.70,60,49,3,1,128.92,0.00,0.00,0.00,2,10.00,10,1084.36,0,2,9,java.lang.Object,0.00,6,0,19,9,6,8,1,11,254,2
"org.apache.jackrabbit.core.persistence.CachingPersistenceManager",1,0.00,1.00,2,0.01,30.51,1,0,1,1,4,99.60,10,3,3,1,148.08,0.00,0.00,0.00,0,1.00,1,25.51,0,0,1,,0.00,0,0,1,0,0,1,0,2,11,1
"org.apache.jackrabbit.core.persistence.IterablePersistenceManager",1,0.00,1.00,2,0.02,181.89,1,0,3,1,6,160.11,18,4,4,2,141.98,0.00,0.50,0.00,0,1.00,1,69.90,0,0,2,,0.00,0,1,1,0,0,1,0,2,21,1
"org.apache.jackrabbit.core.persistence.PMContext",7,0.03,1.00,26,0.18,2285.83,13,6,6,7,29,85.30,60,39,25,1,133.41,0.00,0.00,0.14,0,37.00,1,542.32,0,6,4,java.lang.Object,0.00,0,0,7,0,0,1,0,14,140,1
"org.apache.jackrabbit.core.persistence.PersistenceCopier",4,0.17,4.00,65,0.97,62618.03,8,4,17,41,13,63.35,54,84,1,1,92.73,0.00,0.00,0.38,1,2.00,10,2905.01,0,0,12,java.lang.Object,0.00,37,0,16,0,37,4,0,13,497,1
"org.apache.jackrabbit.core.persistence.PersistenceManager",12,0.00,1.00,13,0.10,440.31,12,0,8,12,25,114.55,143,17,16,1,158.68,0.00,0.00,0.00,0,12.00,1,298.66,0,5,9,,0.00,0,0,12,0,0,7,0,13,101,1
"org.apache.jackrabbit.standalone.cli.mixin.AddMixin",5,0.17,1.20,19,0.21,4081.62,8,3,5,11,1,130.47,24,26,0,1,130.23,0.00,0.00,0.20,0,14.00,2,625.80,0,2,1,java.lang.Object,0.00,6,0,6,0,6,3,1,10,144,1
"org.apache.jackrabbit.standalone.cli.mixin.RemoveMixin",5,0.17,1.20,19,0.21,4081.62,8,3,5,11,1,130.47,24,26,0,1,130.23,0.00,0.00,0.20,0,14.00,2,625.80,0,2,1,java.lang.Object,0.00,6,0,6,0,6,3,1,10,144,1
"org.apache.jackrabbit.spi.commons.AbstractReadableRepositoryService",7,0.17,2.00,33,0.47,13405.21,10,3,22,22,11,74.43,62,58,1,2,122.54,0.00,0.50,0.19,0,23.00,3,1416.51,2,4,10,org.apache.jackrabbit.spi.commons.AbstractRepositoryService,0.00,15,1,14,0,15,3,0,15,300,2
"org.apache.jackrabbit.spi.commons.AbstractRepositoryService",69,0.22,1.10,205,3.02,70635.45,73,4,61,104,33,136.28,302,393,1,1,136.04,0.00,0.00,0.03,6,644.00,3,9046.11,0,37,32,java.lang.Object,0.00,35,0,76,1,35,32,1,82,1975,2
"org.apache.jackrabbit.spi.commons.ChildInfoImpl",4,0.11,1.00,14,0.09,1169.64,7,3,3,4,6,91.49,29,19,4,1,133.78,0.00,0.00,0.25,0,10.00,1,278.61,0,2,2,java.lang.Object,0.00,0,0,4,1,0,2,2,8,77,1
"org.apache.jackrabbit.spi.commons.EventBundleImpl",4,0.33,1.00,12,0.10,1457.57,6,2,5,5,5,100.81,25,17,3,1,133.03,0.00,0.00,0.25,1,8.00,1,295.56,0,2,2,java.lang.Object,0.00,1,0,4,0,1,2,2,8,79,1
"org.apache.jackrabbit.spi.commons.EventFilterImpl",9,0.17,2.44,61,0.85,32589.10,15,6,11,34,8,95.87,50,98,3,1,113.74,0.00,0.00,0.31,0,17.00,10,2555.72,0,4,5,java.lang.Object,0.00,25,0,22,0,25,5,2,18,505,1
"org.apache.jackrabbit.spi.commons.EventImpl",13,0.03,1.08,51,0.67,16157.48,23,10,12,21,8,110.94,65,82,2,1,128.82,0.00,0.00,0.13,0,106.00,2,2018.69,0,9,6,java.lang.Object,0.00,8,0,14,1,8,4,2,22,441,1
"org.apache.jackrabbit.spi.commons.ItemInfoBuilder",5,0.00,1.00,14,0.10,1124.52,5,0,31,6,18,92.77,54,20,1,1,141.25,0.00,0.00,0.00,1,5.00,1,286.47,0,4,17,java.lang.Object,0.00,1,0,5,0,1,1,0,8,84,2
"org.apache.jackrabbit.spi.commons.ItemInfoBuilder$Listener",3,0.00,1.00,4,0.03,122.13,3,0,31,3,3,158.56,13,5,0,1,158.32,0.00,0.00,0.00,0,3.00,1,79.07,0,0,3,,0.00,0,0,3,0,0,3,0,3,28,1
"org.apache.jackrabbit.spi.commons.ItemInfoBuilder$NodeInfoBuilder",16,0.04,1.38,75,0.78,19287.50,26,10,31,42,15,124.44,76,104,0,1,124.21,0.00,0.00,0.14,1,136.00,5,2341.89,0,13,15,java.lang.Object,0.00,26,0,22,0,26,3,0,11,514,2
"org.apache.jackrabbit.spi.commons.ItemInfoBuilder$NodeInfoBuilder$Predicate<ItemInfo>",1,0.00,1.00,3,0.02,259.92,1,0,31,2,1,134.19,0,4,0,1,134.19,0.00,0.00,0.00,0,1.00,1,69.84,0,0,1,java.lang.Object,0.00,1,0,1,0,1,1,0,0,21,0
"org.apache.jackrabbit.spi.commons.ItemInfoBuilder$NodeInfoBuilder$Transformer<ItemInfo,ChildInfo>",1,0.00,1.00,4,0.05,688.44,1,0,31,5,5,126.19,0,5,0,1,126.19,0.00,0.00,0.00,0,1.00,1,160.16,0,1,5,java.lang.Object,0.00,4,0,1,0,4,0,0,0,39,0
"org.apache.jackrabbit.spi.commons.ItemInfoBuilder$NodeInfoBuilder$Transformer<ItemInfo,PropertyId>",1,0.00,1.00,3,0.03,277.94,1,0,31,2,2,133.96,0,4,0,1,133.96,0.00,0.00,0.00,0,1.00,1,75.89,0,1,2,java.lang.Object,0.00,1,0,1,0,1,0,0,0,23,0
"org.apache.jackrabbit.spi.commons.ItemInfoBuilder$PropertyInfoBuilder",18,0.01,1.39,75,1.05,25226.86,26,8,31,38,11,81.40,134,108,0,1,123.69,0.00,0.00,0.11,1,82.00,4,3159.17,0,17,11,java.lang.Object,0.00,20,0,25,0,20,1,0,17,675,2
"org.apache.jackrabbit.spi.commons.ItemInfoCacheImpl",9,0.08,2.22,47,0.62,22762.24,12,3,9,25,16,118.18,44,69,8,1,117.95,0.00,0.00,0.26,3,11.00,4,1853.91,0,0,8,java.lang.Object,0.00,16,0,20,0,16,9,1,11,404,1
"org.apache.jackrabbit.spi.commons.ItemInfoImpl",4,0.33,1.00,12,0.09,982.24,6,2,5,4,6,86.28,33,17,2,1,134.38,0.00,0.00,0.25,0,8.00,1,262.56,0,1,4,java.lang.Object,0.00,0,0,4,4,0,3,2,7,73,2
"org.apache.jackrabbit.spi.commons.LockInfoImpl",9,0.04,1.00,32,0.25,4101.20,16,7,3,9,3,89.97,69,45,1,1,132.27,0.00,0.00,0.11,0,58.00,1,752.42,0,3,2,java.lang.Object,0.00,0,0,9,1,0,6,2,17,193,1
"org.apache.jackrabbit.spi.commons.NodeInfoImpl",10,0.05,1.80,61,0.90,44929.51,17,7,12,35,11,64.97,80,91,3,2,113.08,1.00,0.33,0.10,0,66.00,6,2702.34,0,7,8,org.apache.jackrabbit.spi.commons.ItemInfoImpl,0.00,25,1,18,1,25,3,1,19,534,1
"org.apache.jackrabbit.spi.commons.NodeInfoImpl$Iterator<ChildInfo>",3,0.00,1.33,11,0.09,2016.32,3,0,12,8,2,130.87,0,15,0,1,130.87,0.00,0.00,0.00,0,1.00,2,263.42,0,1,2,java.lang.Object,0.00,5,0,4,0,5,2,0,0,69,0
"org.apache.jackrabbit.spi.commons.NodeInfoImpl$Iterator<PropertyId>",3,0.00,1.00,10,0.09,1383.30,3,0,12,12,2,132.23,0,15,0,1,132.23,0.00,0.00,0.00,0,3.00,1,280.71,0,1,2,java.lang.Object,0.00,9,0,3,0,9,2,0,0,73,0
"org.apache.jackrabbit.spi.commons.PropertyInfoImpl",7,0.12,1.14,31,0.36,8380.48,11,4,8,20,11,76.17,56,48,3,2,124.27,1.00,0.33,0.14,0,27.00,2,1087.46,0,3,8,org.apache.jackrabbit.spi.commons.ItemInfoImpl,0.00,13,1,8,1,13,4,1,12,245,1
"org.apache.jackrabbit.spi.commons.QItemDefinitionImpl",10,0.05,1.70,45,0.56,18775.30,17,7,5,22,6,80.35,72,69,2,1,122.64,0.00,0.00,0.19,3,42.00,5,1686.07,0,2,4,java.lang.Object,0.00,12,0,17,2,12,8,2,20,374,2
"org.apache.jackrabbit.spi.commons.QNodeDefinitionImpl",10,0.03,2.10,48,0.86,29161.81,14,4,12,44,9,72.98,87,89,3,2,121.09,0.00,0.50,0.22,0,22.00,4,2580.93,2,3,6,org.apache.jackrabbit.spi.commons.QItemDefinitionImpl,0.10,34,1,21,0,34,7,1,18,541,1
"org.apache.jackrabbit.spi.commons.QNodeTypeDefinitionImpl",23,0.01,2.57,166,2.81,173483.75,35,12,28,98,24,76.50,150,282,8,1,108.72,0.00,0.00,0.08,3,231.00,11,8429.53,0,12,16,java.lang.Object,0.00,75,0,59,0,75,11,2,44,1587,1
"org.apache.jackrabbit.spi.commons.QPropertyDefinitionImpl",14,0.07,2.07,72,1.34,61202.27,22,8,15,50,13,67.98,118,133,3,2,116.09,0.00,0.50,0.19,0,62.00,7,4024.66,2,4,10,org.apache.jackrabbit.spi.commons.QItemDefinitionImpl,0.08,36,1,29,0,36,10,1,25,803,1
"org.apache.jackrabbit.spi.commons.SerializableBatch",13,0.08,1.08,42,0.52,10383.29,15,2,19,24,6,180.33,24,64,0,1,130.33,0.00,0.00,0.42,0,0.00,2,1561.65,0,1,6,java.lang.Object,0.00,11,0,14,0,11,12,2,6,363,1
"org.apache.jackrabbit.spi.commons.SerializableBatch$AddNode",2,0.50,1.00,12,0.11,1497.16,6,4,19,3,3,169.34,3,15,0,1,119.34,0.00,0.00,0.50,0,2.00,1,329.26,0,0,3,java.lang.Object,0.00,1,0,2,0,1,2,1,1,84,2
"org.apache.jackrabbit.spi.commons.SerializableBatch$AddProperty",2,0.50,1.50,15,0.14,2432.83,6,4,19,3,4,165.09,3,20,0,1,115.09,0.00,0.00,0.50,0,2.00,2,420.06,0,0,4,java.lang.Object,0.00,1,0,3,0,1,2,1,1,101,2
"org.apache.jackrabbit.spi.commons.SerializableBatch$Move",2,0.33,1.00,10,0.09,1155.23,5,3,19,3,3,173.18,3,13,0,1,123.18,0.00,0.00,0.50,0,2.00,1,258.40,0,0,3,java.lang.Object,0.00,1,0,2,0,1,2,1,1,69,2
"org.apache.jackrabbit.spi.commons.SerializableBatch$Operation",1,0.00,1.00,2,0.01,88.08,1,0,19,1,1,102.16,7,3,0,2,144.46,0.00,0.50,0.00,0,1.00,1,44.04,0,0,1,,0.00,0,1,1,0,0,1,0,1,15,1
"org.apache.jackrabbit.spi.commons.SerializableBatch$Remove",2,1.00,1.00,6,0.05,478.47,3,1,19,3,2,184.47,3,9,0,1,134.47,0.00,0.00,0.50,0,2.00,1,135.35,0,0,2,java.lang.Object,0.00,1,0,2,0,1,2,1,1,39,2
"org.apache.jackrabbit.spi.commons.SerializableBatch$ReorderNodes",2,0.33,1.00,10,0.08,1275.81,5,3,19,3,2,172.84,3,13,0,1,122.84,0.00,0.00,0.50,0,2.00,1,252.33,0,0,2,java.lang.Object,0.00,1,0,2,0,1,2,1,1,69,2
"org.apache.jackrabbit.spi.commons.SerializableBatch$SetMixins",2,0.00,1.00,8,0.07,904.53,4,2,19,3,3,177.63,3,11,0,1,127.63,0.00,0.00,0.50,0,2.00,1,208.76,0,0,3,java.lang.Object,0.00,1,0,2,0,1,2,1,1,56,2
"org.apache.jackrabbit.spi.commons.SerializableBatch$SetPrimaryType",2,0.00,1.00,8,0.07,752.94,4,2,19,3,3,178.26,3,11,0,1,128.26,0.00,0.00,0.50,0,2.00,1,196.96,0,0,3,java.lang.Object,0.00,1,0,2,0,1,2,1,1,54,2
"org.apache.jackrabbit.spi.commons.SerializableBatch$SetValue",2,0.33,1.50,13,0.11,1944.51,5,3,19,3,3,168.35,3,17,0,1,118.35,0.00,0.00,0.50,0,2.00,2,342.29,0,0,3,java.lang.Object,0.00,1,0,3,0,1,2,1,1,85,2
"org.apache.jackrabbit.spi.commons.SessionInfoImpl",9,0.12,1.00,22,0.17,2676.24,13,4,5,14,3,122.42,50,32,2,1,140.29,0.00,0.00,0.14,0,32.00,1,524.22,0,3,1,java.lang.Object,0.00,5,0,9,1,5,6,2,15,143,1
"org.apache.jackrabbit.core.integration.random.task.ContentOperationsTask",2,0.00,1.00,5,0.06,815.97,2,0,3,3,4,189.21,3,11,1,2,139.21,0.00,0.50,0.00,0,2.00,1,189.26,0,1,3,org.apache.jackrabbit.core.integration.random.task.RandomOperationsTask,0.00,1,1,2,0,1,1,0,1,49,1
"org.apache.jackrabbit.core.integration.random.task.RandomOperationsTask",5,0.00,1.60,32,0.42,13947.60,11,6,7,18,5,164.73,5,48,2,1,114.73,0.00,0.00,0.17,1,11.00,4,1262.57,0,1,3,java.lang.Object,0.00,13,0,8,2,13,4,1,3,259,2
"org.apache.jackrabbit.core.integration.random.task.VersionOperationsTask",2,0.00,1.00,6,0.06,835.17,2,0,3,3,4,182.56,3,12,1,2,132.56,0.00,0.50,0.00,0,2.00,1,193.26,0,1,3,org.apache.jackrabbit.core.integration.random.task.RandomOperationsTask,0.00,1,1,2,0,1,1,0,1,50,1
"org.apache.jackrabbit.core.fs.AbstractFileSystemTest",6,0.10,1.33,101,1.43,130422.92,8,2,5,30,4,131.75,15,113,2,2,91.86,3.00,0.20,0.42,2,0.00,3,4295.55,0,1,2,junit.framework.TestCase,0.00,24,1,8,3,24,5,0,13,770,2
"org.apache.jackrabbit.core.fs.BasedFileSystem",18,0.03,1.44,56,0.59,13272.47,20,2,2,38,7,151.15,60,83,5,1,130.54,0.00,0.00,0.47,1,0.00,6,1782.66,0,6,2,java.lang.Object,0.00,20,0,26,0,20,12,1,21,437,1
"org.apache.jackrabbit.core.fs.FileSystem",16,2.00,1.00,19,0.15,797.39,18,2,2,16,48,107.63,146,20,47,1,157.63,0.00,0.00,0.00,0,16.00,1,436.96,0,5,1,,0.00,0,0,16,0,0,11,0,19,144,1
"org.apache.jackrabbit.core.fs.FileSystemException",2,0.00,1.00,5,0.03,221.18,2,0,0,2,27,95.20,20,8,27,2,143.68,0.00,0.50,0.00,0,2.00,1,88.69,0,0,0,java.lang.Exception,0.00,0,1,2,0,0,2,0,3,29,1
"org.apache.jackrabbit.core.fs.FileSystemFactory",1,0.00,1.00,2,0.01,38.26,1,0,1,1,6,127.16,14,3,5,1,147.31,0.00,0.00,0.00,0,1.00,1,25.51,0,1,1,,0.00,0,0,1,0,0,0,0,2,11,1
"org.apache.jackrabbit.core.fs.FileSystemPathUtil",9,0.12,2.44,94,1.08,53821.33,13,4,2,32,7,53.75,84,104,5,1,103.75,0.00,0.00,0.14,1,33.00,7,3232.14,0,6,2,java.lang.Object,0.00,23,0,22,0,23,3,0,20,641,2
"org.apache.jackrabbit.core.fs.FileSystemResource",17,0.12,1.53,59,0.56,14638.74,19,2,4,32,26,112.12,89,90,23,1,129.99,0.00,0.00,0.62,3,0.00,5,1681.57,0,7,3,java.lang.Object,0.00,15,0,26,0,15,10,0,20,410,1
"org.apache.jackrabbit.core.fs.RandomAccessOutputStream",1,0.00,1.00,2,0.02,132.18,1,0,2,1,0,122.92,14,3,0,2,143.07,0.00,0.50,0.00,0,1.00,1,52.87,0,0,0,java.io.OutputStream,0.00,0,1,1,0,0,1,0,2,17,2
"org.apache.jackrabbit.core.fs.TestAll",1,0.00,1.00,7,0.06,1740.69,1,0,6,3,3,65.85,8,9,0,2,113.96,0.00,0.50,0.00,0,1.00,1,186.48,0,1,3,junit.framework.TestCase,0.00,2,1,1,0,2,0,0,2,47,1
"org.apache.jackrabbit.spi.commons.util.StringCache",9,0.08,3.33,75,0.79,35933.83,12,3,1,19,1,129.29,34,108,1,1,108.68,0.00,0.00,0.26,2,21.00,7,2368.25,0,4,0,java.lang.Object,0.00,10,0,30,0,10,5,0,15,496,1
"org.apache.jackrabbit.core.fs.local.FileUtil",3,0.00,4.67,38,0.46,29992.15,3,0,3,17,2,50.79,25,47,2,1,98.89,0.00,0.00,0.00,2,3.00,9,1373.03,0,0,0,java.lang.Object,0.00,14,0,14,0,14,3,0,8,262,2
"org.apache.jackrabbit.core.fs.local.HandleMonitor",6,0.00,1.50,28,0.28,6106.33,8,2,9,17,3,82.47,43,36,2,1,124.76,0.00,0.00,0.50,1,0.00,2,837.63,0,1,1,java.lang.Object,0.00,11,0,9,0,11,5,0,10,200,1
"org.apache.jackrabbit.core.fs.local.HandleMonitor$Handle",5,0.12,1.60,24,0.24,5412.31,7,2,9,14,1,106.67,29,33,0,1,124.54,0.00,0.00,0.60,1,2.00,3,728.23,0,1,1,java.lang.Object,0.00,9,0,8,0,9,4,0,8,174,1
"org.apache.jackrabbit.core.fs.local.HandleMonitor$Handle$MonitoredInputStream",3,1.00,1.00,9,0.07,820.15,4,1,9,5,1,134.25,13,13,0,3,134.01,0.00,0.67,0.33,0,4.00,1,213.99,1,0,1,org.apache.jackrabbit.util.LazyFileInputStream,0.19,2,2,3,0,2,3,0,5,60,1
"org.apache.jackrabbit.core.fs.local.LocalFileSystem",26,0.09,2.19,171,1.94,72571.03,29,3,12,57,16,135.27,86,228,11,1,114.66,0.00,0.00,0.42,3,0.00,6,5829.63,0,8,5,java.lang.Object,0.00,31,0,57,0,31,18,1,25,1221,1
"org.apache.jackrabbit.core.fs.local.LocalFileSystem$FileFilter",1,0.00,1.00,3,0.02,173.90,1,0,12,2,0,135.56,0,4,0,1,135.56,0.00,0.00,0.00,0,1.00,1,52.97,0,0,0,java.lang.Object,0.00,1,0,1,0,1,1,0,0,17,0
"org.apache.jackrabbit.core.fs.local.LocalFileSystem$FileFilter_0",1,0.00,1.00,3,0.02,173.90,1,0,12,2,0,135.56,0,4,0,1,135.56,0.00,0.00,0.00,0,1.00,1,52.97,0,0,0,java.lang.Object,0.00,1,0,1,0,1,1,0,0,17,0
"org.apache.jackrabbit.core.fs.local.LocalFileSystemTest",4,0.33,1.25,22,0.19,4387.59,5,1,4,11,4,120.93,3,25,1,3,120.93,0.00,0.67,0.75,1,0.00,2,560.81,2,1,3,org.apache.jackrabbit.core.fs.AbstractFileSystemTest,0.90,7,2,5,0,7,3,0,1,134,1
"org.apache.jackrabbit.api.security.user.AbstractUserTest",13,1.00,1.92,60,0.74,23269.68,14,1,19,41,19,172.78,15,89,8,4,122.78,6.33,0.13,0.08,3,24.00,4,2230.85,1,11,11,org.apache.jackrabbit.test.AbstractJCRTest,0.10,28,3,25,19,28,2,0,5,492,2
"org.apache.jackrabbit.api.security.user.Authorizable",13,0.00,1.00,14,0.11,671.38,13,0,4,13,39,107.51,127,15,39,1,157.51,0.00,0.00,0.00,0,13.00,1,334.46,0,7,0,,0.00,0,0,13,0,0,6,0,14,111,1
"org.apache.jackrabbit.api.security.user.AuthorizableExistsException",1,1.00,1.00,4,0.03,332.00,2,1,1,1,10,96.47,6,6,10,2,128.69,0.00,0.50,0.00,0,1.00,1,87.11,0,0,0,javax.jcr.RepositoryException,0.00,0,1,1,0,0,1,0,2,25,1
"org.apache.jackrabbit.api.security.user.AuthorizableTest",19,0.00,2.74,286,3.50,177122.48,19,0,11,59,9,145.64,27,330,1,5,95.64,0.00,0.80,0.00,0,0.00,5,10496.94,5,0,8,org.apache.jackrabbit.api.security.user.AbstractUserTest,0.00,40,4,52,0,40,19,0,21,1935,1
"org.apache.jackrabbit.api.security.user.Group",5,0.00,1.00,6,0.05,286.84,5,0,2,5,30,114.86,39,7,29,2,157.15,0.00,0.50,0.00,0,5.00,1,147.15,0,2,1,,0.00,0,1,5,0,0,3,0,6,49,1
"org.apache.jackrabbit.api.security.user.GroupTest",24,0.00,2.67,355,4.21,200486.67,24,0,7,62,7,97.14,16,424,1,5,97.14,0.00,0.80,0.00,4,0.00,8,12622.34,4,0,6,org.apache.jackrabbit.api.security.user.AbstractUserTest,0.00,38,4,64,0,38,24,0,8,2435,1
"org.apache.jackrabbit.api.security.user.Impersonation",4,0.00,1.00,5,0.03,146.26,4,0,4,4,13,108.69,38,6,12,1,158.69,0.00,0.00,0.00,0,4.00,1,97.51,0,1,1,,0.00,0,0,4,0,0,3,0,5,35,1
"org.apache.jackrabbit.api.security.user.ImpersonationTest",18,0.04,1.22,118,1.28,26112.61,21,3,10,34,5,117.03,5,163,1,5,117.03,0.00,0.80,0.37,1,0.00,2,3851.18,9,2,4,org.apache.jackrabbit.api.security.user.AbstractUserTest,0.18,16,4,22,0,16,16,0,3,822,1
"org.apache.jackrabbit.api.security.user.NestedGroupTest",10,1.00,2.70,96,1.04,53498.59,11,1,8,23,8,105.82,5,126,1,5,105.82,0.00,0.80,0.00,3,10.00,8,3129.23,4,1,7,org.apache.jackrabbit.api.security.user.AbstractUserTest,0.20,13,4,27,0,13,9,0,3,649,1
"org.apache.jackrabbit.api.security.user.TestAll",1,0.00,1.00,12,0.13,4399.74,1,0,3,3,8,59.76,7,14,0,2,102.05,0.00,0.50,0.00,0,1.00,1,381.92,0,1,8,junit.framework.TestCase,0.00,2,1,1,0,2,0,0,1,87,1
"org.apache.jackrabbit.api.security.user.User",7,0.00,1.00,8,0.05,209.25,7,0,2,7,35,117.09,55,9,34,2,159.38,0.00,0.50,0.00,0,7.00,1,136.13,0,3,1,,0.00,0,1,7,0,0,4,0,8,51,1
"org.apache.jackrabbit.api.security.user.UserManager",10,3.00,1.00,14,0.14,942.99,13,3,4,10,49,145.09,156,16,45,1,155.45,0.00,0.00,0.00,0,10.00,1,431.99,0,6,4,,0.00,0,0,10,0,0,4,0,14,126,1
"org.apache.jackrabbit.api.security.user.UserManagerCreateGroupTest",8,0.14,2.00,67,0.76,17256.19,10,2,7,31,6,160.90,11,89,1,5,110.90,0.00,0.80,0.38,1,0.00,4,2279.09,3,2,5,org.apache.jackrabbit.api.security.user.AbstractUserTest,0.11,23,4,16,0,23,6,0,9,475,1
"org.apache.jackrabbit.api.security.user.UserManagerCreateUserTest",18,0.06,1.89,143,1.73,37945.63,20,2,7,38,6,163.15,19,191,1,5,113.15,0.00,0.80,0.44,1,0.00,4,5176.43,3,2,5,org.apache.jackrabbit.api.security.user.AbstractUserTest,0.09,20,4,34,0,20,16,0,17,1076,1
"org.apache.jackrabbit.api.security.user.UserManagerTest",2,0.00,2.50,20,0.22,6093.31,2,0,5,7,4,145.94,5,22,1,5,106.05,0.00,0.80,0.00,0,0.00,3,672.14,1,0,3,org.apache.jackrabbit.api.security.user.AbstractUserTest,0.00,5,4,5,0,5,2,0,3,138,1
"org.apache.jackrabbit.api.security.user.UserTest",7,1.00,2.29,86,1.17,47902.93,8,1,9,41,5,140.24,19,113,1,5,100.35,0.00,0.80,0.00,0,0.00,7,3518.51,5,0,4,org.apache.jackrabbit.api.security.user.AbstractUserTest,0.00,34,4,16,0,34,7,0,17,635,1
"org.apache.jackrabbit.core.nodetype.BitSetENTCacheImpl",13,0.08,1.77,86,0.90,26587.80,19,6,7,42,6,83.55,90,107,3,1,115.77,0.00,0.00,0.24,5,5.00,4,2708.43,0,4,3,java.lang.Object,0.00,29,0,23,0,29,9,1,27,603,1
"org.apache.jackrabbit.core.nodetype.BitSetENTCacheImpl$BitSetKey",12,0.09,3.42,124,1.61,102255.17,15,3,7,21,2,70.24,79,149,0,1,102.46,0.00,0.00,0.42,1,0.00,8,4819.69,0,3,2,java.lang.Object,0.00,9,0,41,0,9,9,1,18,959,1
"org.apache.jackrabbit.core.nodetype.CyclicNodeTypeRegistrationTest",5,0.60,2.40,107,1.83,100800.56,10,5,17,37,14,58.20,69,124,0,4,87.58,0.00,0.75,0.68,0,0.00,3,5490.28,2,0,14,org.apache.jackrabbit.test.AbstractJCRTest,0.26,32,3,12,0,32,5,0,19,957,1
"org.apache.jackrabbit.core.nodetype.EffectiveNodeType",41,0.03,5.05,548,7.53,641769.84,49,8,21,129,30,53.75,289,766,22,1,96.04,0.00,0.00,0.16,9,436.00,24,22601.42,0,29,10,java.lang.Object,0.00,88,0,207,0,88,12,1,129,4136,1
"org.apache.jackrabbit.core.nodetype.EffectiveNodeTypeCache",8,0.00,1.00,10,0.06,224.51,8,0,2,8,6,127.37,53,11,4,3,159.60,0.00,0.67,0.00,0,8.00,1,168.83,0,1,3,,0.00,0,2,8,0,0,7,0,10,62,1
"org.apache.jackrabbit.core.nodetype.EffectiveNodeTypeCache$Key",3,0.00,1.00,4,0.02,72.40,3,0,2,3,1,117.82,22,5,0,2,160.11,0.00,0.50,0.00,0,3.00,1,54.98,0,2,1,,0.00,0,1,3,0,0,1,0,3,23,0
"org.apache.jackrabbit.core.nodetype.EffectiveNodeTypeCacheImpl",11,0.10,1.82,63,0.60,12933.92,13,2,10,32,4,72.51,91,81,1,1,120.61,0.00,0.00,0.59,4,0.00,4,1796.26,0,1,3,java.lang.Object,0.00,21,0,20,0,21,10,1,33,418,1
"org.apache.jackrabbit.core.nodetype.EffectiveNodeTypeCacheImpl$WeightedKey",11,0.05,1.82,68,0.68,24613.45,13,2,10,25,1,115.69,51,76,0,1,115.46,0.00,0.00,0.45,0,0.00,5,2032.43,0,2,1,java.lang.Object,0.00,14,0,20,0,14,9,1,19,450,2
"org.apache.jackrabbit.core.nodetype.InvalidNodeTypeDefException",2,0.00,1.00,5,0.03,221.18,2,0,0,2,10,93.68,18,8,10,2,143.68,0.00,0.50,0.00,0,2.00,1,88.69,0,0,0,java.lang.Exception,0.00,0,1,2,0,0,2,0,3,29,1
"org.apache.jackrabbit.core.nodetype.NodeTypeConflictException",2,0.00,1.00,5,0.03,221.18,2,0,0,2,13,93.68,18,8,13,2,143.68,0.00,0.50,0.00,0,2.00,1,88.69,0,0,0,java.lang.Exception,0.00,0,1,2,0,0,2,0,3,29,1
"org.apache.jackrabbit.core.nodetype.NodeTypeDefStore",10,0.22,1.30,31,0.36,7228.04,11,1,18,26,10,130.86,48,50,1,1,130.63,0.00,0.00,0.80,1,0.00,3,1069.93,0,2,9,java.lang.Object,0.00,16,0,13,0,16,8,0,12,251,1
"org.apache.jackrabbit.core.nodetype.NodeTypeDefinitionImpl",10,0.22,1.70,61,0.60,16812.87,14,4,14,26,7,74.16,71,73,0,1,116.45,0.00,0.00,0.45,0,0.00,3,1802.97,0,5,7,java.lang.Object,0.00,16,0,17,0,16,5,1,15,401,1
"org.apache.jackrabbit.core.nodetype.NodeTypeImpl",20,0.14,3.20,196,2.34,107006.49,25,5,26,62,33,57.67,169,259,22,2,105.78,0.00,0.50,0.33,1,0.00,15,7011.81,0,9,12,org.apache.jackrabbit.spi.commons.nodetype.AbstractNodeType,0.00,42,1,64,0,42,11,2,67,1357,1
"org.apache.jackrabbit.core.nodetype.NodeTypeManagerImpl",23,0.06,2.91,221,3.21,156986.76,29,6,48,109,35,54.97,209,315,11,2,104.97,0.00,0.50,0.22,4,0.00,13,9629.14,0,16,26,org.apache.jackrabbit.spi.commons.nodetype.AbstractNodeTypeManager,0.06,86,1,67,0,86,7,3,51,1778,1
"org.apache.jackrabbit.core.nodetype.NodeTypeRegistry",45,0.03,4.51,696,10.85,1301938.70,57,12,45,229,53,71.51,638,994,30,1,91.65,0.00,0.00,0.11,19,744.00,54,32559.11,0,6,24,java.lang.Object,0.00,184,0,203,0,184,39,2,200,5362,1
"org.apache.jackrabbit.core.nodetype.NodeTypeRegistryListener",3,0.00,1.00,4,0.02,103.08,3,0,2,3,3,116.61,22,5,2,1,158.90,0.00,0.00,0.00,0,3.00,1,69.55,0,0,1,,0.00,0,0,3,0,0,3,0,4,26,1
"org.apache.jackrabbit.core.nodetype.NodeTypesInContentTest",2,1.00,1.50,14,0.19,3230.51,3,1,13,15,7,96.25,11,18,1,4,114.12,0.00,0.75,0.50,0,0.00,2,577.96,1,0,6,org.apache.jackrabbit.test.AbstractJCRTest,0.14,13,3,3,0,13,2,0,3,120,1
"org.apache.jackrabbit.core.nodetype.NodeTypesInContentTest$TraversingItemVisitor.Default",1,0.00,3.00,10,0.12,3100.02,1,0,13,7,0,105.95,0,10,0,1,105.95,0.00,0.00,0.00,0,1.00,3,345.51,0,0,0,java.lang.Object,0.00,6,0,3,0,6,1,0,0,72,0
"org.apache.jackrabbit.core.nodetype.TestAll",1,0.00,1.00,5,0.04,864.35,1,0,3,3,1,73.32,10,7,0,2,121.80,0.00,0.50,0.00,0,1.00,1,115.51,0,1,1,junit.framework.TestCase,0.00,2,1,1,0,2,0,0,2,31,1
"org.apache.jackrabbit.standalone.cli.xml.AbstractExportViewToFile",13,0.10,1.23,49,0.60,15844.30,19,6,14,27,4,110.98,65,77,2,1,128.85,0.00,0.00,0.08,2,79.00,3,1810.16,0,6,2,java.lang.Object,0.00,14,0,16,2,14,7,1,21,388,2
"org.apache.jackrabbit.standalone.cli.xml.ExportDocViewToFile",1,0.00,1.00,3,0.05,621.35,1,0,5,4,1,88.91,7,11,0,2,131.21,0.00,0.50,0.00,0,1.00,1,156.06,0,0,1,org.apache.jackrabbit.standalone.cli.xml.AbstractExportViewToFile,0.00,3,1,1,0,3,1,0,2,38,1
"org.apache.jackrabbit.standalone.cli.xml.ExportSysViewToFile",1,0.00,1.00,3,0.05,621.35,1,0,5,4,1,88.91,7,11,0,2,131.21,0.00,0.50,0.00,0,1.00,1,156.06,0,0,1,org.apache.jackrabbit.standalone.cli.xml.AbstractExportViewToFile,0.00,3,1,1,0,3,1,0,2,38,1
"org.apache.jackrabbit.standalone.cli.xml.ImportXmlFromInputStream",9,0.16,1.11,34,0.41,11755.88,13,4,7,21,1,128.88,39,47,0,1,128.64,0.00,0.00,0.11,0,37.00,2,1228.82,0,4,1,java.lang.Object,0.00,12,0,10,0,12,5,1,15,261,1
"org.apache.jackrabbit.test.api.lock.AbstractLockTest",30,0.15,1.60,189,2.40,70205.59,35,5,18,79,8,135.95,90,267,3,4,115.33,1.00,0.43,0.35,2,0.00,4,7199.45,6,2,5,org.apache.jackrabbit.test.AbstractJCRTest,0.14,49,3,48,3,49,28,0,42,1503,2
"org.apache.jackrabbit.test.api.lock.DeepLockTest",8,1.00,1.88,53,0.61,13157.72,9,1,7,28,3,166.50,9,81,1,5,116.50,0.00,0.80,0.00,0,0.00,5,1833.25,2,0,2,org.apache.jackrabbit.test.api.lock.AbstractLockTest,0.16,20,4,15,0,20,8,0,9,389,1
"org.apache.jackrabbit.test.api.lock.LockManagerTest",23,0.35,1.57,194,2.42,45874.27,27,4,14,58,3,161.22,24,265,1,4,111.22,0.00,0.75,0.59,3,0.00,3,7266.97,4,1,2,org.apache.jackrabbit.test.AbstractJCRTest,0.16,35,3,36,0,35,22,0,24,1426,1
"org.apache.jackrabbit.test.api.lock.LockTest",24,0.00,1.54,278,3.56,84267.95,24,0,9,72,3,56.03,211,369,1,4,104.13,0.00,0.75,0.00,1,0.00,3,10667.64,2,1,2,org.apache.jackrabbit.test.AbstractJCRTest,0.00,48,3,37,0,48,23,0,143,2064,1
"org.apache.jackrabbit.test.api.lock.OpenScopedLockTest",3,1.00,1.00,8,0.06,699.10,4,1,2,6,2,191.13,4,12,1,5,141.13,0.00,0.80,0.00,0,4.00,1,172.97,0,0,1,org.apache.jackrabbit.test.api.lock.AbstractLockTest,0.17,3,4,3,0,3,3,0,2,49,1
"org.apache.jackrabbit.test.api.lock.SessionScopedLockTest",5,1.00,1.60,39,0.52,12237.68,6,1,9,23,3,133.30,15,55,1,5,112.68,0.00,0.80,0.00,0,10.00,3,1549.25,3,0,2,org.apache.jackrabbit.test.api.lock.AbstractLockTest,0.16,18,4,8,0,18,5,0,8,297,1
"org.apache.jackrabbit.test.api.lock.SetValueLockExceptionTest",5,0.40,5.00,123,1.85,88898.86,26,21,13,29,3,37.57,41,159,1,4,85.68,0.00,0.75,0.37,1,0.00,15,5541.18,5,1,2,org.apache.jackrabbit.test.AbstractJCRTest,0.26,24,3,25,0,24,4,0,15,921,1
"org.apache.jackrabbit.test.api.lock.TestAll",1,0.00,1.00,10,0.10,3275.34,1,0,3,3,7,68.45,12,12,1,2,106.02,0.00,0.50,0.00,0,1.00,1,301.01,0,1,6,junit.framework.TestCase,0.00,2,1,1,0,2,0,0,3,71,1
"org.apache.jackrabbit.rmi.value.AbstractValue",11,0.50,1.55,40,0.42,8563.00,13,2,13,24,9,80.34,106,69,9,1,130.33,0.00,0.00,0.05,2,20.00,3,1247.09,0,6,0,java.lang.Object,0.00,13,0,17,9,13,5,2,16,298,1
"org.apache.jackrabbit.rmi.value.AbstractValue$Binary",4,0.00,1.25,14,0.13,3591.83,4,0,13,7,0,129.89,0,19,0,1,129.89,0.00,0.00,0.00,0,4.00,2,377.81,0,1,0,java.lang.Object,0.00,3,0,5,0,3,3,0,0,90,0
"org.apache.jackrabbit.rmi.value.AbstractValue$FilterInputStream",1,0.00,1.00,4,0.03,387.58,1,0,13,2,0,128.16,0,6,0,1,128.16,0.00,0.00,0.00,0,1.00,1,98.61,1,0,0,java.lang.Object,0.00,1,0,1,0,1,1,0,0,28,0
"org.apache.jackrabbit.rmi.value.BinaryValue",10,0.22,1.30,38,0.40,10860.10,13,3,11,24,2,179.24,19,55,1,1,129.24,0.00,0.00,0.13,1,22.00,3,1186.46,0,5,1,java.lang.Object,0.00,14,0,13,0,14,5,2,6,269,0
"org.apache.jackrabbit.rmi.value.BooleanValue",4,0.33,1.00,11,0.08,853.16,6,2,1,5,2,123.56,21,17,1,2,141.43,0.00,0.50,0.25,0,4.00,1,229.27,0,1,1,org.apache.jackrabbit.rmi.value.AbstractValue,0.13,1,1,4,0,1,3,0,7,65,0
"org.apache.jackrabbit.rmi.value.DateValue",7,0.03,1.43,48,0.80,60996.99,12,5,7,20,2,90.72,102,63,1,2,110.86,0.00,0.50,0.23,0,0.00,4,2390.39,0,3,1,org.apache.jackrabbit.rmi.value.AbstractValue,0.44,13,1,10,0,13,4,0,25,442,0
"org.apache.jackrabbit.rmi.value.DecimalValue",7,0.00,1.14,24,0.25,6642.75,11,4,4,15,2,111.85,39,40,1,2,129.73,0.00,0.50,0.25,1,0.00,2,750.16,0,3,1,org.apache.jackrabbit.rmi.value.AbstractValue,0.44,8,1,8,0,8,4,0,12,178,0
"org.apache.jackrabbit.rmi.value.DoubleValue",7,0.17,1.14,22,0.19,5011.45,9,2,4,12,2,130.93,34,36,1,2,130.69,0.00,0.50,0.36,0,0.00,2,584.23,0,3,1,org.apache.jackrabbit.rmi.value.AbstractValue,0.44,5,1,8,0,5,4,0,10,146,0
"org.apache.jackrabbit.rmi.value.LongValue",7,0.17,1.00,19,0.14,2041.62,9,2,3,11,2,140.60,29,31,1,2,140.36,0.00,0.50,0.36,0,0.00,1,421.17,0,3,1,org.apache.jackrabbit.rmi.value.AbstractValue,0.44,4,1,7,0,4,4,0,10,117,0
"org.apache.jackrabbit.rmi.value.NameValue",3,0.50,1.00,9,0.07,823.24,5,2,3,3,2,101.78,20,13,1,2,134.00,0.00,0.50,0.17,0,4.00,1,200.63,0,1,1,org.apache.jackrabbit.rmi.value.AbstractValue,0.00,0,1,3,0,0,2,0,7,55,1
"org.apache.jackrabbit.rmi.value.PathValue",3,0.50,1.00,9,0.07,837.75,5,2,3,3,2,101.72,20,13,1,2,133.94,0.00,0.50,0.17,0,4.00,1,205.46,0,1,1,org.apache.jackrabbit.rmi.value.AbstractValue,0.00,0,1,3,0,0,2,0,7,56,1
"org.apache.jackrabbit.rmi.value.ReferenceValue",3,0.50,1.00,9,0.07,837.75,5,2,3,3,2,91.65,21,13,1,2,133.94,0.00,0.50,0.17,0,4.00,1,205.46,0,1,1,org.apache.jackrabbit.rmi.value.AbstractValue,0.00,0,1,3,0,0,2,0,7,56,1
"org.apache.jackrabbit.rmi.value.SerialValueFactory",19,0.89,1.58,77,0.97,35219.27,20,1,14,51,21,143.32,67,130,10,1,122.70,0.00,0.00,0.16,3,58.00,4,2923.52,0,18,11,java.lang.Object,0.00,32,0,30,0,32,1,1,17,633,1
"org.apache.jackrabbit.rmi.value.SerializableBinary",8,0.34,3.38,101,1.24,76006.55,13,5,14,31,1,149.14,11,140,1,1,99.14,0.00,0.00,0.50,1,0.00,6,3707.87,0,1,0,java.lang.Object,0.00,23,0,27,0,23,7,2,3,694,0
"org.apache.jackrabbit.rmi.value.StringValue",8,0.14,3.25,96,1.49,189423.66,10,2,6,24,3,47.92,64,133,2,2,96.03,0.00,0.50,0.38,0,0.00,16,4459.27,0,3,1,org.apache.jackrabbit.rmi.value.AbstractValue,0.53,16,1,26,0,16,5,0,41,750,0
"org.apache.jackrabbit.jcr.DocViewImportHandler",8,0.04,3.62,103,1.63,97003.08,12,4,18,40,9,60.73,97,149,1,3,98.29,0.00,0.67,0.22,2,14.00,10,4903.24,0,1,8,org.apache.jackrabbit.jcr2spi.xml.TargetImportHandler,0.00,32,2,29,0,32,7,0,39,856,0
"org.apache.jackrabbit.jcr.ImportHandler",12,0.14,1.75,83,1.03,27190.41,23,11,20,41,13,67.32,102,126,1,2,115.42,0.00,0.50,0.22,0,26.00,5,3085.36,0,1,12,org.xml.sax.helpers.DefaultHandler,0.00,29,1,21,0,29,11,0,43,634,1
"org.apache.jackrabbit.jcr.ImportHandler$NamespaceContext",7,0.25,1.86,32,0.28,7589.69,9,2,20,17,2,164.38,16,45,0,1,124.50,0.00,0.00,0.71,0,0.00,4,841.34,0,2,2,java.lang.Object,0.00,10,0,13,0,10,5,1,5,201,0
"org.apache.jackrabbit.jcr.Importer",4,0.00,1.00,8,0.05,355.83,4,0,6,4,9,112.20,25,10,7,1,144.42,0.00,0.00,0.00,0,4.00,1,164.34,0,0,2,,0.00,0,0,4,0,0,4,0,7,51,1
"org.apache.jackrabbit.jcr.Importer$NodeInfo",6,0.10,1.00,20,0.13,2262.30,10,4,6,6,1,132.91,0,27,0,1,132.91,0.00,0.00,0.17,0,22.00,1,396.66,0,4,1,java.lang.Object,0.00,0,0,6,0,0,2,0,0,111,1
"org.apache.jackrabbit.jcr.Importer$PropInfo",4,0.11,1.00,14,0.09,1305.18,7,3,6,4,1,133.41,0,19,0,1,133.41,0.00,0.00,0.25,0,10.00,1,277.40,0,1,1,java.lang.Object,0.00,0,0,4,0,0,3,0,0,77,1
"org.apache.jackrabbit.jcr.Importer$TextValue",3,0.00,1.00,4,0.02,76.13,3,0,6,3,0,127.72,18,5,0,1,159.94,0.00,0.00,0.00,0,3.00,1,52.87,0,2,0,,0.00,0,0,3,0,0,1,0,3,22,0
"org.apache.jackrabbit.jcr.SessionImportTest",7,0.00,1.86,82,1.63,77253.63,7,0,22,49,5,82.30,37,129,1,4,100.18,0.00,0.75,0.00,2,10.00,4,4892.75,2,2,4,org.apache.jackrabbit.test.AbstractJCRTest,0.24,42,3,13,0,42,5,0,14,815,1
"org.apache.jackrabbit.jcr.SessionImporter",16,0.10,4.25,258,4.24,260675.59,25,9,54,127,32,48.45,180,347,1,1,92.58,0.00,0.00,0.20,6,78.00,13,12707.56,0,4,32,java.lang.Object,0.00,111,0,68,0,111,12,2,95,2093,1
"org.apache.jackrabbit.jcr.SysViewImportHandler",6,0.28,7.67,127,2.20,155027.03,16,10,14,38,7,42.34,68,190,1,3,86.46,0.00,0.67,0.33,1,0.00,17,6597.31,1,0,6,org.apache.jackrabbit.jcr2spi.xml.TargetImportHandler,0.00,32,2,46,0,32,6,0,46,1100,0
"org.apache.jackrabbit.jcr.SysViewImportHandler$ImportState",0,0.00,0.00,7,0.07,1292.96,6,6,14,1,2,171.00,18,8,0,1,171.00,0.00,0.00,0.00,0,0.00,0,215.49,0,0,2,java.lang.Object,0.00,1,0,0,0,1,0,0,6,47,0
"org.apache.jackrabbit.jcr.TargetImportHandler",4,0.11,2.25,28,0.30,8654.76,7,3,15,11,5,75.46,48,40,2,2,113.03,2.00,0.25,0.25,0,6.00,4,914.93,0,0,3,org.xml.sax.helpers.DefaultHandler,0.00,7,1,9,2,7,4,0,10,198,1
"org.apache.jackrabbit.jcr.TargetImportHandler$AppendableValue",3,0.00,1.00,4,0.03,218.89,3,0,15,3,0,114.04,21,6,0,2,156.33,0.00,0.50,0.00,0,3.00,1,104.62,0,0,0,,0.00,0,1,3,0,0,3,0,3,34,1
"org.apache.jackrabbit.jcr.TargetImportHandler$BufferedStringValue",7,0.61,3.29,85,0.90,41599.25,13,6,15,25,1,58.46,51,106,0,1,100.75,0.00,0.00,0.69,0,0.00,5,2691.00,0,2,1,java.lang.Object,0.00,18,0,23,0,18,5,1,23,533,1
"org.apache.jackrabbit.jcr.TargetImportHandler$BufferedStringValue$OutputStreamWriter",1,0.00,1.00,4,0.03,410.55,1,0,15,3,0,167.85,2,6,0,1,127.96,0.00,0.00,0.00,0,1.00,1,101.47,1,0,0,java.lang.Object,0.00,2,0,1,0,2,1,0,2,28,0
"org.apache.jackrabbit.jcr.TargetImportHandler$StringValue",4,0.33,1.00,10,0.06,695.71,5,1,15,6,0,142.36,16,15,0,1,142.13,0.00,0.00,0.75,0,0.00,1,187.08,0,2,0,java.lang.Object,0.00,2,0,4,0,2,2,1,5,56,1
"org.apache.jackrabbit.jcr.TestAll",1,0.00,1.00,5,0.04,864.35,1,0,3,3,2,142.42,3,7,1,2,121.80,0.00,0.50,0.00,0,1.00,1,115.51,0,1,1,junit.framework.TestCase,0.00,2,1,1,0,2,0,0,1,31,1
"org.apache.jackrabbit.jcr.WorkspaceContentHandler",12,0.06,1.42,45,0.62,14511.59,18,6,16,33,3,128.85,3,78,1,2,128.85,0.00,0.50,0.22,0,0.00,4,1859.09,0,0,2,org.xml.sax.helpers.DefaultHandler,0.00,21,1,17,0,21,12,0,1,417,1
"org.apache.jackrabbit.webdav.security.report.AbstractSecurityReport",3,1.00,2.67,18,0.24,7860.96,4,1,10,11,11,72.54,22,26,3,1,114.83,0.00,0.00,0.33,0,4.00,4,722.01,0,1,8,java.lang.Object,0.00,8,0,8,3,8,2,1,4,152,2
"org.apache.jackrabbit.webdav.security.report.AclPrincipalReport",2,0.50,3.00,22,0.46,25348.96,4,2,14,23,12,79.45,29,28,0,2,99.59,0.00,0.50,0.25,0,2.00,5,1386.42,1,1,12,org.apache.jackrabbit.webdav.security.report.AbstractSecurityReport,0.00,21,1,6,0,21,1,0,7,239,1
"org.apache.jackrabbit.webdav.security.report.PrincipalMatchReport",4,0.07,1.50,21,0.27,6680.19,9,5,11,10,11,81.89,49,28,0,2,119.46,0.00,0.50,0.25,0,6.00,3,805.78,1,2,11,org.apache.jackrabbit.webdav.security.report.AbstractSecurityReport,0.00,6,1,6,0,6,2,0,8,170,1
"org.apache.jackrabbit.webdav.security.report.PrincipalSearchReport",5,0.06,1.60,33,0.47,18607.70,13,8,16,17,13,84.37,69,42,0,2,113.75,0.00,0.50,0.18,0,9.00,4,1420.55,1,2,13,org.apache.jackrabbit.webdav.security.report.AbstractSecurityReport,0.00,12,1,8,0,12,3,0,12,272,1
"org.apache.jackrabbit.webdav.security.report.PrincipalSearchReport$SearchArgument",3,0.25,1.00,10,0.09,1016.28,5,2,16,6,4,173.17,7,14,0,1,133.28,0.00,0.00,0.67,0,0.00,1,257.08,0,2,4,java.lang.Object,0.00,3,0,3,0,3,1,0,2,67,1
"org.apache.jackrabbit.webdav.security.report.SearchablePropertyReport",5,0.12,1.80,25,0.37,10758.40,9,4,17,17,13,80.98,61,35,0,1,118.55,0.00,0.00,0.15,0,14.00,4,1106.35,0,2,13,java.lang.Object,0.00,12,0,9,0,12,3,1,13,234,1
"org.apache.jackrabbit.webdav.security.report.SearchablePropertyReport$PrincipalSearchProperty",4,0.24,2.25,34,0.37,9164.72,11,7,17,13,6,160.67,7,48,0,1,110.67,0.00,0.00,0.32,0,0.00,3,1112.18,0,1,6,java.lang.Object,0.00,9,0,9,0,9,3,1,5,240,1
"org.apache.jackrabbit.spi.AbstractSPITest",3,0.50,2.67,28,0.40,23173.97,5,2,2,13,7,56.09,32,42,4,2,104.56,13.00,0.07,0.83,0,0.00,5,1186.80,2,1,3,junit.framework.TestCase,0.00,10,1,8,13,10,2,0,8,246,1
"org.apache.jackrabbit.spi.Batch",10,0.00,1.00,11,0.18,1212.26,10,0,9,10,47,201.86,234,12,42,1,154.59,0.00,0.00,0.00,0,10.00,1,537.71,0,0,5,,0.00,0,0,10,0,0,10,0,11,143,1
"org.apache.jackrabbit.spi.ChildInfo",3,0.00,1.00,4,0.01,64.24,3,0,0,3,16,112.42,24,5,15,1,160.52,0.00,0.00,0.00,0,3.00,1,42.83,0,2,1,,0.00,0,0,3,0,0,1,0,4,19,1
"org.apache.jackrabbit.spi.Event",10,8.00,1.00,19,0.29,16403.56,18,8,2,10,18,95.68,97,22,14,1,145.68,0.00,0.00,0.00,0,10.00,1,859.07,0,5,4,,0.00,0,0,10,0,0,5,0,19,217,1
"org.apache.jackrabbit.spi.EventBundle",2,0.00,1.00,3,0.02,163.00,2,0,1,2,15,107.47,20,4,15,1,155.95,0.00,0.00,0.00,0,2.00,1,64.14,0,1,0,,0.00,0,0,2,0,0,1,0,3,22,1
"org.apache.jackrabbit.spi.EventFilter",1,0.00,1.00,2,0.01,79.62,1,0,1,1,16,178.18,20,3,15,2,144.80,0.00,0.50,0.00,0,1.00,1,42.51,0,0,1,,0.00,0,1,1,0,0,1,0,2,15,1
"org.apache.jackrabbit.spi.Helper",8,0.00,1.12,30,0.29,4828.05,11,3,6,17,4,131.51,39,40,1,1,131.28,0.00,0.00,0.33,3,0.00,2,868.92,0,6,3,java.lang.Object,0.00,9,0,9,0,9,2,0,12,210,1
"org.apache.jackrabbit.spi.IdFactory",6,0.00,1.00,7,0.05,234.62,6,0,0,6,42,108.46,57,8,38,1,158.46,0.00,0.00,0.00,0,6.00,1,151.01,0,2,4,,0.00,0,0,6,0,0,4,0,7,52,1
"org.apache.jackrabbit.spi.ItemId",3,0.00,1.00,4,0.01,64.24,3,0,0,3,50,150.16,45,5,49,1,160.52,0.00,0.00,0.00,0,3.00,1,42.83,0,1,1,,0.00,0,0,3,0,0,2,0,4,19,1
"org.apache.jackrabbit.spi.ItemInfo",3,0.00,1.00,4,0.01,64.24,3,0,0,3,23,118.23,21,5,21,1,160.52,0.00,0.00,0.00,0,3.00,1,42.83,0,2,2,,0.00,0,0,3,0,0,1,0,4,19,1
"org.apache.jackrabbit.spi.ItemInfoCache",4,0.00,1.00,6,0.05,379.67,4,0,0,4,13,106.95,40,7,10,1,155.43,0.00,0.00,0.00,0,4.00,1,153.08,0,2,3,,0.00,0,0,4,0,0,2,0,6,47,1
"org.apache.jackrabbit.spi.ItemInfoCache$Entry",3,0.25,2.00,17,0.17,4973.27,5,2,0,5,1,140.03,11,26,0,2,119.41,0.00,0.50,0.67,0,1.00,4,519.98,0,0,1,ItemInfo>,0.00,2,1,6,0,2,3,0,3,123,0
"org.apache.jackrabbit.spi.LockInfo",7,0.00,1.00,8,0.03,133.90,7,0,0,7,20,112.80,56,9,19,1,160.91,0.00,0.00,0.00,0,7.00,1,89.27,0,2,1,,0.00,0,0,7,1,0,5,0,8,39,1
"org.apache.jackrabbit.spi.Name",2,17.00,1.00,20,0.31,6824.97,19,17,1,2,469,115.01,34,21,469,4,105.88,0.00,0.75,0.00,0,2.00,1,944.74,0,2,0,,0.00,0,3,2,0,0,0,0,11,175,1
"org.apache.jackrabbit.spi.NameFactory",2,0.00,1.00,3,0.02,154.32,2,0,0,2,28,118.57,25,4,27,1,156.14,0.00,0.00,0.00,0,2.00,1,73.07,0,0,1,,0.00,0,0,2,0,0,2,0,3,24,1
"org.apache.jackrabbit.spi.NodeId",0,0.00,0.00,1,0.01,31.02,0,0,0,0,139,171.00,4,2,139,2,171.00,0.00,0.50,0.00,0,0.00,0,15.51,0,0,0,,0.00,0,1,0,0,0,0,0,1,6,1
"org.apache.jackrabbit.spi.NodeInfo",7,0.00,1.00,8,0.04,265.30,7,0,1,7,26,110.46,62,9,23,2,158.57,0.00,0.50,0.00,0,7.00,1,129.36,0,3,3,,0.20,0,1,7,0,0,4,0,8,49,1
"org.apache.jackrabbit.spi.Path",21,4.00,1.00,27,0.20,1852.45,25,4,3,21,268,155.21,343,28,268,2,155.68,0.00,0.50,0.00,0,21.00,1,609.06,0,8,0,,0.00,0,1,21,0,0,13,0,28,191,1
"org.apache.jackrabbit.spi.Path$Element",9,0.00,1.00,10,0.04,187.75,9,0,3,9,1,128.39,58,11,0,2,160.61,0.00,0.50,0.00,0,9.00,1,120.00,0,1,1,,0.00,0,1,9,0,0,8,0,9,51,1
"org.apache.jackrabbit.spi.PathFactory",15,0.00,1.00,16,0.18,1240.33,15,0,1,15,42,105.90,149,17,40,1,155.90,0.00,0.00,0.00,0,15.00,1,530.41,0,15,2,,0.00,0,0,15,0,0,0,0,16,159,1
"org.apache.jackrabbit.spi.PropertyId",2,0.00,1.00,3,0.01,65.85,2,0,0,2,69,126.83,13,4,67,2,159.05,0.00,0.50,0.00,0,2.00,1,38.73,0,0,2,,0.00,0,1,2,0,0,2,0,3,16,1
"org.apache.jackrabbit.spi.PropertyInfo",4,0.00,1.00,5,0.02,114.28,4,0,0,4,23,127.31,25,6,21,2,159.53,0.00,0.50,0.00,0,4.00,1,65.85,0,0,2,,0.29,0,1,4,0,0,4,0,5,27,1
"org.apache.jackrabbit.spi.QItemDefinition",8,1.00,1.00,10,0.05,596.40,9,1,1,8,15,124.03,53,11,14,1,156.25,0.00,0.00,0.00,0,8.00,1,153.82,0,0,1,,0.00,0,0,8,0,0,8,0,10,57,1
"org.apache.jackrabbit.spi.QNodeDefinition",3,1.00,1.00,5,0.04,608.40,4,1,1,3,64,104.73,25,6,63,2,152.83,0.00,0.50,0.00,0,3.00,1,111.07,0,0,1,,0.00,0,1,3,0,0,3,0,5,35,1
"org.apache.jackrabbit.spi.QNodeTypeDefinition",11,0.00,1.00,12,0.05,300.56,11,0,1,11,59,117.40,82,13,56,1,159.69,0.00,0.00,0.00,0,11.00,1,163.70,0,1,3,,0.00,0,0,11,0,0,10,0,12,66,1
"org.apache.jackrabbit.spi.QPropertyDefinition",7,1.00,1.00,9,0.06,705.26,8,1,1,7,78,112.93,50,10,76,2,155.22,0.00,0.50,0.00,0,7.00,1,165.31,0,1,2,,0.00,0,1,7,0,0,6,0,9,57,1
"org.apache.jackrabbit.spi.QValue",14,1.00,1.00,16,0.11,963.55,15,1,8,14,107,114.24,109,17,105,1,156.53,0.00,0.00,0.00,0,14.00,1,319.98,0,6,2,,0.00,0,0,14,0,0,8,0,15,111,1
"org.apache.jackrabbit.spi.QValueConstraint",2,1.00,1.00,4,0.03,507.88,3,1,3,2,17,120.69,28,5,16,1,140.83,0.00,0.00,0.00,0,2.00,1,97.47,0,1,1,,0.00,0,0,2,0,0,1,0,4,30,1
"org.apache.jackrabbit.spi.QValueFactory",13,0.00,1.00,14,0.14,853.48,13,0,8,13,47,114.40,101,15,43,1,156.69,0.00,0.00,0.00,0,13.00,1,412.13,0,13,4,,0.00,0,0,13,0,0,0,0,14,128,1
"org.apache.jackrabbit.spi.QValueFactoryTest",45,0.07,1.71,244,3.19,58235.85,51,6,13,91,7,170.30,55,346,1,3,120.30,0.50,0.50,0.23,2,0.00,7,9555.35,1,0,6,org.apache.jackrabbit.spi.AbstractSPITest,0.06,46,2,77,1,46,45,0,38,2051,1
"org.apache.jackrabbit.spi.QValueTest",44,0.07,1.52,240,3.11,56128.57,50,6,13,91,7,170.37,49,332,1,3,120.37,0.50,0.50,0.24,1,0.00,4,9315.21,1,0,6,org.apache.jackrabbit.spi.AbstractSPITest,0.06,47,2,67,1,47,44,0,30,1997,1
"org.apache.jackrabbit.spi.QueryInfo",3,0.00,1.00,4,0.02,91.45,3,0,2,3,13,111.21,25,5,12,1,159.31,0.00,0.00,0.00,0,3.00,1,50.63,0,2,1,,0.00,0,0,3,0,0,1,0,4,21,1
"org.apache.jackrabbit.spi.QueryResultRow",3,0.00,1.00,4,0.02,101.97,3,0,0,3,6,110.46,32,5,3,1,158.94,0.00,0.00,0.00,0,3.00,1,62.81,0,1,3,,0.00,0,0,3,0,0,2,0,4,24,1
"org.apache.jackrabbit.spi.RepositoryService",68,0.00,1.00,69,1.33,10023.46,68,0,26,68,57,143.57,1075,94,35,1,153.92,0.00,0.00,0.00,0,68.00,1,3990.93,0,15,22,,0.00,0,0,68,0,0,53,0,85,1022,1
"org.apache.jackrabbit.spi.RepositoryServiceFactory",1,0.00,1.00,2,0.02,175.12,1,0,2,1,5,104.54,12,3,4,1,142.11,0.00,0.00,0.00,0,1.00,1,54.60,0,1,1,,0.00,0,0,1,0,0,0,0,2,17,1
"org.apache.jackrabbit.spi.RepositoryServiceStub",6,0.08,3.33,55,0.92,59152.23,16,10,10,23,7,103.91,24,78,6,1,103.68,0.00,0.00,0.03,0,10.00,14,2748.05,0,5,1,java.lang.Object,0.00,17,0,20,3,17,1,0,5,488,2
"org.apache.jackrabbit.spi.RepositoryServiceTest",8,0.00,1.12,29,0.30,4608.84,9,1,3,24,5,131.44,2,41,1,3,131.44,0.00,0.67,1.00,0,0.00,2,887.39,2,0,4,org.apache.jackrabbit.spi.AbstractSPITest,0.27,16,2,9,0,16,8,0,2,209,1
"org.apache.jackrabbit.spi.SessionInfo",6,0.00,1.00,7,0.05,327.43,6,0,3,6,37,108.84,63,8,37,1,157.32,0.00,0.00,0.00,0,6.00,1,164.39,0,3,0,,0.00,0,0,6,0,0,3,0,7,54,1
"org.apache.jackrabbit.spi.SessionInfoTest",3,0.33,1.67,17,0.17,2520.28,6,3,2,11,4,121.78,2,23,1,3,121.78,0.00,0.67,0.56,0,0.00,2,503.29,2,0,3,org.apache.jackrabbit.spi.AbstractSPITest,1.00,8,2,5,0,8,3,0,2,120,1
"org.apache.jackrabbit.spi.Subscription",0,0.00,0.00,1,0.00,12.00,0,0,0,0,9,171.00,9,2,9,1,171.00,0.00,0.00,0.00,0,0.00,0,8.00,0,0,0,,0.00,0,0,0,0,0,0,0,1,4,1
"org.apache.jackrabbit.spi.TestAll",1,0.00,1.00,8,0.07,2228.14,1,0,3,3,7,160.95,1,10,3,2,110.95,0.00,0.50,0.00,0,1.00,1,223.66,0,1,4,junit.framework.TestCase,0.00,2,1,1,0,2,0,0,1,55,1
"org.apache.jackrabbit.spi.XASessionInfo",1,0.00,1.00,2,0.01,48.43,1,0,1,1,3,102.37,11,3,3,2,146.50,0.00,0.50,0.00,0,1.00,1,27.12,0,1,0,,0.00,0,1,1,0,0,0,0,2,11,1
"org.apache.jackrabbit.webdav.jcr.observation.SubscriptionImpl",21,0.04,2.43,146,1.84,62089.91,36,15,32,70,22,64.44,203,206,4,1,114.44,0.00,0.00,0.10,3,286.00,9,5531.68,0,10,18,java.lang.Object,0.00,49,0,51,0,49,11,3,44,1110,1
"org.apache.jackrabbit.webdav.jcr.observation.SubscriptionImpl$EventBundleImpl",3,0.25,4.00,48,0.87,54089.79,5,2,32,26,3,112.86,9,63,0,1,92.25,0.00,0.00,0.33,0,4.00,10,2609.40,0,1,3,java.lang.Object,0.00,23,0,12,0,23,2,1,9,421,1
"org.apache.jackrabbit.webdav.jcr.observation.SubscriptionImpl$TransactionEvent",3,0.00,1.00,4,0.04,298.09,3,0,32,3,1,205.27,3,12,0,1,155.27,0.00,0.00,0.00,0,3.00,1,133.02,0,0,1,java.lang.Object,0.00,0,0,3,0,0,3,0,3,40,0
"org.apache.jackrabbit.webdav.jcr.observation.SubscriptionImpl$TransactionEvent_0",3,0.50,2.67,22,0.28,4799.11,4,1,32,10,4,114.26,13,38,0,1,114.02,0.00,0.00,0.67,0,0.00,3,838.48,0,0,4,java.lang.Object,0.00,7,0,8,0,7,3,2,7,176,1
"org.apache.jackrabbit.webdav.jcr.observation.SubscriptionManagerImpl",10,0.07,1.90,77,1.04,29513.05,13,3,27,54,15,63.53,103,107,1,1,112.00,0.00,0.00,0.27,4,34.00,4,3125.41,0,5,14,java.lang.Object,0.00,44,0,19,0,44,5,2,22,629,1
"org.apache.jackrabbit.webdav.jcr.observation.SubscriptionManagerImpl$SubscriptionMap",6,0.30,1.67,36,0.44,15754.59,8,2,27,22,3,114.93,0,46,0,1,114.93,0.00,0.00,0.75,0,0.00,3,1313.35,0,3,3,java.lang.Object,0.00,16,0,10,0,16,3,0,0,285,1
"org.apache.jackrabbit.webdav.jcr.observation.SubscriptionManagerImpl$WrappedSubscription",3,1.00,1.00,8,0.05,565.02,4,1,27,4,1,141.86,2,12,0,1,141.86,0.00,0.00,0.33,0,4.00,1,151.98,0,2,1,java.lang.Object,0.00,1,0,3,0,1,1,1,2,46,1
"org.apache.jackrabbit.spi.BatchReadConfig",2,0.67,2.00,13,0.14,3297.03,5,3,3,7,5,72.35,23,18,4,1,116.48,0.00,0.00,0.67,0,0.00,2,434.23,0,0,1,java.lang.Object,0.00,5,0,4,0,5,2,0,3,99,1
"org.apache.jackrabbit.spi.ChildInfoImpl",2,0.00,1.50,8,0.11,1698.48,2,0,6,6,5,87.82,24,15,2,2,125.38,0.00,0.50,0.00,0,2.00,2,317.82,0,1,3,org.apache.jackrabbit.spi.commons.ChildInfoImpl,0.00,4,1,3,0,4,1,0,4,77,0
"org.apache.jackrabbit.spi.EventFactory",3,0.12,4.00,60,1.11,75538.11,7,4,22,32,15,55.27,18,85,2,1,87.49,0.00,0.00,0.33,0,4.00,9,3318.59,0,2,13,java.lang.Object,0.00,29,0,12,0,29,1,0,6,538,0
"org.apache.jackrabbit.spi.EventSubscription",7,0.05,2.71,73,1.12,51392.65,14,7,18,36,12,54.92,60,101,3,1,103.03,0.00,0.00,0.18,2,10.00,8,3369.65,0,2,10,java.lang.Object,0.00,29,0,19,0,29,5,2,19,627,0
"org.apache.jackrabbit.spi.EventSubscription$EventListener",1,0.00,1.00,3,0.03,202.37,1,0,18,2,0,135.04,0,4,0,1,135.04,0.00,0.00,0.00,0,1.00,1,76.53,0,0,0,java.lang.Object,0.00,1,0,1,0,1,1,0,0,22,0
"org.apache.jackrabbit.spi.IdFactoryImpl",5,1.00,1.20,19,0.19,4381.00,6,1,12,13,15,130.22,20,29,6,2,129.99,0.00,0.50,0.20,2,8.00,2,581.58,0,4,9,org.apache.jackrabbit.spi.commons.identifier.AbstractIdFactory,0.17,8,1,6,0,8,1,0,3,133,0
"org.apache.jackrabbit.spi.LockInfoImpl",2,0.00,1.00,5,0.11,1405.48,2,0,4,11,8,88.88,20,10,4,2,137.35,0.00,0.50,0.00,0,2.00,1,323.48,0,1,4,org.apache.jackrabbit.spi.commons.LockInfoImpl,0.00,9,1,2,0,9,1,0,3,79,0
"org.apache.jackrabbit.spi.NodeInfoImpl",4,0.00,1.75,22,0.43,11450.80,4,0,14,25,9,69.47,34,42,1,3,117.58,0.00,0.67,0.00,0,4.00,2,1276.61,0,3,8,org.apache.jackrabbit.spi.commons.NodeInfoImpl,0.00,21,2,7,0,21,1,0,4,265,0
"org.apache.jackrabbit.spi.PropertyInfoImpl",2,0.00,2.00,17,0.26,10330.73,2,0,8,10,8,63.79,23,30,1,3,107.91,0.00,0.67,0.00,0,2.00,3,786.19,0,1,7,org.apache.jackrabbit.spi.commons.PropertyInfoImpl,0.00,8,2,4,0,8,1,0,3,161,0
"org.apache.jackrabbit.spi.QueryInfoImpl",5,0.11,1.40,36,0.41,11138.55,12,7,15,14,8,64.93,44,48,1,1,113.04,0.00,0.00,0.06,0,11.00,2,1241.90,0,4,7,java.lang.Object,0.00,9,0,7,0,9,1,1,12,271,0
"org.apache.jackrabbit.spi.QueryInfoImpl$RangeIteratorDecorator",1,0.00,2.00,6,0.09,1772.14,1,0,15,4,1,116.23,0,13,0,1,116.23,0.00,0.00,0.00,0,0.00,2,257.99,1,1,1,java.lang.Object,0.00,3,0,2,0,3,0,0,0,56,0
"org.apache.jackrabbit.spi.QueryResultRowImpl",4,0.22,3.75,60,0.77,33916.40,7,3,16,26,9,53.60,29,77,1,1,95.89,0.00,0.00,0.50,0,0.00,7,2302.41,0,2,8,java.lang.Object,0.00,22,0,15,0,22,2,1,7,427,0
"org.apache.jackrabbit.spi.RepositoryServiceImpl",84,0.12,1.83,539,7.94,255331.34,90,6,109,242,60,135.02,280,794,3,1,114.41,0.00,0.00,0.05,10,1394.00,6,23809.64,0,53,57,java.lang.Object,0.00,158,0,154,0,158,31,1,106,4670,1
"org.apache.jackrabbit.spi.RepositoryServiceImpl$BatchImpl",16,0.27,1.50,75,0.94,27597.10,19,3,109,38,10,122.96,6,118,0,1,122.96,0.00,0.00,0.08,1,54.00,5,2823.26,0,3,10,java.lang.Object,0.00,22,0,24,0,22,13,1,3,605,2
"org.apache.jackrabbit.spi.RepositoryServiceImpl$BatchImpl$Callable_24",1,0.00,4.00,18,0.22,8470.68,1,0,109,11,0,92.93,0,23,0,1,92.93,0.00,0.00,0.00,0,0.00,4,672.61,0,1,0,java.lang.Object,0.00,10,0,4,0,10,0,0,0,123,0
"org.apache.jackrabbit.spi.RepositoryServiceImpl$BatchImpl$Callable_25",1,0.00,1.00,7,0.09,1264.60,1,0,109,6,1,115.05,0,9,0,1,115.05,0.00,0.00,0.00,0,0.00,1,263.16,0,1,1,java.lang.Object,0.00,5,0,1,0,5,0,0,0,56,0
"org.apache.jackrabbit.spi.RepositoryServiceImpl$BatchImpl$Callable_26",1,0.00,2.00,12,0.15,4346.03,1,0,109,6,1,101.94,0,12,0,1,101.94,0.00,0.00,0.00,0,0.00,2,441.40,0,1,1,java.lang.Object,0.00,5,0,2,0,5,0,0,0,86,0
"org.apache.jackrabbit.spi.RepositoryServiceImpl$BatchImpl$Callable_27",1,0.00,1.00,6,0.07,1023.12,1,0,109,5,1,118.27,0,8,0,1,118.27,0.00,0.00,0.00,0,0.00,1,214.82,0,1,1,java.lang.Object,0.00,4,0,1,0,4,0,0,0,48,0
"org.apache.jackrabbit.spi.RepositoryServiceImpl$BatchImpl$Callable_28",1,0.00,2.00,11,0.13,3937.07,1,0,109,5,1,103.68,0,11,0,1,103.68,0.00,0.00,0.00,0,0.00,2,387.57,0,1,1,java.lang.Object,0.00,4,0,2,0,4,0,0,0,78,0
"org.apache.jackrabbit.spi.RepositoryServiceImpl$BatchImpl$Callable_29",1,0.00,4.00,11,0.12,3582.00,1,0,109,7,2,104.08,4,16,0,1,103.85,0.00,0.00,0.00,0,0.00,4,348.00,0,1,2,java.lang.Object,0.00,6,0,4,0,6,0,0,4,72,0
"org.apache.jackrabbit.spi.RepositoryServiceImpl$BatchImpl$Callable_30",1,0.00,5.00,17,0.20,9413.96,1,0,109,6,0,93.44,0,22,0,1,93.44,0.00,0.00,0.00,0,0.00,5,612.88,0,1,0,java.lang.Object,0.00,5,0,5,0,5,0,0,0,121,0
"org.apache.jackrabbit.spi.RepositoryServiceImpl$BatchImpl$Callable_31",1,0.00,5.00,21,0.23,9389.63,1,0,109,9,0,90.02,0,22,0,1,90.02,0.00,0.00,0.00,0,0.00,5,704.48,0,1,0,java.lang.Object,0.00,8,0,5,0,8,0,0,0,134,0
"org.apache.jackrabbit.spi.RepositoryServiceImpl$BatchImpl$Callable_32",1,0.00,1.00,5,0.04,498.94,1,0,109,4,0,123.68,0,6,0,1,123.68,0.00,0.00,0.00,0,0.00,1,120.37,0,1,0,java.lang.Object,0.00,3,0,1,0,3,0,0,0,30,0
"org.apache.jackrabbit.spi.RepositoryServiceImpl$BatchImpl$Callable_33",1,0.00,2.00,9,0.09,2216.31,1,0,109,4,0,108.90,0,11,0,1,108.90,0.00,0.00,0.00,0,0.00,2,275.19,0,1,0,java.lang.Object,0.00,3,0,2,0,3,0,0,0,59,0
"org.apache.jackrabbit.spi.RepositoryServiceImpl$BatchImpl$Callable_34",1,0.00,1.00,5,0.02,162.57,1,0,109,3,0,127.52,0,5,0,1,127.52,0.00,0.00,0.00,0,0.00,1,58.19,0,1,0,java.lang.Object,0.00,2,0,1,0,2,0,0,0,18,0
"org.apache.jackrabbit.spi.RepositoryServiceImpl$BatchImpl$Callable_34$Callable_35",1,0.00,1.00,4,0.03,251.86,1,0,109,2,0,129.63,0,5,0,1,129.63,0.00,0.00,0.00,0,0.00,1,76.53,0,1,0,java.lang.Object,0.00,1,0,1,0,1,0,0,0,22,0
"org.apache.jackrabbit.spi.RepositoryServiceImpl$Callable",1,0.00,2.00,7,0.08,1860.32,1,0,109,7,0,113.57,0,10,0,1,113.57,0.00,0.00,0.00,0,1.00,2,246.04,0,1,0,java.lang.Object,0.00,6,0,2,0,6,0,0,0,53,0
"org.apache.jackrabbit.spi.RepositoryServiceImpl$Callable_0",1,0.00,2.00,9,0.13,3031.52,1,0,109,11,0,107.83,0,11,0,1,107.83,0.00,0.00,0.00,0,1.00,2,379.38,0,1,0,java.lang.Object,0.00,10,0,2,0,10,0,0,0,77,0
"org.apache.jackrabbit.spi.RepositoryServiceImpl$Callable_1",1,0.00,2.00,14,0.16,5137.21,1,0,109,11,1,148.87,1,18,0,1,98.87,0.00,0.00,0.00,0,1.00,2,490.81,0,1,1,java.lang.Object,0.00,10,0,2,0,10,0,0,1,96,0
"org.apache.jackrabbit.spi.RepositoryServiceImpl$Callable_10",1,0.00,1.00,4,0.05,637.24,1,0,109,6,0,126.46,0,5,0,1,126.46,0.00,0.00,0.00,0,1.00,1,141.98,0,1,0,java.lang.Object,0.00,5,0,1,0,5,0,0,0,35,0
"org.apache.jackrabbit.spi.RepositoryServiceImpl$Callable_11",1,0.00,1.00,4,0.05,637.24,1,0,109,6,0,126.46,0,5,0,1,126.46,0.00,0.00,0.00,0,1.00,1,141.98,0,1,0,java.lang.Object,0.00,5,0,1,0,5,0,0,0,35,0
"org.apache.jackrabbit.spi.RepositoryServiceImpl$Callable_12",1,0.00,2.00,9,0.09,2503.49,1,0,109,5,0,108.48,0,11,0,1,108.48,0.00,0.00,0.00,0,1.00,2,257.98,0,1,0,java.lang.Object,0.00,4,0,2,0,4,0,0,0,56,0
"org.apache.jackrabbit.spi.RepositoryServiceImpl$Callable_13",1,0.00,7.00,27,0.40,28652.93,1,0,109,14,2,132.06,1,33,0,1,82.06,0.00,0.00,0.00,0,0.00,7,1196.29,0,1,2,java.lang.Object,0.00,13,0,7,0,13,0,0,1,206,0
"org.apache.jackrabbit.spi.RepositoryServiceImpl$Callable_14",1,0.00,3.00,14,0.16,7500.66,1,0,109,7,0,97.48,0,15,0,1,97.48,0.00,0.00,0.00,0,1.00,3,467.83,0,1,0,java.lang.Object,0.00,6,0,3,0,6,0,0,0,91,0
"org.apache.jackrabbit.spi.RepositoryServiceImpl$Callable_15",1,0.00,2.00,8,0.12,2696.48,1,0,109,8,1,110.14,0,11,0,1,110.14,0.00,0.00,0.00,0,0.00,2,354.38,0,1,1,java.lang.Object,0.00,7,0,2,0,7,0,0,0,71,0
"org.apache.jackrabbit.spi.RepositoryServiceImpl$Callable_16",1,0.00,2.00,8,0.12,2732.58,1,0,109,8,1,110.09,0,11,0,1,110.09,0.00,0.00,0.00,0,0.00,2,362.24,0,1,1,java.lang.Object,0.00,7,0,2,0,7,0,0,0,72,0
"org.apache.jackrabbit.spi.RepositoryServiceImpl$Callable_17",1,0.00,5.00,27,0.40,18702.11,1,0,109,16,3,83.60,0,30,0,1,83.60,0.00,0.00,0.00,0,0.00,5,1203.02,0,1,3,java.lang.Object,0.00,15,0,5,0,15,0,0,0,201,0
"org.apache.jackrabbit.spi.RepositoryServiceImpl$Callable_18",1,0.00,2.00,11,0.12,3438.53,1,0,109,7,0,104.15,0,14,0,1,104.15,0.00,0.00,0.00,0,1.00,2,353.95,0,1,0,java.lang.Object,0.00,6,0,2,0,6,0,0,0,72,0
"org.apache.jackrabbit.spi.RepositoryServiceImpl$Callable_19",1,0.00,2.00,10,0.09,2533.56,1,0,109,6,0,106.73,0,12,0,1,106.73,0.00,0.00,0.00,0,1.00,2,282.79,0,1,0,java.lang.Object,0.00,5,0,2,0,5,0,0,0,60,0
"org.apache.jackrabbit.spi.RepositoryServiceImpl$Callable_2",1,0.00,1.00,4,0.03,278.00,1,0,109,3,0,129.30,0,5,0,1,129.30,0.00,0.00,0.00,0,1.00,1,84.00,0,1,0,java.lang.Object,0.00,2,0,1,0,2,0,0,0,23,0
"org.apache.jackrabbit.spi.RepositoryServiceImpl$Callable_20",1,0.00,1.00,3,0.02,193.32,1,0,109,2,0,135.20,0,4,0,1,135.20,0.00,0.00,0.00,0,1.00,1,59.81,0,1,0,java.lang.Object,0.00,1,0,1,0,1,0,0,0,18,0
"org.apache.jackrabbit.spi.RepositoryServiceImpl$Callable_21",1,0.00,1.00,4,0.03,278.00,1,0,109,3,0,129.30,0,5,0,1,129.30,0.00,0.00,0.00,0,1.00,1,84.00,0,1,0,java.lang.Object,0.00,2,0,1,0,2,0,0,0,23,0
"org.apache.jackrabbit.spi.RepositoryServiceImpl$Callable_22",1,0.00,2.00,8,0.11,2627.42,1,0,109,8,1,110.23,0,11,0,1,110.23,0.00,0.00,0.00,0,0.00,2,338.69,0,1,1,java.lang.Object,0.00,7,0,2,0,7,0,0,0,69,0
"org.apache.jackrabbit.spi.RepositoryServiceImpl$Callable_23",1,0.00,1.00,3,0.02,244.46,1,0,109,3,0,134.40,0,4,0,1,134.40,0.00,0.00,0.00,0,1.00,1,74.42,0,1,0,java.lang.Object,0.00,2,0,1,0,2,0,0,0,21,0
"org.apache.jackrabbit.spi.RepositoryServiceImpl$Callable_3",1,0.00,1.00,10,0.11,2209.22,1,0,109,9,1,107.36,0,13,0,1,107.36,0.00,0.00,0.00,0,1.00,1,344.05,0,1,1,java.lang.Object,0.00,8,0,1,0,8,0,0,0,69,0
"org.apache.jackrabbit.spi.RepositoryServiceImpl$Callable_36",1,0.00,1.00,2,0.01,51.30,1,0,109,1,0,146.30,0,3,0,1,146.30,0.00,0.00,0.00,0,1.00,1,27.65,0,1,0,,0.00,0,0,1,0,0,0,0,0,11,1
"org.apache.jackrabbit.spi.RepositoryServiceImpl$Callable_4",1,0.00,1.00,5,0.05,728.53,1,0,109,4,1,122.39,0,6,0,1,122.39,0.00,0.00,0.00,0,0.00,1,157.28,0,1,1,java.lang.Object,0.00,3,0,1,0,3,0,0,0,37,0
"org.apache.jackrabbit.spi.RepositoryServiceImpl$Callable_5",1,0.00,1.00,7,0.11,1613.29,1,0,109,8,1,114.22,0,8,0,1,114.22,0.00,0.00,0.00,0,0.00,1,320.75,0,1,1,java.lang.Object,0.00,7,0,1,0,7,0,0,0,66,0
"org.apache.jackrabbit.spi.RepositoryServiceImpl$Callable_6",1,0.00,1.00,4,0.03,258.13,1,0,109,3,0,129.55,0,5,0,1,129.55,0.00,0.00,0.00,0,1.00,1,78.32,0,1,0,java.lang.Object,0.00,2,0,1,0,2,0,0,0,22,0
"org.apache.jackrabbit.spi.RepositoryServiceImpl$Callable_7",1,0.00,1.00,3,0.03,258.13,1,0,109,3,0,134.21,0,4,0,1,134.21,0.00,0.00,0.00,0,1.00,1,78.32,0,1,0,java.lang.Object,0.00,2,0,1,0,2,0,0,0,22,0
"org.apache.jackrabbit.spi.RepositoryServiceImpl$Callable_8",1,0.00,1.00,4,0.03,258.13,1,0,109,3,0,129.55,0,5,0,1,129.55,0.00,0.00,0.00,0,1.00,1,78.32,0,1,0,java.lang.Object,0.00,2,0,1,0,2,0,0,0,22,0
"org.apache.jackrabbit.spi.RepositoryServiceImpl$Callable_9",1,0.00,1.00,4,0.03,258.13,1,0,109,3,0,129.55,0,5,0,1,129.55,0.00,0.00,0.00,0,1.00,1,78.32,0,1,0,java.lang.Object,0.00,2,0,1,0,2,0,0,0,22,0
"org.apache.jackrabbit.spi.RepositoryServiceImpl$NamespaceResolver",2,0.00,1.00,5,0.02,262.00,2,0,109,2,0,143.10,0,7,0,1,143.10,0.00,0.00,0.00,0,2.00,1,68.00,0,2,0,java.lang.Object,0.00,0,0,2,0,0,0,0,0,24,0
"org.apache.jackrabbit.spi.RepositoryServiceImpl$NodeTypeDefinitionImpl",0,0.00,0.00,1,0.02,184.37,0,0,109,0,0,171.00,0,1,0,1,171.00,0.00,0.00,0.00,0,0.00,0,64.53,0,0,0,java.lang.Object,0.00,0,0,0,0,0,0,0,0,18,0
"org.apache.jackrabbit.spi.RepositoryServiceImpl$TraversingItemVisitor",4,0.00,1.50,11,0.17,2957.78,4,0,109,9,3,137.09,2,23,0,1,137.09,0.00,0.00,0.00,0,4.00,2,500.20,0,0,3,java.lang.Object,0.00,5,0,6,0,5,4,0,2,114,0
"org.apache.jackrabbit.spi.RepositoryStubImpl",3,1.00,1.67,18,0.18,4506.13,4,1,9,11,8,68.73,24,25,0,3,116.84,0.00,0.67,0.33,1,4.00,3,527.18,1,2,8,org.apache.jackrabbit.core.JackrabbitRepositoryStub,0.15,8,2,5,0,8,1,0,6,118,1
"org.apache.jackrabbit.spi.RepositoryStubImpl$AbstractRepositoryConfig",1,0.00,1.00,3,0.01,72.00,1,0,9,1,1,138.58,0,4,0,1,138.58,0.00,0.00,0.00,0,1.00,1,32.00,0,1,1,java.lang.Object,0.00,0,0,1,0,0,0,0,0,12,0
"org.apache.jackrabbit.spi.ServiceStubImpl",4,0.11,2.00,22,0.24,5579.00,7,3,10,11,6,170.01,6,34,0,2,120.01,0.00,0.50,0.25,0,6.00,3,707.59,1,3,6,org.apache.jackrabbit.spi.RepositoryServiceStub,0.60,7,1,8,0,7,1,0,2,160,1
"org.apache.jackrabbit.spi.SessionInfoImpl",14,0.02,1.14,59,0.68,15560.58,19,5,29,44,16,106.65,77,83,2,1,124.53,0.00,0.00,0.21,1,62.00,3,2026.84,0,9,15,java.lang.Object,0.00,30,0,16,0,30,5,1,20,451,0
"org.apache.jackrabbit.spi.SessionInfoImpl$NamespaceResolver",2,0.00,2.00,9,0.09,2289.95,2,0,29,5,0,174.29,2,17,0,1,124.30,0.00,0.00,0.00,0,2.00,2,262.88,0,2,0,java.lang.Object,0.00,3,0,4,0,3,0,0,2,64,0
"org.apache.jackrabbit.spi.Spi2jcrRepositoryServiceFactory",1,0.00,8.00,22,0.33,21832.83,4,3,7,7,6,48.71,12,32,0,1,86.28,0.00,0.00,1.00,0,0.00,8,975.10,0,1,6,java.lang.Object,0.00,6,0,8,0,6,0,1,4,179,1
"org.apache.jackrabbit.server.remoting.davex.BatchReadConfig",8,0.02,2.25,51,0.56,15778.39,14,6,10,24,2,73.55,62,67,2,1,115.84,0.00,0.00,0.19,3,12.00,6,1681.66,0,0,0,java.lang.Object,0.00,16,0,18,0,16,8,0,11,350,0
"org.apache.jackrabbit.server.remoting.davex.BatchReadConfigTest",3,0.00,1.67,38,0.49,18449.25,3,0,2,13,2,150.79,5,46,1,2,100.79,0.00,0.50,0.00,0,3.00,2,1480.02,0,0,1,junit.framework.TestCase,0.00,10,1,5,0,10,3,0,3,314,1
"org.apache.jackrabbit.server.remoting.davex.DiffException",3,1.00,1.00,9,0.05,576.74,4,1,1,3,8,185.22,3,14,8,2,135.22,0.00,0.50,0.33,0,4.00,1,164.85,0,1,0,java.io.IOException,0.00,0,1,3,0,0,2,0,1,49,0
"org.apache.jackrabbit.server.remoting.davex.DiffHandler",4,0.00,1.00,5,0.04,228.23,4,0,0,4,5,157.17,3,6,4,1,157.17,0.00,0.00,0.00,0,4.00,1,133.14,0,0,1,,0.00,0,0,4,0,0,4,0,1,44,0
"org.apache.jackrabbit.server.remoting.davex.DiffParser",8,0.08,4.38,109,1.42,142835.44,19,11,6,26,4,77.75,45,144,2,1,95.63,0.00,0.00,0.16,4,22.00,21,4263.29,0,0,2,java.lang.Object,0.00,18,0,35,0,18,8,0,26,780,0
"org.apache.jackrabbit.server.remoting.davex.DiffParserTest",11,0.00,1.64,156,2.35,117553.81,11,0,4,22,3,136.29,27,174,1,2,96.41,0.00,0.50,0.00,0,11.00,3,7064.31,0,0,2,junit.framework.TestCase,0.00,11,1,18,0,11,11,0,27,1215,1
"org.apache.jackrabbit.server.remoting.davex.DiffParserTest$DummyDiffHandler",1,0.00,1.00,4,0.03,337.74,1,0,4,2,0,128.63,0,6,0,1,128.63,0.00,0.00,0.00,0,1.00,1,91.76,0,0,0,java.lang.Object,0.00,1,0,1,0,1,1,0,0,26,0
"org.apache.jackrabbit.server.remoting.davex.DiffParserTest$DummyDiffHandler_0",1,0.00,1.00,4,0.04,722.24,1,0,4,4,0,126.03,0,6,0,1,126.03,0.00,0.00,0.00,0,1.00,1,133.34,0,0,0,java.lang.Object,0.00,3,0,1,0,3,1,0,0,33,0
"org.apache.jackrabbit.server.remoting.davex.DiffParserTest$DummyDiffHandler_1",1,0.00,1.00,4,0.03,337.74,1,0,4,2,0,128.63,0,6,0,1,128.63,0.00,0.00,0.00,0,1.00,1,91.76,0,0,0,java.lang.Object,0.00,1,0,1,0,1,1,0,0,26,0
"org.apache.jackrabbit.server.remoting.davex.DiffParserTest$DummyDiffHandler_10",1,0.00,2.00,6,0.05,852.32,1,0,4,3,0,118.74,0,9,0,1,118.74,0.00,0.00,0.00,0,1.00,2,143.93,0,0,0,java.lang.Object,0.00,2,0,2,0,2,1,0,0,36,0
"org.apache.jackrabbit.server.remoting.davex.DiffParserTest$DummyDiffHandler_11",1,0.00,2.00,6,0.05,852.32,1,0,4,3,0,118.74,0,9,0,1,118.74,0.00,0.00,0.00,0,1.00,2,143.93,0,0,0,java.lang.Object,0.00,2,0,2,0,2,1,0,0,36,0
"org.apache.jackrabbit.server.remoting.davex.DiffParserTest$DummyDiffHandler_12",1,0.00,1.00,4,0.03,337.74,1,0,4,2,0,128.63,0,6,0,1,128.63,0.00,0.00,0.00,0,1.00,1,91.76,0,0,0,java.lang.Object,0.00,1,0,1,0,1,1,0,0,26,0
"org.apache.jackrabbit.server.remoting.davex.DiffParserTest$DummyDiffHandler_13",4,0.00,1.00,5,0.05,372.07,4,0,4,4,2,205.50,4,13,0,1,155.50,0.00,0.00,0.00,0,4.00,1,161.67,0,0,2,java.lang.Object,0.00,0,0,4,0,0,4,1,4,50,1
"org.apache.jackrabbit.server.remoting.davex.DiffParserTest$DummyDiffHandler_2",1,0.00,1.00,4,0.03,337.74,1,0,4,2,0,128.63,0,6,0,1,128.63,0.00,0.00,0.00,0,1.00,1,91.76,0,0,0,java.lang.Object,0.00,1,0,1,0,1,1,0,0,26,0
"org.apache.jackrabbit.server.remoting.davex.DiffParserTest$DummyDiffHandler_3",1,0.00,1.00,4,0.03,337.74,1,0,4,2,0,128.63,0,6,0,1,128.63,0.00,0.00,0.00,0,1.00,1,91.76,0,0,0,java.lang.Object,0.00,1,0,1,0,1,1,0,0,26,0
"org.apache.jackrabbit.server.remoting.davex.DiffParserTest$DummyDiffHandler_4",1,0.00,1.00,4,0.03,337.74,1,0,4,2,0,128.63,0,6,0,1,128.63,0.00,0.00,0.00,0,1.00,1,91.76,0,0,0,java.lang.Object,0.00,1,0,1,0,1,1,0,0,26,0
"org.apache.jackrabbit.server.remoting.davex.DiffParserTest$DummyDiffHandler_5",4,0.00,1.00,13,0.13,1680.57,4,0,4,8,0,132.54,0,21,0,1,132.54,0.00,0.00,0.00,0,4.00,1,390.97,0,0,0,java.lang.Object,0.00,4,0,4,0,4,4,0,0,101,0
"org.apache.jackrabbit.server.remoting.davex.DiffParserTest$DummyDiffHandler_6",1,0.00,1.00,4,0.04,511.20,1,0,4,2,0,127.21,0,6,0,1,127.21,0.00,0.00,0.00,0,1.00,1,112.00,0,0,0,java.lang.Object,0.00,1,0,1,0,1,1,0,0,30,0
"org.apache.jackrabbit.server.remoting.davex.DiffParserTest$DummyDiffHandler_7",1,0.00,1.00,3,0.03,294.70,1,0,4,2,0,133.76,0,5,0,1,133.76,0.00,0.00,0.00,0,1.00,1,76.53,0,0,0,java.lang.Object,0.00,1,0,1,0,1,1,0,0,22,0
"org.apache.jackrabbit.server.remoting.davex.DiffParserTest$DummyDiffHandler_8",1,0.00,2.00,6,0.05,852.32,1,0,4,3,0,118.74,0,9,0,1,118.74,0.00,0.00,0.00,0,1.00,2,143.93,0,0,0,java.lang.Object,0.00,2,0,2,0,2,1,0,0,36,0
"org.apache.jackrabbit.server.remoting.davex.DiffParserTest$DummyDiffHandler_9",1,0.00,1.00,3,0.02,228.24,1,0,4,2,0,134.63,0,5,0,1,134.63,0.00,0.00,0.00,0,1.00,1,70.91,0,0,0,java.lang.Object,0.00,1,0,1,0,1,1,0,0,21,0
"org.apache.jackrabbit.server.remoting.davex.JcrRemotingServlet",14,0.00,3.50,197,3.08,139438.32,23,9,36,101,27,76.33,206,264,2,4,96.47,0.33,0.60,0.11,5,74.00,9,9227.31,4,7,25,org.apache.jackrabbit.webdav.jcr.JCRWebdavServerServlet,0.11,87,3,49,1,87,7,0,30,1620,2
"org.apache.jackrabbit.server.remoting.davex.JcrRemotingServlet$DavLocatorFactoryImpl",4,0.00,1.50,15,0.18,5061.37,4,0,36,6,2,128.68,0,24,0,3,128.68,0.00,0.67,0.00,1,4.00,2,543.20,1,2,2,org.apache.jackrabbit.webdav.jcr.DavLocatorFactoryImpl,0.00,2,2,6,0,2,2,0,0,131,2
"org.apache.jackrabbit.server.remoting.davex.JcrRemotingServlet$ResourceFactoryImpl",2,0.00,2.50,10,0.16,5040.31,2,0,36,5,5,75.64,14,18,0,2,117.93,0.00,0.50,0.00,0,2.00,4,492.74,1,1,5,org.apache.jackrabbit.webdav.jcr.DavResourceFactoryImpl,0.00,3,1,5,0,3,1,0,9,106,2
"org.apache.jackrabbit.server.remoting.davex.JcrRemotingServlet$WrappingLocator",13,0.10,1.46,49,0.40,8103.99,17,4,36,25,2,131.11,1,70,0,1,131.11,0.00,0.00,0.35,1,0.00,3,1185.07,0,7,2,java.lang.Object,0.00,12,0,19,0,12,6,1,1,292,2
"org.apache.jackrabbit.server.remoting.davex.JsonDiffHandler",15,0.00,5.00,272,4.17,301409.53,24,9,28,102,10,110.53,53,337,2,1,89.92,0.00,0.00,0.11,9,75.00,15,12511.75,0,7,8,java.lang.Object,0.00,87,0,75,0,87,8,1,33,2191,0
"org.apache.jackrabbit.server.remoting.davex.JsonDiffHandler$ImportItem",2,1.00,1.50,7,0.06,987.41,3,1,28,3,1,131.90,0,10,0,1,131.90,0.00,0.00,0.00,0,2.00,2,170.67,0,0,1,java.lang.Object,0.00,1,0,3,0,1,2,0,0,45,2
"org.apache.jackrabbit.server.remoting.davex.JsonDiffHandler$ImportMvProp",2,1.00,1.50,10,0.12,2592.62,3,1,28,8,0,120.32,0,15,0,2,120.32,0.00,0.50,0.50,0,2.00,2,369.04,0,0,0,org.apache.jackrabbit.server.remoting.davex.ImportItem,0.00,6,1,3,0,6,2,0,0,84,1
"org.apache.jackrabbit.server.remoting.davex.JsonDiffHandler$ImportNode",5,0.12,3.00,34,0.41,14616.31,9,4,28,12,1,164.43,5,47,0,2,114.43,0.00,0.50,0.35,0,9.00,7,1232.57,0,0,1,org.apache.jackrabbit.server.remoting.davex.ImportItem,0.00,7,1,15,0,7,5,0,5,266,1
"org.apache.jackrabbit.server.remoting.davex.JsonDiffHandler$ImportProp",2,1.00,1.00,7,0.06,719.67,3,1,28,3,0,133.07,0,11,0,2,133.07,0.00,0.50,0.50,0,2.00,1,190.19,0,0,0,org.apache.jackrabbit.server.remoting.davex.ImportItem,0.00,1,1,2,0,1,2,0,0,50,1
"org.apache.jackrabbit.server.remoting.davex.JsonDiffHandler$NodeHandler",11,0.03,1.82,55,0.61,14817.16,14,3,28,25,2,120.15,5,76,0,1,120.15,0.00,0.00,0.30,1,25.00,4,1842.10,0,0,2,java.lang.Object,0.00,14,0,20,0,14,11,1,5,411,1
"org.apache.jackrabbit.server.remoting.davex.JsonDiffHandler$ValueHandler",10,0.56,1.10,17,0.15,1996.26,11,1,28,10,1,152.86,5,28,0,1,152.86,0.00,0.00,0.50,0,10.00,2,458.73,0,1,1,java.lang.Object,0.00,0,0,11,0,0,9,1,5,131,1
"org.apache.jackrabbit.server.remoting.davex.JsonDiffHandler$ValuesHandler",10,0.56,1.10,20,0.21,2737.58,11,1,28,14,1,140.56,5,32,0,1,140.56,0.00,0.00,0.50,0,10.00,2,621.88,0,1,1,java.lang.Object,0.00,4,0,11,0,4,9,1,5,167,1
"org.apache.jackrabbit.server.remoting.davex.JsonDiffHandlerTest",1,0.00,2.00,29,0.40,18782.92,1,0,17,8,2,103.25,3,31,1,2,82.64,0.00,0.50,0.00,0,1.00,2,1202.01,0,0,1,junit.framework.TestCase,0.00,7,1,2,0,7,1,0,1,215,1
"org.apache.jackrabbit.server.remoting.davex.JsonDiffHandlerTest$DummySession",41,0.00,1.00,69,0.44,3300.17,41,0,17,41,0,155.99,10,111,0,1,155.99,0.00,0.00,0.00,0,41.00,1,1309.31,0,20,0,java.lang.Object,0.00,0,0,41,0,0,21,1,10,404,2
"org.apache.jackrabbit.server.remoting.davex.JsonWriter",13,1.00,2.23,98,1.35,50135.78,14,1,11,36,3,78.83,90,138,1,1,111.05,0.00,0.00,0.08,8,24.00,7,4037.45,0,1,2,java.lang.Object,0.00,23,0,29,0,23,12,0,28,796,0
"org.apache.jackrabbit.server.remoting.davex.TestAll",1,0.00,1.00,7,0.06,1740.69,1,0,3,3,3,71.66,7,9,0,2,113.96,0.00,0.50,0.00,0,1.00,1,186.48,0,1,3,junit.framework.TestCase,0.00,2,1,1,0,2,0,0,2,47,1
"org.apache.jackrabbit.standalone.cli.core.AbstractSetProperty",8,0.14,1.00,21,0.14,1752.44,12,4,1,8,3,141.58,39,30,3,1,141.34,0.00,0.00,0.12,0,32.00,1,424.57,0,4,0,java.lang.Object,0.00,0,0,8,3,0,4,1,14,119,2
"org.apache.jackrabbit.standalone.cli.core.AddNode",5,0.17,1.60,26,0.31,8294.37,8,3,6,16,1,101.59,25,35,0,1,119.46,0.00,0.00,0.20,0,14.00,4,919.82,0,2,1,java.lang.Object,0.00,11,0,8,0,11,3,1,11,193,1
"org.apache.jackrabbit.standalone.cli.core.ClearWorkspace",1,0.00,6.00,18,0.29,8643.05,2,1,11,18,2,44.66,8,26,0,1,92.76,0.00,0.00,1.00,0,0.00,6,884.23,0,0,2,java.lang.Object,0.00,17,0,6,0,17,1,1,4,164,1
"org.apache.jackrabbit.standalone.cli.core.Clone",9,0.10,1.11,32,0.39,8679.20,14,5,6,19,1,129.91,44,46,0,1,129.68,0.00,0.00,0.11,0,44.00,2,1175.77,0,4,1,java.lang.Object,0.00,10,0,10,0,10,5,1,16,256,1
"org.apache.jackrabbit.standalone.cli.core.Copy",7,0.12,1.43,31,0.40,10885.55,11,4,7,18,1,91.10,44,43,0,1,123.33,0.00,0.00,0.14,0,27.00,4,1198.82,0,3,1,java.lang.Object,0.00,11,0,10,0,11,4,1,13,250,1
"org.apache.jackrabbit.standalone.cli.core.CurrentNode",3,0.25,1.33,14,0.16,3009.30,5,2,6,10,1,106.97,16,19,0,1,124.84,0.00,0.00,0.33,0,5.00,2,480.92,0,1,1,java.lang.Object,0.00,7,0,4,0,7,2,1,7,108,1
"org.apache.jackrabbit.standalone.cli.core.Login",7,0.12,1.57,39,0.50,20512.16,11,4,10,21,1,117.76,32,52,0,1,117.52,0.00,0.00,0.14,0,27.00,5,1492.44,0,3,1,java.lang.Object,0.00,14,0,11,0,14,4,1,13,291,1
"org.apache.jackrabbit.standalone.cli.core.Logout",1,0.00,2.00,10,0.12,2542.81,2,1,6,9,1,64.43,7,13,0,1,106.72,0.00,0.00,1.00,0,0.00,2,361.76,0,0,1,java.lang.Object,0.00,8,0,2,0,8,1,1,3,78,1
"org.apache.jackrabbit.standalone.cli.core.Move",7,0.07,1.57,35,0.49,16178.51,12,5,8,24,1,138.95,26,52,0,1,118.33,0.00,0.00,0.14,0,27.00,5,1455.89,0,3,1,java.lang.Object,0.00,17,0,11,0,17,4,1,12,286,1
"org.apache.jackrabbit.standalone.cli.core.OrderBefore",7,0.12,1.14,26,0.31,6805.69,11,4,6,14,1,129.88,32,38,0,1,129.64,0.00,0.00,0.14,0,27.00,2,921.80,0,3,1,java.lang.Object,0.00,7,0,8,0,7,4,1,13,205,1
"org.apache.jackrabbit.standalone.cli.core.ReadValue",7,0.12,1.43,31,0.41,12298.61,11,4,6,21,1,123.14,33,44,0,1,122.91,0.00,0.00,0.14,0,27.00,4,1238.96,0,3,1,java.lang.Object,0.00,14,0,10,0,14,4,1,13,254,1
"org.apache.jackrabbit.standalone.cli.core.Refresh",5,0.17,1.40,24,0.27,6647.62,8,3,7,15,1,105.99,25,33,0,1,123.87,0.00,0.00,0.20,0,14.00,3,817.68,0,2,1,java.lang.Object,0.00,10,0,7,0,10,3,1,10,175,1
"org.apache.jackrabbit.standalone.cli.core.RemoveItem",3,0.25,1.67,16,0.21,4955.24,5,2,6,14,1,101.60,16,23,0,1,119.47,0.00,0.00,0.33,0,5.00,3,624.49,0,1,1,java.lang.Object,0.00,11,0,5,0,11,2,1,7,132,1
"org.apache.jackrabbit.standalone.cli.core.RemoveItems",5,0.17,1.60,28,0.40,11949.38,8,3,11,22,2,100.34,25,40,0,1,118.21,0.00,0.00,0.20,0,14.00,4,1193.21,0,2,2,java.lang.Object,0.00,17,0,8,0,17,3,1,10,230,1
"org.apache.jackrabbit.standalone.cli.core.Rename",7,0.12,1.57,36,0.48,16687.15,11,4,7,22,1,138.84,27,51,0,1,118.23,0.00,0.00,0.14,0,27.00,5,1453.56,0,3,1,java.lang.Object,0.00,15,0,11,0,15,4,1,11,293,1
"org.apache.jackrabbit.standalone.cli.core.Save",3,0.25,1.33,17,0.18,4235.47,5,2,6,10,1,102.18,17,22,0,1,120.06,0.00,0.00,0.33,0,5.00,2,544.88,0,1,1,java.lang.Object,0.00,7,0,4,0,7,2,1,7,119,1
"org.apache.jackrabbit.standalone.cli.core.SetBinaryProperty",1,0.00,2.00,11,0.19,4695.00,2,1,6,8,2,60.79,7,15,0,2,103.08,0.00,0.50,1.00,0,0.00,2,573.31,0,0,2,org.apache.jackrabbit.standalone.cli.core.AbstractSetProperty,0.00,7,1,2,0,7,1,0,3,114,1
"org.apache.jackrabbit.standalone.cli.core.SetMultivalueProperty",3,0.25,1.67,22,0.35,12795.83,5,2,6,12,2,78.55,18,30,0,2,110.77,0.00,0.50,0.33,0,5.00,3,1052.82,0,1,2,org.apache.jackrabbit.standalone.cli.core.AbstractSetProperty,0.00,9,1,5,0,9,2,0,7,202,1
"org.apache.jackrabbit.standalone.cli.core.SetProperty",1,0.00,3.00,15,0.26,8786.84,2,1,6,9,2,47.71,8,21,0,2,95.82,0.00,0.50,1.00,0,0.00,3,773.35,0,0,2,org.apache.jackrabbit.standalone.cli.core.AbstractSetProperty,0.00,8,1,3,0,8,1,0,3,147,1
"org.apache.jackrabbit.spi.commons.namespace.AbstractNamespaceResolver",7,0.17,2.71,70,0.64,24542.45,8,1,3,16,12,57.08,70,79,10,1,105.55,0.00,0.00,0.86,0,0.00,4,1915.29,0,0,2,java.lang.Object,0.00,9,0,19,2,9,7,1,15,392,2
"org.apache.jackrabbit.spi.commons.namespace.NamespaceAdder",3,0.00,1.33,16,0.18,2992.84,4,1,6,8,1,121.24,0,20,0,1,121.24,0.00,0.00,1.00,0,0.00,2,541.91,0,0,1,java.lang.Object,0.00,5,0,4,0,5,3,0,0,119,1
"org.apache.jackrabbit.spi.commons.namespace.NamespaceExtractor",2,0.00,1.50,16,0.18,3978.77,6,4,12,12,1,73.68,24,21,0,1,111.24,0.00,0.00,0.25,0,2.00,2,553.64,0,1,1,java.lang.Object,0.00,10,0,3,0,10,1,0,4,118,1
"org.apache.jackrabbit.spi.commons.namespace.NamespaceExtractor$NamespaceHandler",1,0.00,6.00,19,0.25,12230.03,1,0,12,5,0,130.59,2,26,0,2,90.70,0.00,0.50,0.00,0,0.00,6,752.53,0,0,0,org.xml.sax.helpers.DefaultHandler,0.00,4,1,6,0,4,1,0,2,141,1
"org.apache.jackrabbit.spi.commons.namespace.NamespaceListener",3,0.00,1.00,4,0.03,159.82,3,0,0,3,1,109.30,26,5,1,1,157.40,0.00,0.00,0.00,0,3.00,1,89.52,0,0,0,,0.00,0,0,3,0,0,3,0,4,31,1
"org.apache.jackrabbit.spi.commons.namespace.NamespaceMapping",10,0.04,2.10,54,0.63,22127.93,13,3,3,23,10,100.54,53,76,9,1,118.42,0.00,0.00,0.30,2,18.00,5,1891.91,0,5,1,java.lang.Object,0.00,13,0,21,0,13,5,1,18,427,1
"org.apache.jackrabbit.spi.commons.namespace.NamespaceResolver",2,0.00,1.00,3,0.02,99.22,2,0,1,2,66,113.52,22,4,66,1,157.65,0.00,0.00,0.00,0,2.00,1,54.92,0,2,0,,0.00,0,0,2,0,0,0,0,3,21,1
"org.apache.jackrabbit.spi.commons.namespace.RegistryNamespaceResolver",3,0.50,2.33,16,0.17,8339.19,4,1,3,6,5,117.85,12,28,4,1,117.61,0.00,0.00,0.67,0,1.00,3,503.19,0,2,1,java.lang.Object,0.00,3,0,7,0,3,1,1,3,116,1
"org.apache.jackrabbit.spi.commons.namespace.SessionNamespaceResolver",3,0.50,1.67,12,0.11,2384.80,4,1,3,6,3,93.36,19,20,2,1,125.58,0.00,0.00,0.67,0,1.00,2,340.69,0,2,1,java.lang.Object,0.00,3,0,5,0,3,1,1,7,84,1
"org.apache.jackrabbit.jca.test.AbstractTestCase",1,4.00,2.00,14,0.20,4909.47,7,6,9,8,4,149.02,25,21,2,2,99.02,2.00,0.25,0.33,0,0.00,2,593.42,0,0,2,junit.framework.TestCase,0.00,7,1,2,2,7,1,0,9,123,2
"org.apache.jackrabbit.jca.test.ConnectionFactoryTest",5,0.00,1.20,45,0.54,18587.02,5,0,11,16,4,75.03,32,54,0,3,107.25,0.00,0.67,0.00,0,0.00,2,1623.61,0,0,4,org.apache.jackrabbit.jca.test.AbstractTestCase,0.00,11,2,6,0,11,5,0,20,335,2
"org.apache.jackrabbit.jca.test.ConnectionRequestInfoTest",3,0.42,1.00,19,0.28,7357.64,9,6,3,14,2,115.52,12,24,0,3,115.28,0.00,0.67,0.44,0,0.00,1,833.84,0,0,2,org.apache.jackrabbit.jca.test.AbstractTestCase,0.00,11,2,3,0,11,3,0,4,187,2
"org.apache.jackrabbit.rmi.server.security.ServerAccessControlEntry",4,0.33,1.00,11,0.10,1340.10,5,1,7,8,7,139.89,0,18,2,2,139.89,0.00,0.50,0.75,0,0.00,1,298.41,1,3,5,org.apache.jackrabbit.rmi.server.ServerObject,0.00,4,2,4,0,4,1,1,0,80,1
"org.apache.jackrabbit.rmi.server.security.ServerAccessControlList",4,0.00,2.25,27,0.35,16935.97,4,0,12,13,10,113.23,1,42,1,3,113.23,0.00,0.67,0.00,0,4.00,5,1060.31,2,1,9,org.apache.jackrabbit.rmi.server.security.ServerAccessControlPolicy,0.00,9,3,9,0,9,3,1,1,218,1
"org.apache.jackrabbit.rmi.server.security.ServerAccessControlManager",8,0.14,1.12,25,0.32,6951.85,9,1,10,18,7,130.03,0,46,1,2,130.03,0.00,0.50,0.88,0,0.00,2,962.53,1,6,6,org.apache.jackrabbit.rmi.server.ServerObject,0.00,10,2,9,0,10,2,1,0,229,1
"org.apache.jackrabbit.rmi.server.security.ServerAccessControlPolicy",2,1.00,1.00,7,0.05,730.53,3,1,5,2,5,133.02,0,13,2,2,133.02,1.00,0.33,0.50,0,2.00,1,159.46,0,1,3,org.apache.jackrabbit.rmi.server.ServerObject,0.00,0,2,2,1,0,1,1,0,43,1
"org.apache.jackrabbit.rmi.server.security.ServerAccessControlPolicyIterator",2,0.00,1.00,5,0.05,584.99,2,0,5,3,3,90.35,19,11,1,3,140.35,0.00,0.67,0.00,0,2.00,1,156.38,1,1,2,org.apache.jackrabbit.rmi.server.iterator.ServerIterator,0.00,1,3,2,0,1,1,0,3,43,1
"org.apache.jackrabbit.rmi.server.security.ServerPrivilege",7,0.17,1.00,17,0.14,1824.13,8,1,6,13,5,140.75,0,29,2,2,140.75,0.00,0.50,0.86,0,0.00,1,408.74,1,4,3,org.apache.jackrabbit.rmi.server.ServerObject,0.00,6,2,7,0,6,3,1,0,114,1
"org.apache.jackrabbit.test.api.observation.AbstractObservationTest",14,0.23,1.79,85,1.11,36578.20,17,3,14,42,25,64.93,126,116,22,4,114.93,7.33,0.12,0.12,3,62.00,6,3321.04,2,3,3,org.apache.jackrabbit.test.AbstractJCRTest,0.20,28,3,25,22,28,11,0,19,684,2
"org.apache.jackrabbit.test.api.observation.AbstractObservationTest$Callable",1,0.00,1.00,2,0.01,51.30,1,0,14,1,0,146.30,0,3,0,1,146.30,0.00,0.00,0.00,0,1.00,1,27.65,0,0,0,,0.00,0,0,1,0,0,1,0,0,11,1
"org.apache.jackrabbit.test.api.observation.AddEventListenerTest",7,0.00,1.14,84,1.22,35472.39,7,0,5,21,4,59.25,54,110,1,5,101.54,0.00,0.80,0.00,0,0.00,2,3654.35,5,1,3,org.apache.jackrabbit.test.api.observation.AbstractObservationTest,0.00,14,4,8,0,14,6,0,10,678,1
"org.apache.jackrabbit.test.api.observation.EventIteratorTest",3,0.00,1.67,47,0.59,15877.45,3,0,5,15,4,53.56,34,54,1,5,97.69,0.00,0.80,0.00,0,0.00,2,1770.04,2,0,3,org.apache.jackrabbit.test.api.observation.AbstractObservationTest,0.00,12,4,5,0,12,3,0,8,328,1
"org.apache.jackrabbit.test.api.observation.EventJournalTest",15,0.07,1.40,112,1.37,27314.46,16,1,9,45,3,163.72,19,132,1,5,113.72,0.00,0.80,0.93,2,0.00,3,4100.32,4,1,2,org.apache.jackrabbit.test.api.observation.AbstractObservationTest,0.09,30,4,21,0,30,14,0,10,843,1
"org.apache.jackrabbit.test.api.observation.EventResult",5,0.00,2.00,30,0.28,5463.78,8,3,8,16,19,73.76,56,43,19,1,117.89,0.00,0.00,0.33,2,2.00,3,845.75,0,3,0,java.lang.Object,0.00,11,0,10,0,11,2,1,11,195,1
"org.apache.jackrabbit.test.api.observation.EventTest",3,0.00,1.00,33,0.42,8149.26,3,0,3,13,3,62.82,23,37,1,5,105.11,0.00,0.80,0.00,0,0.00,1,1256.61,2,0,2,org.apache.jackrabbit.test.api.observation.AbstractObservationTest,0.00,10,4,3,0,10,3,0,4,243,1
"org.apache.jackrabbit.test.api.observation.GetDateTest",1,0.00,4.00,21,0.25,8247.23,1,0,7,11,2,58.30,6,20,1,5,90.52,0.00,0.80,0.00,0,0.00,4,752.14,0,0,1,org.apache.jackrabbit.test.api.observation.AbstractObservationTest,0.00,10,4,4,0,10,1,0,3,134,1
"org.apache.jackrabbit.test.api.observation.GetDateTest$Callable",1,0.00,1.00,4,0.03,256.15,1,0,7,3,0,129.58,0,5,0,1,129.58,0.00,0.00,0.00,0,1.00,1,80.34,0,0,0,java.lang.Object,0.00,2,0,1,0,2,1,0,0,23,0
"org.apache.jackrabbit.test.api.observation.GetIdentifierTest",6,0.00,1.00,42,0.56,9717.64,6,0,4,18,2,114.20,3,43,1,5,114.20,0.00,0.80,0.00,0,0.00,1,1680.04,0,0,1,org.apache.jackrabbit.test.api.observation.AbstractObservationTest,0.00,12,4,6,0,12,6,0,1,345,1
"org.apache.jackrabbit.test.api.observation.GetIdentifierTest$Callable",1,0.00,1.00,4,0.03,256.15,1,0,4,3,0,129.58,0,5,0,1,129.58,0.00,0.00,0.00,0,1.00,1,80.34,0,0,0,java.lang.Object,0.00,2,0,1,0,2,1,0,0,23,0
"org.apache.jackrabbit.test.api.observation.GetIdentifierTest$Callable_0",1,0.00,1.00,3,0.04,362.27,1,0,4,4,0,133.05,0,4,0,1,133.05,0.00,0.00,0.00,0,1.00,1,108.08,0,0,0,java.lang.Object,0.00,3,0,1,0,3,1,0,0,28,0
"org.apache.jackrabbit.test.api.observation.GetIdentifierTest$Callable_1",1,0.00,1.00,4,0.02,200.72,1,0,4,3,0,130.41,0,5,0,1,130.41,0.00,0.00,0.00,0,1.00,1,70.91,0,0,0,java.lang.Object,0.00,2,0,1,0,2,1,0,0,21,0
"org.apache.jackrabbit.test.api.observation.GetIdentifierTest$Callable_2",1,0.00,1.00,4,0.04,333.05,1,0,4,4,0,128.68,0,5,0,1,128.68,0.00,0.00,0.00,0,1.00,1,106.10,0,0,0,java.lang.Object,0.00,3,0,1,0,3,1,0,0,28,0
"org.apache.jackrabbit.test.api.observation.GetIdentifierTest$Callable_3",1,0.00,1.00,4,0.03,217.60,1,0,4,3,0,130.13,0,5,0,1,130.13,0.00,0.00,0.00,0,1.00,1,76.53,0,0,0,java.lang.Object,0.00,2,0,1,0,2,1,0,0,22,0
"org.apache.jackrabbit.test.api.observation.GetIdentifierTest$Callable_4",1,0.00,1.00,4,0.02,200.72,1,0,4,3,0,130.41,0,5,0,1,130.41,0.00,0.00,0.00,0,1.00,1,70.91,0,0,0,java.lang.Object,0.00,2,0,1,0,2,1,0,0,21,0
"org.apache.jackrabbit.test.api.observation.GetInfoTest",5,0.00,2.00,49,0.52,12390.91,5,0,4,12,2,158.52,6,40,1,5,108.52,0.00,0.80,0.00,0,2.00,2,1549.53,0,0,1,org.apache.jackrabbit.test.api.observation.AbstractObservationTest,0.00,7,4,10,0,7,5,0,1,309,1
"org.apache.jackrabbit.test.api.observation.GetInfoTest$Callable",1,0.00,1.00,4,0.03,256.15,1,0,4,3,0,129.58,0,5,0,1,129.58,0.00,0.00,0.00,0,1.00,1,80.34,0,0,0,java.lang.Object,0.00,2,0,1,0,2,1,0,0,23,0
"org.apache.jackrabbit.test.api.observation.GetInfoTest$Callable_0",1,0.00,1.00,4,0.02,200.72,1,0,4,3,0,130.41,0,5,0,1,130.41,0.00,0.00,0.00,0,1.00,1,70.91,0,0,0,java.lang.Object,0.00,2,0,1,0,2,1,0,0,21,0
"org.apache.jackrabbit.test.api.observation.GetInfoTest$Callable_1",1,0.00,1.00,4,0.04,333.05,1,0,4,4,0,128.68,0,5,0,1,128.68,0.00,0.00,0.00,0,1.00,1,106.10,0,0,0,java.lang.Object,0.00,3,0,1,0,3,1,0,0,28,0
"org.apache.jackrabbit.test.api.observation.GetInfoTest$Callable_2",1,0.00,1.00,3,0.02,151.81,1,0,4,2,0,136.03,0,4,0,1,136.03,0.00,0.00,0.00,0,1.00,1,54.60,0,0,0,java.lang.Object,0.00,1,0,1,0,1,1,0,0,17,0
"org.apache.jackrabbit.test.api.observation.GetInfoTest$Callable_3",1,0.00,1.00,3,0.02,136.54,1,0,4,2,0,136.39,0,4,0,1,136.39,0.00,0.00,0.00,0,1.00,1,49.51,0,0,0,java.lang.Object,0.00,1,0,1,0,1,1,0,0,16,0
"org.apache.jackrabbit.test.api.observation.GetRegisteredEventListenersTest",2,0.00,1.00,21,0.24,6030.45,2,0,2,5,3,74.08,12,24,1,5,106.30,0.00,0.80,0.00,0,0.00,1,725.25,3,0,2,org.apache.jackrabbit.test.api.observation.AbstractObservationTest,0.00,3,4,2,0,3,2,0,2,152,1
"org.apache.jackrabbit.test.api.observation.GetUserDataTest",4,0.00,1.25,26,0.22,4445.18,4,0,5,10,3,167.94,5,27,1,5,117.94,0.00,0.80,0.00,1,2.00,2,654.29,3,0,2,org.apache.jackrabbit.test.api.observation.AbstractObservationTest,0.00,6,4,5,0,6,4,0,2,143,1
"org.apache.jackrabbit.test.api.observation.GetUserDataTest$Callable",1,0.00,1.00,4,0.03,256.15,1,0,5,3,0,129.58,0,5,0,1,129.58,0.00,0.00,0.00,0,1.00,1,80.34,0,0,0,java.lang.Object,0.00,2,0,1,0,2,1,0,0,23,0
"org.apache.jackrabbit.test.api.observation.GetUserDataTest$Callable_0",1,0.00,1.00,5,0.05,863.43,1,0,5,3,0,121.80,0,6,0,1,121.80,0.00,0.00,0.00,0,1.00,1,161.73,0,0,0,java.lang.Object,0.00,2,0,1,0,2,1,0,0,39,0
"org.apache.jackrabbit.test.api.observation.GetUserDataTest$Callable_1",1,0.00,1.00,3,0.02,136.54,1,0,5,2,0,136.39,0,4,0,1,136.39,0.00,0.00,0.00,0,1.00,1,49.51,0,0,0,java.lang.Object,0.00,1,0,1,0,1,1,0,0,16,0
"org.apache.jackrabbit.test.api.observation.GetUserDataTest$Callable_2",1,0.00,1.00,4,0.02,240.37,1,0,5,3,0,129.79,0,5,0,1,129.79,0.00,0.00,0.00,0,1.00,1,74.61,0,0,0,java.lang.Object,0.00,2,0,1,0,2,1,0,0,22,0
"org.apache.jackrabbit.test.api.observation.LockingTest",3,0.00,2.33,55,0.75,25565.66,3,0,6,16,4,48.90,34,54,1,5,93.03,0.00,0.80,0.00,1,0.00,3,2261.12,3,1,3,org.apache.jackrabbit.test.api.observation.AbstractObservationTest,0.00,13,4,7,0,13,2,0,6,390,1
"org.apache.jackrabbit.test.api.observation.NodeAddedTest",4,0.00,1.00,41,0.46,9392.73,4,0,3,9,3,64.86,30,42,1,5,107.15,0.00,0.80,0.00,0,0.00,1,1372.91,3,0,2,org.apache.jackrabbit.test.api.observation.AbstractObservationTest,0.00,5,4,4,0,5,4,0,5,276,1
"org.apache.jackrabbit.test.api.observation.NodeMovedTest",5,0.38,1.00,85,1.22,41635.93,7,2,4,16,3,112.36,91,85,1,5,94.23,0.00,0.80,0.20,2,0.00,1,3653.50,5,0,2,org.apache.jackrabbit.test.api.observation.AbstractObservationTest,0.00,11,4,5,0,11,5,0,13,674,1
"org.apache.jackrabbit.test.api.observation.NodeRemovedTest",2,0.00,1.00,24,0.27,5847.23,2,0,3,7,3,59.32,23,25,1,5,103.45,0.00,0.80,0.00,0,0.00,1,802.77,3,0,2,org.apache.jackrabbit.test.api.observation.AbstractObservationTest,0.00,5,4,2,0,5,2,0,3,160,1
"org.apache.jackrabbit.test.api.observation.NodeReorderTest",5,0.38,3.80,143,2.02,136737.96,7,2,5,24,4,131.77,127,147,1,5,81.77,0.00,0.80,0.20,2,5.00,6,6058.89,5,0,3,org.apache.jackrabbit.test.api.observation.AbstractObservationTest,0.00,19,4,19,0,19,5,0,40,1013,1
"org.apache.jackrabbit.test.api.observation.PropertyAddedTest",3,0.00,1.33,37,0.48,12114.70,3,0,5,13,3,52.28,29,40,1,5,102.28,0.00,0.80,0.00,0,0.00,2,1451.08,3,0,2,org.apache.jackrabbit.test.api.observation.AbstractObservationTest,0.00,10,4,4,0,10,3,0,4,274,1
"org.apache.jackrabbit.test.api.observation.PropertyChangedTest",4,0.00,1.75,65,1.06,47696.82,4,0,7,24,4,49.73,44,72,1,5,93.85,0.00,0.80,0.00,0,0.00,4,3181.32,3,0,3,org.apache.jackrabbit.test.api.observation.AbstractObservationTest,0.00,20,4,7,0,20,4,0,7,548,1
"org.apache.jackrabbit.test.api.observation.PropertyRemovedTest",2,0.00,1.00,26,0.35,8292.36,2,0,4,8,3,63.40,24,30,1,5,100.96,0.00,0.80,0.00,0,0.00,1,1063.85,3,0,2,org.apache.jackrabbit.test.api.observation.AbstractObservationTest,0.00,6,4,2,0,6,2,0,3,201,1
"org.apache.jackrabbit.test.api.observation.TestAll",1,0.00,1.00,22,0.28,10800.80,1,0,3,3,19,45.03,11,24,1,2,89.16,0.00,0.50,0.00,0,1.00,1,827.66,0,1,18,junit.framework.TestCase,0.00,2,1,1,0,2,0,0,3,167,1
"org.apache.jackrabbit.test.api.observation.WorkspaceOperationTest",3,0.00,1.00,49,0.73,22769.39,3,0,3,11,3,45.53,28,48,1,5,95.53,0.00,0.80,0.00,0,0.00,1,2203.07,4,0,2,org.apache.jackrabbit.test.api.observation.AbstractObservationTest,0.00,8,4,3,0,8,3,0,4,408,1
"org.apache.jackrabbit.webdav.jcr.property.LengthsProperty",3,1.00,1.33,14,0.14,2666.85,4,1,5,6,4,93.03,19,19,1,2,125.25,0.00,0.50,0.33,0,6.00,2,415.22,1,1,3,org.apache.jackrabbit.webdav.property.AbstractDavProperty,0.00,3,1,4,0,3,2,1,4,96,1
"org.apache.jackrabbit.webdav.jcr.property.NamespacesProperty",6,0.10,2.50,41,0.61,21190.33,8,2,17,24,9,163.82,8,53,2,2,113.82,0.00,0.50,0.58,0,0.00,7,1837.40,1,3,7,org.apache.jackrabbit.webdav.property.AbstractDavProperty,0.00,18,1,15,0,18,3,1,4,362,1
"org.apache.jackrabbit.webdav.jcr.property.ValuesProperty",13,0.12,2.54,77,1.12,46152.45,15,2,19,40,15,84.53,89,104,7,2,116.76,0.00,0.50,0.38,2,0.00,10,3373.33,1,7,8,org.apache.jackrabbit.webdav.property.AbstractDavProperty,0.00,27,1,33,0,27,6,1,21,665,1
"org.apache.jackrabbit.rmi.client.security.ClientAccessControlEntry",4,0.33,1.50,15,0.13,2350.09,5,1,8,9,5,171.19,11,26,1,1,131.30,0.00,0.00,0.75,0,0.00,2,393.58,1,3,4,org.apache.jackrabbit.rmi.client.ClientObject,0.00,5,1,6,0,5,1,1,3,100,1
"org.apache.jackrabbit.rmi.client.security.ClientAccessControlList",4,0.00,1.25,11,0.12,1939.51,4,0,10,8,5,120.70,20,27,1,2,138.57,0.00,0.50,0.00,0,4.00,2,363.94,2,1,4,org.apache.jackrabbit.rmi.client.security.ClientAccessControlPolicy,0.00,4,2,5,0,4,3,1,6,92,1
"org.apache.jackrabbit.rmi.client.security.ClientAccessControlManager",10,0.33,1.80,43,0.54,13646.75,11,1,14,23,5,163.60,26,84,1,1,123.72,0.00,0.00,0.70,0,0.00,3,1610.79,1,6,4,org.apache.jackrabbit.rmi.client.ClientObject,0.00,13,1,18,0,13,4,1,12,355,1
"org.apache.jackrabbit.rmi.client.security.ClientAccessControlPolicy",2,1.00,1.00,7,0.05,627.26,3,1,4,2,5,133.78,9,12,2,1,133.54,0.00,0.00,0.50,0,2.00,1,147.60,0,1,3,org.apache.jackrabbit.rmi.client.ClientObject,0.00,0,1,2,1,0,1,1,1,41,1
"org.apache.jackrabbit.rmi.client.security.ClientAccessControlPolicyIterator",3,0.00,1.00,7,0.05,528.94,3,0,6,4,5,192.08,5,14,1,2,142.08,0.00,0.50,0.00,0,3.00,1,161.13,2,2,4,org.apache.jackrabbit.rmi.client.iterator.ClientIterator,0.00,1,2,3,0,1,1,1,3,49,1
"org.apache.jackrabbit.rmi.client.security.ClientPrivilege",9,0.38,1.89,37,0.31,6357.66,10,1,6,19,5,175.96,13,61,1,1,125.96,0.00,0.00,0.67,1,0.00,4,940.29,1,4,4,org.apache.jackrabbit.rmi.client.ClientObject,0.00,10,1,17,0,10,5,1,6,234,1
"org.apache.jackrabbit.server.BasicCredentialsProvider",2,0.33,4.50,34,0.53,33606.22,5,3,10,18,6,117.76,38,47,3,1,91.48,0.00,0.00,0.50,0,2.00,8,1599.13,0,1,3,java.lang.Object,0.00,16,0,9,0,16,1,1,4,278,1
"org.apache.jackrabbit.server.BasicCredentialsProviderTest",4,0.00,1.75,32,0.47,18080.86,4,0,19,18,3,158.40,4,40,1,2,108.40,0.00,0.50,0.00,0,4.00,3,1422.28,0,0,2,junit.framework.TestCase,0.00,14,1,7,0,14,4,0,2,276,1
"org.apache.jackrabbit.server.BasicCredentialsProviderTest$RequestImpl",51,1.00,1.00,101,0.51,4510.72,52,1,19,51,0,155.67,0,153,0,1,155.67,0.00,0.00,0.02,0,100.00,1,1519.42,0,37,0,java.lang.Object,0.00,0,0,51,0,0,14,1,0,478,1
"org.apache.jackrabbit.server.CredentialsProvider",1,0.00,1.00,2,0.01,78.44,1,0,4,1,6,100.72,11,4,6,1,144.85,0.00,0.00,0.00,0,1.00,1,41.22,0,1,0,,0.00,0,0,1,0,0,0,0,2,14,1
"org.apache.jackrabbit.server.SessionProvider",2,0.00,1.00,3,0.03,158.68,2,0,6,2,4,106.04,19,5,4,1,156.04,0.00,0.00,0.00,0,2.00,1,86.25,0,1,0,,0.00,0,0,2,0,0,1,0,3,26,1
"org.apache.jackrabbit.server.SessionProviderImpl",3,1.00,1.33,12,0.11,2236.10,4,1,7,6,4,107.98,16,19,2,1,125.86,0.00,0.00,0.33,0,4.00,2,342.21,0,1,2,java.lang.Object,0.00,3,0,4,0,3,2,1,5,82,1
"org.apache.jackrabbit.server.TestAll",1,0.00,1.00,5,0.04,864.35,1,0,3,3,1,79.51,7,7,0,2,121.80,0.00,0.50,0.00,0,1.00,1,115.51,0,1,1,junit.framework.TestCase,0.00,2,1,1,0,2,0,0,2,31,1
"org.apache.jackrabbit.test.api.AbstractImportXmlTest",13,0.10,2.46,218,2.84,81565.50,52,39,39,78,3,47.87,112,271,1,4,95.97,0.33,0.60,0.12,4,0.00,4,8524.22,2,5,2,org.apache.jackrabbit.test.AbstractJCRTest,0.21,65,3,32,1,65,8,0,34,1522,1
"org.apache.jackrabbit.test.api.AbstractPropertyTest",5,0.06,1.60,31,0.33,7588.89,9,4,6,15,12,117.05,21,40,9,4,116.81,3.00,0.23,0.30,2,2.00,3,987.46,3,1,3,org.apache.jackrabbit.test.AbstractJCRTest,0.39,10,3,8,9,10,4,0,9,206,1
"org.apache.jackrabbit.test.api.AbstractWorkspaceCopyBetweenTest",4,0.50,2.50,49,0.50,14107.98,10,6,6,23,7,60.31,29,59,5,5,102.60,4.25,0.18,0.54,2,0.00,4,1514.54,3,1,2,org.apache.jackrabbit.test.api.AbstractWorkspaceCopyTest,0.30,19,4,10,17,19,3,0,13,317,1
"org.apache.jackrabbit.test.api.AbstractWorkspaceCopyTest",3,0.50,1.67,21,0.18,3080.92,6,3,4,8,4,83.42,18,29,3,4,115.64,6.67,0.12,0.67,1,0.00,3,532.36,2,0,1,org.apache.jackrabbit.test.AbstractJCRTest,0.28,5,3,5,20,5,3,0,7,126,1
"org.apache.jackrabbit.test.api.AbstractWorkspaceReferenceableTest",2,0.00,2.00,13,0.14,3764.38,2,0,6,7,6,83.80,12,20,4,6,116.03,0.80,0.50,0.00,0,0.00,3,433.25,2,1,2,org.apache.jackrabbit.test.api.AbstractWorkspaceCopyBetweenTest,0.17,5,5,4,4,5,1,0,4,94,1
"org.apache.jackrabbit.test.api.AbstractWorkspaceSameNameSibsTest",2,1.00,5.00,40,0.45,25070.03,6,4,5,10,6,45.70,22,47,4,6,89.83,0.80,0.50,0.75,0,0.00,9,1353.63,3,0,2,org.apache.jackrabbit.test.api.AbstractWorkspaceCopyBetweenTest,0.34,8,5,10,4,8,2,0,10,249,1
"org.apache.jackrabbit.test.api.AbstractWorkspaceVersionableTest",2,0.00,2.00,13,0.15,3837.06,2,0,6,7,6,98.09,10,20,4,6,115.96,0.80,0.50,0.00,0,0.00,3,443.40,2,1,2,org.apache.jackrabbit.test.api.AbstractWorkspaceCopyBetweenTest,0.17,5,5,4,4,5,1,0,4,96,1
"org.apache.jackrabbit.test.api.AddNodeTest",13,0.00,2.00,90,1.07,21920.45,13,0,12,38,3,84.18,82,132,1,4,116.40,0.00,0.75,0.00,0,0.00,4,3208.12,1,0,2,org.apache.jackrabbit.test.AbstractJCRTest,0.00,25,3,26,0,25,13,0,34,672,1
"org.apache.jackrabbit.test.api.Base64",11,0.12,2.27,108,1.78,229742.97,15,4,7,18,2,58.91,86,135,2,1,101.20,0.00,0.00,0.14,2,39.00,8,5351.38,0,0,0,java.lang.Object,0.00,7,0,25,0,7,11,0,23,993,1
"org.apache.jackrabbit.test.api.BinaryPropertyTest",19,0.00,3.26,207,2.56,121904.63,19,0,9,63,4,85.57,108,316,1,5,103.44,0.00,0.80,0.00,0,0.00,6,7666.40,0,1,3,org.apache.jackrabbit.test.api.AbstractPropertyTest,0.20,44,4,62,0,44,18,0,40,1455,1
"org.apache.jackrabbit.test.api.BooleanPropertyTest",13,0.00,2.77,98,1.09,36347.55,13,0,7,40,3,94.23,70,164,1,5,112.10,0.00,0.80,0.00,0,0.00,6,3264.03,0,1,2,org.apache.jackrabbit.test.api.AbstractPropertyTest,0.23,27,4,36,0,27,12,0,26,654,1
"org.apache.jackrabbit.test.api.CheckPermissionTest",3,0.00,2.67,27,0.33,9648.30,3,0,3,10,2,59.45,26,39,1,4,107.56,0.00,0.75,0.00,2,0.00,5,1003.38,1,0,1,org.apache.jackrabbit.test.AbstractJCRTest,0.00,7,3,8,0,7,3,0,7,204,1
"org.apache.jackrabbit.test.api.DatePropertyTest",13,0.00,2.62,99,1.12,36626.24,13,0,8,41,3,94.22,71,160,1,5,112.09,0.00,0.80,0.00,0,0.00,6,3371.86,0,1,2,org.apache.jackrabbit.test.api.AbstractPropertyTest,0.23,28,4,34,0,28,12,0,28,676,1
"org.apache.jackrabbit.test.api.DocumentViewImportTest",21,0.01,2.05,149,1.83,51028.62,25,4,13,47,3,94.78,120,229,1,5,112.65,0.00,0.80,0.26,11,136.00,6,5480.17,6,0,2,org.apache.jackrabbit.test.api.AbstractImportXmlTest,0.17,26,4,43,0,26,21,0,47,1066,1
"org.apache.jackrabbit.test.api.DoublePropertyTest",13,0.00,2.62,98,1.12,37231.14,13,0,8,43,3,94.16,68,157,1,5,112.03,0.00,0.80,0.00,0,0.00,6,3353.62,0,1,2,org.apache.jackrabbit.test.api.AbstractPropertyTest,0.23,30,4,34,0,30,12,0,24,672,1
"org.apache.jackrabbit.test.api.EscapeJCRUtil",7,0.22,2.57,73,0.80,43331.10,10,3,1,18,2,124.24,27,89,1,1,103.62,0.00,0.00,0.14,5,17.00,7,2403.89,0,6,1,java.lang.Object,0.00,11,0,18,0,11,1,0,8,491,1
"org.apache.jackrabbit.test.api.ExportDocViewTest",39,0.04,3.05,437,5.96,255316.28,59,20,40,145,5,51.85,361,599,1,4,101.85,0.00,0.75,0.09,23,696.00,10,17881.88,3,11,4,org.apache.jackrabbit.test.AbstractJCRTest,0.12,106,3,119,0,106,28,0,100,3316,1
"org.apache.jackrabbit.test.api.ExportDocViewTest$AttributeSeparator",4,0.33,1.75,30,0.26,5803.98,10,6,40,13,0,114.45,1,35,0,1,114.45,0.00,0.00,0.42,1,0.00,4,786.84,0,2,0,java.lang.Object,0.00,9,0,7,0,9,2,0,1,174,1
"org.apache.jackrabbit.test.api.ExportDocViewTest$StackEntry",0,0.00,0.00,3,0.02,129.73,2,2,40,0,0,171.00,2,4,0,1,171.00,0.00,0.00,0.00,0,0.00,0,51.89,0,0,0,java.lang.Object,0.00,0,0,0,0,0,0,0,2,15,1
"org.apache.jackrabbit.test.api.ExportSysViewTest",12,0.19,1.17,46,0.50,8123.35,19,7,16,25,3,170.76,24,73,1,4,130.88,0.00,0.75,0.32,2,4.00,2,1490.02,2,0,2,org.apache.jackrabbit.test.AbstractJCRTest,0.21,13,3,14,0,13,12,0,4,340,1
"org.apache.jackrabbit.test.api.ExportSysViewTest$SysViewParser",2,0.20,2.00,19,0.20,4460.31,7,5,16,10,1,158.88,3,27,0,1,108.88,0.00,0.00,0.30,0,0.00,2,610.34,0,0,1,java.lang.Object,0.00,8,0,4,0,8,2,0,3,131,1
"org.apache.jackrabbit.test.api.GetWeakReferencesTest",6,0.40,1.50,59,0.79,15262.93,8,2,7,22,3,108.49,5,69,1,4,108.49,0.00,0.75,0.83,0,0.00,4,2359.00,2,0,2,org.apache.jackrabbit.test.AbstractJCRTest,0.12,16,3,9,0,16,6,0,2,465,1
"org.apache.jackrabbit.test.api.HasPermissionTest",3,0.00,1.00,36,0.58,16192.73,4,1,3,12,2,59.06,23,44,1,4,101.35,0.00,0.75,1.00,0,0.00,1,1745.66,1,0,1,org.apache.jackrabbit.test.AbstractJCRTest,0.00,9,3,3,0,9,3,0,4,343,1
"org.apache.jackrabbit.test.api.ImpersonateTest",1,0.00,7.00,25,0.38,17811.86,1,0,9,12,3,103.07,18,39,1,4,84.93,0.00,0.75,0.00,0,0.00,7,1126.01,1,0,2,org.apache.jackrabbit.test.AbstractJCRTest,0.00,11,3,7,0,11,1,0,8,194,1
"org.apache.jackrabbit.test.api.LifecycleTest",3,0.75,3.33,32,0.39,10529.20,5,2,8,10,3,126.12,10,51,1,4,105.50,0.00,0.75,1.00,0,0.00,4,1165.95,3,0,2,org.apache.jackrabbit.test.AbstractJCRTest,0.14,7,3,10,0,7,3,0,4,233,1
"org.apache.jackrabbit.test.api.LongPropertyTest",13,0.00,2.62,96,1.09,34613.00,13,0,8,42,3,94.41,67,157,1,5,112.28,0.00,0.80,0.00,0,0.00,6,3274.34,0,1,2,org.apache.jackrabbit.test.api.AbstractPropertyTest,0.23,29,4,34,0,29,12,0,24,658,1
"org.apache.jackrabbit.test.api.NamePropertyTest",10,0.00,2.20,58,0.61,12746.50,10,0,7,29,3,88.07,69,97,1,5,120.29,0.00,0.80,0.00,0,0.00,5,1819.93,0,1,2,org.apache.jackrabbit.test.api.AbstractPropertyTest,0.24,19,4,22,0,19,9,0,19,385,1
"org.apache.jackrabbit.test.api.NameTest",5,0.00,1.40,34,0.52,12329.11,5,0,9,24,3,97.31,27,41,1,4,115.18,0.00,0.75,0.00,1,0.00,3,1554.75,0,1,2,org.apache.jackrabbit.test.AbstractJCRTest,0.00,19,3,7,0,19,4,0,5,326,1
"org.apache.jackrabbit.test.api.NamespaceRegistryReadMethodsTest",6,0.30,2.17,61,0.73,18665.36,10,4,10,21,3,73.79,37,73,1,4,106.01,0.00,0.75,0.50,0,0.00,3,2178.77,2,0,2,org.apache.jackrabbit.test.AbstractJCRTest,0.25,15,3,13,0,15,6,0,12,430,1
"org.apache.jackrabbit.test.api.NamespaceRegistryTest",8,0.24,2.75,77,0.88,21919.86,14,6,8,33,2,65.81,58,109,1,4,108.10,0.00,0.75,0.38,0,0.00,5,2633.26,2,2,1,org.apache.jackrabbit.test.AbstractJCRTest,0.24,25,3,22,0,25,6,0,28,544,1
"org.apache.jackrabbit.test.api.NamespaceRemappingTest",13,0.12,1.62,107,1.36,32646.88,15,2,10,47,2,72.87,163,157,1,4,110.43,0.00,0.75,0.62,2,0.00,3,4086.99,3,1,1,org.apache.jackrabbit.test.AbstractJCRTest,0.21,34,3,21,0,34,12,0,35,824,1
"org.apache.jackrabbit.test.api.NodeAddMixinTest",8,0.00,3.25,113,1.48,52637.75,8,0,12,46,4,49.43,85,145,1,4,97.91,0.00,0.75,0.00,1,0.00,6,4435.50,2,0,3,org.apache.jackrabbit.test.AbstractJCRTest,0.00,38,3,26,0,38,8,0,35,796,1
"org.apache.jackrabbit.test.api.NodeCanAddMixinTest",5,0.00,2.60,63,0.85,23733.14,5,0,9,31,4,51.58,45,84,1,4,101.57,0.00,0.75,0.00,0,0.00,3,2539.37,2,0,3,org.apache.jackrabbit.test.AbstractJCRTest,0.00,26,3,13,0,26,5,0,16,467,1
"org.apache.jackrabbit.test.api.NodeDiscoveringNodeTypesTest",6,0.00,2.83,65,0.85,28143.63,8,2,9,29,3,56.44,49,102,1,4,104.55,0.00,0.75,0.50,1,0.00,5,2537.19,2,1,2,org.apache.jackrabbit.test.AbstractJCRTest,0.25,23,3,17,0,23,5,0,14,485,1
"org.apache.jackrabbit.test.api.NodeItemIsModifiedTest",4,0.00,1.00,23,0.29,3640.74,4,0,4,12,2,84.06,50,28,1,4,121.62,0.00,0.75,0.00,0,0.00,1,875.35,0,0,1,org.apache.jackrabbit.test.AbstractJCRTest,0.00,8,3,4,0,8,4,0,11,188,1
"org.apache.jackrabbit.test.api.NodeItemIsNewTest",2,0.00,1.00,10,0.13,1491.05,2,0,4,9,2,92.93,27,13,1,4,122.31,0.00,0.75,0.00,0,0.00,1,380.20,0,0,1,org.apache.jackrabbit.test.AbstractJCRTest,0.00,7,3,2,0,7,2,0,5,85,1
"org.apache.jackrabbit.test.api.NodeIteratorTest",5,0.00,2.80,45,0.45,14239.92,5,0,5,13,3,75.74,30,63,1,4,107.96,0.00,0.75,0.00,0,0.00,5,1336.28,1,0,2,org.apache.jackrabbit.test.AbstractJCRTest,0.13,8,3,14,0,8,5,0,11,280,1
"org.apache.jackrabbit.test.api.NodeMixinUtil",3,0.00,2.67,26,0.40,10207.13,3,0,9,19,5,129.89,11,37,4,1,109.28,0.00,0.00,0.00,0,3.00,3,1186.50,0,3,1,java.lang.Object,0.00,16,0,8,0,16,0,0,4,230,1
"org.apache.jackrabbit.test.api.NodeOrderableChildNodesTest",10,0.48,1.40,84,1.06,18041.90,13,3,9,27,3,63.12,105,113,1,4,111.59,0.00,0.75,0.77,2,0.00,2,3165.39,2,0,2,org.apache.jackrabbit.test.AbstractJCRTest,0.11,17,3,14,0,17,10,0,42,645,1
"org.apache.jackrabbit.test.api.NodeReadMethodsTest",38,0.38,3.97,550,8.44,677819.03,40,2,17,118,3,52.16,269,807,1,4,94.45,0.00,0.75,0.13,6,0.00,14,25310.75,4,6,2,org.apache.jackrabbit.test.AbstractJCRTest,0.12,80,3,151,0,80,32,0,120,4365,1
"org.apache.jackrabbit.test.api.NodeReadMethodsTest$ItemVisitor",2,0.00,1.00,5,0.04,319.50,2,0,17,5,0,142.42,0,8,0,1,142.42,0.00,0.00,0.00,0,2.00,1,114.87,0,0,0,java.lang.Object,0.00,3,0,2,0,3,2,0,0,33,0
"org.apache.jackrabbit.test.api.NodeRemoveMixinTest",4,0.00,4.00,70,0.98,34008.21,4,0,12,27,4,83.48,60,105,1,4,93.84,0.00,0.75,0.00,0,0.00,4,2944.82,2,0,3,org.apache.jackrabbit.test.AbstractJCRTest,0.00,23,3,16,0,23,4,0,26,515,1
"org.apache.jackrabbit.test.api.NodeSetPrimaryTypeTest",9,0.00,3.11,113,1.60,50051.38,9,0,13,44,4,58.70,67,154,1,4,100.99,0.00,0.75,0.00,1,0.00,5,4810.84,2,1,3,org.apache.jackrabbit.test.AbstractJCRTest,0.00,35,3,28,0,35,8,0,35,869,1
"org.apache.jackrabbit.test.api.NodeTest",37,0.89,1.68,338,4.61,101369.37,38,1,15,83,3,70.65,461,452,1,4,108.21,0.00,0.75,0.14,0,0.00,3,13829.52,8,0,2,org.apache.jackrabbit.test.AbstractJCRTest,0.13,46,3,62,0,46,37,0,234,2718,1
"org.apache.jackrabbit.test.api.NodeUUIDTest",3,0.00,2.00,33,0.46,11092.25,3,0,8,21,3,151.17,71,45,1,4,103.90,0.00,0.75,0.00,1,0.00,2,1386.67,2,0,2,org.apache.jackrabbit.test.AbstractJCRTest,0.00,18,3,6,0,18,3,0,26,265,1
"org.apache.jackrabbit.test.api.PathPropertyTest",10,0.00,2.20,76,1.00,41752.77,10,0,7,34,3,78.56,64,115,1,5,110.78,0.00,0.80,0.00,0,0.00,5,2994.64,0,1,2,org.apache.jackrabbit.test.api.AbstractPropertyTest,0.24,24,4,22,0,24,9,0,25,579,1
"org.apache.jackrabbit.test.api.PathTest",8,0.29,1.00,52,0.83,16402.60,9,1,8,27,2,115.89,3,62,1,4,115.89,0.00,0.75,0.75,0,0.00,1,2483.08,1,0,1,org.apache.jackrabbit.test.AbstractJCRTest,0.12,19,3,8,0,19,8,0,1,511,1
"org.apache.jackrabbit.test.api.PropertyItemIsModifiedTest",6,0.00,1.17,33,0.38,5086.89,7,1,5,17,2,79.54,47,42,1,4,121.83,0.00,0.75,1.00,0,0.00,2,1135.72,2,0,1,org.apache.jackrabbit.test.AbstractJCRTest,0.25,11,3,7,0,11,6,0,10,249,1
"org.apache.jackrabbit.test.api.PropertyItemIsNewTest",4,0.00,1.25,20,0.22,2981.66,5,1,5,14,2,79.96,31,27,1,4,122.26,0.00,0.75,1.00,0,0.00,2,655.48,2,0,1,org.apache.jackrabbit.test.AbstractJCRTest,0.27,10,3,5,0,10,4,0,6,148,1
"org.apache.jackrabbit.test.api.PropertyReadMethodsTest",20,0.08,1.75,104,1.17,26379.44,22,2,12,58,4,102.35,101,172,1,4,120.23,0.00,0.75,0.42,0,0.00,4,3514.64,3,0,3,org.apache.jackrabbit.test.AbstractJCRTest,0.17,38,3,35,0,38,20,0,32,757,1
"org.apache.jackrabbit.test.api.PropertyReadMethodsTest$ItemVisitor",2,0.00,1.00,5,0.04,319.50,2,0,12,5,0,142.42,0,9,0,1,142.42,0.00,0.00,0.00,0,2.00,1,114.87,0,0,0,java.lang.Object,0.00,3,0,2,0,3,2,0,0,33,0
"org.apache.jackrabbit.test.api.PropertyTest",1,0.00,1.00,11,0.14,2766.67,1,0,5,11,2,152.88,27,17,1,4,105.05,0.00,0.75,0.00,0,0.00,1,433.06,1,0,1,org.apache.jackrabbit.test.AbstractJCRTest,0.00,10,3,1,0,10,1,0,5,85,1
"org.apache.jackrabbit.test.api.PropertyTypeTest",3,0.00,2.67,31,0.40,15832.87,3,0,8,20,2,71.94,18,49,1,4,104.16,0.00,0.75,0.00,1,5.00,6,1210.94,2,0,1,org.apache.jackrabbit.test.AbstractJCRTest,0.14,17,3,8,0,17,3,0,3,226,1
"org.apache.jackrabbit.test.api.PropertyUtil",13,0.05,4.15,189,2.58,110779.16,29,16,16,42,16,54.68,101,280,16,1,96.97,0.00,0.00,0.01,1,46.00,8,7735.36,0,5,0,java.lang.Object,0.00,29,0,54,0,29,8,0,23,1397,1
"org.apache.jackrabbit.test.api.ReferencePropertyTest",14,0.69,1.57,59,0.64,10999.99,15,1,7,39,3,125.87,65,97,1,5,125.64,0.00,0.80,0.36,0,0.00,4,1933.97,2,1,2,org.apache.jackrabbit.test.api.AbstractPropertyTest,0.44,25,4,22,0,25,13,0,22,427,1
"org.apache.jackrabbit.test.api.ReferenceableRootNodesTest",3,0.75,3.00,29,0.30,8332.45,5,2,5,14,3,59.93,26,41,1,4,108.03,0.00,0.75,1.00,0,0.00,3,912.27,2,0,2,org.apache.jackrabbit.test.AbstractJCRTest,0.28,11,3,9,0,11,3,0,8,195,1
"org.apache.jackrabbit.test.api.ReferencesTest",5,0.00,5.40,151,2.50,141745.47,5,0,9,44,3,36.32,59,178,1,4,80.45,0.00,0.75,0.00,0,0.00,10,7511.68,2,0,2,org.apache.jackrabbit.test.AbstractJCRTest,0.00,39,3,27,0,39,5,0,44,1289,1
"org.apache.jackrabbit.test.api.RepositoryDescriptorTest",5,0.00,2.00,98,1.32,34657.09,7,2,11,27,2,75.02,29,108,1,4,92.89,0.00,0.75,0.50,0,0.00,3,3962.21,2,0,1,org.apache.jackrabbit.test.AbstractJCRTest,0.26,22,3,10,0,22,5,0,10,731,1
"org.apache.jackrabbit.test.api.RepositoryFactoryTest",3,0.00,1.67,14,0.15,3544.21,3,0,5,8,3,164.12,6,22,1,4,124.23,0.00,0.75,0.00,1,3.00,3,439.91,1,1,2,org.apache.jackrabbit.test.AbstractJCRTest,0.00,5,3,5,0,5,2,0,3,99,1
"org.apache.jackrabbit.test.api.RepositoryLoginTest",4,0.56,1.50,32,0.32,6589.76,7,3,6,14,2,79.67,25,55,1,4,111.89,0.00,0.75,0.75,0,0.00,3,947.65,2,0,1,org.apache.jackrabbit.test.AbstractJCRTest,0.13,10,3,6,0,10,4,0,6,205,1
"org.apache.jackrabbit.test.api.RootNodeTest",6,0.20,1.33,24,0.20,2557.66,8,2,5,15,2,128.00,29,34,1,4,127.77,0.00,0.75,0.67,0,0.00,2,590.10,2,0,1,org.apache.jackrabbit.test.AbstractJCRTest,0.25,9,3,8,0,9,6,0,10,149,1
"org.apache.jackrabbit.test.api.SerializationContext",4,0.31,1.75,83,0.98,18215.43,38,34,6,13,5,114.15,14,94,2,1,93.53,0.00,0.00,0.26,0,0.00,3,2945.79,0,1,3,java.lang.Object,0.00,9,0,7,0,9,3,0,3,517,0
"org.apache.jackrabbit.test.api.SerializationTest",59,0.16,1.58,307,3.44,84845.44,71,12,29,103,5,159.84,163,459,1,4,119.96,0.00,0.75,0.24,12,264.00,5,10305.06,4,2,4,org.apache.jackrabbit.test.AbstractJCRTest,0.09,44,3,93,0,44,57,0,56,2149,1
"org.apache.jackrabbit.test.api.SessionReadMethodsTest",14,0.04,1.93,88,0.95,24909.24,16,2,9,44,3,98.35,72,129,1,4,116.23,0.00,0.75,0.46,2,0.00,4,2860.42,2,2,2,org.apache.jackrabbit.test.AbstractJCRTest,0.20,30,3,27,0,30,12,0,20,618,1
"org.apache.jackrabbit.test.api.SessionRemoveItemTest",9,0.34,2.00,81,0.85,18784.95,13,4,12,27,4,159.10,14,110,1,4,109.10,0.00,0.75,0.56,0,0.00,4,2545.92,4,0,3,org.apache.jackrabbit.test.AbstractJCRTest,0.23,18,3,18,0,18,9,0,14,515,1
"org.apache.jackrabbit.test.api.SessionTest",16,0.00,1.75,191,2.72,73008.19,16,0,12,41,3,129.49,309,247,1,4,103.21,0.00,0.75,0.00,0,0.00,3,8146.43,2,0,2,org.apache.jackrabbit.test.AbstractJCRTest,0.00,25,3,28,0,25,16,0,149,1564,1
"org.apache.jackrabbit.test.api.SessionUUIDTest",2,0.00,3.00,31,0.47,16819.52,2,0,7,18,3,109.75,68,42,1,4,95.97,0.00,0.75,0.00,0,0.00,3,1412.88,2,0,2,org.apache.jackrabbit.test.AbstractJCRTest,0.00,16,3,6,0,16,2,0,25,256,1
"org.apache.jackrabbit.test.api.SetPropertyAssumeTypeTest",12,0.38,1.50,191,3.12,114064.75,30,18,14,31,5,63.49,74,354,1,4,95.71,0.00,0.75,0.41,1,0.00,3,9366.32,3,0,4,org.apache.jackrabbit.test.AbstractJCRTest,0.21,19,3,18,0,19,12,0,20,1759,1
"org.apache.jackrabbit.test.api.SetPropertyBooleanTest",8,0.00,1.00,40,0.40,5108.54,9,1,3,17,2,123.07,35,59,1,4,122.84,0.00,0.75,1.00,0,0.00,1,1194.99,2,0,1,org.apache.jackrabbit.test.AbstractJCRTest,0.24,9,3,8,0,9,8,0,7,284,1
"org.apache.jackrabbit.test.api.SetPropertyCalendarTest",8,0.38,1.00,42,0.48,6294.08,11,3,4,19,2,122.36,35,61,1,4,122.12,0.00,0.75,0.67,0,0.00,1,1447.70,2,0,1,org.apache.jackrabbit.test.AbstractJCRTest,0.24,11,3,8,0,11,8,0,7,330,1
"org.apache.jackrabbit.test.api.SetPropertyConstraintViolationExceptionTest",6,0.00,6.67,148,2.27,114170.27,6,0,14,31,4,75.02,95,254,1,4,85.38,0.00,0.75,0.00,0,0.00,9,6809.32,1,0,3,org.apache.jackrabbit.test.AbstractJCRTest,0.00,25,3,40,0,25,6,0,56,1152,1
"org.apache.jackrabbit.test.api.SetPropertyDecimalTest",5,0.25,1.00,26,0.30,4164.46,8,3,4,18,2,122.16,24,37,1,4,121.93,0.00,0.75,0.53,0,0.00,1,889.46,3,0,1,org.apache.jackrabbit.test.AbstractJCRTest,0.26,13,3,5,0,13,5,0,6,207,1
"org.apache.jackrabbit.test.api.SetPropertyDoubleTest",8,0.38,1.00,43,0.49,6956.79,11,3,3,21,2,122.02,37,62,1,4,121.78,0.00,0.75,0.67,0,0.00,1,1467.01,3,0,1,org.apache.jackrabbit.test.AbstractJCRTest,0.24,13,3,8,0,13,8,0,9,338,1
"org.apache.jackrabbit.test.api.SetPropertyInputStreamTest",9,0.28,1.78,84,1.06,32107.67,14,5,6,30,3,107.53,43,118,1,4,107.30,0.00,0.75,0.44,0,0.00,5,3194.60,2,0,2,org.apache.jackrabbit.test.AbstractJCRTest,0.23,21,3,16,0,21,9,0,13,646,1
"org.apache.jackrabbit.test.api.SetPropertyLongTest",8,0.38,1.00,42,0.46,6673.90,11,3,3,18,2,122.16,35,61,1,4,121.92,0.00,0.75,0.67,0,0.00,1,1392.28,2,0,1,org.apache.jackrabbit.test.AbstractJCRTest,0.24,10,3,8,0,10,8,0,7,323,1
"org.apache.jackrabbit.test.api.SetPropertyNodeTest",8,0.57,1.25,52,0.60,11748.77,11,3,3,23,3,99.11,44,73,1,4,116.98,0.00,0.75,0.83,0,0.00,3,1799.71,3,0,2,org.apache.jackrabbit.test.AbstractJCRTest,0.24,15,3,10,0,15,8,0,10,399,1
"org.apache.jackrabbit.test.api.SetPropertyStringTest",30,0.23,1.20,190,2.37,41911.20,38,8,6,46,2,117.40,138,267,1,4,117.16,0.00,0.75,0.35,0,0.00,3,7098.91,2,0,1,org.apache.jackrabbit.test.AbstractJCRTest,0.14,16,3,36,0,16,30,0,35,1555,1
"org.apache.jackrabbit.test.api.SetPropertyValueTest",33,0.21,1.33,217,2.67,55145.84,41,8,6,49,2,116.76,160,297,1,4,116.53,0.00,0.75,0.33,0,0.00,6,8003.44,2,0,1,org.apache.jackrabbit.test.AbstractJCRTest,0.14,16,3,44,0,16,33,0,38,1745,1
"org.apache.jackrabbit.test.api.SetValueBinaryTest",9,0.50,1.78,84,1.00,24194.16,13,4,10,41,3,76.04,62,115,1,4,108.27,0.00,0.75,0.69,1,0.00,3,3002.25,2,0,2,org.apache.jackrabbit.test.AbstractJCRTest,0.23,32,3,16,0,32,9,0,19,607,1
"org.apache.jackrabbit.test.api.SetValueBooleanTest",6,0.60,1.33,35,0.34,4076.56,9,3,6,19,2,80.27,45,46,1,4,122.56,0.00,0.75,0.83,0,0.00,2,1014.68,2,0,1,org.apache.jackrabbit.test.AbstractJCRTest,0.25,13,3,8,0,13,6,0,13,234,1
"org.apache.jackrabbit.test.api.SetValueConstraintViolationExceptionTest",12,0.00,6.92,333,5.08,265599.87,12,0,15,38,4,62.80,179,528,1,4,82.95,0.00,0.75,0.00,0,0.00,9,15247.70,1,0,3,org.apache.jackrabbit.test.AbstractJCRTest,0.00,26,3,83,0,26,12,0,122,2530,1
"org.apache.jackrabbit.test.api.SetValueDateTest",6,0.60,1.33,38,0.38,4778.39,9,3,8,20,2,76.77,45,49,1,4,119.06,0.00,0.75,0.83,0,0.00,2,1136.55,2,0,1,org.apache.jackrabbit.test.AbstractJCRTest,0.25,14,3,8,0,14,6,0,13,254,1
"org.apache.jackrabbit.test.api.SetValueDecimalTest",5,0.33,1.20,27,0.31,4274.76,8,3,7,20,2,73.69,42,35,1,4,121.80,0.00,0.75,0.60,0,0.00,2,925.58,3,0,1,org.apache.jackrabbit.test.AbstractJCRTest,0.26,15,3,6,0,15,5,0,13,210,1
"org.apache.jackrabbit.test.api.SetValueDoubleTest",6,0.60,1.33,36,0.37,4723.96,9,3,6,21,2,76.81,47,47,1,4,119.10,0.00,0.75,0.83,0,0.00,2,1110.39,3,0,1,org.apache.jackrabbit.test.AbstractJCRTest,0.25,15,3,8,0,15,6,0,15,252,1
"org.apache.jackrabbit.test.api.SetValueLongTest",6,0.60,1.33,35,0.34,4076.56,9,3,6,19,2,80.27,45,46,1,4,122.56,0.00,0.75,0.83,0,0.00,2,1014.68,2,0,1,org.apache.jackrabbit.test.AbstractJCRTest,0.25,13,3,8,0,13,6,0,13,234,1
"org.apache.jackrabbit.test.api.SetValueReferenceTest",7,0.39,1.29,39,0.36,4422.61,10,3,7,21,3,72.82,64,51,1,4,122.82,0.00,0.75,0.67,1,0.00,2,1089.24,3,0,2,org.apache.jackrabbit.test.AbstractJCRTest,0.24,14,3,9,0,14,7,0,16,253,1
"org.apache.jackrabbit.test.api.SetValueStringTest",25,0.20,1.56,161,1.69,29488.26,34,9,10,42,2,99.81,132,207,1,4,117.68,0.00,0.75,0.30,0,0.00,2,5073.42,2,0,1,org.apache.jackrabbit.test.AbstractJCRTest,0.16,17,3,39,0,17,25,0,47,1089,1
"org.apache.jackrabbit.test.api.SetValueValueFormatExceptionTest",12,0.00,2.58,90,1.25,38465.78,12,0,12,30,4,79.43,79,163,1,4,111.65,0.00,0.75,0.00,1,38.00,7,3752.65,2,1,3,org.apache.jackrabbit.test.AbstractJCRTest,0.00,18,3,31,0,18,11,0,27,722,1
"org.apache.jackrabbit.test.api.SetValueVersionExceptionTest",12,0.30,2.08,98,1.09,24627.80,18,6,12,28,3,78.84,77,168,1,4,111.06,0.00,0.75,0.44,0,0.00,3,3256.64,5,0,2,org.apache.jackrabbit.test.AbstractJCRTest,0.21,16,3,25,0,16,12,0,31,656,1
"org.apache.jackrabbit.test.api.ShareableNodeTest",42,0.07,1.36,653,9.60,270917.33,43,1,21,108,3,47.06,403,777,1,4,97.06,0.00,0.75,0.93,2,0.00,4,28805.07,6,2,2,org.apache.jackrabbit.test.AbstractJCRTest,0.12,66,3,57,0,66,40,0,263,5215,1
"org.apache.jackrabbit.test.api.StringPropertyTest",13,0.00,2.69,99,1.14,32217.23,13,0,7,45,4,70.23,99,161,1,5,112.52,0.00,0.80,0.00,0,0.00,5,3412.80,0,1,3,org.apache.jackrabbit.test.api.AbstractPropertyTest,0.23,32,4,35,0,32,12,0,26,681,1
"org.apache.jackrabbit.test.api.SysViewContentHandler",13,0.12,4.92,290,4.68,289257.61,35,22,27,90,4,37.85,138,411,2,2,86.32,0.00,0.50,0.16,5,57.00,16,14052.08,0,1,2,org.xml.sax.helpers.DefaultHandler,0.00,77,1,64,0,77,12,0,90,2303,0
"org.apache.jackrabbit.test.api.SysViewContentHandler$ChildNodeElem",0,0.00,0.00,3,0.01,82.42,2,2,27,0,0,171.00,0,4,0,1,171.00,0.00,0.00,0.00,0,0.00,0,41.21,0,0,0,java.lang.Object,0.00,0,0,0,0,0,0,0,0,13,1
"org.apache.jackrabbit.test.api.SysViewContentHandler$ConditionException",1,0.00,1.00,3,0.02,106.02,1,0,27,1,0,137.25,0,5,0,2,137.25,0.00,0.50,0.00,0,1.00,1,45.51,0,0,0,org.xml.sax.SAXException,0.00,0,1,1,0,0,1,0,0,16,1
"org.apache.jackrabbit.test.api.SysViewContentHandler$NodeElemData",0,0.00,0.00,8,0.06,805.37,7,7,27,2,0,171.00,10,9,0,1,171.00,0.00,0.00,0.00,0,0.00,0,191.76,0,0,0,java.lang.Object,0.00,2,0,0,0,2,0,0,10,43,1
"org.apache.jackrabbit.test.api.SysViewContentHandler$PropElemData",0,0.00,0.00,5,0.03,169.39,4,4,27,0,0,171.00,0,6,0,1,171.00,0.00,0.00,0.00,0,0.00,0,75.28,0,0,0,java.lang.Object,0.00,0,0,0,0,0,0,0,0,21,1
"org.apache.jackrabbit.test.api.TestAll",1,0.00,1.00,98,1.74,75999.10,1,0,3,3,95,97.59,21,100,1,2,58.29,0.00,0.50,0.00,0,1.00,1,5220.24,0,1,94,junit.framework.TestCase,0.00,2,1,1,0,2,0,0,12,775,1
"org.apache.jackrabbit.test.api.TreeComparator",22,0.04,3.23,262,3.84,160654.69,36,14,17,71,2,59.17,158,354,1,2,101.46,0.00,0.50,0.11,11,78.00,11,11505.42,0,2,1,junit.framework.Assert,0.00,49,1,71,0,49,20,0,54,2029,0
"org.apache.jackrabbit.test.api.UndefinedPropertyTest",3,0.00,1.00,12,0.12,1687.81,3,0,6,9,4,94.66,19,18,1,4,126.88,0.00,0.75,0.00,0,5.00,1,351.99,2,1,3,org.apache.jackrabbit.test.AbstractJCRTest,0.14,6,3,3,0,6,2,0,4,82,1
"org.apache.jackrabbit.test.api.ValueFactoryTest",5,0.33,6.80,137,2.31,261400.33,24,19,15,32,3,37.72,37,216,1,4,80.01,0.00,0.75,0.32,0,0.00,14,6937.55,2,1,2,org.apache.jackrabbit.test.AbstractJCRTest,0.26,27,3,34,0,27,4,0,15,1184,1
"org.apache.jackrabbit.test.api.WorkspaceCloneReferenceableTest",4,0.00,1.75,35,0.55,12128.34,4,0,4,16,3,65.64,44,48,1,7,109.77,0.00,0.86,0.00,0,0.00,3,1650.08,1,0,2,org.apache.jackrabbit.test.api.AbstractWorkspaceReferenceableTest,0.00,12,6,7,0,12,4,0,20,334,1
"org.apache.jackrabbit.test.api.WorkspaceCloneSameNameSibsTest",2,0.00,2.50,22,0.33,8343.93,2,0,4,15,2,83.29,29,26,1,7,103.43,0.00,0.86,0.00,0,0.00,3,978.21,0,0,1,org.apache.jackrabbit.test.api.AbstractWorkspaceSameNameSibsTest,0.00,13,6,5,0,13,2,0,10,186,1
"org.apache.jackrabbit.test.api.WorkspaceCloneTest",8,0.00,2.00,60,0.95,21376.80,8,0,9,26,3,64.23,64,88,1,6,112.33,0.00,0.83,0.00,0,0.00,3,2842.44,3,0,2,org.apache.jackrabbit.test.api.AbstractWorkspaceCopyBetweenTest,0.00,18,5,16,0,18,8,0,30,563,1
"org.apache.jackrabbit.test.api.WorkspaceCloneVersionableTest",1,0.00,3.00,12,0.20,6456.99,1,0,3,8,3,144.43,22,19,1,7,100.49,0.00,0.86,0.00,0,0.00,3,610.51,1,0,2,org.apache.jackrabbit.test.api.AbstractWorkspaceVersionableTest,0.00,7,6,3,0,7,1,0,10,122,1
"org.apache.jackrabbit.test.api.WorkspaceCopyBetweenWorkspacesReferenceableTest",1,0.00,1.00,9,0.13,2552.06,1,0,3,9,3,108.10,16,12,1,7,108.58,0.00,0.86,0.00,0,0.00,1,396.98,1,0,2,org.apache.jackrabbit.test.api.AbstractWorkspaceReferenceableTest,0.00,8,6,1,0,8,1,0,5,83,1
"org.apache.jackrabbit.test.api.WorkspaceCopyBetweenWorkspacesSameNameSibsTest",2,0.00,2.50,22,0.32,8483.17,2,0,4,14,2,83.23,29,26,1,7,103.38,0.00,0.86,0.00,0,0.00,3,954.62,0,0,1,org.apache.jackrabbit.test.api.AbstractWorkspaceSameNameSibsTest,0.00,12,6,5,0,12,2,0,10,184,1
"org.apache.jackrabbit.test.api.WorkspaceCopyBetweenWorkspacesTest",7,0.00,2.29,54,0.84,20788.94,7,0,10,26,3,63.83,57,80,1,6,111.94,0.00,0.83,0.00,0,0.00,3,2513.34,3,0,2,org.apache.jackrabbit.test.api.AbstractWorkspaceCopyBetweenTest,0.00,19,5,16,0,19,7,0,26,494,1
"org.apache.jackrabbit.test.api.WorkspaceCopyBetweenWorkspacesVersionableTest",1,0.00,3.00,12,0.20,6531.71,1,0,3,7,3,144.39,22,19,1,7,100.45,0.00,0.86,0.00,0,0.00,3,590.57,1,0,2,org.apache.jackrabbit.test.api.AbstractWorkspaceVersionableTest,0.00,6,6,3,0,6,1,0,10,120,1
"org.apache.jackrabbit.test.api.WorkspaceCopyReferenceableTest",3,0.00,1.00,12,0.15,2578.04,3,0,3,11,3,107.56,17,17,1,7,125.44,0.00,0.86,0.00,0,1.00,1,439.97,1,1,2,org.apache.jackrabbit.test.api.AbstractWorkspaceReferenceableTest,0.37,8,6,3,0,8,2,0,6,99,1
"org.apache.jackrabbit.test.api.WorkspaceCopySameNameSibsTest",5,0.00,2.00,39,0.53,15141.14,5,0,5,19,3,63.80,42,48,1,7,111.90,0.00,0.86,0.00,0,0.00,3,1600.20,0,1,2,org.apache.jackrabbit.test.api.AbstractWorkspaceSameNameSibsTest,0.35,14,6,10,0,14,4,0,15,311,1
"org.apache.jackrabbit.test.api.WorkspaceCopyTest",6,0.00,2.17,50,0.71,16290.95,6,0,8,24,3,61.99,53,75,1,5,110.09,0.00,0.80,0.00,0,0.00,3,2116.89,2,0,2,org.apache.jackrabbit.test.api.AbstractWorkspaceCopyTest,0.00,18,4,13,0,18,6,0,24,420,1
"org.apache.jackrabbit.test.api.WorkspaceCopyVersionableTest",3,0.00,2.00,17,0.24,8035.12,3,0,4,11,3,75.48,23,28,1,7,117.77,0.00,0.86,0.00,0,1.00,4,706.90,1,1,2,org.apache.jackrabbit.test.api.AbstractWorkspaceVersionableTest,0.37,8,6,6,0,8,2,0,11,146,1
"org.apache.jackrabbit.test.api.WorkspaceManagementTest",3,0.00,2.00,19,0.20,3954.77,4,1,5,9,1,85.02,20,29,0,4,117.24,0.00,0.75,1.00,0,0.00,3,608.35,2,0,1,org.apache.jackrabbit.test.AbstractJCRTest,0.14,6,3,6,0,6,3,0,9,138,1
"org.apache.jackrabbit.test.api.WorkspaceMoveReferenceableTest",3,0.00,1.00,12,0.15,2578.04,3,0,3,11,3,93.21,18,17,1,7,125.44,0.00,0.86,0.00,0,1.00,1,439.97,1,1,2,org.apache.jackrabbit.test.api.AbstractWorkspaceReferenceableTest,0.37,8,6,3,0,8,2,0,7,99,1
"org.apache.jackrabbit.test.api.WorkspaceMoveSameNameSibsTest",4,0.00,1.75,27,0.36,9089.75,4,0,5,17,3,73.12,31,33,1,7,115.41,0.00,0.86,0.00,0,0.00,3,1074.33,0,1,2,org.apache.jackrabbit.test.api.AbstractWorkspaceSameNameSibsTest,0.36,13,6,7,0,13,3,0,12,211,1
"org.apache.jackrabbit.test.api.WorkspaceMoveTest",6,0.00,2.17,50,0.71,16290.95,6,0,8,24,3,61.99,52,75,1,5,110.09,0.00,0.80,0.00,0,0.00,3,2116.89,2,0,2,org.apache.jackrabbit.test.api.AbstractWorkspaceCopyTest,0.00,18,4,13,0,18,6,0,23,420,1
"org.apache.jackrabbit.test.api.WorkspaceMoveVersionableTest",3,0.00,2.00,17,0.24,7790.45,3,0,4,12,3,75.59,23,28,1,7,117.88,0.00,0.86,0.00,0,1.00,4,711.52,1,1,2,org.apache.jackrabbit.test.api.AbstractWorkspaceVersionableTest,0.37,9,6,6,0,9,2,0,11,146,1
"org.apache.jackrabbit.test.api.WorkspaceReadMethodsTest",5,0.00,1.40,33,0.34,7833.32,5,0,4,18,2,98.86,29,48,1,4,116.74,0.00,0.75,0.00,0,11.00,2,1012.40,2,0,1,org.apache.jackrabbit.test.AbstractJCRTest,0.13,13,3,7,0,13,5,0,7,222,1
"org.apache.jackrabbit.test.api.WorkspaceTest",2,0.00,2.00,12,0.10,1442.88,3,1,5,6,2,119.54,9,18,1,4,119.31,0.00,0.75,1.00,0,0.00,3,289.82,2,0,1,org.apache.jackrabbit.test.AbstractJCRTest,0.14,4,3,4,0,4,2,0,3,70,1
"org.apache.jackrabbit.spi.commons.lock.Locked",6,1.00,3.17,57,0.74,41867.30,7,1,15,28,5,144.17,130,83,1,1,104.87,0.00,0.00,0.17,4,10.00,13,2234.21,0,5,4,java.lang.Object,0.00,22,0,19,0,22,1,0,22,399,2
"org.apache.jackrabbit.spi.commons.lock.Locked$EventListener",1,0.00,1.00,4,0.02,212.76,1,0,15,2,0,130.21,0,6,0,1,130.21,0.00,0.00,0.00,0,1.00,1,65.36,0,0,0,java.lang.Object,0.00,1,0,1,0,1,1,0,0,20,0
"org.apache.jackrabbit.test.api.query.AbstractOrderByTest",13,0.17,2.15,119,1.42,45057.32,15,2,15,38,13,89.48,74,134,12,5,107.35,3.00,0.24,0.35,4,0.00,5,4258.31,1,4,1,org.apache.jackrabbit.test.api.query.AbstractQueryTest,0.09,25,4,28,12,25,9,0,16,849,0
"org.apache.jackrabbit.test.api.query.AbstractQueryLevel2Test",5,0.00,1.80,41,0.63,18024.37,5,0,8,23,4,61.06,44,57,2,5,109.17,0.50,0.57,0.00,0,2.00,3,1887.82,0,0,2,org.apache.jackrabbit.test.api.query.AbstractQueryTest,0.00,18,4,9,2,18,5,0,9,373,2
"org.apache.jackrabbit.test.api.query.AbstractQueryTest",16,0.02,2.31,139,1.73,59132.95,25,9,21,63,30,59.03,151,169,26,4,109.03,22.00,0.04,0.09,3,86.00,8,5182.56,3,7,4,org.apache.jackrabbit.test.AbstractJCRTest,0.19,47,3,37,66,47,9,0,33,1022,2
"org.apache.jackrabbit.test.api.query.CreateQueryTest",1,0.00,2.00,10,0.10,2293.02,1,0,5,6,2,89.20,5,14,1,5,107.08,0.00,0.80,0.00,0,0.00,2,305.51,0,0,1,org.apache.jackrabbit.test.api.query.AbstractQueryTest,0.00,5,4,2,0,5,1,0,2,64,1
"org.apache.jackrabbit.test.api.query.DerefQueryLevel1Test",8,0.29,2.50,76,1.06,36105.99,9,1,10,33,4,74.19,54,96,1,5,106.42,0.00,0.80,0.75,2,0.00,6,3167.35,3,1,3,org.apache.jackrabbit.test.api.query.AbstractQueryTest,0.20,25,4,20,0,25,7,0,12,610,1
"org.apache.jackrabbit.test.api.query.ElementTest",9,0.00,1.22,65,1.02,25137.14,10,1,3,14,3,80.07,55,76,1,5,112.29,0.00,0.80,1.00,0,0.00,2,3061.53,2,0,2,org.apache.jackrabbit.test.api.query.AbstractQueryTest,0.10,5,4,11,0,5,9,0,9,602,1
"org.apache.jackrabbit.test.api.query.GetLanguageTest",6,0.20,1.33,30,0.39,6811.67,7,1,5,19,3,102.93,31,42,1,5,120.80,0.00,0.80,0.83,0,0.00,2,1165.34,3,0,2,org.apache.jackrabbit.test.api.query.AbstractQueryTest,0.21,13,4,8,0,13,6,0,8,256,1
"org.apache.jackrabbit.test.api.query.GetPersistentQueryPathLevel1Test",3,0.00,1.67,18,0.18,2834.23,4,1,4,12,2,86.20,20,25,1,5,118.43,0.00,0.80,1.00,0,0.00,2,528.99,2,0,1,org.apache.jackrabbit.test.api.query.AbstractQueryTest,0.22,9,4,5,0,9,3,0,6,121,1
"org.apache.jackrabbit.test.api.query.GetPersistentQueryPathTest",1,0.00,2.00,10,0.15,3678.06,1,0,4,10,3,138.84,20,16,1,5,105.46,0.00,0.80,0.00,0,0.00,2,451.91,0,0,2,org.apache.jackrabbit.test.api.query.AbstractQueryTest,0.00,9,4,2,0,9,1,0,3,88,1
"org.apache.jackrabbit.test.api.query.GetPropertyNamesTest",3,0.50,2.00,31,0.40,12471.04,4,1,8,23,2,56.94,25,35,1,5,105.04,0.00,0.80,0.67,0,2.00,3,1211.38,2,0,1,org.apache.jackrabbit.test.api.query.AbstractQueryTest,0.22,20,4,6,0,20,3,0,10,228,1
"org.apache.jackrabbit.test.api.query.GetStatementTest",3,0.00,1.33,16,0.17,2472.36,4,1,3,12,2,89.68,19,23,1,5,121.90,0.00,0.80,1.00,0,0.00,2,497.93,2,0,1,org.apache.jackrabbit.test.api.query.AbstractQueryTest,0.22,9,4,4,0,9,3,0,5,116,1
"org.apache.jackrabbit.test.api.query.GetSupportedQueryLanguagesTest",3,0.00,1.67,17,0.19,2807.45,4,1,7,13,2,79.12,22,25,1,5,121.41,0.00,0.80,1.00,0,0.00,2,563.00,3,0,1,org.apache.jackrabbit.test.api.query.AbstractQueryTest,0.22,10,4,5,0,10,3,0,7,128,1
"org.apache.jackrabbit.test.api.query.OrderByDateTest",4,0.00,1.00,46,0.78,25291.98,4,0,2,7,2,54.12,32,51,1,6,102.22,0.00,0.83,0.00,0,0.00,1,2328.29,2,0,1,org.apache.jackrabbit.test.api.query.AbstractOrderByTest,0.00,3,5,4,0,3,4,0,5,453,1
"org.apache.jackrabbit.test.api.query.OrderByDecimalTest",1,0.00,1.00,4,0.07,1047.77,1,0,2,2,2,145.37,3,6,1,6,124.76,0.00,0.83,0.00,0,0.00,1,202.81,2,0,1,org.apache.jackrabbit.test.api.query.AbstractOrderByTest,0.00,1,5,1,0,1,1,0,1,48,1
"org.apache.jackrabbit.test.api.query.OrderByDoubleTest",2,0.00,1.00,7,0.09,1050.04,2,0,0,2,2,87.65,23,10,1,6,131.78,0.00,0.83,0.00,0,0.00,1,270.26,2,0,1,org.apache.jackrabbit.test.api.query.AbstractOrderByTest,0.00,0,5,2,0,0,2,0,3,64,1
"org.apache.jackrabbit.test.api.query.OrderByLengthTest",4,0.00,1.00,10,0.09,960.63,4,0,2,6,2,191.02,6,16,1,6,141.03,0.00,0.83,0.00,0,8.00,1,274.34,2,3,1,org.apache.jackrabbit.test.api.query.AbstractOrderByTest,0.31,2,5,4,0,2,1,0,3,72,1
"org.apache.jackrabbit.test.api.query.OrderByLocalNameTest",4,0.00,1.00,12,0.10,1623.89,4,0,4,7,2,182.66,7,18,1,6,132.66,0.00,0.83,0.00,0,8.00,1,310.00,2,3,1,org.apache.jackrabbit.test.api.query.AbstractOrderByTest,0.31,3,5,4,0,3,1,0,4,79,1
"org.apache.jackrabbit.test.api.query.OrderByLocalNameTest$Comparator",1,0.00,1.00,5,0.05,936.18,1,0,4,3,0,121.53,0,6,0,1,121.53,0.00,0.00,0.00,0,1.00,1,146.97,0,0,0,java.lang.Object,0.00,2,0,1,0,2,1,0,0,38,0
"org.apache.jackrabbit.test.api.query.OrderByLongTest",1,0.00,1.00,4,0.05,604.38,1,0,0,1,2,160.02,20,6,1,6,126.64,0.00,0.83,0.00,0,0.00,1,149.29,2,0,1,org.apache.jackrabbit.test.api.query.AbstractOrderByTest,0.00,0,5,1,0,0,1,0,2,36,1
"org.apache.jackrabbit.test.api.query.OrderByLowerCaseTest",4,0.00,1.00,10,0.09,925.21,4,0,2,5,2,191.15,6,16,1,6,141.15,0.00,0.83,0.00,0,8.00,1,263.01,3,3,1,org.apache.jackrabbit.test.api.query.AbstractOrderByTest,0.31,1,5,4,0,1,1,0,3,70,1
"org.apache.jackrabbit.test.api.query.OrderByMultiTypeTest",1,0.00,4.00,41,0.95,64082.02,1,0,3,8,2,119.94,23,58,1,6,72.67,0.00,0.83,0.00,0,0.00,4,2852.27,1,0,1,org.apache.jackrabbit.test.api.query.AbstractOrderByTest,0.00,7,5,4,0,7,1,0,5,472,1
"org.apache.jackrabbit.test.api.query.OrderByNameTest",4,0.00,1.00,12,0.10,1623.89,4,0,3,6,2,182.66,7,18,1,6,132.66,0.00,0.83,0.00,0,8.00,1,310.00,2,3,1,org.apache.jackrabbit.test.api.query.AbstractOrderByTest,0.31,2,5,4,0,2,1,0,4,79,1
"org.apache.jackrabbit.test.api.query.OrderByStringTest",1,0.00,1.00,4,0.05,508.68,1,0,0,1,2,160.61,20,6,1,6,127.23,0.00,0.83,0.00,0,0.00,1,142.89,2,0,1,org.apache.jackrabbit.test.api.query.AbstractOrderByTest,0.00,0,5,1,0,0,1,0,2,35,1
"org.apache.jackrabbit.test.api.query.OrderByURITest",1,0.00,1.00,6,0.08,1302.15,2,1,2,1,2,138.06,3,7,1,6,117.45,0.00,0.83,1.00,0,0.00,1,245.13,2,0,1,org.apache.jackrabbit.test.api.query.AbstractOrderByTest,0.00,0,5,1,0,0,1,0,1,55,1
"org.apache.jackrabbit.test.api.query.OrderByUpperCaseTest",4,0.00,1.00,10,0.09,925.21,4,0,2,5,2,191.15,6,16,1,6,141.15,0.00,0.83,0.00,0,8.00,1,263.01,3,3,1,org.apache.jackrabbit.test.api.query.AbstractOrderByTest,0.31,1,5,4,0,1,1,0,3,70,1
"org.apache.jackrabbit.test.api.query.PredicatesTest",7,0.33,1.86,42,0.57,9286.97,10,3,5,17,2,74.95,50,68,1,5,117.24,0.00,0.80,0.62,0,0.00,2,1696.44,2,0,1,org.apache.jackrabbit.test.api.query.AbstractQueryTest,0.20,10,4,13,0,10,7,0,11,356,1
"org.apache.jackrabbit.test.api.query.QueryResultNodeIteratorTest",6,0.00,2.50,59,0.71,23116.10,6,0,6,20,3,64.67,47,78,1,5,106.96,0.00,0.80,0.00,0,0.00,5,2125.45,2,0,2,org.apache.jackrabbit.test.api.query.AbstractQueryTest,0.10,14,4,15,0,14,6,0,17,420,1
"org.apache.jackrabbit.test.api.query.SQLJcrPathTest",3,0.00,1.33,18,0.21,3114.20,4,1,6,14,3,85.93,19,24,1,5,118.16,0.00,0.80,1.00,0,0.00,2,629.21,3,0,2,org.apache.jackrabbit.test.api.query.AbstractQueryTest,0.22,11,4,4,0,11,3,0,6,138,1
"org.apache.jackrabbit.test.api.query.SQLJoinTest",4,0.00,2.50,77,1.35,57211.95,4,0,3,16,3,42.26,32,89,1,5,90.37,0.00,0.80,0.00,0,0.00,3,4061.07,3,0,2,org.apache.jackrabbit.test.api.query.AbstractQueryTest,0.00,12,4,10,0,12,4,0,5,718,1
"org.apache.jackrabbit.test.api.query.SQLOrderByTest",4,0.00,1.00,20,0.26,4935.77,5,1,1,9,3,70.58,37,25,1,5,120.58,0.00,0.80,1.00,0,0.00,1,774.28,4,0,2,org.apache.jackrabbit.test.api.query.AbstractQueryTest,0.11,5,4,4,0,5,4,0,7,172,1
"org.apache.jackrabbit.test.api.query.SQLPathTest",10,0.22,1.80,67,0.85,20945.22,11,1,8,27,3,83.46,60,80,1,5,115.69,0.00,0.80,0.80,1,0.00,4,2561.97,4,2,2,org.apache.jackrabbit.test.api.query.AbstractQueryTest,0.19,17,4,18,0,17,8,0,17,522,1
"org.apache.jackrabbit.test.api.query.SQLPathTest$TraversingItemVisitor.Default",1,0.00,2.00,4,0.06,896.15,1,0,8,5,0,125.13,0,6,0,1,125.13,0.00,0.00,0.00,0,1.00,2,173.83,0,0,0,java.lang.Object,0.00,4,0,2,0,4,1,0,0,41,0
"org.apache.jackrabbit.test.api.query.SQLPathTest$TraversingItemVisitor.Default_0",1,0.00,2.00,4,0.04,553.13,1,0,8,3,0,126.78,0,7,0,1,126.78,0.00,0.00,0.00,0,1.00,2,125.96,0,0,0,java.lang.Object,0.00,2,0,2,0,2,1,0,0,32,0
"org.apache.jackrabbit.test.api.query.SQLQueryLevel2Test",8,0.00,1.50,67,0.83,18095.68,8,0,5,20,3,68.51,56,80,1,6,110.80,0.00,0.83,0.00,3,0.00,4,2480.00,8,0,2,org.apache.jackrabbit.test.api.query.AbstractQueryLevel2Test,0.00,12,5,12,0,12,8,0,19,517,1
"org.apache.jackrabbit.test.api.query.SaveTest",9,0.12,2.22,76,1.12,26394.51,10,1,13,33,3,59.83,81,106,1,4,109.83,0.00,0.75,0.89,1,0.00,4,3345.38,3,0,2,org.apache.jackrabbit.test.AbstractJCRTest,0.11,24,3,20,0,24,9,0,26,638,1
"org.apache.jackrabbit.test.api.query.SetLimitTest",1,0.00,2.00,14,0.19,4147.56,1,0,2,11,2,120.21,3,20,1,5,99.60,0.00,0.80,0.00,0,0.00,2,559.20,0,0,1,org.apache.jackrabbit.test.api.query.AbstractQueryTest,0.00,10,4,2,0,10,1,0,1,105,1
"org.apache.jackrabbit.test.api.query.SetOffsetTest",1,0.00,2.00,14,0.19,4765.03,1,0,2,11,2,119.74,3,20,1,5,99.12,0.00,0.80,0.00,0,0.00,2,573.39,0,0,1,org.apache.jackrabbit.test.api.query.AbstractQueryTest,0.00,10,4,2,0,10,1,0,1,107,1
"org.apache.jackrabbit.test.api.query.SimpleSelectionTest",3,0.00,1.67,21,0.30,5931.41,4,1,6,22,3,65.30,26,29,1,5,113.40,0.00,0.80,1.00,0,0.00,2,885.74,2,0,2,org.apache.jackrabbit.test.api.query.AbstractQueryTest,0.22,19,4,5,0,19,3,0,7,177,1
"org.apache.jackrabbit.test.api.query.Statement",3,0.25,1.33,12,0.08,2004.82,5,2,0,4,7,108.36,17,17,7,1,126.23,0.00,0.00,0.33,0,5.00,2,239.93,0,2,0,java.lang.Object,0.00,1,0,4,0,1,1,0,4,65,0
"org.apache.jackrabbit.test.api.query.TestAll",1,0.00,1.00,42,0.62,25900.57,1,0,3,3,39,38.13,12,44,1,2,75.70,0.00,0.50,0.00,0,1.00,1,1854.17,0,1,38,junit.framework.TestCase,0.00,2,1,1,0,2,0,0,3,327,1
"org.apache.jackrabbit.test.api.query.TextNodeTest",5,0.62,1.40,48,0.72,22888.19,7,2,4,13,3,58.40,43,57,1,5,106.50,0.00,0.80,1.00,0,0.00,3,2151.03,2,0,2,org.apache.jackrabbit.test.api.query.AbstractQueryTest,0.11,8,4,7,0,8,5,0,6,416,1
"org.apache.jackrabbit.test.api.query.XPathDocOrderTest",6,0.00,2.00,49,0.57,13694.24,6,0,6,14,4,68.42,46,52,1,5,110.71,0.00,0.80,0.00,1,6.00,4,1718.96,3,0,3,org.apache.jackrabbit.test.api.query.AbstractQueryTest,0.10,8,4,12,0,8,6,0,8,341,1
"org.apache.jackrabbit.test.api.query.XPathJcrPathTest",3,0.00,1.33,18,0.23,3372.56,4,1,6,17,3,85.66,19,24,1,5,117.88,0.00,0.80,1.00,0,0.00,2,676.10,2,0,2,org.apache.jackrabbit.test.api.query.AbstractQueryTest,0.22,14,4,4,0,14,3,0,6,146,1
"org.apache.jackrabbit.test.api.query.XPathOrderByTest",4,0.00,1.00,15,0.17,2492.95,5,1,1,5,3,83.09,34,21,1,5,131.20,0.00,0.80,1.00,0,0.00,1,517.58,3,0,2,org.apache.jackrabbit.test.api.query.AbstractQueryTest,0.11,1,4,4,0,1,4,0,6,121,1
"org.apache.jackrabbit.test.api.query.XPathPosIndexTest",3,0.00,2.00,23,0.29,7356.34,3,0,6,13,4,64.15,31,29,1,5,112.62,0.00,0.80,0.00,1,2.00,4,859.79,3,0,3,org.apache.jackrabbit.test.api.query.AbstractQueryTest,0.11,10,4,6,0,10,3,0,5,170,1
"org.apache.jackrabbit.test.api.query.XPathQueryLevel2Test",8,0.00,1.50,44,0.50,8214.20,8,0,5,18,3,88.90,55,62,1,6,121.12,0.00,0.83,0.00,3,8.00,4,1497.10,7,0,2,org.apache.jackrabbit.test.api.query.AbstractQueryLevel2Test,0.00,10,5,12,0,10,8,0,19,323,1
"org.apache.jackrabbit.core.version.CheckinRemoveVersionTest",1,0.00,2.00,14,0.17,3937.93,1,0,5,15,3,100.01,4,21,1,4,99.78,0.00,0.75,0.00,0,0.00,2,520.15,0,0,2,org.apache.jackrabbit.test.AbstractJCRTest,0.00,14,3,2,0,14,1,0,2,99,1
"org.apache.jackrabbit.core.version.DateVersionSelector",9,0.19,1.67,46,0.44,15930.99,11,2,3,18,7,71.13,80,61,3,1,119.23,0.00,0.00,0.33,0,17.00,5,1323.31,0,2,4,java.lang.Object,0.00,9,0,15,0,9,7,1,13,298,1
"org.apache.jackrabbit.core.version.InternalActivity",2,0.00,1.00,3,0.02,95.45,2,0,1,2,8,109.67,17,5,5,2,157.78,0.00,0.50,0.00,0,2.00,1,57.60,0,0,3,,0.00,0,1,2,0,0,2,0,3,21,1
"org.apache.jackrabbit.core.version.InternalActivityImpl",8,0.00,2.12,55,0.78,25731.94,8,0,12,34,17,81.96,49,74,6,2,114.18,0.00,0.50,0.00,0,0.00,4,2335.36,0,1,13,org.apache.jackrabbit.core.version.InternalVersionItemImpl,0.33,26,1,17,0,26,7,1,12,466,0
"org.apache.jackrabbit.core.version.InternalBaseline",3,0.00,1.00,4,0.02,75.45,3,0,2,3,8,111.49,30,5,6,2,159.97,0.00,0.50,0.00,0,3.00,1,49.60,0,3,2,,0.00,0,1,3,0,0,0,0,4,21,1
"org.apache.jackrabbit.core.version.InternalBaselineImpl",4,0.00,1.75,17,0.23,6558.71,4,0,7,12,11,105.22,21,27,1,3,123.10,0.00,0.67,0.00,0,4.00,4,686.25,2,2,11,org.apache.jackrabbit.core.version.InternalVersionImpl,0.00,8,2,7,0,8,2,1,5,148,0
"org.apache.jackrabbit.core.version.InternalFreeze",1,0.00,1.00,2,0.01,44.19,1,0,1,1,5,96.82,9,3,4,2,146.81,0.00,0.50,0.00,0,1.00,1,26.09,0,1,1,,0.00,0,1,1,0,0,0,0,2,11,1
"org.apache.jackrabbit.core.version.InternalFreezeImpl",2,1.00,1.00,7,0.05,622.75,3,1,0,2,7,91.28,15,11,2,2,133.57,2.00,0.25,0.50,0,2.00,1,157.85,0,1,5,org.apache.jackrabbit.core.version.InternalVersionItemImpl,0.33,0,1,2,2,0,1,1,4,43,1
"org.apache.jackrabbit.core.version.InternalFrozenNode",7,0.00,1.00,8,0.05,254.06,7,0,8,7,12,126.49,45,9,7,2,158.72,0.00,0.50,0.00,0,7.00,1,151.10,0,5,5,,0.00,0,1,7,0,0,2,0,8,54,1
"org.apache.jackrabbit.core.version.InternalFrozenNodeImpl",12,0.09,3.08,100,1.66,106851.35,16,4,16,57,15,57.85,96,148,3,3,105.95,0.00,0.67,0.17,1,56.00,13,4991.00,0,7,13,org.apache.jackrabbit.core.version.InternalFreezeImpl,0.17,45,2,37,0,45,5,1,35,864,0
"org.apache.jackrabbit.core.version.InternalFrozenVHImpl",7,0.00,1.29,20,0.19,3047.68,7,0,5,14,10,159.55,26,36,1,3,138.93,0.00,0.67,0.00,2,9.00,2,565.22,0,6,10,org.apache.jackrabbit.core.version.InternalFreezeImpl,0.23,7,2,9,0,7,1,1,8,145,0
"org.apache.jackrabbit.core.version.InternalFrozenVersionHistory",4,0.00,1.00,5,0.02,98.72,4,0,2,4,5,117.74,30,7,2,2,160.04,0.00,0.50,0.00,0,4.00,1,65.11,0,3,3,,0.00,0,1,4,0,0,1,0,5,27,1
"org.apache.jackrabbit.core.version.InternalVersion",13,0.00,1.00,14,0.05,194.03,13,0,4,13,33,129.53,83,15,30,2,161.76,0.00,0.50,0.00,0,13.00,1,153.87,0,10,4,,0.00,0,1,13,0,0,3,0,14,68,1
"org.apache.jackrabbit.core.version.InternalVersionHistory",10,0.00,1.00,11,0.05,185.55,10,0,3,10,23,128.79,64,12,21,2,161.01,0.00,0.50,0.00,0,10.00,1,143.84,0,4,3,,0.00,0,1,10,0,0,6,0,11,59,1
"org.apache.jackrabbit.core.version.InternalVersionHistoryImpl",23,0.08,3.30,269,3.96,216875.54,33,10,20,117,24,50.58,215,351,9,2,100.58,0.00,0.50,0.17,6,154.00,11,11865.46,0,7,18,org.apache.jackrabbit.core.version.InternalVersionItemImpl,0.15,94,1,76,0,94,16,1,85,2085,0
"org.apache.jackrabbit.core.version.InternalVersionHistoryImplTest",1,0.00,2.00,10,0.08,1845.61,1,0,2,4,2,59.71,8,11,1,2,107.82,0.00,0.50,0.00,0,1.00,2,250.73,0,0,1,junit.framework.TestCase,0.00,3,1,2,0,3,1,0,2,58,1
"org.apache.jackrabbit.core.version.InternalVersionImpl",32,0.10,1.78,164,1.79,49530.67,37,5,13,81,16,101.80,176,216,5,2,119.68,1.00,0.33,0.10,8,426.00,3,5371.33,0,14,13,org.apache.jackrabbit.core.version.InternalVersionItemImpl,0.11,49,1,57,1,49,18,1,49,1166,0
"org.apache.jackrabbit.core.version.InternalVersionItem",2,0.00,1.00,3,0.01,31.00,2,0,1,2,13,113.52,16,4,12,1,161.63,0.00,0.00,0.00,0,2.00,1,26.00,0,2,1,,0.00,0,0,2,0,0,0,0,3,13,1
"org.apache.jackrabbit.core.version.InternalVersionItemImpl",4,0.50,1.00,10,0.06,749.51,6,2,1,4,9,99.58,29,13,5,1,141.87,0.00,0.00,0.12,0,6.00,1,193.33,0,1,4,java.lang.Object,0.00,0,0,4,7,0,3,1,7,58,1
"org.apache.jackrabbit.core.version.InternalVersionManager",15,0.00,1.00,16,0.16,712.56,15,0,7,15,18,109.69,129,27,8,1,157.80,0.00,0.00,0.00,0,15.00,1,467.22,0,12,10,,0.00,0,0,15,0,0,3,0,16,145,1
"org.apache.jackrabbit.core.version.InternalVersionManagerBase",31,0.09,2.29,233,3.21,126119.85,37,6,21,106,29,60.86,303,345,9,1,110.86,0.00,0.00,0.08,13,251.00,8,9637.25,0,16,24,java.lang.Object,0.00,75,0,71,2,75,15,1,61,1820,1
"org.apache.jackrabbit.core.version.InternalVersionManagerBase$WriteOperation",3,0.00,1.33,13,0.09,1026.68,5,2,21,4,1,110.65,15,20,0,1,128.52,0.00,0.00,0.50,0,1.00,2,263.22,0,0,1,java.lang.Object,0.00,1,0,4,0,1,3,0,4,70,1
"org.apache.jackrabbit.core.version.InternalVersionManagerImpl",28,0.01,1.89,218,3.13,160476.74,40,12,46,101,45,67.44,208,332,3,2,109.73,0.00,0.50,0.08,3,436.00,9,9398.59,1,13,43,org.apache.jackrabbit.core.version.InternalVersionManagerBase,0.07,73,1,53,0,73,15,2,63,1737,1
"org.apache.jackrabbit.core.version.InternalVersionManagerImpl$DynamicESCFactory",4,0.33,1.25,16,0.14,2648.81,6,2,46,7,4,78.17,34,26,0,1,126.28,0.00,0.00,0.25,1,8.00,2,415.98,0,3,4,java.lang.Object,0.00,3,0,5,0,3,1,1,6,104,3
"org.apache.jackrabbit.core.version.InternalVersionManagerImpl$SourcedTarget",1,0.00,1.00,3,0.02,151.81,1,0,46,2,0,136.03,0,4,0,1,136.03,0.00,0.00,0.00,0,1.00,1,54.60,0,1,0,java.lang.Object,0.00,1,0,1,0,1,0,0,0,17,0
"org.apache.jackrabbit.core.version.InternalVersionManagerImpl$SourcedTarget_0",1,0.00,1.00,3,0.02,136.54,1,0,46,2,0,136.39,0,4,0,1,136.39,0.00,0.00,0.00,0,1.00,1,49.51,0,1,0,java.lang.Object,0.00,1,0,1,0,1,0,0,0,16,0
"org.apache.jackrabbit.core.version.InternalVersionManagerImpl$SourcedTarget_1",1,0.00,1.00,5,0.03,405.56,1,0,46,3,1,124.39,0,6,0,1,124.39,0.00,0.00,0.00,0,1.00,1,100.00,0,1,1,java.lang.Object,0.00,2,0,1,0,2,0,0,0,27,0
"org.apache.jackrabbit.core.version.InternalVersionManagerImpl$SourcedTarget_2",1,0.00,2.00,10,0.12,3154.38,1,0,46,9,3,126.60,3,12,0,1,105.99,0.00,0.00,0.00,0,1.00,2,374.61,0,1,3,java.lang.Object,0.00,8,0,2,0,8,0,0,3,78,0
"org.apache.jackrabbit.core.version.InternalVersionManagerImpl$SourcedTarget_3",1,0.00,1.00,4,0.02,206.18,1,0,46,2,1,130.32,0,5,0,1,130.32,0.00,0.00,0.00,0,1.00,1,72.73,0,1,1,java.lang.Object,0.00,1,0,1,0,1,0,0,0,21,0
"org.apache.jackrabbit.core.version.InternalVersionManagerImpl$SourcedTarget_4",1,0.00,1.00,3,0.02,211.25,1,0,46,2,1,134.90,0,4,0,1,134.90,0.00,0.00,0.00,0,1.00,1,74.42,0,1,1,java.lang.Object,0.00,1,0,1,0,1,0,0,0,21,0
"org.apache.jackrabbit.core.version.InternalVersionManagerImpl$SourcedTarget_5",1,0.00,1.00,2,0.01,83.22,1,0,46,1,0,144.65,0,3,0,1,144.65,0.00,0.00,0.00,0,1.00,1,35.61,0,1,0,java.lang.Object,0.00,0,0,1,0,0,0,0,0,13,2
"org.apache.jackrabbit.core.version.InternalXAVersionManager",47,0.03,1.74,229,2.75,69708.93,56,9,31,115,34,105.57,240,362,1,2,123.44,0.00,0.50,0.08,5,768.00,4,8259.34,10,12,33,org.apache.jackrabbit.core.version.InternalVersionManagerBase,0.13,68,1,82,0,68,35,3,68,1766,1
"org.apache.jackrabbit.core.version.InternalXAVersionManager$InternalXAResource",6,0.00,1.00,9,0.06,370.36,6,0,31,6,1,156.90,0,15,0,1,156.90,0.00,0.00,0.00,0,10.00,1,176.58,0,0,1,java.lang.Object,0.00,0,0,6,0,0,6,0,0,57,0
"org.apache.jackrabbit.core.version.InternalXAVersionManager$InternalXAResource_0",7,0.00,1.14,13,0.07,528.69,7,0,31,7,1,156.18,0,21,0,1,156.18,0.00,0.00,0.00,1,12.00,2,216.61,0,0,1,java.lang.Object,0.00,0,0,8,0,0,7,0,0,70,0
"org.apache.jackrabbit.core.version.LabelVersionSelector",6,0.60,1.00,19,0.15,2611.38,7,1,2,10,5,84.32,49,28,1,1,132.42,0.00,0.00,0.50,1,6.00,1,458.62,0,2,4,java.lang.Object,0.00,4,0,6,0,4,4,1,8,122,1
"org.apache.jackrabbit.core.version.NodeStateEx",42,0.07,2.36,302,4.06,161063.20,47,5,25,124,44,68.77,331,426,27,1,111.06,0.00,0.00,0.27,13,0.00,13,12175.26,0,19,17,java.lang.Object,0.00,82,0,99,0,82,23,0,84,2405,1
"org.apache.jackrabbit.core.version.RemoveAndAddVersionLabelXATest",1,0.00,1.00,20,0.25,6765.23,1,0,4,14,2,92.54,4,22,0,4,92.31,0.00,0.75,0.00,0,0.00,1,755.25,0,0,2,org.apache.jackrabbit.test.AbstractJCRTest,0.00,13,3,1,0,13,1,0,1,148,1
"org.apache.jackrabbit.core.version.RemoveOrphanVersionHistoryTest",4,0.00,2.25,85,1.15,33608.16,4,0,11,36,1,46.46,45,104,0,4,90.59,0.00,0.75,0.00,1,0.00,3,3442.95,1,0,1,org.apache.jackrabbit.test.AbstractJCRTest,0.00,32,3,9,0,32,4,0,27,602,1
"org.apache.jackrabbit.core.version.RemoveVersionLabelTest",1,0.00,1.00,13,0.16,2801.93,1,0,5,12,2,84.43,5,15,1,4,102.30,0.00,0.75,0.00,0,0.00,1,487.82,0,0,1,org.apache.jackrabbit.test.AbstractJCRTest,0.00,11,3,1,0,11,1,0,3,96,1
"org.apache.jackrabbit.core.version.RemoveVersionTest",3,0.00,2.33,71,0.96,31450.61,3,0,12,39,2,68.21,43,79,0,4,88.35,0.00,0.75,0.00,0,0.00,5,2878.55,1,0,2,org.apache.jackrabbit.test.AbstractJCRTest,0.00,36,3,7,0,36,3,0,20,516,1
"org.apache.jackrabbit.core.version.RestoreTest",1,0.00,1.00,12,0.14,2401.89,1,0,4,13,3,124.74,3,14,1,4,104.12,0.00,0.75,0.00,0,0.00,1,425.85,0,0,2,org.apache.jackrabbit.test.AbstractJCRTest,0.00,12,3,1,0,12,1,0,1,86,1
"org.apache.jackrabbit.core.version.TestAll",1,0.00,1.00,9,0.09,2740.87,1,0,3,3,5,60.23,8,11,0,2,108.33,0.00,0.50,0.00,0,1.00,1,261.86,0,1,5,junit.framework.TestCase,0.00,2,1,1,0,2,0,0,2,63,1
"org.apache.jackrabbit.core.version.VersionHistoryImpl",24,0.91,1.71,116,1.61,40077.73,25,1,25,66,15,123.28,109,185,3,3,123.04,0.00,0.67,0.12,6,52.00,3,4828.61,3,14,14,org.apache.jackrabbit.core.NodeImpl,0.02,42,2,41,0,42,10,1,34,1015,1
"org.apache.jackrabbit.core.version.VersionHistoryInfo",3,0.25,1.00,10,0.06,775.96,5,2,1,3,9,86.10,25,14,8,1,134.20,0.00,0.00,0.33,0,5.00,1,170.34,0,2,1,java.lang.Object,0.00,0,0,3,0,0,1,0,6,52,1
"org.apache.jackrabbit.core.version.VersionImpl",16,0.87,1.38,68,0.89,21838.03,17,1,17,44,14,105.91,87,90,6,3,123.78,0.00,0.67,0.19,2,70.00,3,2683.64,2,9,10,org.apache.jackrabbit.core.NodeImpl,0.02,28,2,22,0,28,7,1,24,589,1
"org.apache.jackrabbit.core.version.VersionItemStateManager",5,0.25,3.40,42,0.52,16125.41,7,2,16,26,13,91.53,25,68,3,2,109.40,0.00,0.50,0.30,0,2.00,6,1545.60,0,1,11,org.apache.jackrabbit.core.state.SharedItemStateManager,0.00,21,1,17,0,21,4,0,14,313,1
"org.apache.jackrabbit.core.version.VersionItemStateProvider",17,0.02,1.06,44,0.44,7478.95,21,4,14,31,14,139.18,71,72,1,1,138.94,0.00,0.00,0.24,0,81.00,2,1328.34,0,6,13,java.lang.Object,0.00,14,0,18,0,14,11,2,26,342,0
"org.apache.jackrabbit.core.version.VersionIteratorImpl",11,0.02,1.73,54,0.53,14208.39,15,4,10,30,5,91.69,74,76,2,1,123.92,0.00,0.00,0.23,3,26.00,3,1578.17,0,2,3,java.lang.Object,0.00,19,0,19,0,19,9,1,17,354,0
"org.apache.jackrabbit.core.version.VersionIteratorImplTest",1,0.00,3.00,16,0.17,5534.61,2,1,4,7,5,96.36,0,16,1,2,96.36,0.00,0.50,1.00,0,0.00,3,508.69,0,0,4,junit.framework.TestCase,0.00,6,1,3,0,6,1,0,0,103,1
"org.apache.jackrabbit.core.version.VersionIteratorImplTest$DummyInternalVersion",16,0.47,1.00,36,0.18,1846.63,18,2,4,16,6,143.53,0,27,0,1,143.53,0.00,0.00,0.06,0,44.00,1,545.55,0,12,6,java.lang.Object,0.00,0,0,16,0,0,4,1,0,169,2
"org.apache.jackrabbit.core.version.VersionManagerImplBase",17,0.03,3.06,164,2.21,120376.00,26,9,27,72,21,60.70,190,249,1,1,104.83,0.00,0.00,0.14,9,146.00,14,6625.08,0,9,20,java.lang.Object,0.00,55,0,52,4,55,8,0,45,1241,2
"org.apache.jackrabbit.core.version.VersionManagerImplBase$WriteOperation",3,0.00,1.33,13,0.10,1164.80,5,2,27,4,1,110.21,15,20,0,1,128.09,0.00,0.00,0.50,0,1.00,2,285.08,0,0,1,java.lang.Object,0.00,1,0,4,0,1,3,0,4,74,1
"org.apache.jackrabbit.core.version.VersionManagerImplConfig",5,1.00,3.00,74,1.21,58761.33,6,1,16,41,17,66.56,66,106,0,4,95.94,0.33,0.60,0.20,2,11.00,7,3620.53,3,4,17,org.apache.jackrabbit.core.version.VersionManagerImplMerge,0.00,36,3,15,1,36,1,0,16,625,2
"org.apache.jackrabbit.core.version.VersionManagerImplMerge",9,0.88,6.00,184,3.01,191308.71,10,1,28,75,20,127.28,193,251,1,3,87.98,1.00,0.40,0.22,5,19.00,16,9030.66,4,3,19,org.apache.jackrabbit.core.version.VersionManagerImplRestore,0.00,66,2,54,2,66,6,0,71,1522,2
"org.apache.jackrabbit.core.version.VersionManagerImplRestore",9,0.38,8.22,266,5.09,508069.39,10,1,29,112,28,125.82,211,364,1,2,78.55,3.00,0.20,0.67,3,0.00,46,15255.04,5,2,27,org.apache.jackrabbit.core.version.VersionManagerImplBase,0.00,103,1,74,3,103,7,0,127,2272,2
"org.apache.jackrabbit.core.version.VersionSelector",1,0.00,1.00,2,0.01,51.00,1,0,1,1,6,160.11,34,3,4,1,146.32,0.00,0.00,0.00,0,1.00,1,34.00,0,0,2,,0.00,0,0,1,0,0,1,0,2,13,1
"org.apache.jackrabbit.core.version.VersionSet",4,0.17,1.25,15,0.16,2991.22,6,2,3,7,13,82.42,33,22,8,1,130.52,0.00,0.00,0.38,0,4.00,2,470.93,0,1,5,java.lang.Object,0.00,3,0,5,0,3,3,1,8,114,1
"org.apache.jackrabbit.harness.compatibility.AbstractRepositoryTest",6,0.00,1.67,71,1.04,29065.60,6,0,19,48,4,153.02,11,104,1,1,103.02,0.00,0.00,0.00,5,6.00,4,3122.75,0,1,3,java.lang.Object,0.00,42,0,10,1,42,5,0,5,574,1
"org.apache.jackrabbit.harness.compatibility.CreateRepositoryTest",1,0.00,1.00,3,0.02,206.68,1,0,1,1,1,134.97,0,6,0,2,134.97,0.00,0.50,0.00,0,1.00,1,65.70,1,0,1,org.apache.jackrabbit.harness.compatibility.AbstractRepositoryTest,0.00,0,1,1,0,0,1,0,0,20,1
"org.apache.jackrabbit.webdav.server.AbstractWebdavServlet",48,2.00,3.25,448,6.55,227228.91,50,2,68,178,59,56.19,451,650,3,2,106.19,6.00,0.12,0.00,7,228.00,34,19664.06,1,6,56,javax.servlet.http.HttpServlet,0.00,130,1,156,6,130,42,1,87,3624,2
"org.apache.jackrabbit.webdav.server.BindTest",14,5.00,1.29,429,6.92,462426.46,19,5,39,76,21,80.49,59,460,1,2,80.26,0.00,0.50,0.00,3,14.00,3,20745.58,2,3,20,junit.framework.TestCase,0.00,62,1,18,0,62,11,0,50,3473,1
"org.apache.jackrabbit.webdav.server.RFC4918DestinationHeaderTest",3,5.00,1.33,48,0.86,50544.02,8,5,13,24,4,92.97,14,59,1,2,92.73,0.00,0.50,0.00,0,3.00,2,2566.72,2,0,3,junit.framework.TestCase,0.00,21,1,4,0,21,3,0,4,467,1
"org.apache.jackrabbit.webdav.server.RFC4918IfHeaderTest",4,5.00,1.50,78,1.47,103465.78,9,5,16,30,7,70.58,20,95,1,2,88.46,0.00,0.50,0.00,0,4.00,2,4418.29,2,0,6,junit.framework.TestCase,0.00,26,1,6,0,26,4,0,10,754,1
"org.apache.jackrabbit.webdav.server.RFC4918PropfindTest",4,0.20,1.25,44,0.74,26280.23,9,5,20,31,11,141.93,11,57,1,2,102.04,0.00,0.50,0.05,0,6.00,2,2225.44,2,0,10,junit.framework.TestCase,0.00,27,1,5,0,27,4,0,1,405,1
"org.apache.jackrabbit.webdav.server.WebdavServerTests",1,0.00,1.00,8,0.07,2228.14,1,0,3,3,4,110.95,0,10,0,2,110.95,0.00,0.50,0.00,0,1.00,1,223.66,0,1,4,junit.framework.TestCase,0.00,2,1,1,0,2,0,0,0,55,1
"org.apache.jackrabbit.rmi.server.jmx.JCRServer",12,0.03,1.33,55,0.52,12446.00,18,6,11,30,4,164.61,33,79,0,1,124.73,0.00,0.00,0.14,1,66.00,4,1570.88,0,5,4,java.lang.Object,0.00,18,0,16,0,18,7,1,12,355,1
"org.apache.jackrabbit.rmi.server.jmx.JCRServerMBean",11,0.00,1.00,12,0.06,232.45,11,0,1,11,1,160.57,8,14,1,1,160.57,0.00,0.00,0.00,0,11.00,1,174.92,0,4,0,,0.00,0,0,11,0,0,7,0,1,69,1
"org.apache.jackrabbit.webdav.AbstractLocatorFactory",6,0.50,2.67,41,0.57,34923.76,8,2,3,20,6,130.23,110,55,3,1,112.10,0.00,0.00,0.08,1,10.00,10,1698.49,0,5,3,java.lang.Object,0.00,14,0,16,3,14,1,1,18,338,2
"org.apache.jackrabbit.webdav.AbstractLocatorFactory$DavResourceLocatorImpl",13,0.07,1.69,52,0.56,17529.35,18,5,3,28,4,81.48,100,74,0,1,123.77,0.00,0.00,0.14,4,92.00,4,1688.80,0,6,4,java.lang.Object,0.00,15,0,22,0,15,7,1,16,383,1
"org.apache.jackrabbit.webdav.DavCompliance",1,19.00,3.00,30,0.44,11678.97,20,19,2,5,6,39.49,11,31,6,1,83.62,0.00,0.00,0.00,0,1.00,3,1307.56,0,1,0,java.lang.Object,0.00,4,0,3,0,4,0,0,8,239,2
"org.apache.jackrabbit.webdav.DavConstants",0,0.00,0.00,75,1.67,38410.85,74,74,3,3,69,171.00,43,76,67,1,171.00,0.00,0.00,0.00,0,0.00,0,5021.68,0,0,2,,0.00,3,0,0,0,3,0,0,19,685,1
"org.apache.jackrabbit.webdav.DavException",9,0.02,1.22,40,0.42,7800.64,14,5,8,18,131,83.07,71,55,128,2,125.36,1.00,0.33,0.18,2,46.00,3,1264.72,0,3,4,java.lang.Exception,0.00,9,1,11,1,9,6,1,10,295,1
"org.apache.jackrabbit.webdav.DavLocatorFactory",3,0.00,1.00,4,0.04,214.66,3,0,0,3,15,146.04,46,5,15,1,156.40,0.00,0.00,0.00,0,3.00,1,114.84,0,3,1,,0.00,0,0,3,0,0,0,0,4,37,1
"org.apache.jackrabbit.webdav.DavMethods",6,0.01,1.83,134,2.34,94467.84,76,70,4,12,39,132.86,170,152,38,1,87.73,0.00,0.00,0.02,2,14.00,3,7022.94,0,0,1,java.lang.Object,0.00,6,0,11,0,6,6,0,44,1093,1
"org.apache.jackrabbit.webdav.DavResource",32,1.00,1.00,34,0.25,1655.22,33,1,13,32,82,115.21,228,35,69,1,157.50,0.00,0.00,0.00,0,32.00,1,758.65,0,14,17,,0.00,0,0,32,0,0,18,0,34,252,1
"org.apache.jackrabbit.webdav.DavResourceFactory",2,0.00,1.00,3,0.03,184.32,2,0,0,2,26,111.40,22,4,21,1,155.53,0.00,0.00,0.00,0,2.00,1,94.16,0,2,6,,0.00,0,0,2,0,0,0,0,3,28,1
"org.apache.jackrabbit.webdav.DavResourceIterator",2,0.00,1.00,3,0.02,120.42,2,0,1,2,16,124.76,13,4,16,1,156.99,0.00,0.00,0.00,0,2.00,1,51.75,0,1,1,,0.00,0,0,2,0,0,1,0,3,19,1
"org.apache.jackrabbit.webdav.DavResourceIteratorImpl",6,0.05,1.00,18,0.16,3040.64,10,4,5,13,9,132.14,26,25,7,1,131.90,0.00,0.00,0.21,1,6.00,1,483.34,0,2,2,java.lang.Object,0.00,7,0,6,0,7,4,1,7,123,1
"org.apache.jackrabbit.webdav.DavResourceLocator",10,0.00,1.00,11,0.05,222.33,10,0,0,10,47,118.10,75,12,47,1,160.39,0.00,0.00,0.00,0,10.00,1,148.22,0,6,1,,0.00,0,0,10,0,0,4,0,11,60,1
"org.apache.jackrabbit.webdav.DavServletRequest",16,0.00,1.00,17,0.11,668.98,16,0,8,16,15,110.13,137,18,6,2,158.23,0.00,0.50,0.00,0,16.00,1,318.71,0,7,9,,0.00,0,1,16,0,0,9,0,17,115,1
"org.apache.jackrabbit.webdav.DavServletResponse",5,6.00,1.00,12,0.12,1085.81,11,6,4,5,113,140.90,83,13,110,2,141.37,0.00,0.50,0.00,0,5.00,1,345.73,0,0,4,,0.00,0,1,5,0,0,5,0,12,91,1
"org.apache.jackrabbit.webdav.DavSession",5,0.00,1.00,6,0.03,160.93,5,0,0,5,19,126.91,31,7,19,1,159.13,0.00,0.00,0.00,0,5.00,1,102.12,0,1,0,,0.00,0,0,5,0,0,4,0,6,38,1
"org.apache.jackrabbit.webdav.DavSessionProvider",2,0.00,1.00,3,0.02,98.54,2,0,0,2,7,120.11,24,4,5,1,157.67,0.00,0.00,0.00,0,2.00,1,56.18,0,0,2,,0.00,0,0,2,0,0,2,0,3,20,1
"org.apache.jackrabbit.webdav.MultiStatus",9,0.31,1.89,45,0.58,16377.76,11,2,8,32,34,69.11,81,64,26,1,119.11,0.00,0.00,0.22,3,39.00,3,1753.68,0,3,8,java.lang.Object,0.00,23,0,17,0,23,6,2,13,377,1
"org.apache.jackrabbit.webdav.MultiStatusResponse",21,0.00,2.57,165,2.08,98156.03,28,7,15,64,43,62.26,176,212,29,1,110.36,0.00,0.00,0.14,4,145.00,8,6244.08,0,8,15,java.lang.Object,0.00,43,0,54,0,43,13,2,39,1209,1
"org.apache.jackrabbit.webdav.Status",5,0.12,2.80,53,0.69,43470.93,9,4,6,19,7,123.06,18,70,3,1,102.44,0.00,0.00,0.35,0,9.00,10,2073.30,0,2,4,java.lang.Object,0.00,14,0,14,0,14,3,2,8,387,1
"org.apache.jackrabbit.webdav.WebdavRequest",0,0.00,0.00,1,0.01,76.11,0,0,5,0,15,171.00,7,5,10,7,171.00,0.00,0.86,0.00,0,0.00,0,38.05,0,0,5,,0.00,0,6,0,0,0,0,0,1,11,1
"org.apache.jackrabbit.webdav.WebdavRequestImpl",90,0.00,1.77,407,4.49,169122.45,100,10,59,221,42,162.51,248,565,1,1,122.63,0.00,0.00,0.10,12,0.00,13,13478.85,0,63,41,java.lang.Object,0.00,131,0,159,0,131,27,2,70,2854,1
"org.apache.jackrabbit.webdav.WebdavResponse",0,0.00,0.00,1,0.01,39.30,0,0,1,0,7,171.00,7,3,6,3,171.00,0.00,0.67,0.00,0,0.00,0,19.65,0,0,1,,0.00,0,2,0,0,0,0,0,1,7,1
"org.apache.jackrabbit.webdav.WebdavResponseImpl",39,0.05,1.18,119,1.31,28889.82,41,2,32,98,17,180.57,76,171,1,1,130.57,0.00,0.00,0.45,2,0.00,5,3921.01,0,8,16,java.lang.Object,0.00,59,0,46,0,59,31,1,19,904,1
"org.apache.jackrabbit.core.security.authorization.acl.ACLEditor",16,0.05,2.44,129,1.70,59054.05,21,5,31,52,17,66.73,118,160,4,2,109.02,0.00,0.50,0.15,6,94.00,7,5093.14,4,11,15,org.apache.jackrabbit.core.ProtectedItemModifier,0.00,36,1,39,0,36,5,2,34,983,1
"org.apache.jackrabbit.core.security.authorization.acl.ACLProvider",13,0.02,2.46,137,2.12,85093.72,17,4,48,82,31,54.96,136,169,5,2,103.44,0.00,0.50,0.27,4,58.00,7,6346.59,7,7,29,org.apache.jackrabbit.core.security.authorization.AbstractAccessControlProvider,0.08,69,1,32,0,69,6,1,34,1121,1
"org.apache.jackrabbit.core.security.authorization.acl.ACLProvider$AclPermissions",8,0.05,2.88,93,1.42,78648.87,11,3,48,48,16,82.60,46,116,0,2,100.47,0.00,0.50,0.29,2,18.00,6,4246.63,2,0,16,org.apache.jackrabbit.core.security.authorization.AbstractCompiledPermissions,0.25,40,1,23,0,40,8,1,21,754,1
"org.apache.jackrabbit.core.security.authorization.acl.ACLTemplate",15,0.01,2.87,140,2.20,132054.76,22,7,32,71,24,55.99,125,191,9,2,104.10,0.00,0.50,0.13,5,77.00,11,6614.64,0,3,15,org.apache.jackrabbit.core.security.authorization.AbstractACLTemplate,0.08,56,1,43,0,56,12,0,47,1189,0
"org.apache.jackrabbit.core.security.authorization.acl.ACLTemplate$Entry",6,0.60,1.33,24,0.28,6353.32,7,1,32,10,4,174.66,10,36,0,2,124.66,0.00,0.50,0.50,0,14.00,2,828.10,1,2,4,org.apache.jackrabbit.core.security.authorization.AccessControlEntryImpl,0.18,4,1,8,0,4,4,0,2,184,0
"org.apache.jackrabbit.core.security.authorization.acl.ACLTemplateTest",13,0.58,1.38,166,2.76,99529.54,14,1,19,49,12,139.97,35,191,1,6,100.08,0.00,0.83,0.46,2,0.00,4,8294.97,2,3,11,org.apache.jackrabbit.core.security.authorization.AbstractACLTemplateTest,0.18,36,5,18,0,36,10,0,28,1526,1
"org.apache.jackrabbit.core.security.authorization.acl.ACLTemplateTest$Principal",1,0.00,1.00,3,0.01,151.48,1,0,19,2,0,136.03,0,4,0,1,136.03,0.00,0.00,0.00,0,1.00,1,42.87,0,1,0,java.lang.Object,0.00,1,0,1,0,1,0,0,0,15,0
"org.apache.jackrabbit.core.security.authorization.acl.CachingEntryCollector",8,0.29,3.12,86,1.04,46561.67,11,3,11,28,7,53.79,74,116,1,3,103.79,0.00,0.67,0.58,1,0.00,9,3117.87,5,4,7,org.apache.jackrabbit.core.security.authorization.acl.EntryCollector,0.13,20,2,25,0,20,4,0,31,605,0
"org.apache.jackrabbit.core.security.authorization.acl.CachingEntryCollector$CacheEntry",2,0.00,1.00,11,0.12,2588.66,4,2,11,7,1,120.42,0,15,0,1,120.42,0.00,0.00,0.50,0,2.00,1,367.30,0,1,1,java.lang.Object,0.00,5,0,2,0,5,1,0,0,89,1
"org.apache.jackrabbit.core.security.authorization.acl.EffectivePolicyTest",5,0.00,1.80,36,0.51,14049.49,5,0,15,18,7,94.31,26,57,1,7,112.18,0.00,0.86,0.00,0,10.00,3,1544.31,5,2,6,org.apache.jackrabbit.core.security.authorization.AbstractEffectivePolicyTest,0.12,13,6,9,0,13,3,0,18,300,1
"org.apache.jackrabbit.core.security.authorization.acl.EntryCollector",11,0.04,2.64,94,1.43,63129.17,16,5,22,58,11,57.49,103,137,2,2,107.49,1.00,0.33,0.16,5,45.00,13,4293.37,2,7,10,org.apache.jackrabbit.core.security.authorization.AccessControlObserver,0.13,47,1,29,1,47,4,1,34,812,1
"org.apache.jackrabbit.core.security.authorization.acl.EntryCollectorTest",9,0.16,3.89,195,3.06,229970.14,17,8,25,51,11,126.54,26,242,1,5,86.66,0.00,0.80,0.26,4,0.00,7,9177.89,4,3,10,org.apache.jackrabbit.test.api.security.AbstractAccessControlTest,0.23,42,4,35,0,42,6,0,24,1640,1
"org.apache.jackrabbit.core.security.authorization.acl.EntryFilter",1,0.00,1.00,2,0.02,187.97,1,0,2,1,3,162.48,3,3,3,1,141.86,0.00,0.00,0.00,0,1.00,1,61.89,0,0,0,,0.00,0,0,1,0,0,1,0,1,20,1
"org.apache.jackrabbit.core.security.authorization.acl.EntryFilterImpl",4,0.13,3.00,38,0.46,14965.52,9,5,9,17,5,74.79,26,51,1,1,107.02,0.00,0.00,0.30,2,6.00,5,1372.69,0,1,4,java.lang.Object,0.00,13,0,12,0,13,3,1,12,280,0
"org.apache.jackrabbit.core.security.authorization.acl.EntryTest",5,0.50,1.60,46,0.92,36217.25,6,1,16,36,9,154.90,8,55,1,6,104.90,0.00,0.83,0.60,1,0.00,3,2773.39,1,1,8,org.apache.jackrabbit.core.security.authorization.AbstractEntryTest,0.12,31,5,8,0,31,4,0,6,503,1
"org.apache.jackrabbit.core.security.authorization.acl.EvaluationUtil",3,0.00,3.00,21,0.25,8798.03,3,0,12,8,9,151.80,7,32,6,1,111.92,0.00,0.00,0.00,0,3.00,5,749.22,0,2,3,java.lang.Object,0.00,5,0,9,0,5,1,0,5,153,1
"org.apache.jackrabbit.core.security.authorization.acl.LockTest",3,0.00,1.00,7,0.08,1280.54,3,0,9,6,5,189.06,3,12,1,7,139.06,0.00,0.86,0.00,0,4.00,1,253.23,0,2,4,org.apache.jackrabbit.core.security.authorization.AbstractLockManagementTest,0.12,3,6,3,0,3,1,0,1,65,1
"org.apache.jackrabbit.core.security.authorization.acl.NodeTypeTest",3,0.00,1.00,7,0.08,1280.54,3,0,9,6,5,189.06,3,12,1,7,139.06,0.00,0.86,0.00,0,4.00,1,253.23,0,2,4,org.apache.jackrabbit.core.security.authorization.AbstractNodeTypeManagementTest,0.11,3,6,3,0,3,1,0,1,65,1
"org.apache.jackrabbit.core.security.authorization.acl.ReadTest",6,0.00,1.00,50,0.75,24216.06,8,2,16,26,6,148.80,12,57,1,6,108.92,0.00,0.83,0.50,1,10.00,1,2258.41,7,2,5,org.apache.jackrabbit.core.security.authorization.AbstractEvaluationTest,0.21,20,5,6,0,20,4,0,5,426,1
"org.apache.jackrabbit.core.security.authorization.acl.TestAll",1,0.00,1.00,13,0.14,4715.12,1,0,4,3,10,52.04,10,15,0,2,100.52,0.00,0.50,0.00,0,1.00,1,428.81,0,1,10,junit.framework.TestCase,0.00,2,1,1,0,2,0,0,2,95,1
"org.apache.jackrabbit.core.security.authorization.acl.VersionTest",3,0.00,1.00,7,0.08,1280.54,3,0,9,6,5,189.06,3,12,1,7,139.06,0.00,0.86,0.00,0,4.00,1,253.23,0,2,4,org.apache.jackrabbit.core.security.authorization.AbstractVersionManagementTest,0.12,3,6,3,0,3,1,0,1,65,1
"org.apache.jackrabbit.core.security.authorization.acl.WriteTest",13,0.00,1.69,166,2.81,100478.34,13,0,24,54,14,51.90,110,203,2,7,100.01,0.17,0.75,0.00,0,0.00,5,8428.23,8,2,12,org.apache.jackrabbit.core.security.authorization.AbstractWriteTest,0.07,41,6,22,1,41,11,0,58,1474,1
"org.apache.jackrabbit.webdav.observation.DefaultEventType",6,0.07,1.67,32,0.41,13570.68,9,3,10,24,10,70.29,50,43,4,1,118.39,0.00,0.00,0.28,1,14.00,3,1239.75,0,5,6,java.lang.Object,0.00,18,0,10,0,18,1,1,9,259,1
"org.apache.jackrabbit.webdav.observation.EventBundle",0,0.00,0.00,1,0.01,31.02,0,0,1,0,5,171.00,6,2,4,2,171.00,0.00,0.50,0.00,0,0.00,0,15.51,0,0,1,,0.00,0,1,0,0,0,0,0,1,6,1
"org.apache.jackrabbit.webdav.observation.EventDiscovery",4,0.17,1.50,16,0.17,3266.85,6,2,9,12,14,77.41,35,22,10,1,125.52,0.00,0.00,0.38,0,0.00,2,500.30,0,2,4,java.lang.Object,0.00,8,0,6,0,8,2,2,5,119,1
"org.apache.jackrabbit.webdav.observation.EventType",2,0.00,1.00,3,0.01,65.85,2,0,2,2,6,209.05,3,4,4,2,159.05,0.00,0.50,0.00,0,2.00,1,38.73,0,2,2,,0.00,0,1,2,0,0,0,0,1,16,1
"org.apache.jackrabbit.webdav.observation.Filter",7,0.17,1.29,26,0.25,5243.97,11,4,7,15,5,130.51,3,35,2,1,130.51,0.00,0.00,0.39,0,0.00,2,757.29,0,4,3,java.lang.Object,0.00,8,0,9,0,8,3,1,1,184,1
"org.apache.jackrabbit.webdav.observation.ObservationConstants",0,0.00,0.00,22,0.40,7644.67,21,21,2,2,15,171.00,31,23,13,1,171.00,0.00,0.00,0.00,0,0.00,0,1189.17,0,0,2,,0.00,2,0,0,0,2,0,0,10,203,1
"org.apache.jackrabbit.webdav.observation.ObservationDavServletRequest",3,0.00,1.00,4,0.02,105.15,3,0,2,3,3,110.73,25,5,0,2,158.84,0.00,0.50,0.00,0,3.00,1,58.38,0,2,3,,0.00,0,1,3,0,0,1,0,4,23,1
"org.apache.jackrabbit.webdav.observation.ObservationDavServletResponse",2,0.00,1.00,3,0.02,145.14,2,0,2,2,4,108.24,17,4,1,2,156.35,0.00,0.50,0.00,0,2.00,1,72.57,0,0,3,,0.00,0,1,2,0,0,2,0,3,24,1
"org.apache.jackrabbit.webdav.observation.ObservationResource",4,1.00,1.00,6,0.06,373.67,5,1,2,4,12,105.48,39,7,7,2,155.48,0.00,0.50,0.00,0,4.00,1,169.26,0,2,6,,0.00,0,1,4,0,0,2,0,5,51,1
"org.apache.jackrabbit.webdav.observation.Subscription",1,0.00,1.00,2,0.01,48.43,1,0,1,1,13,136.14,15,3,12,2,146.50,0.00,0.50,0.00,0,1.00,1,27.12,0,1,1,,0.00,0,1,1,0,0,0,0,2,11,1
"org.apache.jackrabbit.webdav.observation.SubscriptionDiscovery",5,1.00,2.00,32,0.40,13086.10,6,1,9,20,13,82.68,31,43,6,2,114.90,0.00,0.50,0.20,0,8.00,3,1186.48,1,3,7,org.apache.jackrabbit.webdav.property.AbstractDavProperty,0.00,15,1,10,0,15,2,0,7,248,1
"org.apache.jackrabbit.webdav.observation.SubscriptionDiscovery$Subscription",2,0.00,1.50,8,0.09,1537.07,2,0,9,5,3,146.34,6,11,0,1,125.72,0.00,0.00,0.00,0,2.00,2,260.90,0,2,3,java.lang.Object,0.00,3,0,3,0,3,0,0,2,63,0
"org.apache.jackrabbit.webdav.observation.SubscriptionInfo",10,0.02,2.30,75,0.95,40690.86,16,6,14,31,22,60.86,93,96,10,1,110.86,0.00,0.00,0.15,0,50.00,6,2849.24,0,1,12,java.lang.Object,0.00,21,0,23,0,21,9,2,11,552,1
"org.apache.jackrabbit.webdav.observation.SubscriptionManager",4,0.00,1.00,5,0.05,310.01,4,0,1,4,12,108.02,35,10,7,1,156.12,0.00,0.00,0.00,0,4.00,1,161.92,0,2,6,,0.00,0,0,4,0,0,2,0,5,48,1
"org.apache.jackrabbit.rmi.client.principal.ClientGroup",5,1.00,1.40,19,0.20,4283.22,6,1,10,11,7,130.27,23,30,1,2,130.03,0.00,0.50,0.20,0,8.00,2,591.59,1,1,6,org.apache.jackrabbit.rmi.client.principal.ClientPrincipal,0.00,6,1,7,0,6,4,1,7,139,1
"org.apache.jackrabbit.rmi.client.principal.ClientGroup$Enumeration<Principal>",2,0.00,1.00,5,0.03,268.38,2,0,10,4,0,143.02,0,7,0,1,143.02,0.00,0.00,0.00,0,2.00,1,92.73,0,1,0,java.lang.Object,0.00,2,0,2,0,2,1,0,0,29,0
"org.apache.jackrabbit.rmi.client.principal.ClientPrincipal",3,0.50,1.33,10,0.07,1106.99,4,1,4,5,4,100.70,18,16,2,1,132.92,0.00,0.00,0.67,0,1.00,2,211.02,0,2,2,java.lang.Object,0.00,2,0,4,1,2,1,1,3,58,1
"org.apache.jackrabbit.rmi.client.principal.ClientPrincipalIterator",2,0.00,1.00,5,0.05,584.73,2,0,4,3,5,180.24,4,10,1,2,140.35,0.00,0.50,0.00,0,2.00,1,143.55,1,1,4,org.apache.jackrabbit.rmi.client.iterator.ClientIterator,0.00,1,2,2,0,1,1,0,2,41,1
"org.apache.jackrabbit.api.observation.JackrabbitEvent",1,0.00,1.00,2,0.01,44.19,1,0,1,1,1,102.69,11,3,1,2,146.81,0.00,0.50,0.00,0,1.00,1,26.09,0,0,0,,0.00,0,1,1,0,0,1,0,2,11,1
"org.apache.jackrabbit.core.persistence.db.DatabasePersistenceManager",40,0.07,3.20,494,6.24,281133.03,74,34,39,138,21,57.89,298,701,3,2,100.18,5.00,0.14,0.10,15,190.00,11,18713.42,2,9,18,org.apache.jackrabbit.core.persistence.AbstractPersistenceManager,0.00,98,1,128,5,98,31,0,136,3389,2
"org.apache.jackrabbit.core.persistence.db.DatabasePersistenceManager$DbBLOBStore",4,0.00,1.75,30,0.39,11695.04,4,0,39,18,2,94.18,20,39,0,1,112.05,0.00,0.00,0.00,0,10.00,3,1172.64,0,2,2,java.lang.Object,0.00,14,0,7,0,14,2,1,9,238,0
"org.apache.jackrabbit.core.persistence.db.DatabasePersistenceManager$DbBLOBStore$FilterInputStream",1,0.00,1.00,4,0.02,218.17,1,0,39,3,0,180.12,1,5,0,1,130.12,0.00,0.00,0.00,0,1.00,1,68.97,0,0,0,java.lang.Object,0.00,2,0,1,0,2,1,0,1,21,0
"org.apache.jackrabbit.core.persistence.db.DatabasePersistenceManager$SizedInputStream",7,0.08,1.00,22,0.17,2593.31,9,2,39,7,0,132.97,0,30,0,2,132.97,0.00,0.50,0.43,0,0.00,1,512.17,2,0,0,java.io.FilterInputStream,0.00,0,1,7,0,0,7,0,0,134,0
"org.apache.jackrabbit.core.persistence.db.DerbyPersistenceManager",4,0.00,2.00,28,0.27,7362.38,6,2,5,15,2,122.74,69,39,1,4,113.61,0.00,0.75,0.50,0,0.00,5,815.65,0,0,1,org.apache.jackrabbit.core.persistence.db.SimpleDbPersistenceManager,0.00,11,3,8,0,11,4,0,19,170,1
"org.apache.jackrabbit.core.persistence.db.JNDIDatabasePersistenceManager",3,0.50,1.00,10,0.08,1276.06,4,1,5,6,1,88.37,35,14,0,3,132.50,0.00,0.67,0.67,0,1.00,1,241.45,0,2,1,org.apache.jackrabbit.core.persistence.db.DatabasePersistenceManager,0.06,3,2,3,0,3,1,0,7,64,1
"org.apache.jackrabbit.core.persistence.db.MSSqlPersistenceManager",4,0.00,1.25,20,0.16,2828.96,6,2,1,7,2,93.06,52,27,0,4,122.44,0.00,0.75,0.50,0,0.00,2,485.50,1,2,2,org.apache.jackrabbit.core.persistence.db.SimpleDbPersistenceManager,0.00,3,3,5,0,3,2,0,7,119,1
"org.apache.jackrabbit.core.persistence.db.OraclePersistenceManager",10,0.07,3.50,135,2.00,89071.72,16,6,25,64,9,68.68,134,192,0,4,98.06,0.00,0.75,0.23,1,14.00,8,6010.73,5,2,9,org.apache.jackrabbit.core.persistence.db.SimpleDbPersistenceManager,0.06,54,3,35,0,54,8,0,50,1051,1
"org.apache.jackrabbit.core.persistence.db.OraclePersistenceManager$OracleBLOBStore",1,0.00,4.00,14,0.19,7266.34,1,0,25,6,0,97.76,4,22,0,2,97.52,0.00,0.50,0.00,0,1.00,4,555.96,0,0,0,org.apache.jackrabbit.core.persistence.db.DbBLOBStore,0.00,5,1,4,0,5,1,0,2,103,0
"org.apache.jackrabbit.core.persistence.db.SimpleDbPersistenceManager",10,0.02,1.00,26,0.18,2204.69,15,5,5,12,6,103.76,121,37,3,3,141.32,1.50,0.33,0.18,0,34.00,1,545.94,0,5,3,org.apache.jackrabbit.core.persistence.db.DatabasePersistenceManager,0.05,2,2,10,3,2,5,1,5,151,1
"org.apache.jackrabbit.rmi.server.iterator.ServerIterator",5,0.00,1.80,27,0.30,8591.55,8,3,7,15,10,81.75,61,42,7,2,119.32,7.00,0.11,0.33,1,2.00,3,895.42,0,2,3,org.apache.jackrabbit.rmi.server.ServerObject,0.00,10,2,9,7,10,3,1,9,201,2
"org.apache.jackrabbit.rmi.server.iterator.ServerNodeIterator",2,0.00,1.00,5,0.05,488.90,2,0,4,2,3,90.97,19,10,1,3,140.96,0.00,0.67,0.00,0,2.00,1,141.40,1,1,2,org.apache.jackrabbit.rmi.server.iterator.ServerIterator,0.00,0,3,2,0,0,1,0,3,40,1
"org.apache.jackrabbit.rmi.server.iterator.ServerNodeTypeIterator",2,0.00,1.00,5,0.05,584.99,2,0,4,3,3,90.35,19,10,1,3,140.35,0.00,0.67,0.00,0,2.00,1,156.38,1,1,2,org.apache.jackrabbit.rmi.server.iterator.ServerIterator,0.00,1,3,2,0,1,1,0,3,43,1
"org.apache.jackrabbit.rmi.server.iterator.ServerPropertyIterator",2,0.00,1.00,5,0.05,584.99,2,0,4,3,3,90.35,19,10,1,3,140.35,0.00,0.67,0.00,0,2.00,1,156.38,1,1,2,org.apache.jackrabbit.rmi.server.iterator.ServerIterator,0.00,1,3,2,0,1,1,0,3,43,1
"org.apache.jackrabbit.rmi.server.iterator.ServerRowIterator",2,0.00,1.00,5,0.05,584.99,2,0,4,3,3,90.35,19,10,1,3,140.35,0.00,0.67,0.00,0,2.00,1,156.38,1,1,2,org.apache.jackrabbit.rmi.server.iterator.ServerIterator,0.00,1,3,2,0,1,1,0,3,43,1
"org.apache.jackrabbit.rmi.server.iterator.ServerVersionIterator",2,0.00,1.00,5,0.05,584.99,2,0,4,3,3,90.35,19,10,1,3,140.35,0.00,0.67,0.00,0,2.00,1,156.38,1,1,2,org.apache.jackrabbit.rmi.server.iterator.ServerIterator,0.00,1,3,2,0,1,1,0,3,43,1
"org.apache.jackrabbit.test.api.query.qom.AbstractJoinTest",4,0.00,1.75,22,0.32,10239.73,7,3,8,10,6,138.57,15,42,5,6,117.96,1.00,0.45,0.33,3,6.00,4,958.59,0,2,1,org.apache.jackrabbit.test.api.query.qom.AbstractQOMTest,0.00,6,5,7,5,6,2,0,6,207,2
"org.apache.jackrabbit.test.api.query.qom.AbstractQOMTest",8,0.00,2.50,104,1.31,54544.71,8,0,14,28,21,56.76,59,108,20,5,99.05,6.25,0.13,0.00,3,16.00,7,3942.95,0,1,1,org.apache.jackrabbit.test.api.query.AbstractQueryTest,0.00,20,4,20,25,20,7,0,10,739,2
"org.apache.jackrabbit.test.api.query.qom.AbstractQOMTest$Callable",1,0.00,1.00,2,0.01,69.06,1,0,14,1,0,145.29,0,3,0,1,145.29,0.00,0.00,0.00,0,1.00,1,36.53,0,1,0,,0.00,0,0,1,0,0,0,0,0,13,1
"org.apache.jackrabbit.test.api.query.qom.AndConstraintTest",1,0.00,1.00,13,0.32,9476.09,1,0,4,12,2,118.75,3,29,1,6,98.13,0.00,0.83,0.00,0,0.00,1,949.16,1,0,1,org.apache.jackrabbit.test.api.query.qom.AbstractQOMTest,0.00,11,5,1,0,11,1,0,1,169,1
"org.apache.jackrabbit.test.api.query.qom.BindVariableValueTest",15,0.17,1.13,127,1.85,40411.65,24,9,9,36,3,110.27,5,158,1,6,110.27,0.00,0.83,0.27,0,0.00,3,5547.51,5,0,2,org.apache.jackrabbit.test.api.query.qom.AbstractQOMTest,0.18,21,5,17,0,21,15,0,3,1113,1
"org.apache.jackrabbit.test.api.query.qom.ChildNodeJoinConditionTest",4,0.67,1.25,27,0.38,7442.00,6,2,7,12,2,166.17,4,33,1,7,116.17,0.00,0.86,1.00,0,0.00,2,1133.76,4,0,1,org.apache.jackrabbit.test.api.query.qom.AbstractJoinTest,0.12,8,6,5,0,8,4,0,1,234,1
"org.apache.jackrabbit.test.api.query.qom.ChildNodeTest",7,0.00,2.14,57,0.98,23847.57,7,0,9,24,3,159.32,11,94,1,6,109.32,0.00,0.83,0.00,0,0.00,3,2925.75,1,0,2,org.apache.jackrabbit.test.api.query.qom.AbstractQOMTest,0.00,17,5,15,0,17,7,0,8,557,1
"org.apache.jackrabbit.test.api.query.qom.ColumnTest",3,0.33,1.00,18,0.37,9390.15,6,3,16,13,2,82.22,20,43,1,6,114.45,0.00,0.83,0.56,0,0.00,1,1107.89,1,0,1,org.apache.jackrabbit.test.api.query.qom.AbstractQOMTest,0.00,10,5,3,0,10,3,0,3,222,1
"org.apache.jackrabbit.test.api.query.qom.ColumnTest$Callable",1,0.00,4.00,21,0.32,11360.74,1,0,16,16,0,89.42,0,20,0,1,89.42,0.00,0.00,0.00,0,0.00,4,948.24,0,1,0,java.lang.Object,0.00,15,0,4,0,15,0,0,0,159,0
"org.apache.jackrabbit.test.api.query.qom.ColumnTest$Callable_0",1,0.00,2.00,11,0.13,2593.99,1,0,16,9,0,105.11,0,10,0,1,105.11,0.00,0.00,0.00,0,1.00,2,377.87,0,1,0,java.lang.Object,0.00,8,0,2,0,8,0,0,0,75,0
"org.apache.jackrabbit.test.api.query.qom.ColumnTest$Callable_1",1,0.00,1.00,8,0.11,1860.13,1,0,16,9,0,111.57,0,9,0,1,111.57,0.00,0.00,0.00,0,0.00,1,330.02,0,1,0,java.lang.Object,0.00,8,0,1,0,8,0,0,0,69,0
"org.apache.jackrabbit.test.api.query.qom.DescendantNodeJoinConditionTest",4,0.67,2.00,37,0.48,13432.53,6,2,7,14,2,147.36,8,43,1,7,107.48,0.00,0.86,1.00,0,0.00,5,1426.49,4,0,1,org.apache.jackrabbit.test.api.query.qom.AbstractJoinTest,0.12,10,6,8,0,10,4,0,5,282,1
"org.apache.jackrabbit.test.api.query.qom.DescendantNodeTest",7,0.00,2.14,57,0.97,23944.58,7,0,9,24,3,159.31,11,92,1,6,109.31,0.00,0.83,0.00,0,0.00,3,2922.52,1,0,2,org.apache.jackrabbit.test.api.query.qom.AbstractQOMTest,0.00,17,5,15,0,17,7,0,8,557,1
"org.apache.jackrabbit.test.api.query.qom.EquiJoinConditionTest",7,0.58,1.00,37,0.56,9016.76,9,2,5,11,2,120.44,4,51,1,7,120.44,0.00,0.86,1.00,0,0.00,1,1668.20,5,0,1,org.apache.jackrabbit.test.api.query.qom.AbstractJoinTest,0.11,4,6,7,0,4,7,0,1,348,1
"org.apache.jackrabbit.test.api.query.qom.FullTextSearchScoreTest",3,1.00,1.00,18,0.39,8065.78,4,1,7,19,2,164.97,3,43,1,6,114.97,0.00,0.83,0.33,0,0.00,1,1157.73,2,0,1,org.apache.jackrabbit.test.api.query.qom.AbstractQOMTest,0.11,16,5,3,0,16,3,0,1,234,1
"org.apache.jackrabbit.test.api.query.qom.FullTextSearchScoreTest$Callable",1,0.00,3.00,10,0.12,3075.58,1,0,7,7,0,105.98,0,13,0,1,105.98,0.00,0.00,0.00,0,1.00,3,359.03,0,1,0,java.lang.Object,0.00,6,0,3,0,6,0,0,0,73,0
"org.apache.jackrabbit.test.api.query.qom.FullTextSearchScoreTest$Callable_0",1,0.00,3.00,8,0.10,2346.83,1,0,7,7,0,110.52,0,11,0,1,110.52,0.00,0.00,0.00,0,1.00,3,310.66,0,1,0,java.lang.Object,0.00,6,0,3,0,6,0,0,0,64,0
"org.apache.jackrabbit.test.api.query.qom.GetQueryTest",3,0.00,2.67,35,0.57,18496.95,3,0,11,24,3,102.32,13,48,1,6,102.08,0.00,0.83,0.00,1,0.00,4,1714.09,2,0,2,org.apache.jackrabbit.test.api.query.qom.AbstractQOMTest,0.00,21,5,8,0,21,3,0,4,299,1
"org.apache.jackrabbit.test.api.query.qom.LengthTest",29,0.18,1.28,156,2.06,42478.02,30,1,14,59,3,119.94,12,226,1,6,119.94,0.00,0.83,0.83,3,0.00,3,6174.99,4,2,2,org.apache.jackrabbit.test.api.query.qom.AbstractQOMTest,0.15,30,5,37,0,30,27,0,9,1328,1
"org.apache.jackrabbit.test.api.query.qom.NodeLocalNameTest",27,0.21,1.07,110,1.59,31030.54,29,2,10,49,3,124.43,5,162,1,6,124.43,0.00,0.83,0.30,5,0.00,2,4771.33,5,3,2,org.apache.jackrabbit.test.api.query.qom.AbstractQOMTest,0.16,22,5,29,0,22,24,0,2,1037,1
"org.apache.jackrabbit.test.api.query.qom.NodeNameTest",22,0.57,2.05,152,2.36,54976.14,23,1,11,44,3,165.05,36,249,1,6,115.05,0.00,0.83,0.45,5,0.00,5,7084.45,4,3,2,org.apache.jackrabbit.test.api.query.qom.AbstractQOMTest,0.17,22,5,45,0,22,19,0,25,1384,1
"org.apache.jackrabbit.test.api.query.qom.NotConstraintTest",1,0.00,1.00,9,0.17,3807.19,1,0,3,11,2,127.82,3,21,1,6,107.21,0.00,0.83,0.00,0,0.00,1,515.77,1,0,1,org.apache.jackrabbit.test.api.query.qom.AbstractQOMTest,0.00,10,5,1,0,10,1,0,1,100,1
"org.apache.jackrabbit.test.api.query.qom.OrConstraintTest",1,0.00,1.00,9,0.18,4478.52,1,0,3,11,2,127.27,3,22,1,6,106.65,0.00,0.83,0.00,0,0.00,1,553.02,1,0,1,org.apache.jackrabbit.test.api.query.qom.AbstractQOMTest,0.00,10,5,1,0,10,1,0,1,107,1
"org.apache.jackrabbit.test.api.query.qom.OrderingTest",3,0.25,1.00,24,0.35,7904.24,5,2,6,14,2,160.38,5,34,1,7,110.38,0.00,0.86,0.67,1,0.00,1,1041.64,2,1,1,org.apache.jackrabbit.test.api.query.qom.AbstractJoinTest,0.12,11,6,3,0,11,2,0,3,221,1
"org.apache.jackrabbit.test.api.query.qom.PropertyExistenceTest",1,0.00,1.00,11,0.23,7477.29,1,0,3,9,2,101.88,4,23,1,6,101.65,0.00,0.83,0.00,0,0.00,1,682.00,1,0,1,org.apache.jackrabbit.test.api.query.qom.AbstractQOMTest,0.00,8,5,1,0,8,1,0,1,133,1
"org.apache.jackrabbit.test.api.query.qom.PropertyValueTest",1,0.00,1.00,12,0.31,10301.57,2,1,4,12,2,99.38,4,32,1,6,99.14,0.00,0.83,1.00,0,0.00,1,925.16,1,0,1,org.apache.jackrabbit.test.api.query.qom.AbstractQOMTest,0.00,11,5,1,0,11,1,0,1,174,1
"org.apache.jackrabbit.test.api.query.qom.QueryObjectModelFactoryTest",50,0.03,1.04,298,4.38,82971.59,57,7,39,150,2,140.18,151,361,1,6,119.56,0.00,0.83,0.17,0,0.00,2,13147.38,0,0,1,org.apache.jackrabbit.test.api.query.qom.AbstractQOMTest,0.00,100,5,52,0,100,50,0,50,2727,1
"org.apache.jackrabbit.test.api.query.qom.RowTest",10,0.17,1.00,45,0.58,8765.25,12,2,7,33,2,125.37,5,60,1,6,125.37,0.00,0.83,0.35,1,2.00,1,1729.75,1,1,1,org.apache.jackrabbit.test.api.query.qom.AbstractQOMTest,0.10,23,5,10,0,23,9,0,3,383,1
"org.apache.jackrabbit.test.api.query.qom.SameNodeJoinConditionTest",8,0.43,1.12,34,0.61,12063.26,10,2,5,15,2,123.49,5,66,1,7,123.49,0.00,0.86,0.88,1,0.00,2,1844.65,4,1,1,org.apache.jackrabbit.test.api.query.qom.AbstractJoinTest,0.11,7,6,9,0,7,7,0,2,389,1
"org.apache.jackrabbit.test.api.query.qom.SameNodeTest",6,0.00,2.33,50,0.87,21648.57,6,0,9,23,3,159.11,10,84,1,6,109.11,0.00,0.83,0.00,0,0.00,3,2595.48,1,0,2,org.apache.jackrabbit.test.api.query.qom.AbstractQOMTest,0.00,17,5,14,0,17,6,0,8,490,1
"org.apache.jackrabbit.test.api.query.qom.SelectorTest",4,0.00,3.00,43,0.56,14297.26,4,0,9,18,2,145.35,10,69,1,6,105.46,0.00,0.83,0.00,0,0.00,5,1683.29,1,0,1,org.apache.jackrabbit.test.api.query.qom.AbstractQOMTest,0.00,14,5,12,0,14,4,0,8,327,1
"org.apache.jackrabbit.test.api.query.qom.SelectorTest$Callable",1,0.00,2.00,11,0.13,2582.00,1,0,9,9,0,105.13,0,13,0,1,105.13,0.00,0.00,0.00,0,1.00,2,393.50,0,1,0,java.lang.Object,0.00,8,0,2,0,8,0,0,0,78,0
"org.apache.jackrabbit.test.api.query.qom.TestAll",1,0.00,1.00,28,0.37,15077.10,1,0,3,3,25,84.35,4,30,1,2,84.11,0.00,0.50,0.00,0,1.00,1,1120.16,0,1,24,junit.framework.TestCase,0.00,2,1,1,0,2,0,0,1,215,1
"org.apache.jackrabbit.test.api.query.qom.UpperLowerCaseTest",12,0.55,1.25,63,1.29,35903.69,13,1,7,36,2,167.50,17,134,1,6,117.50,0.00,0.83,0.50,2,0.00,3,3859.86,4,1,1,org.apache.jackrabbit.test.api.query.qom.AbstractQOMTest,0.19,24,5,15,0,24,11,0,14,791,1
"org.apache.jackrabbit.api.security.principal.ItemBasedPrincipal",1,0.00,1.00,2,0.01,59.45,1,0,1,1,13,135.44,15,3,13,2,145.80,0.00,0.50,0.00,0,1.00,1,33.60,0,1,0,,0.00,0,1,1,0,0,0,0,2,13,1
"org.apache.jackrabbit.api.security.principal.JackrabbitPrincipal",0,0.00,0.00,1,0.01,31.02,0,0,1,0,2,171.00,4,2,2,2,171.00,0.00,0.50,0.00,0,0.00,0,15.51,0,0,0,,0.00,0,1,0,0,0,0,0,1,6,1
"org.apache.jackrabbit.api.security.principal.PrincipalIterator",1,0.00,1.00,2,0.01,44.19,1,0,2,1,23,98.71,8,3,23,2,146.81,0.00,0.50,0.00,0,1.00,1,26.09,0,1,0,,0.00,0,1,1,0,0,0,0,2,11,1
"org.apache.jackrabbit.api.security.principal.PrincipalManager",7,3.00,1.00,11,0.06,375.52,10,3,2,7,23,147.02,111,12,22,1,157.38,0.00,0.00,0.00,0,7.00,1,194.66,0,2,1,,0.00,0,0,7,0,0,5,0,11,65,1
"org.apache.jackrabbit.api.security.principal.PrincipalManagerTest",20,0.11,3.05,184,2.30,78991.35,22,2,11,54,7,106.83,13,235,1,4,106.83,0.00,0.75,0.60,3,0.00,7,6908.94,2,1,6,org.apache.jackrabbit.test.AbstractJCRTest,0.09,34,3,61,0,34,19,0,11,1397,1
"org.apache.jackrabbit.api.security.principal.TestAll",1,0.00,1.00,5,0.04,864.35,1,0,3,3,1,79.51,7,7,0,2,121.80,0.00,0.50,0.00,0,1.00,1,115.51,0,1,1,junit.framework.TestCase,0.00,2,1,1,0,2,0,0,1,31,1
"org.apache.jackrabbit.core.fs.db.DB2FileSystem",2,0.00,1.00,8,0.10,1519.98,2,0,0,2,1,152.14,39,25,0,3,125.86,0.00,0.67,0.00,0,2.00,1,299.65,1,0,1,org.apache.jackrabbit.core.fs.db.DbFileSystem,0.06,0,2,2,0,0,2,0,5,72,1
"org.apache.jackrabbit.core.fs.db.DatabaseFileSystem",32,0.08,2.88,368,4.85,204877.22,57,25,26,70,13,102.17,145,566,3,1,101.94,0.00,0.00,0.12,9,0.00,6,14535.75,0,10,10,java.lang.Object,0.00,38,0,92,7,38,22,1,53,2640,2
"org.apache.jackrabbit.core.fs.db.DatabaseFileSystem$FileOutputStream",2,0.00,2.50,25,0.37,20151.48,2,0,26,18,1,99.01,1,48,0,1,99.01,0.00,0.00,0.00,0,2.00,4,1120.65,0,0,1,java.lang.Object,0.00,16,0,5,0,16,2,0,1,207,0
"org.apache.jackrabbit.core.fs.db.DatabaseFileSystem$FilterInputStream",1,0.00,1.00,4,0.03,275.53,1,0,26,2,1,179.33,1,5,0,1,129.33,0.00,0.00,0.00,0,1.00,1,76.14,1,0,1,java.lang.Object,0.00,1,0,1,0,1,1,0,1,23,0
"org.apache.jackrabbit.core.fs.db.DbFileSystem",14,0.04,1.64,47,0.52,22344.49,20,6,3,19,8,79.76,119,72,5,2,127.86,5.00,0.14,0.13,2,78.00,8,1568.02,2,6,3,org.apache.jackrabbit.core.fs.db.DatabaseFileSystem,0.09,5,1,23,5,5,8,1,13,362,1
"org.apache.jackrabbit.core.fs.db.DerbyFileSystem",5,0.50,1.40,19,0.15,2459.21,6,1,7,8,5,81.93,45,30,1,3,131.93,0.00,0.67,0.60,0,2.00,3,452.70,1,1,4,org.apache.jackrabbit.core.fs.db.DbFileSystem,0.06,3,2,7,0,3,4,0,8,113,1
"org.apache.jackrabbit.core.fs.db.DerbyFileSystemTest",3,0.75,1.00,17,0.14,2018.73,5,2,5,12,5,172.66,3,21,1,3,122.66,0.00,0.67,1.00,0,0.00,1,432.47,2,1,4,org.apache.jackrabbit.core.fs.AbstractFileSystemTest,1.00,9,2,3,0,9,2,0,1,105,1
"org.apache.jackrabbit.core.fs.db.JNDIDatabaseFileSystem",3,0.50,1.00,9,0.07,1171.64,4,1,2,5,1,88.67,34,14,0,2,132.79,0.00,0.50,0.67,0,1.00,1,213.93,0,2,1,org.apache.jackrabbit.core.fs.db.DatabaseFileSystem,0.06,2,1,3,0,2,1,0,7,58,1
"org.apache.jackrabbit.core.fs.db.MSSqlFileSystem",4,0.33,1.25,15,0.14,2647.89,6,2,1,7,2,93.37,48,23,0,3,130.94,0.00,0.67,0.25,0,6.00,2,408.24,1,2,2,org.apache.jackrabbit.core.fs.db.DbFileSystem,0.06,3,2,5,0,3,2,0,8,102,1
"org.apache.jackrabbit.core.fs.db.Oracle9FileSystem",1,0.00,1.00,5,0.05,971.04,1,0,3,3,3,89.18,6,8,0,4,121.40,0.00,0.75,0.00,0,1.00,1,140.85,0,1,3,org.apache.jackrabbit.core.fs.db.OracleFileSystem,0.00,2,3,1,0,2,0,0,2,35,1
"org.apache.jackrabbit.core.fs.db.OracleFileSystem",6,0.80,1.17,39,0.63,11916.59,7,1,4,11,5,71.84,68,105,1,3,115.97,0.50,0.50,0.33,0,14.00,2,1888.31,1,3,4,org.apache.jackrabbit.core.fs.db.DbFileSystem,0.12,5,2,7,1,5,3,0,11,360,1
"org.apache.jackrabbit.core.xml.AccessControlImporter",14,0.13,4.93,209,2.98,185643.29,28,14,32,71,15,135.30,39,279,1,3,95.42,0.00,0.67,0.19,6,26.00,19,8946.66,1,1,14,org.apache.jackrabbit.core.xml.DefaultProtectedNodeImporter,0.12,57,2,69,0,57,13,0,30,1538,1
"org.apache.jackrabbit.core.xml.AccessControlImporterTest",14,0.09,2.79,258,5.05,201330.02,22,8,31,80,20,111.81,53,431,1,4,91.20,0.00,0.75,0.21,2,0.00,9,15160.38,1,2,19,org.apache.jackrabbit.test.AbstractJCRTest,0.10,66,3,39,0,66,12,0,15,2518,1
"org.apache.jackrabbit.core.xml.AccessControlImporterTest$PseudoConfig",2,1.00,1.00,6,0.05,763.40,3,1,31,3,2,132.87,0,10,0,2,132.87,0.00,0.50,0.50,0,2.00,1,163.12,0,1,2,org.apache.jackrabbit.core.config.ImportConfig,0.40,1,1,2,0,1,1,0,0,44,2
"org.apache.jackrabbit.core.xml.BufferedStringValue",12,0.19,2.83,123,1.42,53846.27,21,9,27,47,9,56.59,102,167,2,1,104.70,0.00,0.00,0.29,5,18.00,5,4254.56,0,6,7,java.lang.Object,0.00,35,0,34,0,35,6,1,42,827,0
"org.apache.jackrabbit.core.xml.BufferedStringValue$Base64ReaderInputStream",3,0.71,2.00,29,0.27,5837.17,10,7,27,8,1,109.34,0,36,0,2,109.34,0.00,0.50,0.62,1,0.00,3,816.91,0,0,1,java.io.InputStream,0.00,5,1,6,0,5,3,0,0,176,2
"org.apache.jackrabbit.core.xml.ClonedInputSource",7,0.08,3.43,69,0.75,36907.08,9,2,9,34,6,145.70,17,101,6,2,105.81,0.00,0.50,0.43,0,7.00,7,2261.97,0,1,0,org.xml.sax.InputSource,0.00,27,1,24,0,27,6,0,3,450,1
"org.apache.jackrabbit.core.xml.DefaultProtectedItemImporter",11,5.00,1.00,27,0.24,2978.42,16,5,8,11,13,140.85,54,39,3,1,140.61,0.00,0.00,0.00,0,11.00,1,715.09,0,0,10,java.lang.Object,0.00,0,0,11,3,0,11,2,14,186,1
"org.apache.jackrabbit.core.xml.DefaultProtectedNodeImporter",1,0.00,1.00,3,0.01,67.21,1,0,0,1,2,159.43,3,5,1,2,138.81,1.00,0.33,0.00,0,1.00,1,33.60,0,0,1,org.apache.jackrabbit.core.xml.DefaultProtectedItemImporter,0.00,0,1,1,1,0,1,0,1,13,1
"org.apache.jackrabbit.core.xml.DefaultProtectedPropertyImporter",1,5.00,1.00,8,0.05,423.99,6,5,3,1,4,137.24,3,10,0,2,116.62,0.00,0.50,0.00,0,1.00,1,147.36,0,0,4,org.apache.jackrabbit.core.xml.DefaultProtectedItemImporter,0.00,0,1,1,0,0,1,0,1,38,1
"org.apache.jackrabbit.core.xml.DocViewImportHandler",9,0.08,3.56,110,1.66,89298.92,12,3,22,49,16,61.42,111,160,1,3,98.98,0.00,0.67,0.26,2,15.00,10,4971.84,0,2,15,org.apache.jackrabbit.core.xml.TargetImportHandler,0.00,40,2,32,0,40,7,0,47,880,0
"org.apache.jackrabbit.core.xml.DocumentViewTest",4,0.00,1.75,33,0.52,12288.99,4,0,14,27,4,61.62,33,55,1,4,109.72,0.00,0.75,0.00,0,0.00,2,1564.51,2,0,3,org.apache.jackrabbit.test.AbstractJCRTest,0.27,23,3,7,0,23,4,0,8,289,1
"org.apache.jackrabbit.core.xml.ImportHandler",10,0.05,1.40,45,0.58,11493.46,17,7,13,33,10,82.07,71,71,4,2,124.36,0.00,0.50,0.19,0,38.00,3,1739.64,0,0,6,org.xml.sax.helpers.DefaultHandler,0.00,23,1,14,0,23,10,0,22,390,1
"org.apache.jackrabbit.core.xml.Importer",4,0.00,1.00,5,0.04,217.79,4,0,2,4,8,108.85,40,7,7,1,157.33,0.00,0.00,0.00,0,4.00,1,113.13,0,0,1,,0.00,0,0,4,0,0,4,0,5,38,1
"org.apache.jackrabbit.core.xml.NamespaceContext",4,0.11,2.25,30,0.36,13992.33,7,3,4,10,3,67.26,47,39,2,1,111.38,0.00,0.00,0.25,0,8.00,3,1072.50,0,3,1,java.lang.Object,0.00,6,0,9,0,6,1,1,9,235,0
"org.apache.jackrabbit.core.xml.NodeInfo",5,0.06,1.00,18,0.12,2090.55,9,4,2,5,11,82.56,49,25,9,1,132.56,0.00,0.00,0.20,0,17.00,1,355.50,0,4,2,java.lang.Object,0.00,0,0,5,0,0,1,0,10,99,1
"org.apache.jackrabbit.core.xml.PropInfo",9,0.03,1.89,52,0.47,12744.62,13,4,10,13,15,120.20,44,66,8,1,119.97,0.00,0.00,0.28,0,26.00,4,1421.97,0,3,7,java.lang.Object,0.00,4,0,17,0,4,6,0,11,329,1
"org.apache.jackrabbit.core.xml.PropInfo$MultipleStatus",0,0.00,0.00,2,0.01,29.48,0,0,10,0,0,171.00,0,1,0,1,171.00,0.00,0.00,0.00,0,0.00,0,19.65,0,0,0,java.lang.Object,0.00,0,0,0,0,0,0,0,0,7,1
"org.apache.jackrabbit.core.xml.ProtectedItemImporter",2,0.00,1.00,3,0.03,94.78,2,0,4,2,7,109.33,20,6,4,1,157.80,0.00,0.00,0.00,0,2.00,1,77.32,0,0,3,,0.00,0,0,2,0,0,2,0,3,25,1
"org.apache.jackrabbit.core.xml.ProtectedNodeImporter",6,0.00,1.00,7,0.07,391.21,6,0,5,6,9,165.84,104,13,6,2,156.71,0.00,0.50,0.00,0,6.00,1,215.71,0,0,3,,0.00,0,1,6,0,0,6,0,7,66,1
"org.apache.jackrabbit.core.xml.ProtectedPropertyImporter",2,0.00,1.00,3,0.03,165.25,2,0,7,2,10,135.76,29,8,3,2,155.90,0.00,0.50,0.00,0,2.00,1,104.13,0,0,7,,0.00,0,1,2,0,0,2,0,3,31,1
"org.apache.jackrabbit.core.xml.SessionImporter",10,0.12,6.30,205,3.08,237969.97,18,8,26,89,18,58.20,132,284,3,1,87.58,0.00,0.00,0.24,2,6.00,21,9253.47,0,2,16,java.lang.Object,0.00,79,0,63,0,79,8,1,74,1561,1
"org.apache.jackrabbit.core.xml.StringValue",4,0.22,1.75,24,0.30,8089.87,7,3,12,12,7,83.59,25,38,1,1,115.81,0.00,0.00,0.50,0,4.00,3,904.01,0,2,6,java.lang.Object,0.00,8,0,7,0,8,2,1,16,191,0
"org.apache.jackrabbit.core.xml.SysViewImportHandler",7,0.19,7.00,133,2.30,158724.63,13,6,17,44,12,40.08,71,206,1,3,88.55,0.00,0.67,0.33,2,8.00,18,6886.16,0,1,11,org.apache.jackrabbit.core.xml.TargetImportHandler,0.00,37,2,49,0,37,6,0,42,1133,0
"org.apache.jackrabbit.core.xml.SysViewImportHandler$ImportState",0,0.00,0.00,7,0.06,941.98,6,6,17,1,2,171.00,18,8,0,1,171.00,0.00,0.00,0.00,0,0.00,0,180.09,0,0,2,java.lang.Object,0.00,1,0,0,0,1,0,0,6,41,0
"org.apache.jackrabbit.core.xml.TargetImportHandler",5,0.06,1.40,22,0.18,2923.57,9,4,7,11,7,84.38,39,32,3,2,126.68,2.00,0.25,0.30,0,1.00,2,548.50,0,0,4,org.xml.sax.helpers.DefaultHandler,0.00,6,1,7,2,6,5,0,6,138,1
"org.apache.jackrabbit.core.xml.TestAll",1,0.00,1.00,6,0.05,1283.53,1,0,3,3,2,67.50,9,8,0,2,117.50,0.00,0.50,0.00,0,1.00,1,150.40,0,1,2,junit.framework.TestCase,0.00,2,1,1,0,2,0,0,2,39,1
"org.apache.jackrabbit.core.xml.TextValue",3,0.00,1.00,4,0.03,122.87,3,0,5,3,9,178.92,9,7,7,1,158.30,0.00,0.00,0.00,0,3.00,1,84.58,0,2,2,,0.00,0,0,3,0,0,1,0,2,29,1
"org.apache.jackrabbit.core.xml.WorkspaceImporter",10,0.29,6.40,277,4.70,416573.09,21,11,37,104,27,124.74,221,421,1,1,80.80,0.00,0.00,0.35,3,0.00,16,14102.28,0,1,27,java.lang.Object,0.00,94,0,64,0,94,9,1,131,2252,1
"org.apache.jackrabbit.core.xml.WorkspaceImporterTest",3,0.00,1.67,20,0.36,7556.23,4,1,7,19,2,135.69,9,53,0,4,115.07,0.00,0.75,1.00,0,0.00,3,1085.34,2,0,2,org.apache.jackrabbit.test.AbstractJCRTest,0.28,16,3,5,0,16,3,0,2,205,1
"org.apache.jackrabbit.spi.commons.nodetype.AbstractItemDefinitionTemplate",13,0.00,1.38,54,0.47,9546.10,20,7,11,27,5,108.03,68,74,2,1,125.90,0.00,0.00,0.14,1,66.00,3,1416.71,0,2,3,java.lang.Object,0.00,14,0,18,2,14,11,1,20,330,1
"org.apache.jackrabbit.spi.commons.nodetype.AbstractNodeType",16,0.13,2.12,108,1.09,38420.23,20,4,17,43,10,97.31,88,137,2,1,115.18,0.00,0.00,0.38,3,0.00,8,3271.19,0,10,8,java.lang.Object,0.00,27,0,34,2,27,6,1,29,695,2
"org.apache.jackrabbit.spi.commons.nodetype.AbstractNodeTypeManager",10,0.00,1.00,18,0.19,2416.11,10,0,15,16,13,134.36,51,31,6,1,152.23,0.00,0.00,0.00,1,10.00,1,557.11,0,9,7,java.lang.Object,0.00,6,0,10,2,6,1,1,12,151,2
"org.apache.jackrabbit.spi.commons.nodetype.InvalidConstraintException",2,0.00,1.00,5,0.03,221.18,2,0,1,2,14,93.68,18,8,14,2,143.68,0.00,0.50,0.00,0,2.00,1,88.69,0,0,0,javax.jcr.RepositoryException,0.00,0,1,2,0,0,2,0,3,29,1
"org.apache.jackrabbit.spi.commons.nodetype.ItemDefinitionImpl",10,0.07,1.60,44,0.39,7650.05,15,5,8,24,6,93.50,66,64,3,1,125.73,0.00,0.00,0.26,0,0.00,3,1156.90,0,2,3,java.lang.Object,0.00,14,0,16,2,14,8,1,22,280,1
"org.apache.jackrabbit.spi.commons.nodetype.NodeDefinitionImpl",8,0.57,2.50,60,0.66,28754.85,9,1,11,14,18,79.04,53,79,11,2,111.27,0.00,0.50,0.50,0,0.00,5,1981.83,0,5,7,org.apache.jackrabbit.spi.commons.nodetype.ItemDefinitionImpl,0.00,6,1,20,0,6,3,1,19,410,1
"org.apache.jackrabbit.spi.commons.nodetype.NodeDefinitionTemplateImpl",10,0.04,2.10,67,0.67,23545.19,15,5,11,22,8,115.49,44,89,3,2,115.25,0.00,0.50,0.24,2,22.00,4,1999.74,0,4,5,org.apache.jackrabbit.spi.commons.nodetype.AbstractItemDefinitionTemplate,0.00,12,1,21,0,12,6,1,15,424,0
"org.apache.jackrabbit.spi.commons.nodetype.NodeDefinitionTemplateImplTest",2,0.00,2.00,13,0.13,2341.30,3,1,5,7,5,138.27,6,21,1,2,117.65,0.00,0.50,1.00,0,0.00,3,376.89,1,0,4,junit.framework.TestCase,0.00,5,1,4,0,5,2,0,4,89,1
"org.apache.jackrabbit.spi.commons.nodetype.NodeTypeConflictException",2,0.00,1.00,5,0.03,221.18,2,0,1,2,0,93.68,18,8,0,2,143.68,0.00,0.50,0.00,0,2.00,1,88.69,0,0,0,javax.jcr.RepositoryException,0.00,0,1,2,0,0,2,0,3,29,1
"org.apache.jackrabbit.spi.commons.nodetype.NodeTypeDefDiff",15,0.19,3.00,152,1.75,82014.76,23,8,16,51,10,55.91,129,185,3,1,104.01,0.00,0.00,0.30,3,0.00,7,5251.11,0,4,7,java.lang.Object,0.00,36,0,45,0,36,11,0,33,1052,1
"org.apache.jackrabbit.spi.commons.nodetype.NodeTypeDefDiff$ChildItemDefDiff",7,0.28,2.57,51,0.47,15513.24,10,3,16,15,1,152.80,14,72,0,1,112.91,0.00,0.00,0.57,5,0.00,8,1398.64,0,1,1,java.lang.Object,0.00,8,0,18,0,8,6,0,11,311,1
"org.apache.jackrabbit.spi.commons.nodetype.NodeTypeDefDiff$ChildNodeDefDiff",4,0.00,2.25,22,0.24,10015.28,4,0,16,10,2,138.59,13,33,0,2,117.98,0.00,0.50,0.00,2,10.00,6,733.35,1,2,2,org.apache.jackrabbit.spi.commons.nodetype.ChildItemDefDiff,0.00,6,1,9,0,6,2,0,8,157,1
"org.apache.jackrabbit.spi.commons.nodetype.NodeTypeDefDiff$PropDefDiff",4,0.00,3.50,40,0.45,28603.34,4,0,16,14,2,85.18,22,54,0,2,103.06,0.00,0.50,0.00,2,10.00,11,1339.89,1,2,2,org.apache.jackrabbit.spi.commons.nodetype.ChildItemDefDiff,0.00,10,1,14,0,10,2,0,17,252,1
"org.apache.jackrabbit.spi.commons.nodetype.NodeTypeDefDiff$QNodeDefinitionId",3,1.00,2.33,28,0.31,11280.31,6,3,16,10,3,107.06,1,37,0,1,107.06,0.00,0.00,1.00,0,0.00,3,918.21,0,0,3,java.lang.Object,0.00,7,0,7,0,7,3,0,1,200,1
"org.apache.jackrabbit.spi.commons.nodetype.NodeTypeDefDiff$QPropertyDefinitionId",3,1.20,2.33,27,0.31,10521.04,8,5,16,10,2,107.29,1,39,0,1,107.29,0.00,0.00,1.00,0,0.00,3,919.71,0,0,2,java.lang.Object,0.00,7,0,7,0,7,3,0,1,207,1
"org.apache.jackrabbit.spi.commons.nodetype.NodeTypeDefinitionFactory",9,0.12,2.11,91,1.20,35990.36,11,2,24,81,11,105.40,41,106,0,1,105.16,0.00,0.00,0.39,5,22.00,3,3586.92,0,8,11,java.lang.Object,0.00,72,0,19,0,72,1,0,6,705,1
"org.apache.jackrabbit.spi.commons.nodetype.NodeTypeDefinitionImpl",10,0.22,1.70,61,0.60,17730.70,14,4,12,26,9,116.50,43,74,2,1,116.27,0.00,0.00,0.45,0,0.00,3,1807.75,0,5,7,java.lang.Object,0.00,16,0,17,0,16,5,1,16,402,1
"org.apache.jackrabbit.spi.commons.nodetype.NodeTypeStorage",4,0.00,1.00,5,0.06,513.62,4,0,6,4,7,106.29,35,7,5,1,154.40,0.00,0.00,0.00,0,4.00,1,180.68,0,2,2,,0.00,0,0,4,0,0,2,0,5,52,1
"org.apache.jackrabbit.spi.commons.nodetype.NodeTypeStorageImpl",4,0.00,3.75,35,0.48,19095.61,5,1,10,22,4,147.92,9,49,1,1,108.04,0.00,0.00,1.00,0,0.00,6,1431.01,0,2,3,java.lang.Object,0.00,18,0,15,0,18,2,1,2,284,1
"org.apache.jackrabbit.spi.commons.nodetype.NodeTypeTemplateImpl",20,0.06,2.05,127,1.23,38748.46,31,11,16,44,7,136.54,73,168,1,1,115.92,0.00,0.00,0.15,5,198.00,6,3704.49,0,7,6,java.lang.Object,0.00,24,0,41,0,24,13,1,28,774,1
"org.apache.jackrabbit.spi.commons.nodetype.PropertyDefinitionImpl",10,0.39,1.70,52,0.62,25614.68,12,2,12,25,21,100.09,51,69,12,2,117.96,0.00,0.50,0.15,0,0.00,5,1852.78,1,4,9,org.apache.jackrabbit.spi.commons.nodetype.ItemDefinitionImpl,0.00,15,1,17,0,15,6,1,14,388,1
"org.apache.jackrabbit.spi.commons.nodetype.PropertyDefinitionTemplateImpl",16,0.04,1.00,52,0.38,4332.23,23,7,7,25,6,134.28,64,70,3,2,134.05,0.00,0.50,0.18,1,104.00,1,1134.15,0,3,3,org.apache.jackrabbit.spi.commons.nodetype.AbstractItemDefinitionTemplate,0.00,9,1,16,0,9,13,1,22,291,0
"org.apache.jackrabbit.spi.commons.nodetype.PropertyDefinitionTemplateImplTest",3,0.00,2.33,20,0.19,3780.88,4,1,5,9,5,157.25,8,33,1,2,117.36,0.00,0.50,1.00,0,0.00,3,578.94,1,0,4,junit.framework.TestCase,0.00,6,1,7,0,6,3,0,6,135,1
"org.apache.jackrabbit.spi.commons.nodetype.QDefinitionBuilderFactory",5,0.06,1.20,31,0.42,10439.53,9,4,22,15,23,155.67,14,47,5,2,115.79,0.00,0.50,0.20,0,10.00,2,1263.79,0,2,18,org.apache.jackrabbit.commons.cnd.DefinitionBuilderFactory,0.44,10,1,6,0,10,3,0,3,275,1
"org.apache.jackrabbit.spi.commons.nodetype.QDefinitionBuilderFactory$QNodeDefinitionBuilderImpl",11,0.00,1.09,35,0.38,6413.19,13,2,22,25,4,131.40,0,64,0,2,131.40,0.00,0.50,0.50,0,0.00,2,1143.49,6,0,4,org.apache.jackrabbit.commons.cnd.AbstractNodeDefinitionBuilder,0.00,14,1,12,0,14,11,0,0,286,1
"org.apache.jackrabbit.spi.commons.nodetype.QDefinitionBuilderFactory$QNodeTypeDefinitionBuilderImpl",6,0.04,1.00,19,0.33,6970.47,11,5,22,14,6,129.07,0,42,0,2,129.07,0.00,0.50,0.23,0,10.00,1,1004.47,1,1,6,org.apache.jackrabbit.commons.cnd.AbstractNodeTypeDefinitionBuilder,0.00,8,1,6,0,8,5,0,0,228,1
"org.apache.jackrabbit.spi.commons.nodetype.QDefinitionBuilderFactory$QPropertyDefinitionBuilderImpl",15,0.00,1.07,47,0.53,8940.71,17,2,22,37,8,131.33,0,86,0,2,131.33,0.00,0.50,0.50,0,0.00,2,1600.15,10,0,8,org.apache.jackrabbit.commons.cnd.AbstractPropertyDefinitionBuilder,0.00,22,1,16,0,22,15,0,0,397,1
"org.apache.jackrabbit.spi.commons.nodetype.QItemDefinitionBuilder",12,0.05,1.00,31,0.21,2483.15,18,6,5,12,6,141.77,57,44,3,1,141.53,0.00,0.00,0.12,0,90.00,1,622.37,0,2,3,java.lang.Object,0.00,0,0,12,2,0,10,0,13,171,2
"org.apache.jackrabbit.spi.commons.nodetype.QNodeDefinitionBuilder",8,0.05,1.25,25,0.23,3610.84,11,3,7,17,10,114.37,41,39,5,2,132.25,0.00,0.50,0.29,0,30.00,2,704.91,1,3,5,org.apache.jackrabbit.spi.commons.nodetype.QItemDefinitionBuilder,0.00,9,1,10,0,9,5,0,9,178,1
"org.apache.jackrabbit.spi.commons.nodetype.QNodeTypeDefinitionBuilder",21,0.04,1.14,65,0.66,13512.51,31,10,10,29,10,113.18,110,94,4,1,131.06,0.00,0.00,0.07,1,271.00,2,1967.70,0,7,6,java.lang.Object,0.00,8,0,24,0,8,14,0,22,483,1
"org.apache.jackrabbit.spi.commons.nodetype.QPropertyDefinitionBuilder",17,0.04,1.18,51,0.49,9214.59,24,7,10,26,10,113.76,85,72,4,2,131.64,0.00,0.50,0.10,0,169.00,2,1477.78,1,4,6,org.apache.jackrabbit.spi.commons.nodetype.QItemDefinitionBuilder,0.00,9,1,20,0,9,13,0,19,360,1
"org.apache.jackrabbit.spi.commons.nodetype.TestAll",1,0.00,1.00,6,0.05,1283.53,1,0,3,3,2,75.20,7,8,0,2,117.50,0.00,0.50,0.00,0,1.00,1,150.40,0,1,2,junit.framework.TestCase,0.00,2,1,1,0,2,0,0,2,39,1
"org.apache.jackrabbit.rmi.remote.principal.RemoteGroup",2,0.00,1.00,3,0.02,95.45,2,0,2,2,3,120.22,25,4,2,2,157.78,0.00,0.50,0.00,0,2.00,1,57.60,0,1,1,,0.00,0,1,2,0,0,1,0,3,21,1
"org.apache.jackrabbit.rmi.remote.principal.RemotePrincipal",1,0.00,1.00,2,0.01,70.32,1,0,2,1,11,192.49,23,3,11,2,145.23,0.00,0.50,0.00,0,1.00,1,35.16,0,1,0,,0.00,0,1,1,0,0,0,0,2,13,1
"org.apache.jackrabbit.core.util.CooperativeFileLock",13,0.12,3.31,141,1.53,52313.26,26,13,11,46,2,105.27,58,187,1,1,105.04,0.00,0.00,0.19,9,0.00,7,4580.76,0,3,1,java.lang.Object,0.00,33,0,43,0,33,10,1,17,884,1
"org.apache.jackrabbit.core.util.CooperativeFileLock$Runnable",1,0.00,8.00,12,0.16,5550.63,1,0,11,6,0,101.02,4,22,0,1,100.78,0.00,0.00,0.00,0,0.00,8,478.46,0,0,0,java.lang.Object,0.00,5,0,8,0,5,1,0,4,95,0
"org.apache.jackrabbit.core.util.CooperativeFileLockTest",3,0.50,1.67,24,0.21,6779.28,4,1,5,11,2,160.78,4,28,1,2,110.78,0.00,0.50,0.67,1,1.00,3,628.94,0,0,1,junit.framework.TestCase,0.00,8,1,5,0,8,3,0,2,136,1
"org.apache.jackrabbit.core.util.DOMBuilder",8,0.11,1.25,36,0.38,7677.59,12,4,13,26,1,82.72,62,51,1,1,125.01,0.00,0.00,0.34,4,0.00,3,1142.07,0,0,0,java.lang.Object,0.00,18,0,10,0,18,8,0,13,270,2
"org.apache.jackrabbit.core.util.DOMWalker",8,0.10,2.75,71,0.79,26083.43,11,3,12,38,3,60.94,85,90,3,1,109.41,0.00,0.00,0.42,0,0.00,6,2366.57,0,4,0,java.lang.Object,0.00,30,0,22,0,30,4,0,12,489,2
"org.apache.jackrabbit.core.util.DOMWalkerTest",1,0.00,3.00,6,0.07,1426.35,1,0,2,5,1,68.78,8,13,0,2,116.88,0.00,0.50,0.00,0,1.00,3,222.23,0,0,1,junit.framework.TestCase,0.00,4,1,3,0,4,1,0,3,49,1
"org.apache.jackrabbit.core.util.Dumpable",1,0.00,1.00,2,0.01,30.51,1,0,1,1,6,110.52,12,3,6,1,148.08,0.00,0.00,0.00,0,1.00,1,25.51,0,0,0,,0.00,0,0,1,0,0,1,0,2,11,1
"org.apache.jackrabbit.core.util.EmptyLinkedMap",11,0.45,1.00,25,0.16,2052.94,13,2,5,13,1,142.12,48,37,1,2,141.89,0.00,0.50,0.09,0,25.00,1,481.36,0,8,0,org.apache.commons.collections.map.LinkedMap,0.00,2,1,11,0,2,3,0,14,140,1
"org.apache.jackrabbit.core.util.ReferenceChangeTracker",6,0.10,1.00,16,0.16,2671.30,8,2,6,15,9,90.81,49,23,8,1,138.91,0.00,0.00,0.58,0,0.00,1,477.96,0,2,1,java.lang.Object,0.00,9,0,6,0,9,4,0,9,127,1
"org.apache.jackrabbit.core.util.RepositoryLock",7,0.31,3.00,60,0.74,24258.85,14,7,9,30,5,71.62,86,105,4,1,109.19,0.00,0.00,0.41,3,0.00,6,2234.83,0,0,1,java.lang.Object,0.00,23,0,21,0,23,7,1,27,443,1
"org.apache.jackrabbit.core.util.RepositoryLockMechanism",3,0.00,1.00,4,0.02,97.53,3,0,1,3,7,110.99,24,5,7,1,159.09,0.00,0.00,0.00,0,3.00,1,65.02,0,0,0,,0.00,0,0,3,0,0,3,0,4,25,1
"org.apache.jackrabbit.core.util.RepositoryLockMechanismFactory",1,0.00,1.00,2,0.01,38.26,1,0,1,1,3,156.44,17,3,2,1,147.31,0.00,0.00,0.00,0,1.00,1,25.51,0,0,1,,0.00,0,0,1,0,0,1,0,2,11,1
"org.apache.jackrabbit.core.util.RepositoryLockTest",6,0.20,1.67,42,0.41,10991.71,7,1,4,19,2,95.79,34,56,1,2,113.66,0.00,0.50,0.83,1,0.00,3,1242.39,0,0,1,junit.framework.TestCase,0.00,13,1,10,0,13,6,0,8,279,1
"org.apache.jackrabbit.core.util.StringIndex",2,0.00,1.00,3,0.02,87.00,2,0,0,2,10,109.62,21,4,10,1,158.10,0.00,0.00,0.00,0,2.00,1,58.00,0,1,0,,0.00,0,0,2,0,0,1,0,3,21,1
"org.apache.jackrabbit.core.util.TestAll",1,0.00,1.00,6,0.05,1283.53,1,0,3,3,2,69.39,8,8,0,2,117.50,0.00,0.50,0.00,0,1.00,1,150.40,0,1,2,junit.framework.TestCase,0.00,2,1,1,0,2,0,0,2,39,1
"org.apache.jackrabbit.core.util.TrackingInputStream",11,0.23,1.36,40,0.32,7877.35,14,3,2,18,5,130.88,47,56,5,2,130.65,0.00,0.50,0.55,0,0.00,2,948.04,0,0,0,java.io.InputStream,0.00,7,1,15,0,7,11,0,15,241,1
"org.apache.jackrabbit.standalone.cli.nodetype.RegisterNodeType",1,0.00,2.00,10,0.14,2960.25,3,2,9,9,2,56.20,9,13,0,1,106.20,0.00,0.00,1.00,0,0.00,2,428.00,0,0,2,java.lang.Object,0.00,8,0,2,0,8,1,1,3,89,1
"org.apache.jackrabbit.core.nodetype.xml.AdditionalNamespaceResolver",5,0.12,1.80,31,0.32,8555.78,7,2,6,13,5,98.50,27,41,4,1,116.38,0.00,0.00,0.40,1,6.00,2,949.71,0,2,1,java.lang.Object,0.00,8,0,9,0,8,3,1,8,218,1
"org.apache.jackrabbit.core.nodetype.xml.Constants",0,0.00,0.00,37,0.46,5130.13,36,36,0,0,2,171.00,32,38,2,1,171.00,0.00,0.00,0.00,0,0.00,0,1393.14,0,0,0,,0.00,0,0,0,0,0,0,0,30,221,1
"org.apache.jackrabbit.core.nodetype.xml.NodeTypeReader",7,0.23,5.29,141,3.00,215605.25,12,5,35,93,30,42.61,80,207,5,1,86.74,0.00,0.00,0.40,3,4.00,18,8998.69,0,6,25,java.lang.Object,0.00,86,0,37,0,86,1,0,21,1412,1
"org.apache.jackrabbit.core.nodetype.xml.NodeTypeWriter",6,0.33,5.50,130,2.28,130868.67,9,3,25,70,19,49.56,72,193,3,1,87.12,0.00,0.00,0.61,2,0.00,16,6848.56,0,0,16,java.lang.Object,0.00,64,0,33,0,64,6,0,21,1118,2
"org.apache.jackrabbit.core.nodetype.xml.SimpleNamespaceRegistry",7,0.08,1.14,24,0.26,4175.73,9,2,3,15,3,171.20,15,33,2,1,131.31,0.00,0.00,0.57,1,0.00,2,772.48,0,4,1,java.lang.Object,0.00,8,0,8,0,8,3,1,10,201,1
"org.apache.jackrabbit.core.nodetype.xml.TestAll",43,0.05,1.40,262,3.64,67848.55,52,9,30,100,22,156.60,106,440,1,4,116.71,0.00,0.75,0.06,3,489.00,4,10909.41,1,4,21,org.apache.jackrabbit.test.AbstractJCRTest,0.06,57,3,60,0,57,39,0,57,2231,1
"org.apache.jackrabbit.webdav.jcr.version.report.AbstractJcrReport",3,0.25,2.67,21,0.32,12839.56,5,2,9,10,15,78.43,19,30,7,1,110.65,0.00,0.00,0.67,0,0.00,6,951.12,0,2,8,java.lang.Object,0.00,7,0,8,7,7,1,1,5,183,2
"org.apache.jackrabbit.webdav.jcr.version.report.ExportViewReport",4,0.00,3.00,39,0.68,24655.25,8,4,24,28,11,67.75,49,55,1,2,105.31,0.00,0.50,0.25,0,6.00,7,2030.01,3,2,10,org.apache.jackrabbit.webdav.jcr.version.report.AbstractJcrReport,0.00,24,1,12,0,24,2,0,13,367,1
"org.apache.jackrabbit.webdav.jcr.version.report.JcrPrivilegeReport",5,0.05,1.80,34,0.57,16972.20,10,5,22,31,17,81.81,34,49,2,2,114.03,0.00,0.50,0.16,1,10.00,4,1704.21,2,2,15,org.apache.jackrabbit.webdav.jcr.version.report.AbstractJcrReport,0.00,26,1,9,0,26,3,0,12,328,1
"org.apache.jackrabbit.webdav.jcr.version.report.LocateByUuidReport",4,0.08,1.50,25,0.43,12757.16,8,4,18,26,16,64.29,38,34,3,2,114.29,0.00,0.50,0.19,0,6.00,3,1289.20,2,2,13,org.apache.jackrabbit.webdav.jcr.version.report.AbstractJcrReport,0.00,22,1,6,0,22,2,0,9,241,1
"org.apache.jackrabbit.webdav.jcr.version.report.LocateCorrespondingNodeReport",5,0.19,1.80,34,0.57,16951.71,9,4,21,28,15,69.91,56,46,1,2,114.04,0.00,0.50,0.10,0,11.00,3,1698.20,1,3,14,org.apache.jackrabbit.webdav.jcr.version.report.AbstractJcrReport,0.00,23,1,9,0,23,2,0,10,326,1
"org.apache.jackrabbit.webdav.jcr.version.report.NodeTypesReport",5,0.17,4.00,61,0.99,38964.39,8,3,25,42,15,70.40,65,78,2,2,99.78,0.00,0.50,0.20,0,13.00,8,2960.09,2,3,13,org.apache.jackrabbit.webdav.jcr.version.report.AbstractJcrReport,0.00,37,1,20,0,37,2,1,23,524,1
"org.apache.jackrabbit.webdav.jcr.version.report.RegisteredNamespacesReport",4,0.00,1.75,23,0.30,7604.45,7,3,14,14,11,74.85,46,33,2,2,118.98,0.00,0.50,0.33,0,6.00,3,902.89,1,2,9,org.apache.jackrabbit.webdav.jcr.version.report.AbstractJcrReport,0.00,10,1,7,0,10,2,1,8,189,1
"org.apache.jackrabbit.webdav.jcr.version.report.RepositoryDescriptorsReport",4,0.33,2.00,27,0.37,11625.27,6,2,15,15,10,76.98,51,36,2,2,114.54,0.00,0.50,0.25,0,8.00,5,1118.05,2,2,8,org.apache.jackrabbit.webdav.jcr.version.report.AbstractJcrReport,0.00,11,1,8,0,11,2,1,7,218,1
"org.apache.jackrabbit.standalone.cli.version.AddVersionLabel",9,0.10,1.11,31,0.36,7819.58,14,5,5,18,1,130.27,40,45,0,1,130.03,0.00,0.00,0.11,0,44.00,2,1087.47,0,4,1,java.lang.Object,0.00,9,0,10,0,9,5,1,16,242,1
"org.apache.jackrabbit.standalone.cli.version.Checkin",5,0.17,1.20,19,0.21,3661.17,8,3,6,13,1,151.22,17,26,0,1,130.60,0.00,0.00,0.20,0,14.00,2,615.17,0,2,1,java.lang.Object,0.00,8,0,6,0,8,3,1,8,141,1
"org.apache.jackrabbit.standalone.cli.version.Checkout",3,0.25,1.33,13,0.14,2488.53,5,2,5,9,1,107.62,16,18,0,1,125.49,0.00,0.00,0.33,0,5.00,2,424.03,0,1,1,java.lang.Object,0.00,6,0,4,0,6,2,1,7,98,1
"org.apache.jackrabbit.standalone.cli.version.Merge",7,0.12,1.14,25,0.29,6104.75,11,4,5,15,1,130.25,32,36,0,1,130.02,0.00,0.00,0.14,0,27.00,2,876.86,0,3,1,java.lang.Object,0.00,8,0,8,0,8,4,1,13,197,1
"org.apache.jackrabbit.standalone.cli.version.RemoveVersion",5,0.17,1.20,19,0.21,4178.32,8,3,5,12,1,130.39,24,27,0,1,130.15,0.00,0.00,0.20,0,14.00,2,643.92,0,2,1,java.lang.Object,0.00,7,0,6,0,7,3,1,10,147,1
"org.apache.jackrabbit.standalone.cli.version.RemoveVersionByLabel",5,0.17,1.20,21,0.25,4983.02,8,3,7,14,1,107.01,25,30,0,1,124.89,0.00,0.00,0.20,0,14.00,2,750.73,0,2,1,java.lang.Object,0.00,9,0,6,0,9,3,1,10,164,1
"org.apache.jackrabbit.standalone.cli.version.RemoveVersionLabel",5,0.17,1.20,19,0.21,4178.32,8,3,5,12,1,130.39,24,27,0,1,130.15,0.00,0.00,0.20,0,14.00,2,643.92,0,2,1,java.lang.Object,0.00,7,0,6,0,7,3,1,10,147,1
"org.apache.jackrabbit.standalone.cli.version.Restore",7,0.12,1.14,25,0.29,6078.98,11,4,5,15,1,130.27,32,36,0,1,130.03,0.00,0.00,0.14,0,27.00,2,878.49,0,3,1,java.lang.Object,0.00,8,0,8,0,8,4,1,13,197,1
"org.apache.jackrabbit.standalone.cli.version.RestoreByLabel",7,0.12,1.14,25,0.29,6078.98,11,4,5,15,1,130.27,33,37,0,1,130.03,0.00,0.00,0.14,0,27.00,2,878.49,0,3,1,java.lang.Object,0.00,8,0,8,0,8,4,1,13,197,1
"org.apache.jackrabbit.api.JackrabbitNode",1,0.00,1.00,2,0.01,51.00,1,0,1,1,2,96.33,9,3,2,1,146.32,0.00,0.00,0.00,0,1.00,1,34.00,0,0,0,,0.00,0,0,1,0,0,1,0,2,13,1
"org.apache.jackrabbit.api.JackrabbitNodeTest",2,0.33,3.50,32,0.40,15063.96,5,3,4,15,3,145.27,3,39,1,4,95.27,0.00,0.75,0.50,0,0.00,5,1204.93,1,0,2,org.apache.jackrabbit.test.AbstractJCRTest,0.14,13,3,7,0,13,2,0,1,235,1
"org.apache.jackrabbit.api.JackrabbitNodeTypeManager",3,2.00,1.00,6,0.06,429.53,5,2,7,3,7,132.44,45,9,7,2,142.79,0.00,0.50,0.00,0,3.00,1,170.55,0,2,0,,0.00,0,1,3,0,0,1,0,6,49,1
"org.apache.jackrabbit.api.JackrabbitRepository",1,0.00,1.00,2,0.01,44.19,1,0,1,1,11,126.67,14,3,11,2,146.81,0.00,0.50,0.00,0,1.00,1,26.09,0,0,0,,0.00,0,1,1,0,0,1,0,2,11,1
"org.apache.jackrabbit.api.JackrabbitRepositoryFactory",1,0.00,1.00,2,0.01,72.19,1,0,3,1,4,96.66,10,3,2,2,145.14,0.00,0.50,0.00,0,1.00,1,42.09,0,1,2,,0.00,0,1,1,0,0,0,0,2,15,1
"org.apache.jackrabbit.api.JackrabbitSession",2,0.00,1.00,3,0.02,108.19,2,0,6,2,30,119.79,25,4,28,2,157.35,0.00,0.50,0.00,0,2.00,1,66.09,0,2,2,,0.00,0,1,2,0,0,0,0,3,23,1
"org.apache.jackrabbit.api.JackrabbitValue",1,0.00,1.00,2,0.01,44.19,1,0,1,1,2,178.72,31,3,2,2,146.81,0.00,0.50,0.00,0,1.00,1,26.09,0,1,0,,0.00,0,1,1,0,0,0,0,2,11,1
"org.apache.jackrabbit.api.JackrabbitWorkspace",2,0.00,1.00,3,0.03,136.06,2,0,4,2,2,127.19,26,6,2,2,156.57,0.00,0.50,0.00,0,2.00,1,84.68,0,0,0,,0.00,0,1,2,0,0,2,0,3,27,1
"org.apache.jackrabbit.api.TestAll",1,0.00,1.00,5,0.04,864.35,1,0,3,3,2,73.32,10,7,0,4,121.80,0.00,0.75,0.00,0,1.00,1,115.51,0,1,2,org.apache.jackrabbit.test.AbstractJCRTest,0.00,2,3,1,0,2,0,0,2,31,1
"org.apache.jackrabbit.api.XASession",1,0.00,1.00,2,0.01,44.19,1,0,2,1,3,190.76,22,3,3,2,146.81,0.00,0.50,0.00,0,1.00,1,26.09,0,1,0,,0.00,0,1,1,0,0,0,0,2,11,1
"org.apache.jackrabbit.commons.cnd.CndImporter",4,0.00,2.00,28,0.50,25641.94,4,0,18,23,9,71.78,49,47,5,1,109.34,0.00,0.00,0.00,2,4.00,4,1501.30,0,3,4,java.lang.Object,0.00,19,0,8,0,19,1,0,4,280,2
"org.apache.jackrabbit.commons.cnd.CompactNodeTypeDefReader",25,0.19,4.84,330,4.56,220625.88,29,4,10,101,9,48.01,245,435,6,1,98.01,0.00,0.00,0.43,17,0.00,17,13694.73,0,2,3,java.lang.Object,0.00,76,0,121,0,76,23,0,30,2491,1
"org.apache.jackrabbit.commons.cnd.DefinitionBuilderFactory",4,0.00,1.00,9,0.11,2175.11,4,0,6,4,3,88.23,39,11,3,1,138.23,0.00,0.00,0.00,0,4.00,1,333.96,0,0,0,java.lang.Object,0.00,0,0,4,2,0,4,0,9,92,2
"org.apache.jackrabbit.commons.cnd.DefinitionBuilderFactory$AbstractItemDefinitionBuilder",8,0.20,1.00,20,0.17,2278.12,13,5,6,8,0,122.57,45,27,0,1,140.44,0.00,0.00,0.02,0,14.00,1,503.18,0,1,0,java.lang.Object,0.00,0,0,8,0,0,7,0,13,135,3
"org.apache.jackrabbit.commons.cnd.DefinitionBuilderFactory$AbstractNodeDefinitionBuilder",3,1.00,1.00,6,0.07,870.51,4,1,6,3,0,140.61,13,8,0,2,140.38,0.00,0.50,0.00,0,3.00,1,196.18,0,0,0,org.apache.jackrabbit.commons.cnd.AbstractItemDefinitionBuilder,0.00,0,1,3,0,0,3,0,3,54,3
"org.apache.jackrabbit.commons.cnd.DefinitionBuilderFactory$AbstractNodeTypeDefinitionBuilder",11,0.20,1.00,23,0.20,2698.29,16,5,6,11,0,108.73,66,31,0,1,140.95,0.00,0.00,0.02,0,20.00,1,609.86,0,1,0,java.lang.Object,0.00,0,0,11,0,0,10,0,16,167,3
"org.apache.jackrabbit.commons.cnd.DefinitionBuilderFactory$AbstractPropertyDefinitionBuilder",8,0.17,1.12,23,0.30,7860.30,14,6,6,9,0,118.31,47,39,0,2,136.18,0.00,0.50,0.02,0,14.00,2,894.74,0,0,0,org.apache.jackrabbit.commons.cnd.AbstractItemDefinitionBuilder,0.00,1,1,9,0,1,8,0,13,202,3
"org.apache.jackrabbit.commons.cnd.Lexer",7,0.04,1.57,135,2.67,97963.18,65,58,5,20,3,90.78,34,149,2,1,90.55,0.00,0.00,0.05,1,6.00,5,8010.29,0,2,1,java.lang.Object,0.00,13,0,11,0,13,5,0,7,1301,1
"org.apache.jackrabbit.commons.cnd.ParseException",6,0.20,1.83,47,0.46,21036.32,9,3,0,10,10,61.42,55,58,10,2,111.42,0.00,0.50,0.17,0,10.00,6,1378.04,2,2,0,java.lang.Exception,0.00,4,1,11,0,4,4,0,11,308,1
"org.apache.jackrabbit.commons.cnd.TemplateBuilderFactory",5,0.25,1.20,20,0.21,3549.68,8,3,13,7,2,176.05,9,36,1,2,126.05,0.00,0.50,0.13,0,7.00,2,636.02,0,2,1,org.apache.jackrabbit.commons.cnd.DefinitionBuilderFactory,0.44,2,1,6,0,2,3,0,2,154,1
"org.apache.jackrabbit.commons.cnd.TemplateBuilderFactory$NodeDefinitionTemplateBuilder",6,0.07,1.00,25,0.33,6912.19,9,3,13,20,0,124.43,1,40,0,2,124.43,0.00,0.50,0.39,0,0.00,1,1001.38,1,0,0,org.apache.jackrabbit.commons.cnd.AbstractNodeDefinitionBuilder,0.00,14,1,6,0,14,6,0,1,219,1
"org.apache.jackrabbit.commons.cnd.TemplateBuilderFactory$NodeTypeTemplateBuilder",7,0.08,1.00,24,0.29,5535.46,9,2,13,20,0,130.38,0,40,0,2,130.38,0.00,0.50,0.43,0,4.00,1,883.34,1,3,0,org.apache.jackrabbit.commons.cnd.AbstractNodeTypeDefinitionBuilder,0.00,13,1,7,0,13,4,0,0,207,1
"org.apache.jackrabbit.commons.cnd.TemplateBuilderFactory$PropertyDefinitionTemplateBuilder",6,0.10,1.00,31,0.47,11343.52,10,4,13,24,0,119.12,1,46,0,2,119.12,0.00,0.50,0.33,0,6.00,1,1414.02,1,0,0,org.apache.jackrabbit.commons.cnd.AbstractPropertyDefinitionBuilder,0.00,18,1,6,0,18,6,0,1,289,1
"org.apache.jackrabbit.standalone.cli.lock.AddLockToken",3,0.25,1.33,14,0.16,2768.67,5,2,6,9,2,92.90,18,21,1,1,125.13,0.00,0.00,0.33,0,5.00,2,466.06,0,1,1,java.lang.Object,0.00,6,0,4,0,6,2,1,7,105,1
"org.apache.jackrabbit.standalone.cli.lock.Lock",7,0.12,1.14,25,0.30,6685.78,11,4,5,15,1,111.83,37,37,0,1,129.70,0.00,0.00,0.14,0,27.00,2,914.96,0,3,1,java.lang.Object,0.00,8,0,8,0,8,4,1,13,204,1
"org.apache.jackrabbit.standalone.cli.lock.RefreshLock",3,0.25,1.33,14,0.16,2775.93,5,2,6,10,1,107.24,16,19,0,1,125.12,0.00,0.00,0.33,0,5.00,2,472.64,0,1,1,java.lang.Object,0.00,7,0,4,0,7,2,1,7,106,1
"org.apache.jackrabbit.standalone.cli.lock.RemoveLockToken",3,0.25,1.33,14,0.16,2714.94,5,2,6,9,2,92.97,19,20,0,1,125.19,0.00,0.00,0.33,0,5.00,2,468.05,0,1,2,java.lang.Object,0.00,6,0,4,0,6,2,1,7,105,1
"org.apache.jackrabbit.standalone.cli.lock.Unlock",3,0.25,1.33,13,0.14,2488.53,5,2,5,9,1,107.62,16,18,0,1,125.49,0.00,0.00,0.33,0,5.00,2,424.03,0,1,1,java.lang.Object,0.00,6,0,4,0,6,2,1,7,98,1
"org.apache.jackrabbit.server.io.AbstractExportContext",7,0.00,1.29,23,0.19,3616.06,12,5,3,10,7,131.78,4,33,4,1,131.78,0.00,0.00,0.20,0,30.00,2,560.01,0,2,3,java.lang.Object,0.00,3,0,9,3,3,5,1,1,140,2
"org.apache.jackrabbit.server.io.BoundedInputStream",14,0.14,1.50,54,0.57,18595.94,19,5,2,23,2,128.75,57,84,2,2,128.51,0.00,0.50,0.33,1,0.00,4,1718.08,0,1,0,java.io.InputStream,0.00,9,1,21,0,9,13,0,19,398,1
"org.apache.jackrabbit.server.io.DefaultHandler",35,0.15,3.03,283,4.10,180286.55,40,5,27,140,22,65.54,277,413,5,1,107.83,0.00,0.00,0.05,14,304.00,12,12296.42,0,11,17,java.lang.Object,0.00,105,0,106,3,105,24,2,83,2350,1
"org.apache.jackrabbit.server.io.DefaultIOListener",4,0.00,1.50,11,0.17,2386.13,6,2,2,8,8,138.06,16,16,5,1,137.82,0.00,0.00,0.50,0,0.00,2,498.31,0,0,3,java.lang.Object,0.00,4,0,6,0,4,4,1,5,119,1
"org.apache.jackrabbit.server.io.DefaultIOManager",2,1.00,1.00,11,0.09,1420.98,3,1,2,9,8,73.99,20,14,1,2,122.47,0.00,0.50,0.00,1,2.00,1,281.72,1,0,7,org.apache.jackrabbit.server.io.IOManagerImpl,0.00,7,1,2,0,7,2,0,3,74,1
"org.apache.jackrabbit.server.io.DirListingExportHandler",17,0.44,1.71,127,1.82,88963.28,19,2,16,51,12,110.30,82,159,1,1,110.07,0.00,0.00,0.09,2,58.00,7,5466.75,0,3,11,java.lang.Object,0.00,34,0,29,0,34,14,2,27,953,1
"org.apache.jackrabbit.server.io.ExportContext",9,0.00,1.00,10,0.06,310.43,9,0,2,9,12,141.02,52,11,12,2,158.89,0.00,0.50,0.00,0,9.00,1,190.99,0,2,0,,0.00,0,1,9,0,0,7,0,10,69,1
"org.apache.jackrabbit.server.io.ExportContextImpl",10,0.09,2.60,62,0.76,22788.38,15,5,14,33,6,83.09,61,93,1,2,115.31,0.00,0.50,0.28,0,0.00,11,2284.88,2,1,5,org.apache.jackrabbit.server.io.AbstractExportContext,0.12,23,1,26,0,23,9,0,22,466,1
"org.apache.jackrabbit.server.io.IOContext",4,0.00,1.00,5,0.02,93.72,4,0,0,4,2,142.34,23,6,2,1,160.21,0.00,0.00,0.00,0,4.00,1,62.48,0,1,1,,0.00,0,0,4,0,0,3,0,5,26,1
"org.apache.jackrabbit.server.io.IOHandler",11,0.00,1.00,12,0.10,581.83,11,0,2,11,12,119.87,136,13,9,1,157.43,0.00,0.00,0.00,0,11.00,1,311.12,0,2,4,,0.00,0,0,11,0,0,9,0,12,101,1
"org.apache.jackrabbit.server.io.IOListener",3,0.00,1.00,4,0.04,168.96,3,0,0,3,8,109.11,25,5,7,1,157.21,0.00,0.00,0.00,0,3.00,1,112.64,0,0,2,,0.00,0,0,3,0,0,3,0,4,35,1
"org.apache.jackrabbit.server.io.IOManager",8,0.00,1.00,9,0.07,418.75,8,0,3,8,13,107.47,77,10,10,1,157.46,0.00,0.00,0.00,0,8.00,1,215.86,0,1,4,,0.00,0,0,8,0,0,7,0,9,71,1
"org.apache.jackrabbit.server.io.IOManagerImpl",9,0.08,2.89,88,1.03,55663.68,12,3,7,27,8,105.54,43,103,1,1,105.30,0.00,0.00,0.26,1,30.00,5,3102.42,0,2,7,java.lang.Object,0.00,18,0,26,1,18,7,1,11,596,1
"org.apache.jackrabbit.server.io.IOUtil",8,2.00,2.50,57,0.68,25491.12,10,2,11,24,15,61.68,79,78,12,1,111.68,0.00,0.00,0.00,0,8.00,3,2054.62,0,7,3,java.lang.Object,0.00,16,0,20,0,16,1,0,19,437,1
"org.apache.jackrabbit.server.io.ImportContext",9,0.00,1.00,10,0.04,206.52,9,0,2,9,12,128.06,58,11,12,2,160.28,0.00,0.50,0.00,0,9.00,1,126.48,0,7,0,,0.00,0,1,9,0,0,2,0,10,53,1
"org.apache.jackrabbit.server.io.ImportContextImpl",16,0.02,1.88,71,0.74,23159.59,25,9,13,40,7,123.74,72,102,2,1,123.51,0.00,0.00,0.13,1,172.00,5,2231.92,0,8,5,java.lang.Object,0.00,24,0,30,1,24,8,1,18,493,1
"org.apache.jackrabbit.server.io.PropertyExportContext",0,0.00,0.00,1,0.01,31.02,0,0,0,0,9,171.00,5,2,9,2,171.00,0.00,0.50,0.00,0,0.00,0,15.51,0,0,0,,0.00,0,1,0,0,0,0,0,1,6,1
"org.apache.jackrabbit.server.io.PropertyHandler",4,0.00,1.00,5,0.06,466.46,4,0,3,4,9,125.34,52,6,6,1,154.72,0.00,0.00,0.00,0,4.00,1,166.54,0,1,3,,0.00,0,0,4,0,0,3,0,5,50,1
"org.apache.jackrabbit.server.io.PropertyImportContext",2,0.00,1.00,3,0.02,164.70,2,0,3,2,10,107.81,17,4,9,2,155.91,0.00,0.50,0.00,0,2.00,1,60.34,0,2,1,,0.00,0,1,2,0,0,0,0,3,21,1
"org.apache.jackrabbit.server.io.PropertyManager",4,0.00,1.00,5,0.05,429.76,4,0,3,4,6,122.78,25,6,2,1,155.00,0.00,0.00,0.00,0,4.00,1,147.70,0,2,4,,0.00,0,0,4,0,0,2,0,5,45,1
"org.apache.jackrabbit.server.io.PropertyManagerImpl",6,0.20,2.50,41,0.46,17946.98,9,3,7,25,10,114.63,26,51,2,1,114.39,0.00,0.00,0.17,1,14.00,6,1372.22,0,2,8,java.lang.Object,0.00,19,0,15,0,19,4,1,7,291,1
"org.apache.jackrabbit.server.io.VersionHandler",12,1.00,1.42,40,0.46,10816.14,13,1,10,17,11,169.74,31,69,1,2,129.85,0.00,0.50,0.00,2,12.00,3,1384.14,0,2,10,org.apache.jackrabbit.server.io.DefaultHandler,0.21,5,1,17,0,5,10,1,15,318,1
"org.apache.jackrabbit.server.io.VersionHistoryHandler",18,0.50,1.28,54,0.49,7874.67,20,2,9,26,11,132.35,9,78,1,1,132.35,0.00,0.00,0.03,2,34.00,2,1458.43,0,3,10,java.lang.Object,0.00,8,0,23,0,8,15,2,7,363,1
"org.apache.jackrabbit.server.io.XmlHandler",10,0.22,1.90,53,0.79,19724.78,14,4,12,36,7,76.54,71,91,2,2,118.83,0.00,0.50,0.05,0,26.00,4,2359.43,5,0,5,org.apache.jackrabbit.server.io.DefaultHandler,0.04,26,1,19,0,26,10,0,21,495,1
"org.apache.jackrabbit.server.io.ZipHandler",11,0.20,2.64,95,1.34,49287.43,14,3,15,58,10,59.86,110,128,2,2,108.34,0.00,0.50,0.15,1,39.00,6,4011.43,5,1,8,org.apache.jackrabbit.server.io.DefaultHandler,0.04,47,1,29,0,47,10,0,27,768,1
"org.apache.jackrabbit.server.io.ZipHandler$ZipEntryExportContext",9,0.25,1.56,24,0.25,4759.29,11,2,15,17,2,188.22,11,39,0,2,138.22,0.00,0.50,0.28,0,20.00,3,743.58,0,1,2,org.apache.jackrabbit.server.io.AbstractExportContext,0.00,8,1,14,0,8,8,0,6,181,1
"org.apache.jackrabbit.server.io.ZipHandler$ZipEntryImportContext",4,0.00,1.00,14,0.19,2737.64,6,2,15,13,5,130.87,0,23,0,2,130.87,0.00,0.50,0.50,0,4.00,1,584.02,0,1,5,org.apache.jackrabbit.server.io.ImportContextImpl,0.30,9,1,4,0,9,3,0,0,131,1
"org.apache.jackrabbit.servlet.AbstractRepositoryServlet",6,0.00,1.67,35,0.43,16966.85,6,0,10,25,7,126.76,106,50,4,2,117.63,8.00,0.10,0.00,2,6.00,4,1283.65,0,3,3,javax.servlet.http.HttpServlet,0.00,19,1,10,8,19,3,0,10,253,2
"org.apache.jackrabbit.servlet.AbstractRepositoryServlet$ProxyRepository",1,0.00,1.00,3,0.03,377.51,1,0,10,2,1,132.91,0,6,0,1,132.91,0.00,0.00,0.00,0,1.00,1,76.53,0,1,1,java.lang.Object,0.00,1,0,1,0,1,0,0,0,22,0
"org.apache.jackrabbit.servlet.ContextRepositoryServlet",1,1.00,6.00,20,0.36,20909.78,2,1,3,10,1,64.29,40,37,0,3,88.03,0.00,0.67,0.00,0,1.00,6,1066.80,2,1,1,org.apache.jackrabbit.servlet.AbstractRepositoryServlet,0.43,9,2,6,0,9,0,0,3,193,1
"org.apache.jackrabbit.servlet.FilterRepositoryFactory",2,1.00,2.50,16,0.23,10708.69,3,1,5,10,2,134.02,38,27,1,1,107.74,0.00,0.00,0.50,0,2.00,4,678.63,0,1,1,java.lang.Object,0.00,8,0,5,0,8,1,1,4,137,1
"org.apache.jackrabbit.servlet.JNDIBindingServlet",2,0.67,3.50,21,0.29,9924.21,5,3,8,15,1,143.61,42,31,0,2,104.31,0.00,0.50,0.67,0,0.00,5,870.42,0,0,1,javax.servlet.http.HttpServlet,0.00,13,1,7,0,13,2,0,6,171,1
"org.apache.jackrabbit.servlet.JNDIRepositoryServlet",1,1.00,5.00,15,0.23,10219.62,2,1,7,12,2,95.89,36,23,0,3,95.19,0.00,0.67,0.00,0,1.00,5,691.98,0,1,2,org.apache.jackrabbit.servlet.AbstractRepositoryServlet,0.43,11,2,5,0,11,0,0,3,132,1
"org.apache.jackrabbit.servlet.ServletRepository",2,0.00,1.00,5,0.03,290.13,2,0,3,4,7,168.98,64,8,4,3,142.75,0.00,0.67,0.00,0,2.00,1,101.88,0,0,3,org.apache.jackrabbit.commons.repository.ProxyRepository,0.00,2,2,2,0,2,2,0,3,32,1
"org.apache.jackrabbit.servlet.ServletRepositoryFactory",2,1.00,2.50,16,0.23,10708.69,3,1,5,10,2,134.02,38,27,1,1,107.74,0.00,0.00,0.50,0,2.00,4,678.63,0,1,1,java.lang.Object,0.00,8,0,5,0,8,1,1,4,137,1
"org.apache.jackrabbit.core.query.lucene.directory.DirectoryManager",7,0.00,1.00,8,0.05,212.76,7,0,3,7,13,111.22,57,9,13,1,159.32,0.00,0.00,0.00,0,7.00,1,147.62,0,2,1,,0.00,0,0,7,0,0,5,0,8,54,1
"org.apache.jackrabbit.core.query.lucene.directory.DirectoryManagerTest",6,0.10,1.17,30,0.31,5882.00,10,4,7,17,5,121.34,4,39,1,2,121.34,0.00,0.50,0.17,1,10.00,2,941.39,0,0,4,junit.framework.TestCase,0.00,11,1,7,0,11,6,0,1,216,1
"org.apache.jackrabbit.core.query.lucene.directory.DirectoryManagerTest$Callable",1,0.00,1.00,5,0.05,626.53,1,0,7,5,1,122.90,0,6,0,1,122.90,0.00,0.00,0.00,0,0.00,1,139.69,0,0,1,java.lang.Object,0.00,4,0,1,0,4,1,0,0,35,0
"org.apache.jackrabbit.core.query.lucene.directory.DirectoryManagerTest$Callable_0",1,0.00,1.00,5,0.05,582.76,1,0,7,6,1,123.15,0,6,0,1,123.15,0.00,0.00,0.00,0,0.00,1,138.80,0,0,1,java.lang.Object,0.00,5,0,1,0,5,1,0,0,36,0
"org.apache.jackrabbit.core.query.lucene.directory.DirectoryManagerTest$Callable_1",1,0.00,1.00,4,0.05,529.59,1,0,7,7,1,127.09,0,5,0,1,127.09,0.00,0.00,0.00,0,0.00,1,148.18,0,0,1,java.lang.Object,0.00,6,0,1,0,6,1,0,0,37,0
"org.apache.jackrabbit.core.query.lucene.directory.DirectoryManagerTest$Callable_2",1,0.00,1.00,6,0.06,856.03,1,0,7,7,1,118.88,0,7,0,1,118.88,0.00,0.00,0.00,0,0.00,1,182.17,0,0,1,java.lang.Object,0.00,6,0,1,0,6,1,0,0,45,0
"org.apache.jackrabbit.core.query.lucene.directory.DirectoryManagerTest$Callable_3",1,0.00,1.00,2,0.01,69.06,1,0,7,1,1,145.29,0,3,0,1,145.29,0.00,0.00,0.00,0,1.00,1,36.53,0,0,1,,0.00,0,0,1,0,0,1,0,0,13,1
"org.apache.jackrabbit.core.query.lucene.directory.FSDirectoryManager",7,0.17,2.00,44,0.44,15572.12,8,1,12,21,4,115.69,32,55,2,1,115.46,0.00,0.00,0.86,0,0.00,5,1308.13,0,2,3,java.lang.Object,0.00,14,0,14,0,14,5,1,13,286,1
"org.apache.jackrabbit.core.query.lucene.directory.FSDirectoryManager$FSDir",18,0.00,1.11,52,0.51,10667.67,19,1,12,41,0,137.91,4,73,0,2,137.91,0.00,0.50,1.00,0,0.00,3,1520.83,0,8,0,org.apache.lucene.store.Directory,0.00,23,1,20,0,23,10,0,1,382,3
"org.apache.jackrabbit.core.query.lucene.directory.FSDirectoryManager$FSDir$FileFilter_0",1,0.00,1.00,3,0.02,173.90,1,0,12,2,0,135.56,0,4,0,1,135.56,0.00,0.00,0.00,0,1.00,1,52.97,0,0,0,java.lang.Object,0.00,1,0,1,0,1,1,0,0,17,0
"org.apache.jackrabbit.core.query.lucene.directory.FSDirectoryManager$FSDir$IndexInputLogWrapper",8,0.14,1.00,21,0.17,2817.36,9,1,12,16,1,139.72,0,31,0,2,139.72,0.00,0.50,0.88,0,0.00,1,524.01,1,1,1,org.apache.lucene.store.IndexInput,0.00,8,1,8,0,8,7,0,0,145,3
"org.apache.jackrabbit.core.query.lucene.directory.FSDirectoryManager$FileFilter",1,0.00,1.00,3,0.02,173.90,1,0,12,2,0,135.56,0,4,0,1,135.56,0.00,0.00,0.00,0,1.00,1,52.97,0,0,0,java.lang.Object,0.00,1,0,1,0,1,1,0,0,17,0
"org.apache.jackrabbit.core.query.lucene.directory.IndexInputStream",4,0.11,1.50,22,0.22,7140.23,7,3,3,8,4,76.94,31,29,4,2,119.23,0.00,0.50,0.25,1,4.00,2,667.15,0,0,0,java.io.InputStream,0.00,4,1,6,0,4,4,0,9,155,1
"org.apache.jackrabbit.core.query.lucene.directory.IndexInputStreamTest",2,0.00,2.50,31,0.36,17615.65,2,0,8,13,2,135.74,4,34,1,2,95.85,0.00,0.50,0.00,1,2.00,4,1070.39,0,0,1,junit.framework.TestCase,0.00,11,1,5,0,11,2,0,2,205,1
"org.apache.jackrabbit.core.query.lucene.directory.IndexOutputStream",5,0.50,1.00,14,0.15,2257.88,6,1,3,10,3,106.64,32,21,3,2,138.87,0.00,0.50,0.60,1,2.00,1,436.27,0,0,0,java.io.OutputStream,0.00,5,1,5,0,5,5,0,7,113,1
"org.apache.jackrabbit.core.query.lucene.directory.IndexOutputStreamTest",2,0.00,3.00,37,0.40,21204.94,2,0,8,16,2,132.11,5,38,1,2,92.22,0.00,0.50,0.00,1,2.00,5,1189.26,0,0,1,junit.framework.TestCase,0.00,14,1,6,0,14,2,0,3,225,1
"org.apache.jackrabbit.core.query.lucene.directory.RAMDirectoryManager",7,0.33,1.43,30,0.28,6394.32,8,1,6,16,4,125.38,28,47,2,1,125.14,0.00,0.00,0.71,0,0.00,3,833.72,0,2,2,java.lang.Object,0.00,9,0,10,0,9,5,1,9,200,1
"org.apache.jackrabbit.core.query.lucene.directory.TestAll",1,0.00,1.00,7,0.06,1740.69,1,0,3,3,3,65.48,10,9,0,2,113.96,0.00,0.50,0.00,0,1.00,1,186.48,0,1,3,junit.framework.TestCase,0.00,2,1,1,0,2,0,0,2,47,1
"org.apache.jackrabbit.webdav.io.InputContext",7,0.00,1.00,8,0.03,152.68,7,0,1,7,11,128.24,42,9,11,1,160.46,0.00,0.00,0.00,0,7.00,1,95.75,0,4,0,,0.00,0,0,7,0,0,3,0,8,41,1
"org.apache.jackrabbit.webdav.io.InputContextImpl",8,0.10,1.12,24,0.21,3268.16,11,3,6,15,3,182.61,14,34,1,1,132.61,0.00,0.00,0.25,0,16.00,2,633.69,0,4,2,java.lang.Object,0.00,7,0,9,0,7,4,1,3,162,1
"org.apache.jackrabbit.webdav.io.OutputContext",8,0.00,1.00,9,0.05,242.82,8,0,1,8,11,141.46,44,10,11,1,159.33,0.00,0.00,0.00,0,8.00,1,156.48,0,1,0,,0.00,0,0,8,0,0,7,0,9,58,1
"org.apache.jackrabbit.webdav.io.OutputContextImpl",9,0.04,1.89,34,0.32,5648.77,12,3,5,17,4,131.02,4,52,2,1,131.02,0.00,0.00,0.30,0,1.00,3,971.05,0,1,2,java.lang.Object,0.00,8,0,17,0,8,8,1,2,237,1
"org.apache.jackrabbit.webdav.io.OutputContextImplTest",1,0.00,1.00,12,0.13,3427.25,1,0,7,4,3,123.52,3,14,1,2,102.91,0.00,0.50,0.00,0,1.00,1,388.10,0,0,2,junit.framework.TestCase,0.00,3,1,1,0,3,1,0,1,86,1
"org.apache.jackrabbit.webdav.io.OutputContextImplTest$DummyResponse",2,0.00,1.00,5,0.06,686.17,2,0,7,4,0,139.81,0,9,0,1,139.81,0.00,0.00,0.00,0,2.00,1,167.29,0,0,0,java.lang.Object,0.00,2,0,2,0,2,2,0,0,44,0
"org.apache.jackrabbit.webdav.io.OutputContextImplTest$DummyResponse_0",30,0.00,1.00,42,0.26,1720.12,30,0,7,30,0,157.15,0,73,0,1,157.15,0.00,0.00,0.00,0,30.00,1,794.65,0,8,0,java.lang.Object,0.00,0,0,30,0,0,22,1,0,260,2
"org.apache.jackrabbit.webdav.io.TestAll",1,0.00,1.00,5,0.04,864.35,1,0,3,3,1,121.80,0,7,0,2,121.80,0.00,0.50,0.00,0,1.00,1,115.51,0,1,1,junit.framework.TestCase,0.00,2,1,1,0,2,0,0,0,31,1
"org.apache.jackrabbit.core.query.lucene.hits.AdaptingHits",6,0.17,2.00,38,0.38,17865.63,12,6,3,15,6,96.59,34,53,3,1,114.46,0.00,0.00,0.31,0,0.00,7,1153.97,0,1,3,java.lang.Object,0.00,9,0,12,0,9,5,1,11,241,1
"org.apache.jackrabbit.core.query.lucene.hits.ArrayHits",6,0.40,2.00,41,0.33,9827.58,10,4,1,9,3,156.39,17,52,2,1,116.50,0.00,0.00,0.58,2,0.00,3,1001.97,0,0,1,java.lang.Object,0.00,3,0,12,0,3,6,1,4,228,1
"org.apache.jackrabbit.core.query.lucene.hits.ArrayHitsTest",1,0.00,1.00,6,0.06,1011.06,1,0,1,5,2,118.31,0,8,1,2,118.31,0.00,0.50,0.00,0,1.00,1,169.24,0,0,1,junit.framework.TestCase,0.00,4,1,1,0,4,1,0,0,41,1
"org.apache.jackrabbit.core.query.lucene.hits.BitSetHits",4,0.33,1.00,15,0.10,1251.29,6,2,1,7,2,154.17,14,20,1,1,133.55,0.00,0.00,0.75,1,0.00,1,290.73,0,0,1,java.lang.Object,0.00,3,0,4,0,3,4,1,4,81,1
"org.apache.jackrabbit.core.query.lucene.hits.Hits",3,0.00,1.00,4,0.02,95.88,3,0,1,3,12,141.28,17,5,12,1,159.15,0.00,0.00,0.00,0,3.00,1,63.48,0,0,0,,0.00,0,0,3,0,0,3,0,4,25,1
"org.apache.jackrabbit.core.query.lucene.hits.HitsIntersection",4,0.33,2.00,31,0.28,16792.68,8,4,1,7,1,131.40,12,40,0,1,110.79,0.00,0.00,0.50,1,4.00,4,850.41,0,0,1,java.lang.Object,0.00,3,0,8,0,3,4,1,4,195,1
"org.apache.jackrabbit.core.query.lucene.hits.ScorerHits",4,0.67,1.50,16,0.12,2073.91,5,1,2,8,5,147.69,12,23,4,1,127.07,0.00,0.00,0.50,0,4.00,2,345.43,0,0,1,java.lang.Object,0.00,4,0,6,0,4,4,1,4,91,1
"org.apache.jackrabbit.spi.commons.query.sql.ASTContainsExpression",7,0.42,1.00,17,0.11,1129.61,9,2,1,8,4,142.38,3,25,2,2,142.38,0.00,0.50,0.14,0,17.00,1,331.40,0,3,2,SimpleNode,0.00,1,1,7,0,1,4,0,1,98,1
"org.apache.jackrabbit.spi.commons.query.sql.ASTIdentifier",6,0.80,1.00,14,0.10,1044.12,7,1,1,7,8,142.13,1,21,6,2,142.13,0.00,0.50,0.33,0,10.00,1,295.38,1,3,2,SimpleNode,0.08,1,1,6,0,1,3,0,1,87,1
"org.apache.jackrabbit.spi.commons.query.sql.ASTLiteral",8,0.29,1.00,19,0.13,1418.97,10,2,0,9,4,142.06,3,28,3,2,142.06,0.00,0.50,0.25,0,18.00,1,403.74,1,3,1,SimpleNode,0.14,1,1,8,0,1,5,0,1,117,1
"org.apache.jackrabbit.spi.commons.query.sql.ASTPredicate",14,0.12,1.00,34,0.24,2461.65,19,5,1,15,4,142.09,1,49,2,2,142.09,0.00,0.50,0.09,0,70.00,1,709.22,1,5,2,SimpleNode,0.06,1,1,14,0,1,9,0,1,199,1
"org.apache.jackrabbit.spi.commons.query.sql.DefaultParserVisitor",20,0.00,1.00,41,0.27,2807.83,20,0,0,20,6,142.86,4,62,1,1,142.86,0.00,0.00,0.00,0,20.00,1,808.87,0,20,5,java.lang.Object,0.00,0,0,20,0,0,0,1,1,245,0
"org.apache.jackrabbit.spi.commons.query.sql.JCRSQLQueryBuilder",27,0.02,3.52,372,5.43,429324.69,37,10,40,154,34,63.85,163,471,2,1,96.07,0.00,0.00,0.09,3,149.00,16,16294.49,0,25,32,java.lang.Object,0.00,127,0,95,0,127,2,1,63,2814,1
"org.apache.jackrabbit.spi.commons.query.sql.JCRSQLQueryBuilder$DefaultParserVisitor",2,0.00,1.00,7,0.07,753.53,2,0,40,5,3,132.92,0,9,0,1,132.92,0.00,0.00,0.00,0,0.00,1,206.90,0,2,3,java.lang.Object,0.00,3,0,2,0,3,0,0,0,53,0
"org.apache.jackrabbit.spi.commons.query.sql.JCRSQLQueryBuilder$DefaultParserVisitor_0",1,0.00,2.00,5,0.05,958.23,1,0,40,3,2,171.29,1,7,0,1,121.29,0.00,0.00,0.00,0,0.00,2,148.18,0,1,2,java.lang.Object,0.00,2,0,2,0,2,0,0,1,37,0
"org.apache.jackrabbit.spi.commons.query.sql.JCRSQLQueryBuilder$DefaultParserVisitor_1",5,0.00,2.20,25,0.25,7597.13,5,0,40,8,3,119.69,0,34,0,1,119.69,0.00,0.00,0.00,1,5.00,5,740.78,0,4,3,java.lang.Object,0.00,3,0,11,0,3,1,0,0,174,0
"org.apache.jackrabbit.spi.commons.query.sql.JCRSQLQueryBuilder$DefaultParserVisitor_2",1,0.00,1.00,4,0.03,474.00,1,0,40,2,1,127.47,0,5,0,1,127.47,0.00,0.00,0.00,0,1.00,1,92.00,0,1,1,java.lang.Object,0.00,1,0,1,0,1,0,0,0,25,0
"org.apache.jackrabbit.spi.commons.query.sql.JCRSQLQueryBuilder$MergingPathQueryNode",5,0.75,6.00,101,1.46,155703.10,6,1,40,26,4,49.11,63,115,0,4,86.67,0.00,0.75,0.40,2,6.00,13,4389.43,0,3,4,org.apache.jackrabbit.spi.commons.query.PathQueryNode,0.00,21,3,30,0,21,2,0,15,766,2
"org.apache.jackrabbit.spi.commons.query.sql.QueryBuilder",4,0.00,1.00,9,0.10,1268.78,4,0,6,7,5,140.31,16,18,0,1,140.07,0.00,0.00,0.00,0,4.00,1,294.46,0,3,5,java.lang.Object,0.00,3,0,4,0,3,1,1,5,78,1
"org.apache.jackrabbit.spi.commons.query.sql.QueryFormat",20,0.00,5.00,373,5.36,446884.10,24,4,29,88,23,110.17,77,442,2,1,89.56,0.00,0.00,0.25,5,30.00,16,16070.64,0,15,21,java.lang.Object,0.00,68,0,100,0,68,5,2,27,2798,0
"org.apache.jackrabbit.commons.repository.EmptyRepository",6,0.00,1.00,13,0.09,857.88,6,0,5,7,1,100.51,42,21,0,2,142.80,0.00,0.50,0.00,0,6.00,1,257.98,0,5,1,org.apache.jackrabbit.commons.AbstractRepository,0.00,1,1,6,0,1,1,0,7,76,1
"org.apache.jackrabbit.commons.repository.JNDIRepository",1,0.00,1.00,3,0.02,215.39,1,0,1,2,2,124.47,15,5,0,3,134.83,0.00,0.67,0.00,0,1.00,1,72.87,0,0,2,org.apache.jackrabbit.commons.repository.ProxyRepository,0.00,1,2,1,0,1,1,0,2,22,1
"org.apache.jackrabbit.commons.repository.JNDIRepositoryFactory",2,0.00,2.50,16,0.19,6983.23,4,2,4,6,3,65.07,23,29,2,1,109.20,0.00,0.00,0.50,0,2.00,4,558.91,0,1,1,java.lang.Object,0.00,4,0,5,0,4,1,1,5,120,1
"org.apache.jackrabbit.commons.repository.ProxyRepository",11,0.45,1.55,40,0.36,6298.70,13,2,9,22,8,83.28,92,65,5,2,131.38,3.00,0.20,0.09,1,20.00,2,1091.27,0,6,3,org.apache.jackrabbit.commons.AbstractRepository,0.00,11,1,17,3,11,5,0,14,274,1
"org.apache.jackrabbit.commons.repository.RepositoryFactory",1,0.00,1.00,2,0.01,38.26,1,0,2,1,11,103.18,11,3,11,1,147.31,0.00,0.00,0.00,0,1.00,1,25.51,0,1,0,,0.00,0,0,1,0,0,0,0,2,11,1
"org.apache.jackrabbit.commons.repository.SingletonRepositoryFactory",2,1.00,1.00,6,0.04,384.68,3,1,1,2,1,87.11,16,9,0,1,135.22,0.00,0.00,0.50,0,2.00,1,105.38,0,1,1,java.lang.Object,0.00,0,0,2,0,0,1,1,4,32,1
"org.apache.jackrabbit.rmi.remote.security.RemoteAccessControlEntry",2,0.00,1.00,3,0.02,130.32,2,0,3,2,10,127.33,27,4,8,2,156.72,0.00,0.50,0.00,0,2.00,1,59.16,0,2,2,,0.00,0,1,2,0,0,0,0,3,21,1
"org.apache.jackrabbit.rmi.remote.security.RemoteAccessControlList",1,0.00,1.00,2,0.01,102.34,1,0,2,1,5,191.21,23,4,4,2,143.94,0.00,0.50,0.00,0,1.00,1,44.04,0,0,1,,0.00,0,1,1,0,0,1,0,2,15,1
"org.apache.jackrabbit.rmi.remote.security.RemoteAccessControlManager",7,0.00,1.00,8,0.09,677.59,7,0,4,7,11,123.14,43,16,8,2,155.36,0.00,0.50,0.00,0,7.00,1,280.77,0,6,3,,0.00,0,1,7,0,0,1,0,8,83,1
"org.apache.jackrabbit.rmi.remote.security.RemoteAccessControlPolicy",0,0.00,0.00,1,0.01,31.02,0,0,1,0,8,171.00,21,2,8,2,171.00,0.00,0.50,0.00,0,0.00,0,15.51,0,0,0,,0.00,0,1,0,0,0,0,0,1,6,1
"org.apache.jackrabbit.rmi.remote.security.RemotePrivilege",5,0.00,1.00,6,0.04,268.93,5,0,2,5,12,115.08,35,8,12,2,157.37,0.00,0.50,0.00,0,5.00,1,122.46,0,3,0,,0.00,0,1,5,0,0,2,0,6,43,1
"org.apache.jackrabbit.rmi.client.iterator.ClientIterator",9,0.18,2.33,60,0.58,24591.49,14,5,7,16,11,66.24,97,85,7,1,114.72,0.00,0.00,0.36,2,7.00,6,1738.91,0,2,4,org.apache.jackrabbit.rmi.client.ClientObject,0.00,7,1,21,7,7,7,1,16,374,2
"org.apache.jackrabbit.rmi.client.iterator.ClientNodeIterator",3,1.00,1.00,9,0.07,845.72,4,1,6,3,5,85.80,24,15,1,2,133.91,0.00,0.50,0.33,0,4.00,1,218.74,2,2,4,org.apache.jackrabbit.rmi.client.iterator.ClientIterator,0.00,0,2,3,0,0,1,1,5,61,1
"org.apache.jackrabbit.rmi.client.iterator.ClientNodeTypeIterator",3,0.00,1.00,7,0.05,528.94,3,0,5,4,5,99.79,22,13,1,2,142.08,0.00,0.50,0.00,0,3.00,1,161.13,2,2,4,org.apache.jackrabbit.rmi.client.iterator.ClientIterator,0.00,1,2,3,0,1,1,1,4,49,1
"org.apache.jackrabbit.rmi.client.iterator.ClientPropertyIterator",3,1.00,1.00,9,0.08,929.67,4,1,6,4,5,85.48,24,16,1,2,133.58,0.00,0.50,0.33,0,4.00,1,233.46,2,2,4,org.apache.jackrabbit.rmi.client.iterator.ClientIterator,0.00,1,2,3,0,1,1,1,5,64,1
"org.apache.jackrabbit.rmi.client.iterator.ClientRowIterator",3,0.00,1.00,7,0.05,528.94,3,0,5,4,5,99.79,22,12,1,2,142.08,0.00,0.50,0.00,0,3.00,1,161.13,2,2,4,org.apache.jackrabbit.rmi.client.iterator.ClientIterator,0.00,1,2,3,0,1,1,1,4,49,1
"org.apache.jackrabbit.rmi.client.iterator.ClientVersionIterator",3,1.00,1.00,9,0.08,929.67,4,1,6,4,5,85.48,24,16,1,2,133.58,0.00,0.50,0.33,0,4.00,1,233.46,2,2,4,org.apache.jackrabbit.rmi.client.iterator.ClientIterator,0.00,1,2,3,0,1,1,1,5,64,1
"org.apache.jackrabbit.spi.CredentialsWrapper",3,0.00,1.67,19,0.18,4761.26,6,3,5,9,2,166.65,4,24,2,1,116.65,0.00,0.00,0.33,0,2.00,3,545.38,0,2,0,java.lang.Object,0.00,6,0,5,0,6,1,0,2,124,0
"org.apache.jackrabbit.spi.DefinitionUtil",6,1.00,7.33,129,2.54,170761.91,7,1,28,75,20,43.85,45,181,1,1,86.14,0.00,0.00,0.17,4,18.00,13,7633.01,0,3,19,java.lang.Object,0.00,69,0,44,0,69,3,1,17,1231,0
"org.apache.jackrabbit.spi.EventImpl",3,0.25,2.33,33,0.70,31074.86,5,2,22,21,16,140.22,6,62,1,2,100.34,0.00,0.50,0.33,1,5.00,5,2093.41,0,1,15,org.apache.jackrabbit.spi.commons.EventImpl,0.00,18,1,7,0,18,2,1,4,395,1
"org.apache.jackrabbit.spi.EventSubscriptionImpl",3,0.25,1.00,10,0.06,706.08,5,2,1,3,3,116.65,15,14,1,1,134.53,0.00,0.00,0.33,0,5.00,1,177.61,0,1,2,java.lang.Object,0.00,0,0,3,0,0,2,1,5,52,1
"org.apache.jackrabbit.spi.ExceptionConverter",4,0.00,4.50,43,0.86,71769.25,4,0,15,25,12,139.74,9,74,6,1,99.85,0.00,0.00,0.00,1,4.00,14,2568.99,0,3,6,java.lang.Object,0.00,21,0,18,0,21,1,0,7,420,1
"org.apache.jackrabbit.spi.IdURICache",10,0.17,1.40,41,0.46,10198.92,14,4,5,23,2,124.77,3,56,1,1,124.77,0.00,0.00,0.40,1,0.00,2,1380.55,0,3,1,java.lang.Object,0.00,13,0,14,0,13,7,0,1,321,0
"org.apache.jackrabbit.spi.ItemInfoImpl",3,0.25,1.33,11,0.12,1998.68,5,2,10,8,9,170.79,6,15,2,1,130.90,0.00,0.00,0.33,0,1.00,2,373.78,0,1,7,java.lang.Object,0.00,5,0,4,2,5,2,1,2,88,1
"org.apache.jackrabbit.spi.LockInfoImpl",9,0.04,1.22,24,0.21,3149.99,12,3,7,15,6,139.69,4,34,1,1,139.69,0.00,0.00,0.30,1,0.00,2,619.86,0,4,5,java.lang.Object,0.00,6,0,11,0,6,5,1,2,163,1
"org.apache.jackrabbit.spi.NamespaceResolverImpl",5,0.17,1.40,22,0.25,7093.31,8,3,8,12,4,163.53,11,30,2,2,123.64,0.00,0.50,0.47,0,0.00,2,755.47,0,3,2,org.apache.jackrabbit.spi.commons.namespace.AbstractNamespaceResolver,0.00,7,1,7,0,7,2,0,5,180,0
"org.apache.jackrabbit.spi.NodeInfoImpl",12,0.01,1.75,62,0.83,42351.31,20,8,19,32,15,116.86,8,83,2,2,116.86,0.00,0.50,0.14,0,98.00,8,2499.23,0,6,13,org.apache.jackrabbit.spi2dav.ItemInfoImpl,0.00,20,1,21,0,20,6,1,6,477,1
"org.apache.jackrabbit.spi.PropertyInfoImpl",7,0.00,1.71,51,0.64,27827.28,11,4,17,18,15,161.01,9,65,2,2,111.01,0.00,0.50,0.25,0,20.00,6,1923.83,0,2,13,org.apache.jackrabbit.spi2dav.ItemInfoImpl,0.00,11,1,12,0,11,5,1,7,358,1
"org.apache.jackrabbit.spi.QueryInfoImpl",4,0.11,2.50,36,0.47,17745.91,7,3,19,20,12,106.71,16,46,1,1,106.47,0.00,0.00,0.42,0,0.00,4,1404.70,0,3,11,java.lang.Object,0.00,16,0,10,0,16,1,1,6,277,1
"org.apache.jackrabbit.spi.QueryResultRowImpl",5,0.17,3.80,63,1.05,58971.06,11,6,21,29,15,148.37,5,80,1,1,98.37,0.00,0.00,0.30,0,8.00,10,3143.36,0,3,14,java.lang.Object,0.00,24,0,19,0,24,2,1,2,552,1
"org.apache.jackrabbit.spi.RepositoryServiceImpl",108,0.01,3.19,1156,19.34,1008166.18,130,22,179,427,139,122.78,343,1568,6,1,102.17,0.00,0.00,0.03,43,3918.00,13,58031.08,0,62,134,java.lang.Object,0.00,319,0,345,1,319,46,2,179,10017,1
"org.apache.jackrabbit.spi.RepositoryServiceImpl$BatchImpl",18,0.18,2.61,212,2.92,110426.52,25,7,179,79,34,122.72,54,262,0,1,102.11,0.00,0.00,0.32,3,0.00,6,8761.73,0,3,34,java.lang.Object,0.00,61,0,47,0,61,15,1,34,1594,1
"org.apache.jackrabbit.spi.RepositoryServiceImpl$IdentifierResolverImpl",5,0.75,1.60,22,0.27,8767.06,6,1,179,15,5,172.89,9,31,0,1,122.89,0.00,0.00,0.40,2,7.00,4,823.23,0,3,5,java.lang.Object,0.00,10,0,8,0,10,2,1,5,181,1
"org.apache.jackrabbit.spi.RepositoryServiceImpl$NamePathResolverImpl",7,0.17,1.00,21,0.23,2799.82,9,2,179,17,12,172.60,15,29,0,1,132.71,0.00,0.00,0.64,0,0.00,1,677.68,0,5,12,java.lang.Object,0.00,10,0,7,0,10,2,1,5,171,1
"org.apache.jackrabbit.spi.RepositoryServiceImpl$NamespaceCache",5,0.25,1.40,23,0.25,8179.58,7,2,179,10,1,123.16,1,31,0,2,123.16,0.00,0.50,0.70,0,0.00,2,744.75,0,3,1,org.apache.jackrabbit.spi.commons.namespace.AbstractNamespaceResolver,0.00,5,1,7,0,5,2,0,1,180,2
"org.apache.jackrabbit.spi.RepositoryServiceImpl$NamespaceResolverImpl",3,0.50,1.67,14,0.13,2927.34,4,1,179,6,1,145.50,11,22,0,1,124.88,0.00,0.00,0.67,0,1.00,2,378.40,0,2,1,java.lang.Object,0.00,3,0,5,0,3,1,1,3,92,1
"org.apache.jackrabbit.spi.RepositoryStubImpl",5,0.38,1.40,23,0.27,6213.79,7,2,19,16,16,163.98,14,35,1,2,124.10,1.00,0.33,0.20,1,8.00,3,811.69,0,4,15,org.apache.jackrabbit.test.RepositoryStub,0.14,11,1,7,1,11,1,0,6,178,1
"org.apache.jackrabbit.spi.RepositoryStubImpl$AbstractRepositoryConfig",1,0.00,1.00,3,0.01,72.00,1,0,19,1,1,138.58,0,4,0,1,138.58,0.00,0.00,0.00,0,1.00,1,32.00,0,1,1,java.lang.Object,0.00,0,0,1,0,0,0,0,0,12,0
"org.apache.jackrabbit.spi.ServiceStubImpl",4,0.00,1.75,25,0.35,9007.39,9,5,16,12,12,165.44,6,38,1,2,115.44,1.00,0.33,0.20,0,10.00,2,1036.86,1,3,11,org.apache.jackrabbit.spi.RepositoryServiceStub,0.60,8,1,7,1,8,1,0,2,219,1
"org.apache.jackrabbit.spi.SessionInfoImpl",10,0.06,1.20,34,0.29,4883.74,14,4,4,18,10,171.87,28,48,7,2,131.99,0.00,0.50,0.20,0,54.00,2,878.71,4,5,3,org.apache.jackrabbit.spi.commons.SessionInfoImpl,0.11,8,1,12,0,8,5,0,7,219,1
"org.apache.jackrabbit.spi.Spi2davRepositoryServiceFactory",1,0.00,11.00,45,0.61,48433.25,7,6,14,11,14,103.79,31,58,1,1,71.89,0.00,0.00,1.00,0,0.00,11,1831.41,0,1,13,java.lang.Object,0.00,10,0,11,0,10,0,1,8,320,1
"org.apache.jackrabbit.spi.TestAll",1,0.00,1.00,5,0.05,1005.92,1,0,3,4,1,73.18,8,7,0,2,121.28,0.00,0.50,0.00,0,1.00,1,159.94,0,1,1,junit.framework.TestCase,0.00,3,1,1,0,3,0,0,3,40,1
"org.apache.jackrabbit.spi.URIResolver",3,0.00,1.00,4,0.04,155.83,3,0,5,3,5,207.49,3,5,1,1,157.49,0.00,0.00,0.00,0,3.00,1,106.00,0,3,4,,0.00,0,0,3,0,0,0,0,1,34,0
"org.apache.jackrabbit.spi.URIResolverImpl",15,0.11,3.13,162,2.53,120662.70,19,4,31,88,28,152.68,29,219,1,1,102.68,0.00,0.00,0.15,8,59.00,12,7583.67,0,10,28,java.lang.Object,0.00,73,0,47,0,73,5,1,21,1346,0
"org.apache.jackrabbit.test.api.retention.AbstractRetentionTest",4,0.33,1.75,22,0.21,3912.36,6,2,9,8,8,121.25,3,32,5,4,121.25,2.67,0.25,0.25,0,4.00,2,621.15,4,3,3,org.apache.jackrabbit.test.AbstractJCRTest,0.13,4,3,7,8,4,1,0,1,143,2
"org.apache.jackrabbit.test.api.retention.HoldEffectTest",13,0.31,1.77,122,1.68,44185.65,16,3,9,38,4,157.46,16,152,1,5,107.47,0.00,0.80,0.62,2,0.00,9,5034.56,3,0,3,org.apache.jackrabbit.test.api.retention.AbstractRetentionTest,0.23,25,4,23,0,25,13,0,14,974,1
"org.apache.jackrabbit.test.api.retention.HoldTest",22,0.00,2.41,224,2.94,84013.95,22,0,15,53,3,155.29,37,300,1,5,105.29,0.00,0.80,0.00,3,0.00,7,8807.52,5,2,2,org.apache.jackrabbit.test.api.retention.AbstractRetentionTest,0.00,31,4,53,0,31,20,0,35,1688,1
"org.apache.jackrabbit.test.api.retention.RetentionPolicyEffectTest",9,0.21,1.89,85,1.03,24144.73,12,3,8,31,4,158.26,13,111,1,5,108.26,0.00,0.80,0.52,2,0.00,7,3100.25,3,0,3,org.apache.jackrabbit.test.api.retention.AbstractRetentionTest,0.26,22,4,17,0,22,9,0,11,620,1
"org.apache.jackrabbit.test.api.retention.RetentionPolicyTest",22,0.00,2.45,219,2.44,60454.33,22,0,12,47,3,158.12,37,308,1,5,108.12,0.00,0.80,0.00,2,0.00,7,7317.40,6,2,2,org.apache.jackrabbit.test.api.retention.AbstractRetentionTest,0.10,25,4,54,0,25,20,0,35,1476,1
"org.apache.jackrabbit.test.api.retention.RetentionPolicyTest$RetentionPolicy",1,0.00,1.00,3,0.01,111.66,1,0,12,1,0,137.08,0,4,0,1,137.08,0.00,0.00,0.00,0,1.00,1,41.22,0,1,0,java.lang.Object,0.00,0,0,1,0,0,0,0,0,14,0
"org.apache.jackrabbit.test.api.retention.TestAll",1,0.00,1.00,8,0.07,2228.14,1,0,3,3,5,68.66,7,10,1,2,110.95,0.00,0.50,0.00,0,1.00,1,223.66,0,1,4,junit.framework.TestCase,0.00,2,1,1,0,2,0,0,2,55,1
"org.apache.jackrabbit.webdav.jcr.AbstractItemResource",18,0.10,3.22,149,2.38,96022.89,21,3,36,87,30,65.40,142,226,2,2,107.69,5.00,0.14,0.24,3,102.00,12,7127.03,9,8,28,org.apache.jackrabbit.webdav.jcr.AbstractResource,0.13,69,1,58,5,69,10,2,43,1308,1
"org.apache.jackrabbit.webdav.jcr.AbstractResource",43,0.03,1.67,191,2.62,83434.65,54,11,61,114,56,90.31,286,285,4,1,122.53,0.00,0.00,0.06,10,854.00,5,7863.03,0,26,52,java.lang.Object,0.00,71,0,72,8,71,17,4,75,1623,1
"org.apache.jackrabbit.webdav.jcr.AbstractResource$EListener",2,0.00,2.50,16,0.24,5536.66,5,3,61,9,6,149.88,5,29,0,1,110.00,0.00,0.00,0.33,0,2.00,4,734.56,0,0,6,java.lang.Object,0.00,7,0,5,0,7,2,1,3,153,0
"org.apache.jackrabbit.webdav.jcr.DavLocatorFactoryImpl",3,0.50,3.33,29,0.33,13164.99,4,1,3,15,3,58.34,26,41,1,2,106.45,1.00,0.33,0.67,0,1.00,5,987.41,0,2,2,org.apache.jackrabbit.webdav.AbstractLocatorFactory,0.00,12,1,10,1,12,1,0,7,202,1
"org.apache.jackrabbit.webdav.jcr.DavResourceFactoryImpl",6,0.07,4.00,76,1.24,58020.03,9,3,26,41,25,54.91,66,104,1,1,99.04,0.00,0.00,0.39,1,6.00,10,3730.79,0,4,24,java.lang.Object,0.00,35,0,24,1,35,2,1,14,655,1
"org.apache.jackrabbit.webdav.jcr.DefaultItemCollection",30,0.31,4.77,382,5.95,282238.53,32,2,72,177,44,50.62,328,555,3,3,99.09,1.50,0.33,0.20,8,86.00,20,17853.40,22,10,41,org.apache.jackrabbit.webdav.jcr.AbstractItemResource,0.16,147,2,143,3,147,20,1,91,3142,1
"org.apache.jackrabbit.webdav.jcr.DefaultItemResource",16,0.73,2.75,111,1.57,50101.31,17,1,47,69,27,71.92,120,167,1,3,114.21,0.00,0.67,0.31,4,44.00,8,4699.53,9,3,26,org.apache.jackrabbit.webdav.jcr.AbstractItemResource,0.04,53,2,44,0,53,13,0,23,914,1
"org.apache.jackrabbit.webdav.jcr.ItemResourceConstants",0,0.00,0.00,48,1.35,46843.37,47,47,9,4,38,171.00,73,49,30,1,171.00,0.00,0.00,0.00,0,0.00,0,4037.55,0,0,8,,0.00,4,0,0,0,4,0,0,26,592,1
"org.apache.jackrabbit.webdav.jcr.JCRWebdavServerServlet",13,0.06,2.00,86,1.03,31080.09,25,12,21,47,20,65.21,126,124,2,3,115.21,1.50,0.33,0.13,2,88.00,7,3087.47,1,7,18,org.apache.jackrabbit.webdav.server.AbstractWebdavServlet,0.20,34,2,26,3,34,6,0,30,618,2
"org.apache.jackrabbit.webdav.jcr.JcrDavException",5,0.08,2.40,51,0.79,24334.76,8,3,29,18,30,56.35,41,64,25,3,104.46,0.00,0.67,0.27,0,10.00,7,2356.73,0,1,5,org.apache.jackrabbit.webdav.DavException,0.21,13,2,12,0,13,4,0,8,485,1
"org.apache.jackrabbit.webdav.jcr.JcrDavExceptionTest",2,0.00,1.50,10,0.09,1229.20,2,0,3,9,1,123.11,9,16,0,2,122.87,0.00,0.50,0.00,0,2.00,2,277.63,0,0,1,junit.framework.TestCase,0.00,7,1,3,0,7,2,0,6,71,1
"org.apache.jackrabbit.webdav.jcr.JcrDavExceptionTest$DerievedRepositoryException",0,0.00,0.00,1,0.01,72.00,0,0,3,0,0,171.00,0,2,0,2,171.00,0.00,0.50,0.00,0,0.00,0,24.00,0,0,0,javax.jcr.lock.LockException,0.00,0,1,0,0,0,0,0,0,8,3
"org.apache.jackrabbit.webdav.jcr.JcrDavSession",8,0.10,1.25,27,0.28,5857.57,11,3,8,21,25,98.37,54,38,21,1,130.59,0.00,0.00,0.25,2,12.00,2,853.95,0,4,4,java.lang.Object,0.00,13,0,10,2,13,4,1,12,211,2
"org.apache.jackrabbit.webdav.jcr.JcrValueType",2,0.33,2.50,28,0.48,16782.60,5,3,5,11,8,106.27,34,34,8,1,97.14,0.00,0.00,0.50,1,2.00,4,1427.89,0,1,0,java.lang.Object,0.00,9,0,5,0,9,1,0,6,309,2
"org.apache.jackrabbit.webdav.jcr.JcrValueTypeTest",3,0.00,2.00,20,0.19,3836.55,3,0,2,6,1,167.35,3,20,0,2,117.35,0.00,0.50,0.00,0,3.00,2,560.56,0,0,1,junit.framework.TestCase,0.00,3,1,6,0,3,3,0,1,126,1
"org.apache.jackrabbit.webdav.jcr.RootCollection",13,1.00,1.38,76,0.98,32793.95,14,1,22,45,14,85.84,85,98,1,2,118.06,0.00,0.50,0.08,3,24.00,4,2951.14,4,5,13,org.apache.jackrabbit.webdav.jcr.AbstractResource,0.07,32,1,18,0,32,8,0,18,566,1
"org.apache.jackrabbit.webdav.jcr.VersionControlledItemCollection",18,0.88,4.83,227,3.58,199106.60,19,1,41,96,29,54.41,206,315,1,4,98.54,0.00,0.75,0.17,5,0.00,24,10729.70,13,8,28,org.apache.jackrabbit.webdav.jcr.DefaultItemCollection,0.11,78,3,87,0,78,10,1,75,1874,1
"org.apache.jackrabbit.webdav.jcr.WorkspaceResourceImpl",25,0.83,2.04,167,2.36,98818.45,26,1,44,89,30,95.61,138,220,1,2,113.48,0.00,0.50,0.20,5,123.00,8,7066.24,9,10,29,org.apache.jackrabbit.webdav.jcr.AbstractResource,0.12,64,1,51,0,64,15,2,43,1324,1
"org.apache.jackrabbit.spi.commons.query.AndQueryNode",4,0.00,1.25,11,0.09,1130.96,4,0,1,5,14,122.54,23,17,12,3,140.42,0.00,0.67,0.00,0,4.00,2,255.84,1,1,3,org.apache.jackrabbit.spi.commons.query.NAryQueryNode,0.15,1,2,5,0,1,3,0,5,71,1
"org.apache.jackrabbit.spi.commons.query.ConstantNameProvider",1,0.00,1.00,2,0.01,41.48,1,0,0,1,1,98.93,8,3,1,1,147.03,0.00,0.00,0.00,0,1.00,1,27.65,0,1,0,,0.00,0,0,1,0,0,0,0,2,11,1
"org.apache.jackrabbit.spi.commons.query.DefaultQueryNodeFactory",13,1.00,1.00,28,0.24,3247.40,14,1,2,25,19,161.51,46,49,4,1,140.89,0.00,0.00,0.08,0,24.00,1,714.30,0,4,15,java.lang.Object,0.00,12,0,13,0,12,9,1,15,203,1
"org.apache.jackrabbit.spi.commons.query.DefaultQueryNodeVisitor",13,0.00,1.00,27,0.22,2640.87,13,0,1,13,19,141.60,4,41,5,1,141.60,0.00,0.00,0.00,0,13.00,1,667.97,0,13,14,java.lang.Object,0.00,0,0,13,1,0,0,1,1,188,1
"org.apache.jackrabbit.spi.commons.query.DerefQueryNode",7,0.67,1.29,21,0.17,4220.37,8,1,2,9,14,113.38,39,31,11,4,131.25,0.00,0.75,0.43,0,15.00,3,520.21,3,2,4,org.apache.jackrabbit.spi.commons.query.LocationStepQueryNode,0.23,2,3,9,0,2,5,0,11,135,1
"org.apache.jackrabbit.spi.commons.query.ExactQueryNode",7,0.25,1.57,24,0.23,7636.08,9,2,2,10,10,111.30,40,35,8,2,129.18,1.00,0.33,0.29,0,14.00,4,691.35,0,3,3,org.apache.jackrabbit.spi.commons.query.QueryNode,0.29,3,1,11,1,3,4,0,10,171,1
"org.apache.jackrabbit.spi.commons.query.LocationStepQueryNode",12,0.05,1.25,40,0.42,11772.24,19,7,3,18,23,87.30,89,58,19,3,129.59,0.50,0.50,0.10,0,60.00,3,1261.95,2,3,5,org.apache.jackrabbit.spi.commons.query.NAryQueryNode,0.11,6,2,15,1,6,9,0,20,296,1
"org.apache.jackrabbit.spi.commons.query.NAryQueryNode",9,0.06,2.67,56,0.56,16773.54,11,2,5,23,11,83.77,61,78,9,2,115.99,8.00,0.10,0.44,0,0.00,4,1672.21,0,1,2,org.apache.jackrabbit.spi.commons.query.QueryNode,0.12,14,1,24,8,14,8,0,13,372,2
"org.apache.jackrabbit.spi.commons.query.NodeTypeQueryNode",4,0.00,1.25,11,0.09,1186.41,4,0,3,5,18,108.03,24,17,14,3,140.25,0.00,0.67,0.00,0,4.00,2,272.03,1,1,5,org.apache.jackrabbit.spi.commons.query.ExactQueryNode,0.17,1,2,5,0,1,3,0,8,74,1
"org.apache.jackrabbit.spi.commons.query.NotQueryNode",4,0.00,1.25,11,0.09,1130.96,4,0,1,5,13,122.54,20,17,11,3,140.42,0.00,0.67,0.00,0,4.00,2,255.84,1,1,3,org.apache.jackrabbit.spi.commons.query.NAryQueryNode,0.15,1,2,5,0,1,3,0,5,71,1
"org.apache.jackrabbit.spi.commons.query.OrQueryNode",4,0.00,1.25,11,0.09,1130.96,4,0,1,5,12,122.54,22,17,10,3,140.42,0.00,0.67,0.00,0,4.00,2,255.84,1,1,3,org.apache.jackrabbit.spi.commons.query.NAryQueryNode,0.15,1,2,5,0,1,3,0,5,71,1
"org.apache.jackrabbit.spi.commons.query.OrderQueryNode",11,0.60,1.18,32,0.30,5042.70,12,1,7,23,20,106.55,76,47,15,2,138.78,0.00,0.50,0.45,2,16.00,2,898.56,0,2,6,org.apache.jackrabbit.spi.commons.query.QueryNode,0.22,12,1,13,0,12,9,0,17,231,1
"org.apache.jackrabbit.spi.commons.query.OrderQueryNode$OrderSpec",7,0.17,1.29,21,0.18,4509.00,9,2,7,11,2,88.73,52,31,0,1,131.02,0.00,0.00,0.36,0,11.00,3,547.59,0,2,2,java.lang.Object,0.00,4,0,9,0,4,5,0,9,144,3
"org.apache.jackrabbit.spi.commons.query.PathQueryNode",10,0.19,2.10,52,0.57,20392.21,13,3,4,19,20,76.40,74,76,14,3,118.69,0.50,0.50,0.17,1,42.00,10,1710.91,3,2,7,org.apache.jackrabbit.spi.commons.query.NAryQueryNode,0.23,9,2,21,1,9,8,0,24,366,1
"org.apache.jackrabbit.spi.commons.query.PropertyFunctionQueryNode",6,0.15,1.33,28,0.24,4364.33,10,4,4,10,14,77.83,51,39,13,2,125.94,0.00,0.50,0.12,0,14.00,2,715.50,0,2,2,org.apache.jackrabbit.spi.commons.query.QueryNode,0.31,4,1,8,0,4,4,0,11,178,1
"org.apache.jackrabbit.spi.commons.query.QueryConstants",0,0.00,0.00,58,0.91,24369.42,53,53,3,1,8,171.00,176,59,7,1,171.00,0.00,0.00,0.00,0,0.00,0,2722.35,0,0,1,,0.00,1,0,0,0,1,0,0,55,408,1
"org.apache.jackrabbit.spi.commons.query.QueryConstants$ConstantNameProvider",1,0.00,2.00,26,0.46,12246.35,2,1,3,6,0,85.87,0,29,0,1,85.87,0.00,0.00,1.00,0,0.00,2,1380.54,0,1,0,java.lang.Object,0.00,5,0,2,0,5,0,0,0,246,0
"org.apache.jackrabbit.spi.commons.query.QueryConstants$ConstantNameProvider_0",1,0.00,2.00,13,0.18,4270.23,2,1,3,6,0,100.70,0,16,0,1,100.70,0.00,0.00,1.00,0,0.00,2,549.56,0,1,0,java.lang.Object,0.00,5,0,2,0,5,0,0,0,116,0
"org.apache.jackrabbit.spi.commons.query.QueryNode",7,0.07,1.00,27,0.31,5642.15,21,14,1,10,25,80.32,69,31,24,1,130.32,0.00,0.00,0.01,0,12.00,1,940.67,0,3,2,java.lang.Object,0.00,3,0,7,15,3,4,0,22,207,2
"org.apache.jackrabbit.spi.commons.query.QueryNodeFactory",12,0.00,1.00,13,0.08,245.28,12,0,1,12,24,128.46,80,17,11,1,160.68,0.00,0.00,0.00,0,12.00,1,240.28,0,9,14,,0.00,0,0,12,0,0,3,0,13,87,1
"org.apache.jackrabbit.spi.commons.query.QueryNodeVisitor",13,0.00,1.00,14,0.14,736.16,13,0,1,13,20,157.20,3,15,20,1,157.20,0.00,0.00,0.00,0,13.00,1,422.09,0,13,13,,0.00,0,0,13,0,0,0,0,1,135,1
"org.apache.jackrabbit.spi.commons.query.QueryParser",3,0.00,1.00,8,0.10,1925.19,3,0,2,6,8,108.28,40,19,3,1,137.66,0.00,0.00,0.00,0,3.00,1,308.05,0,1,5,java.lang.Object,0.00,3,0,3,0,3,2,0,4,73,1
"org.apache.jackrabbit.spi.commons.query.QueryRootNode",11,0.07,1.27,29,0.31,9353.40,14,3,4,21,26,118.77,63,44,22,2,136.65,0.00,0.50,0.27,0,33.00,4,924.62,0,4,5,org.apache.jackrabbit.spi.commons.query.QueryNode,0.22,10,1,14,0,10,7,0,15,236,1
"org.apache.jackrabbit.spi.commons.query.QueryTreeBuilder",4,0.00,1.00,5,0.04,162.28,4,0,2,4,6,108.34,38,10,3,1,158.34,0.00,0.00,0.00,0,4.00,1,113.36,0,2,3,,0.00,0,0,4,0,0,2,0,5,38,1
"org.apache.jackrabbit.spi.commons.query.QueryTreeBuilderRegistry",2,0.00,2.00,25,0.33,9203.40,5,3,11,9,3,72.36,26,33,2,1,101.74,0.00,0.00,0.33,0,2.00,3,979.04,0,1,1,java.lang.Object,0.00,7,0,4,0,7,1,0,6,202,1
"org.apache.jackrabbit.spi.commons.query.QueryTreeDump",17,0.21,2.35,214,2.66,103347.41,20,3,4,62,19,140.64,34,232,2,1,100.75,0.00,0.00,0.53,3,0.00,8,7991.28,0,13,18,java.lang.Object,0.00,45,0,40,0,45,4,1,10,1551,1
"org.apache.jackrabbit.spi.commons.query.RelationQueryNode",20,0.05,1.45,73,0.73,20473.08,31,11,6,35,19,87.12,147,105,11,3,129.41,0.00,0.67,0.14,1,164.00,5,2176.01,0,4,10,org.apache.jackrabbit.spi.commons.query.NAryQueryNode,0.08,15,2,29,0,15,16,1,31,504,1
"org.apache.jackrabbit.spi.commons.query.TextsearchQueryNode",13,0.08,1.69,49,0.48,12778.57,16,3,5,25,16,87.22,93,73,11,2,129.52,0.00,0.50,0.26,0,49.00,4,1449.14,0,4,6,org.apache.jackrabbit.spi.commons.query.QueryNode,0.20,12,1,22,0,12,9,0,20,345,1
"org.apache.jackrabbit.spi.commons.query.TraversingQueryNodeVisitor",7,0.00,1.29,21,0.24,4601.63,7,0,1,17,9,130.95,4,31,0,2,130.95,0.00,0.50,0.00,0,7.00,3,720.95,0,7,9,org.apache.jackrabbit.spi.commons.query.DefaultQueryNodeVisitor,0.00,10,1,9,0,10,0,0,1,176,1
"org.apache.jackrabbit.core.jndi.BindableRepository",14,0.04,1.14,47,0.47,7920.85,20,6,15,36,6,81.50,131,72,2,2,131.50,0.00,0.50,0.20,1,0.00,2,1416.37,0,8,5,org.apache.jackrabbit.commons.AbstractRepository,0.00,22,1,16,0,22,6,4,28,342,1
"org.apache.jackrabbit.core.jndi.BindableRepository$Thread",1,0.00,1.00,3,0.01,56.92,1,0,15,2,0,139.38,0,4,0,1,139.38,0.00,0.00,0.00,0,1.00,1,30.46,0,0,0,java.lang.Object,0.00,1,0,1,0,1,1,0,0,12,0
"org.apache.jackrabbit.core.jndi.BindableRepositoryFactory",2,0.00,1.50,12,0.14,4106.11,3,1,8,7,2,65.80,18,20,2,1,115.80,0.00,0.00,1.00,0,0.00,2,411.33,0,1,1,java.lang.Object,0.00,5,0,3,0,5,1,1,4,91,1
"org.apache.jackrabbit.core.jndi.RegistryHelper",3,0.00,1.33,14,0.22,6262.68,3,0,7,14,4,84.77,37,30,1,1,122.33,0.00,0.00,0.00,0,3.00,2,657.32,0,0,3,java.lang.Object,0.00,11,0,4,0,11,3,0,8,135,1
"org.apache.jackrabbit.core.lock.ConcurrentLockingTest",3,0.00,1.00,12,0.07,767.77,5,2,5,5,2,150.19,11,13,1,5,129.58,0.00,0.80,0.50,0,0.00,1,205.62,1,0,1,org.apache.jackrabbit.core.AbstractConcurrencyTest,0.00,2,4,3,0,2,3,0,3,57,1
"org.apache.jackrabbit.core.lock.ConcurrentLockingTest$Task",1,0.00,2.00,11,0.10,2244.14,1,0,5,6,0,105.61,0,10,0,1,105.61,0.00,0.00,0.00,0,1.00,2,305.62,0,0,0,java.lang.Object,0.00,5,0,2,0,5,1,0,0,63,0
"org.apache.jackrabbit.core.lock.ConcurrentLockingTest$Task_0",1,0.00,2.00,12,0.12,3031.40,1,0,5,7,0,153.17,1,11,0,1,103.17,0.00,0.00,0.00,0,1.00,2,367.45,0,0,0,java.lang.Object,0.00,6,0,2,0,6,1,0,1,73,0
"org.apache.jackrabbit.core.lock.ConcurrentLockingTest$Task_1",1,0.00,3.00,12,0.12,2838.01,1,0,5,7,0,103.30,0,12,0,1,103.30,0.00,0.00,0.00,0,1.00,3,346.53,0,0,0,java.lang.Object,0.00,6,0,3,0,6,1,0,0,70,0
"org.apache.jackrabbit.core.lock.ConcurrentLockingWithTransactionsTest",3,0.17,1.33,15,0.13,2580.16,6,3,10,8,4,142.37,9,21,1,5,121.75,0.00,0.80,0.22,0,1.00,2,377.60,1,1,3,org.apache.jackrabbit.core.AbstractConcurrencyTest,0.00,5,4,4,0,5,2,0,4,93,1
"org.apache.jackrabbit.core.lock.ConcurrentLockingWithTransactionsTest$Task",1,0.00,4.00,22,0.31,15666.15,1,0,10,16,1,137.57,1,25,0,1,87.57,0.00,0.00,0.00,0,1.00,4,936.11,0,0,1,java.lang.Object,0.00,15,0,4,0,15,1,0,1,157,0
"org.apache.jackrabbit.core.lock.ConcurrentLockingWithTransactionsTest$Task_0",1,0.00,4.00,20,0.30,14300.47,1,0,10,15,1,129.31,2,23,0,1,89.43,0.00,0.00,0.00,0,1.00,4,893.65,0,0,1,java.lang.Object,0.00,14,0,4,0,14,1,0,2,150,0
"org.apache.jackrabbit.core.lock.ExtendedLockingTest",1,0.00,3.00,12,0.13,2976.95,1,0,5,9,2,103.37,4,18,1,4,103.14,0.00,0.75,0.00,0,0.00,3,383.75,0,0,1,org.apache.jackrabbit.test.AbstractJCRTest,0.00,8,3,3,0,8,1,0,2,79,1
"org.apache.jackrabbit.core.lock.LockImpl",10,0.11,1.50,40,0.40,8531.22,12,2,6,25,6,107.49,51,60,2,1,125.37,0.00,0.00,0.60,0,0.00,3,1202.83,0,3,4,java.lang.Object,0.00,15,0,15,1,15,7,1,21,283,0
"org.apache.jackrabbit.core.lock.LockInfo",21,0.01,1.71,120,1.26,67335.97,30,9,5,38,9,84.97,142,159,7,1,117.19,0.00,0.00,0.10,2,258.00,8,3787.97,0,6,2,java.lang.Object,0.00,17,0,36,1,17,15,0,30,805,2
"org.apache.jackrabbit.core.lock.LockManager",12,0.00,1.00,13,0.15,688.28,12,0,7,12,8,107.15,116,19,5,1,157.15,0.00,0.00,0.00,0,12.00,1,438.94,0,4,3,,0.00,0,0,12,0,0,8,0,13,131,1
"org.apache.jackrabbit.core.lock.LockManagerImpl",43,0.02,3.09,477,6.79,294416.33,52,9,53,173,36,69.47,277,681,7,1,101.69,0.00,0.00,0.13,21,393.00,10,20364.29,0,6,30,java.lang.Object,0.00,130,0,133,0,130,37,4,80,3683,1
"org.apache.jackrabbit.core.lock.LockManagerImpl$HierarchyEvent",4,0.13,1.25,22,0.16,3162.39,9,5,53,4,2,72.06,39,28,0,1,122.05,0.00,0.00,0.30,0,2.00,2,467.12,0,2,2,java.lang.Object,0.00,0,0,5,0,0,2,0,9,120,1
"org.apache.jackrabbit.core.lock.LockManagerImpl$InternalLockInfo",3,0.00,3.00,23,0.30,8781.92,3,0,53,13,6,63.82,26,35,0,2,111.93,0.00,0.50,0.00,0,4.00,7,899.61,2,0,6,org.apache.jackrabbit.spi.LockInfo,0.00,10,1,9,0,10,3,1,8,177,0
"org.apache.jackrabbit.core.lock.LockManagerImpl$PathMap.ElementVisitor<LockInfo>_0",1,0.00,2.00,5,0.06,1103.81,1,0,53,4,1,120.81,0,7,0,1,120.81,0.00,0.00,0.00,0,1.00,2,177.87,0,0,1,java.lang.Object,0.00,3,0,2,0,3,1,0,0,43,0
"org.apache.jackrabbit.core.lock.LockManagerImpl$PathMap.ElementVisitor<LockInfo>_1",1,0.00,2.00,5,0.07,1306.95,1,0,53,5,1,120.23,0,7,0,1,120.23,0.00,0.00,0.00,0,1.00,2,204.95,0,0,1,java.lang.Object,0.00,4,0,2,0,4,1,0,0,48,0
"org.apache.jackrabbit.core.lock.LockManagerImpl$PathMap.ElementVisitor<LockInfo>_2",1,0.00,3.00,7,0.11,3068.37,1,0,53,5,2,111.76,0,11,0,1,111.76,0.00,0.00,0.00,0,0.00,3,323.53,0,0,2,java.lang.Object,0.00,4,0,3,0,4,1,0,0,68,0
"org.apache.jackrabbit.core.lock.LockManagerImpl$PathMap.ElementVisitor<LockInfo>_3",1,0.00,1.00,3,0.04,412.25,1,0,53,3,0,132.61,0,4,0,1,132.61,0.00,0.00,0.00,0,1.00,1,112.53,0,0,0,java.lang.Object,0.00,2,0,1,0,2,1,0,0,30,0
"org.apache.jackrabbit.core.lock.LockManagerImpl$PathMap.ElementVisitor<LockInfo>_4",1,0.00,3.00,17,0.21,8463.37,1,0,53,8,0,93.92,0,17,0,1,93.92,0.00,0.00,0.00,0,1.00,3,615.21,0,0,0,java.lang.Object,0.00,7,0,3,0,7,1,0,0,120,0
"org.apache.jackrabbit.core.lock.LockManagerImpl$ReentrantLock",3,0.00,3.00,23,0.25,9206.39,4,1,53,10,1,112.00,14,33,0,1,111.76,0.00,0.00,1.00,0,0.00,5,753.01,0,0,1,java.lang.Object,0.00,7,0,9,0,7,3,0,4,157,0
"org.apache.jackrabbit.core.lock.LockManagerImpl$TimeoutHandler",1,0.00,1.00,4,0.02,122.37,1,0,53,2,1,132.10,0,5,0,1,132.10,0.00,0.00,0.00,0,0.00,1,52.05,0,0,1,java.lang.Object,0.00,1,0,1,0,1,1,1,0,17,1
"org.apache.jackrabbit.core.lock.LockManagerImpl$TimeoutHandler$PathMap.ElementVisitor<LockInfo>",1,0.00,4.00,12,0.17,6057.20,1,0,53,9,3,150.64,1,17,0,1,100.64,0.00,0.00,0.00,0,0.00,4,521.42,0,0,3,java.lang.Object,0.00,8,0,4,0,8,1,0,1,101,0
"org.apache.jackrabbit.core.lock.SessionLockManager",12,0.20,1.83,79,1.00,28688.87,17,5,16,39,10,83.01,72,114,3,1,115.23,0.00,0.00,0.38,1,0.00,4,3001.90,0,3,7,java.lang.Object,0.00,27,0,22,0,27,9,1,19,628,1
"org.apache.jackrabbit.core.lock.TestAll",1,0.00,1.00,5,0.04,864.35,1,0,3,3,1,73.32,10,7,0,2,121.80,0.00,0.50,0.00,0,1.00,1,115.51,0,1,1,junit.framework.TestCase,0.00,2,1,1,0,2,0,0,2,31,1
"org.apache.jackrabbit.core.lock.XAEnvironment",15,0.13,3.40,172,2.22,88047.37,28,13,14,75,10,54.09,125,228,2,1,102.20,0.00,0.00,0.20,5,25.00,7,6668.37,0,5,8,java.lang.Object,0.00,60,0,51,0,60,10,0,38,1254,0
"org.apache.jackrabbit.core.lock.XAEnvironment$XALockInfo",7,0.17,1.71,33,0.37,7545.65,9,2,14,19,4,106.66,40,53,0,2,124.54,0.00,0.50,0.36,0,15.00,4,1114.50,1,0,4,org.apache.jackrabbit.core.lock.LockInfo,0.07,12,1,12,0,12,7,0,13,247,0
"org.apache.jackrabbit.core.lock.XALockImpl",2,0.00,2.00,12,0.10,1504.35,4,2,2,5,4,69.16,19,18,1,2,119.16,0.00,0.50,0.50,0,2.00,3,312.38,1,0,4,org.apache.jackrabbit.core.lock.LockImpl,0.17,3,1,4,0,3,2,0,5,79,0
"org.apache.jackrabbit.core.lock.XALockManager",21,0.12,2.05,124,1.40,40456.43,24,3,10,57,13,119.13,86,169,3,1,118.90,0.00,0.00,0.44,3,0.00,4,4187.96,0,4,11,java.lang.Object,0.00,36,0,43,0,36,17,2,27,899,1
"org.apache.jackrabbit.core.retention.AbstractRetentionTest",2,0.00,1.00,5,0.07,797.36,2,0,3,3,6,179.18,4,9,3,5,139.29,0.75,0.50,0.00,1,2.00,1,201.52,0,2,3,org.apache.jackrabbit.test.api.retention.AbstractRetentionTest,0.16,1,4,2,3,1,0,0,2,53,2
"org.apache.jackrabbit.core.retention.HoldImpl",9,0.12,1.56,52,0.62,16739.52,17,8,11,26,11,169.08,17,65,4,1,119.08,0.00,0.00,0.24,0,10.00,3,1862.83,0,5,7,java.lang.Object,0.00,17,0,14,0,17,4,1,7,404,0
"org.apache.jackrabbit.core.retention.HoldTest",5,1.00,2.40,39,0.44,10195.53,6,1,5,16,3,163.21,8,58,1,6,113.21,0.00,0.83,0.20,0,0.00,3,1323.98,1,0,2,org.apache.jackrabbit.core.retention.AbstractRetentionTest,0.16,11,5,12,0,11,5,0,6,280,1
"org.apache.jackrabbit.core.retention.HoldTest$Hold",2,0.00,1.00,5,0.03,405.51,2,0,5,4,0,141.60,0,7,0,1,141.60,0.00,0.00,0.00,0,2.00,1,97.95,0,1,0,java.lang.Object,0.00,2,0,2,0,2,1,0,0,30,0
"org.apache.jackrabbit.core.retention.HoldTest$Hold_0",2,0.00,1.00,5,0.03,308.41,2,0,5,3,0,142.54,0,7,0,1,142.54,0.00,0.00,0.00,0,2.00,1,86.19,0,1,0,java.lang.Object,0.00,1,0,2,0,1,1,0,0,27,0
"org.apache.jackrabbit.core.retention.HoldTest$Hold_1",2,0.00,1.00,5,0.03,459.70,2,0,5,4,0,141.17,0,7,0,1,141.17,0.00,0.00,0.00,0,2.00,1,103.16,0,1,0,java.lang.Object,0.00,2,0,2,0,2,1,0,0,31,0
"org.apache.jackrabbit.core.retention.RetentionManagerImpl",7,0.31,3.00,79,1.45,66329.90,13,6,22,42,11,100.82,30,112,3,2,100.59,0.00,0.50,0.43,0,0.00,6,4359.79,2,3,10,org.apache.jackrabbit.core.ProtectedItemModifier,0.00,35,1,21,0,35,4,1,13,785,1
"org.apache.jackrabbit.core.retention.RetentionPolicyImpl",7,0.04,1.71,36,0.37,11649.41,11,4,9,15,10,140.05,25,49,5,1,119.44,0.00,0.00,0.29,0,7.00,4,1114.63,0,3,5,java.lang.Object,0.00,8,0,12,0,8,4,1,7,258,1
"org.apache.jackrabbit.core.retention.RetentionPolicyTest",1,0.00,2.00,6,0.04,531.50,1,0,2,4,2,120.59,4,10,1,6,120.35,0.00,0.83,0.00,0,0.00,2,130.20,0,0,1,org.apache.jackrabbit.core.retention.AbstractRetentionTest,0.00,3,5,2,0,3,1,0,2,33,1
"org.apache.jackrabbit.core.retention.RetentionPolicyTest$RetentionPolicy",1,0.00,1.00,3,0.01,111.66,1,0,2,1,0,137.08,0,4,0,1,137.08,0.00,0.00,0.00,0,1.00,1,41.22,0,1,0,java.lang.Object,0.00,0,0,1,0,0,0,0,0,14,0
"org.apache.jackrabbit.core.retention.RetentionRegistry",2,0.00,1.00,3,0.03,182.53,2,0,2,2,8,205.56,3,4,7,1,155.56,0.00,0.00,0.00,0,2.00,1,81.08,0,0,1,,0.00,0,0,2,0,0,2,0,1,26,1
"org.apache.jackrabbit.core.retention.RetentionRegistryImpl",11,0.19,4.27,140,2.13,82271.09,20,9,31,76,19,67.68,70,197,3,1,99.90,0.00,0.00,0.28,4,10.00,11,6399.88,0,0,16,java.lang.Object,0.00,65,0,47,0,65,11,2,41,1160,1
"org.apache.jackrabbit.core.retention.RetentionRegistryImpl$PathMap.ElementVisitor<List<HoldImpl>>",1,0.00,2.00,5,0.09,1658.83,1,0,31,6,1,119.41,0,7,0,1,119.41,0.00,0.00,0.00,0,1.00,2,255.36,0,0,1,java.lang.Object,0.00,5,0,2,0,5,1,0,0,59,0
"org.apache.jackrabbit.core.retention.RetentionRegistryImpl$PathMap.ElementVisitor<RetentionPolicyImpl>",1,0.00,1.00,3,0.04,463.27,1,0,31,4,0,132.21,0,4,0,1,132.21,0.00,0.00,0.00,0,1.00,1,126.63,0,0,0,java.lang.Object,0.00,3,0,1,0,3,1,0,0,33,0
"org.apache.jackrabbit.core.retention.TestAll",1,0.00,1.00,6,0.05,1283.53,1,0,3,3,2,75.20,7,8,0,2,117.50,0.00,0.50,0.00,0,1.00,1,150.40,0,1,2,junit.framework.TestCase,0.00,2,1,1,0,2,0,0,2,39,1
"org.apache.jackrabbit.spi.commons.query.sql.Parser",1,0.00,1.00,3,0.04,299.53,1,0,2,1,2,96.14,12,5,1,2,133.70,0.00,0.50,0.00,0,1.00,1,107.71,0,0,1,org.apache.jackrabbit.commons.query.sql2.Parser,0.00,0,1,1,0,0,1,0,2,31,1
"org.apache.jackrabbit.spi.commons.query.sql.ParserTest",4,0.00,4.75,67,0.89,38644.72,6,2,33,38,9,134.23,10,87,0,2,94.34,0.00,0.50,0.50,2,0.00,10,2670.34,1,1,9,junit.framework.TestCase,0.00,34,1,19,0,34,3,0,8,481,1
"org.apache.jackrabbit.spi.commons.query.sql.ParserTest$QOM",14,0.77,1.00,27,0.18,1778.74,15,1,33,18,1,154.43,0,44,0,1,154.43,0.00,0.00,0.29,0,38.00,1,545.39,0,10,1,java.lang.Object,0.00,4,0,14,0,4,4,1,0,162,2
"org.apache.jackrabbit.spi.commons.query.sql.ParserTest$QOMF",2,0.00,1.00,5,0.04,349.69,2,0,33,3,3,142.11,0,9,0,2,142.11,0.00,0.50,0.00,0,2.00,1,106.43,0,1,3,org.apache.jackrabbit.spi.commons.query.qom.QueryObjectModelFactoryImpl,0.00,1,1,2,0,1,1,0,0,32,1
"org.apache.jackrabbit.spi.commons.nodetype.constraint.BooleanConstraint",2,0.00,3.00,23,0.29,10699.16,3,1,5,11,4,123.16,7,34,2,2,102.54,0.00,0.50,1.00,0,0.00,3,869.61,0,0,3,org.apache.jackrabbit.spi.commons.nodetype.constraint.ValueConstraint,0.00,9,1,6,0,9,2,0,3,172,0
"org.apache.jackrabbit.spi.commons.nodetype.constraint.BooleanConstraintTest",9,1.00,1.11,24,0.27,4410.96,10,1,6,17,4,138.56,4,39,0,3,138.56,0.00,0.67,0.00,1,18.00,2,803.49,0,7,4,org.apache.jackrabbit.spi.commons.nodetype.constraint.ValueConstraintTest,0.64,8,2,10,0,8,2,0,2,200,1
"org.apache.jackrabbit.spi.commons.nodetype.constraint.DateConstraint",3,0.62,7.00,70,1.02,79651.51,7,4,10,20,4,105.53,11,110,1,2,84.92,0.00,0.50,0.67,0,0.00,10,3045.17,0,0,4,org.apache.jackrabbit.spi.commons.nodetype.constraint.ValueConstraint,0.00,17,1,21,0,17,3,0,7,557,0
"org.apache.jackrabbit.spi.commons.nodetype.constraint.DateConstraintTest",6,1.00,1.00,25,0.29,6696.31,7,1,8,18,3,124.54,4,32,0,3,124.54,0.00,0.67,0.00,1,10.00,1,872.89,0,5,3,org.apache.jackrabbit.spi.commons.nodetype.constraint.ValueConstraintTest,0.72,12,2,6,0,12,1,0,2,200,1
"org.apache.jackrabbit.spi.commons.nodetype.constraint.NameConstraint",5,0.75,2.00,32,0.41,14498.76,6,1,10,18,8,135.16,16,53,2,2,114.55,0.00,0.50,0.40,0,9.00,3,1221.31,1,3,7,org.apache.jackrabbit.spi.commons.nodetype.constraint.ValueConstraint,0.00,13,1,10,0,13,2,0,6,255,0
"org.apache.jackrabbit.spi.commons.nodetype.constraint.NameConstraintTest",7,1.00,1.14,25,0.32,7098.75,8,1,5,18,3,129.50,3,35,0,3,129.50,0.00,0.67,0.00,1,3.00,2,966.27,1,5,3,org.apache.jackrabbit.spi.commons.nodetype.constraint.ValueConstraintTest,0.81,11,2,8,0,11,2,0,1,223,1
"org.apache.jackrabbit.spi.commons.nodetype.constraint.NumericConstraint",3,0.62,6.67,75,1.00,70811.19,7,4,7,20,4,104.60,11,117,2,2,83.98,0.00,0.50,0.67,1,0.00,9,2998.49,0,0,3,org.apache.jackrabbit.spi.commons.nodetype.constraint.ValueConstraint,0.00,17,1,20,0,17,3,0,7,545,0
"org.apache.jackrabbit.spi.commons.nodetype.constraint.NumericConstraintTest",9,1.00,1.00,21,0.22,3343.62,10,1,5,14,4,139.53,4,31,0,3,139.53,0.00,0.67,0.00,1,26.00,1,650.63,0,8,4,org.apache.jackrabbit.spi.commons.nodetype.constraint.ValueConstraintTest,0.64,5,2,9,0,5,1,0,2,169,1
"org.apache.jackrabbit.spi.commons.nodetype.constraint.PathConstraint",5,0.20,4.20,73,0.97,47016.14,10,5,13,31,12,96.86,23,110,3,2,96.63,0.00,0.50,0.36,0,5.00,7,2924.11,1,3,10,org.apache.jackrabbit.spi.commons.nodetype.constraint.ValueConstraint,0.00,26,1,21,0,26,2,0,13,553,0
"org.apache.jackrabbit.spi.commons.nodetype.constraint.PathConstraintTest",7,1.00,1.14,27,0.39,10294.33,8,1,8,16,6,128.23,3,38,0,3,128.23,0.00,0.67,0.00,2,11.00,2,1169.74,1,5,6,org.apache.jackrabbit.spi.commons.nodetype.constraint.ValueConstraintTest,0.81,9,2,8,0,9,2,0,1,265,1
"org.apache.jackrabbit.spi.commons.nodetype.constraint.ReferenceConstraint",5,1.00,1.80,30,0.37,12286.91,6,1,10,17,8,135.75,17,49,2,2,115.14,0.00,0.50,0.20,0,13.00,3,1107.45,1,3,7,org.apache.jackrabbit.spi.commons.nodetype.constraint.ValueConstraint,0.00,12,1,9,0,12,2,0,7,236,0
"org.apache.jackrabbit.spi.commons.nodetype.constraint.ReferenceConstraintTest",8,1.00,1.12,25,0.30,6384.62,9,1,9,19,5,130.32,5,36,0,3,130.32,0.00,0.67,0.00,1,22.00,2,908.79,1,5,5,org.apache.jackrabbit.spi.commons.nodetype.constraint.ValueConstraintTest,0.89,11,2,9,0,11,3,0,3,213,1
"org.apache.jackrabbit.spi.commons.nodetype.constraint.StringConstraint",2,0.00,2.50,21,0.29,11674.69,3,1,8,12,4,124.44,7,32,2,2,103.83,0.00,0.50,1.00,0,0.00,3,882.70,0,0,3,org.apache.jackrabbit.spi.commons.nodetype.constraint.ValueConstraint,0.00,10,1,5,0,10,2,0,3,173,0
"org.apache.jackrabbit.spi.commons.nodetype.constraint.StringConstraintTest",9,1.00,1.00,21,0.20,2891.09,10,1,8,12,6,140.03,4,31,0,3,140.03,0.00,0.67,0.00,1,19.00,1,598.13,0,8,6,org.apache.jackrabbit.spi.commons.nodetype.constraint.ValueConstraintTest,0.64,3,2,9,0,3,1,0,2,158,1
"org.apache.jackrabbit.spi.commons.nodetype.constraint.ValueConstraint",11,0.18,2.27,85,1.31,72653.50,15,4,12,30,35,60.73,111,142,28,1,109.21,0.00,0.00,0.09,1,23.00,9,3941.44,0,7,14,java.lang.Object,0.00,19,0,25,7,19,4,1,21,753,2
"org.apache.jackrabbit.spi.commons.nodetype.constraint.ValueConstraintTest",19,0.28,1.84,110,1.06,27112.61,22,3,13,30,15,119.95,9,119,7,2,119.95,7.00,0.11,0.07,7,58.00,4,3167.15,1,7,8,junit.framework.TestCase,0.00,11,1,35,7,11,12,0,7,685,2
"org.apache.jackrabbit.spi.commons.nodetype.constraint.ValueConstraintTest$NamespaceResolver",2,0.00,1.00,5,0.03,370.77,2,0,13,2,0,141.91,0,7,0,1,141.91,0.00,0.00,0.00,0,2.00,1,87.73,0,2,0,java.lang.Object,0.00,0,0,2,0,0,0,0,0,28,0
"org.apache.jackrabbit.j.AbstractConfig",6,0.00,2.33,45,0.61,17963.86,9,3,9,30,5,161.91,10,61,3,1,111.91,0.00,0.00,0.33,1,10.00,4,1817.27,0,1,2,java.lang.Object,0.00,24,0,14,3,24,5,0,3,369,2
"org.apache.jackrabbit.j.BootstrapConfig",12,0.04,1.17,40,0.28,4197.02,17,5,3,22,5,183.14,15,55,4,2,133.14,0.00,0.50,0.23,0,42.00,3,839.56,2,4,3,org.apache.jackrabbit.j2ee.AbstractConfig,0.22,10,1,14,0,10,8,0,1,229,1
"org.apache.jackrabbit.j.Installer",4,0.31,4.00,77,1.07,40724.75,17,13,11,28,1,109.55,74,99,1,1,91.42,0.00,0.00,0.31,2,0.00,10,3214.71,0,0,0,java.lang.Object,0.00,24,0,16,0,24,4,0,22,575,1
"org.apache.jackrabbit.j.JCRWebdavServerServlet",1,0.00,1.00,3,0.03,323.38,1,0,1,3,2,85.33,8,6,0,4,133.44,0.00,0.75,0.00,0,1.00,1,98.54,0,1,2,org.apache.jackrabbit.webdav.jcr.JCRWebdavServerServlet,0.06,2,3,1,0,2,0,0,2,29,1
"org.apache.jackrabbit.j.JNDIConfig",10,0.03,1.50,38,0.37,6417.74,14,4,5,25,3,181.00,16,54,2,2,131.00,0.00,0.50,0.22,0,38.00,3,1121.64,1,3,2,org.apache.jackrabbit.j2ee.AbstractConfig,0.12,15,1,15,0,15,7,0,4,263,1
"org.apache.jackrabbit.j.JcrApiNotFoundException",1,1.00,1.00,4,0.03,396.24,2,1,0,1,1,83.96,11,6,0,3,128.08,0.00,0.67,0.00,0,1.00,1,97.38,0,0,1,org.apache.jackrabbit.j2ee.ServletExceptionWithCause,0.00,0,2,1,0,0,1,0,3,27,1
"org.apache.jackrabbit.j.JcrRemotingServlet",1,0.00,1.00,3,0.04,346.31,1,0,1,3,2,90.91,7,5,0,5,133.20,0.00,0.80,0.00,0,1.00,1,107.71,0,1,2,org.apache.jackrabbit.server.remoting.davex.JcrRemotingServlet,0.07,2,4,1,0,2,0,0,2,31,1
"org.apache.jackrabbit.j.RMIConfig",15,0.02,1.53,62,0.68,30784.38,22,7,7,30,3,162.25,32,86,2,2,122.36,0.00,0.50,0.16,0,72.00,9,2032.85,1,5,2,org.apache.jackrabbit.j2ee.AbstractConfig,0.10,15,1,23,0,15,10,0,15,428,1
"org.apache.jackrabbit.j.RepositoryAccessServlet",11,0.07,3.55,117,1.36,51924.08,18,7,18,53,7,54.48,103,173,4,2,104.48,0.00,0.50,0.21,4,16.00,10,4083.04,0,8,3,javax.servlet.http.HttpServlet,0.00,42,1,39,0,42,3,0,33,797,1
"org.apache.jackrabbit.j.RepositoryAccessServlet$ClientFactoryDelegater",1,0.00,1.00,2,0.02,146.32,1,0,18,1,0,142.72,0,4,0,1,142.72,0.00,0.00,0.00,0,1.00,1,58.53,0,1,0,java.lang.Object,0.00,0,0,1,0,0,0,0,0,18,3
"org.apache.jackrabbit.j.RepositoryAccessServlet$RMIClientFactoryDelegater",1,1.00,1.00,5,0.06,878.60,2,1,18,5,1,171.75,1,8,0,2,121.75,0.00,0.50,0.00,0,1.00,1,190.92,0,1,1,org.apache.jackrabbit.j2ee.ClientFactoryDelegater,0.00,4,1,1,0,4,0,0,1,46,2
"org.apache.jackrabbit.j.RepositoryStartupServlet",22,0.06,3.27,213,2.77,126510.22,31,9,37,94,13,76.14,300,327,1,3,105.53,0.00,0.67,0.17,11,66.00,12,8309.83,2,6,12,org.apache.jackrabbit.servlet.AbstractRepositoryServlet,0.32,72,2,72,0,72,16,0,69,1531,1
"org.apache.jackrabbit.j.RepositoryStartupServlet$RMIRemoteFactoryDelegater",1,0.00,1.00,4,0.04,639.67,2,1,37,3,2,126.45,0,8,0,2,126.45,0.00,0.50,1.00,0,0.00,1,132.92,0,1,2,org.apache.jackrabbit.j2ee.RemoteFactoryDelegater,0.00,2,1,1,0,2,0,0,0,34,2
"org.apache.jackrabbit.j.RepositoryStartupServlet$RMIServerSocketFactory",1,0.00,1.00,3,0.03,373.67,1,0,37,2,0,132.94,0,4,0,1,132.94,0.00,0.00,0.00,0,1.00,1,78.32,0,1,0,java.lang.Object,0.00,1,0,1,0,1,0,0,0,22,0
"org.apache.jackrabbit.j.RepositoryStartupServlet$RemoteFactoryDelegater",1,0.00,1.00,2,0.02,121.82,1,0,37,1,0,143.35,0,4,0,1,143.35,0.00,0.00,0.00,0,1.00,1,48.73,0,1,0,java.lang.Object,0.00,0,0,1,0,0,0,0,0,16,3
"org.apache.jackrabbit.j.RepositoryStartupServlet$RepositoryFactory",1,0.00,2.00,7,0.04,1173.50,1,0,37,2,0,115.15,0,9,0,1,115.15,0.00,0.00,0.00,0,0.00,2,131.19,0,1,0,java.lang.Object,0.00,1,0,2,0,1,0,0,0,33,0
"org.apache.jackrabbit.j.ServletExceptionWithCause",1,1.00,2.00,6,0.05,687.61,2,1,1,3,4,109.11,15,9,4,2,119.47,1.00,0.33,0.00,0,1.00,2,156.28,0,0,0,javax.servlet.ServletException,0.00,2,1,2,1,2,1,0,3,40,1
"org.apache.jackrabbit.j.SimpleWebdavServlet",2,1.00,1.50,8,0.07,1118.48,3,1,1,4,2,78.33,20,12,0,4,126.81,0.00,0.75,0.50,0,2.00,2,216.88,0,1,2,org.apache.jackrabbit.webdav.simple.SimpleWebdavServlet,0.06,2,3,3,0,2,1,0,4,57,1
"org.apache.jackrabbit.core.security.AMContext",8,0.02,1.00,30,0.21,2832.21,15,7,6,8,12,83.13,72,45,9,1,133.13,0.00,0.00,0.12,0,50.00,1,637.61,0,7,3,java.lang.Object,0.00,0,0,8,0,0,1,0,15,162,1
"org.apache.jackrabbit.core.security.AbstractAccessControlManager",12,0.73,1.00,39,0.42,5687.03,13,1,16,17,6,99.91,75,49,1,1,132.13,0.00,0.00,0.33,4,28.00,1,1257.41,0,7,5,java.lang.Object,0.00,5,0,12,3,5,5,1,16,294,2
"org.apache.jackrabbit.core.security.AccessManager",10,3.00,1.00,14,0.14,783.06,13,3,8,10,22,135.94,147,18,16,1,156.09,0.00,0.00,0.00,0,10.00,1,429.84,0,0,6,,0.00,0,0,10,0,0,10,0,14,125,1
"org.apache.jackrabbit.core.security.AccessManagerTest",18,1.00,1.72,158,2.30,62923.21,19,1,26,54,15,159.28,26,219,1,4,109.28,0.00,0.75,0.00,2,74.00,3,6907.61,1,2,14,org.apache.jackrabbit.test.AbstractJCRTest,0.00,36,3,31,0,36,16,0,23,1372,1
"org.apache.jackrabbit.core.security.AnonymousPrincipal",5,0.75,1.40,15,0.11,1614.87,6,1,2,6,3,173.25,12,26,3,1,133.37,0.00,0.00,0.40,0,7.00,3,315.98,0,2,0,java.lang.Object,0.00,1,0,7,0,1,3,2,5,86,2
"org.apache.jackrabbit.core.security.DefaultAccessManager",28,0.08,2.11,196,2.45,73195.30,38,10,33,70,21,112.63,132,275,2,2,112.39,0.00,0.50,0.18,6,182.00,7,7352.89,0,10,19,org.apache.jackrabbit.core.security.AbstractAccessControlManager,0.10,42,1,59,0,42,18,1,42,1452,1
"org.apache.jackrabbit.core.security.DefaultAccessManager$WorkspaceAccess",2,1.00,3.00,24,0.24,7108.02,6,4,33,6,1,152.53,2,31,0,1,102.53,0.00,0.00,0.75,0,0.00,4,710.71,0,0,1,java.lang.Object,0.00,4,0,6,0,4,2,0,2,156,1
"org.apache.jackrabbit.core.security.JackrabbitSecurityManager",8,0.00,1.00,9,0.07,330.17,8,0,8,8,10,115.99,58,10,5,1,158.28,0.00,0.00,0.00,0,8.00,1,222.67,0,5,5,,0.00,0,0,8,0,0,3,0,8,73,1
"org.apache.jackrabbit.core.security.SecurityConstants",0,0.00,0.00,6,0.05,476.87,5,5,0,0,14,171.00,23,7,14,1,171.00,0.00,0.00,0.00,0,0.00,0,143.06,0,0,0,,0.00,0,0,0,0,0,0,0,6,35,1
"org.apache.jackrabbit.core.security.SimpleJBossAccessManager",11,0.07,1.55,43,0.61,21367.27,14,3,16,28,8,177.21,19,65,0,1,127.21,0.00,0.00,0.27,2,23.00,5,1840.41,0,0,8,java.lang.Object,0.00,17,0,17,0,17,11,1,7,374,1
"org.apache.jackrabbit.core.security.SystemPrincipal",5,0.75,1.40,15,0.11,1614.87,6,1,2,6,7,173.25,11,26,7,1,133.37,0.00,0.00,0.40,0,7.00,3,315.98,0,2,0,java.lang.Object,0.00,1,0,7,0,1,3,2,5,86,2
"org.apache.jackrabbit.core.security.TestAll",1,0.00,1.00,5,0.04,864.35,1,0,3,3,1,103.93,5,7,0,2,121.80,0.00,0.50,0.00,0,1.00,1,115.51,0,1,1,junit.framework.TestCase,0.00,2,1,1,0,2,0,0,1,31,1
"org.apache.jackrabbit.core.security.TestPrincipal",4,0.17,2.00,16,0.16,3782.49,6,2,3,8,11,174.95,5,23,11,1,124.95,0.00,0.00,0.38,0,0.00,4,480.51,0,1,0,java.lang.Object,0.00,4,0,8,0,4,3,1,1,115,1
"org.apache.jackrabbit.core.security.UserPrincipal",5,0.25,1.60,19,0.16,3587.37,6,1,2,8,2,170.49,14,31,2,1,130.61,0.00,0.00,0.80,0,0.00,3,473.86,0,2,0,java.lang.Object,0.00,3,0,8,0,3,3,2,5,119,1
"org.apache.jackrabbit.jcr.LabelTest",5,0.00,1.00,32,0.47,8531.33,5,0,5,17,2,116.52,0,38,1,6,116.52,0.00,0.83,0.00,0,0.00,1,1419.15,0,0,1,org.apache.jackrabbit.test.api.version.VersionLabelTest,0.00,12,5,5,0,12,5,0,0,294,1
"org.apache.jackrabbit.jcr.TestAll",1,0.00,1.00,5,0.04,864.35,1,0,3,3,2,142.42,3,7,1,2,121.80,0.00,0.50,0.00,0,1.00,1,115.51,0,1,1,junit.framework.TestCase,0.00,2,1,1,0,2,0,0,1,31,1
"org.apache.jackrabbit.jcr.VersionHistoryImpl",26,0.20,1.77,170,2.17,61598.87,29,3,32,79,16,115.50,123,211,2,3,115.27,0.00,0.67,0.14,11,190.00,3,6524.25,6,15,14,org.apache.jackrabbit.jcr2spi.NodeImpl,0.04,53,2,46,0,53,11,1,42,1325,1
"org.apache.jackrabbit.jcr.VersionImpl",12,1.00,1.75,65,0.67,22400.88,13,1,18,24,8,119.27,58,86,2,3,119.04,0.00,0.67,0.08,3,38.00,4,2023.55,7,8,6,org.apache.jackrabbit.jcr2spi.NodeImpl,0.04,12,2,21,0,12,4,1,21,438,1
"org.apache.jackrabbit.jcr.VersionManager",21,0.00,1.00,22,0.35,2446.99,21,0,17,21,17,106.62,182,23,12,1,154.73,0.00,0.00,0.00,0,21.00,1,1048.56,0,10,5,,0.00,0,0,21,0,0,11,0,22,281,1
"org.apache.jackrabbit.jcr.VersionManagerImpl",22,0.19,1.45,111,1.69,53580.63,23,1,33,60,25,168.17,22,142,1,1,118.17,0.00,0.00,0.82,1,0.00,6,5063.02,0,10,24,java.lang.Object,0.00,38,0,32,0,38,12,1,13,1029,1
"org.apache.jackrabbit.core.query.AQTQueryFactory",1,0.00,1.00,3,0.03,368.95,1,0,3,3,3,90.70,7,5,1,1,132.99,0.00,0.00,0.00,0,1.00,1,88.18,0,1,2,java.lang.Object,0.00,2,0,1,0,2,0,1,2,25,2
"org.apache.jackrabbit.core.query.AbstractIndexingTest",2,1.00,1.50,16,0.14,2252.57,5,3,2,6,3,153.07,5,20,2,5,113.19,1.00,0.44,0.83,0,0.00,2,410.11,3,0,1,org.apache.jackrabbit.core.query.AbstractQueryTest,0.24,4,4,3,4,4,2,0,2,97,1
"org.apache.jackrabbit.core.query.AbstractQueryHandler",12,0.06,1.33,39,0.37,7072.86,18,6,10,22,8,89.03,88,61,0,1,131.32,0.00,0.00,0.11,1,80.00,3,1102.95,0,4,8,java.lang.Object,0.00,10,0,16,2,10,8,1,19,266,2
"org.apache.jackrabbit.core.query.AbstractQueryImpl",1,0.00,1.00,2,0.03,248.39,1,0,4,1,4,130.55,15,6,2,1,140.91,0.00,0.00,0.00,0,1.00,1,93.23,0,0,2,java.lang.Object,0.00,0,0,1,2,0,1,1,2,25,2
"org.apache.jackrabbit.core.query.AbstractQueryTest",13,0.21,2.00,103,1.24,40557.12,15,2,19,53,33,79.58,85,117,29,4,111.80,11.33,0.08,0.31,2,37.00,5,3730.06,2,3,4,org.apache.jackrabbit.test.AbstractJCRTest,0.21,40,3,26,34,40,10,0,16,749,1
"org.apache.jackrabbit.core.query.AbstractQueryTest$NodeIteratorAdapter",1,0.00,2.00,6,0.07,1693.22,1,0,19,5,0,116.39,0,9,0,1,116.39,0.00,0.00,0.00,0,1.00,2,208.76,1,1,0,java.lang.Object,0.00,4,0,2,0,4,0,0,0,48,0
"org.apache.jackrabbit.core.query.ChildAxisQueryTest",8,0.00,1.00,154,3.05,136602.06,8,0,7,19,2,89.97,7,187,1,5,89.97,0.00,0.80,0.00,0,0.00,1,9147.26,2,0,1,org.apache.jackrabbit.core.query.AbstractQueryTest,0.00,11,4,8,0,11,8,0,2,1629,1
"org.apache.jackrabbit.core.query.CompoundQueryFactory",3,1.00,2.33,18,0.19,5708.15,4,1,5,10,2,83.73,19,24,1,1,115.95,0.00,0.00,0.00,0,3.00,3,572.72,0,2,1,java.lang.Object,0.00,7,0,7,1,7,1,1,5,131,1
"org.apache.jackrabbit.core.query.DerefTest",7,0.35,1.14,87,1.22,32884.27,16,9,7,26,2,83.93,37,116,1,5,101.80,0.00,0.80,0.41,0,0.00,2,3662.14,3,0,1,org.apache.jackrabbit.core.query.AbstractQueryTest,0.22,19,4,8,0,19,7,0,10,707,1
"org.apache.jackrabbit.core.query.ExcerptTest",16,0.47,1.06,57,0.59,7922.45,18,2,6,28,2,131.97,15,96,1,5,131.97,0.00,0.80,0.06,4,68.00,2,1763.71,1,3,1,org.apache.jackrabbit.core.query.AbstractQueryTest,0.00,12,4,17,0,12,13,0,1,405,1
"org.apache.jackrabbit.core.query.ExecutableQuery",3,0.00,1.00,4,0.03,166.86,3,0,4,3,4,107.26,28,6,3,1,157.26,0.00,0.00,0.00,0,3.00,1,99.40,0,2,1,,0.00,0,0,3,0,0,1,0,4,33,1
"org.apache.jackrabbit.core.query.FnNameQueryTest",2,0.00,1.00,22,0.36,12019.26,2,0,2,5,2,152.40,3,32,1,5,102.40,0.00,0.80,0.00,0,0.00,1,1090.24,1,0,1,org.apache.jackrabbit.core.query.AbstractQueryTest,0.00,3,4,2,0,3,2,0,1,213,1
"org.apache.jackrabbit.core.query.FulltextQueryTest",18,0.00,1.28,183,2.98,73621.39,18,0,7,37,3,105.20,16,232,2,5,105.20,0.00,0.80,0.00,3,0.00,3,8929.41,2,0,1,org.apache.jackrabbit.core.query.AbstractQueryTest,0.00,19,4,23,0,19,18,0,7,1671,1
"org.apache.jackrabbit.core.query.FulltextSQL2QueryTest",2,0.00,1.00,20,0.35,6826.58,2,0,3,14,2,155.87,3,27,1,5,105.87,0.00,0.80,0.00,0,0.00,1,1052.32,1,0,1,org.apache.jackrabbit.core.query.AbstractQueryTest,0.00,12,4,2,0,12,2,0,1,193,1
"org.apache.jackrabbit.core.query.IndexFormatVersionTest",4,0.00,1.00,15,0.18,2796.57,4,0,6,13,6,180.80,4,25,1,4,130.80,0.00,0.75,0.00,1,4.00,1,550.50,1,0,5,org.apache.jackrabbit.test.AbstractJCRTest,0.00,9,3,4,0,9,4,0,1,122,1
"org.apache.jackrabbit.core.query.IndexingRuleTest",7,0.17,1.57,118,1.83,70451.38,9,2,10,31,2,94.46,5,141,1,6,94.46,0.00,0.83,0.64,0,0.00,4,5490.98,2,0,1,org.apache.jackrabbit.core.query.AbstractIndexingTest,0.00,24,5,11,0,24,7,0,3,972,1
"org.apache.jackrabbit.core.query.JoinTest",3,0.50,1.00,24,0.31,7881.35,4,1,5,12,2,160.39,4,35,1,5,110.39,0.00,0.80,0.67,0,2.00,1,938.09,3,0,1,org.apache.jackrabbit.core.query.AbstractQueryTest,0.24,9,4,3,0,9,3,0,1,194,1
"org.apache.jackrabbit.core.query.LargeResultSetTest",3,0.00,2.67,40,0.42,14719.15,3,0,7,13,4,140.04,6,43,1,5,100.16,0.00,0.80,0.00,2,1.00,4,1255.10,2,0,3,org.apache.jackrabbit.core.query.AbstractQueryTest,0.00,10,4,8,0,10,3,0,4,241,1
"org.apache.jackrabbit.core.query.LimitAndOffsetTest",9,0.44,1.00,91,1.05,32815.74,13,4,8,29,4,105.65,2,102,1,5,105.65,0.00,0.80,0.64,1,0.00,1,3143.04,2,1,3,org.apache.jackrabbit.core.query.AbstractQueryTest,0.21,20,4,9,0,20,8,0,2,675,1
"org.apache.jackrabbit.core.query.MixinTest",2,0.00,1.50,20,0.30,7021.52,2,0,8,15,4,126.30,6,28,1,5,105.69,0.00,0.80,0.00,0,2.00,2,888.14,2,0,3,org.apache.jackrabbit.core.query.AbstractQueryTest,0.12,13,4,3,0,13,2,0,4,171,1
"org.apache.jackrabbit.core.query.OnWorkspaceInconsistency",4,0.22,1.25,22,0.25,7257.00,7,3,12,10,10,89.83,52,35,2,1,119.21,0.00,0.00,0.17,0,8.00,2,748.65,0,2,8,java.lang.Object,0.00,6,0,5,0,6,2,0,9,171,2
"org.apache.jackrabbit.core.query.OnWorkspaceInconsistency$OnWorkspaceInconsistency",1,0.00,1.00,5,0.12,2244.04,1,0,12,9,8,118.54,0,18,0,1,118.54,0.00,0.00,0.00,0,0.00,1,357.97,0,0,8,java.lang.Object,0.00,8,0,1,0,8,1,0,0,71,0
"org.apache.jackrabbit.core.query.OnWorkspaceInconsistency$OnWorkspaceInconsistency_0",1,0.00,1.00,4,0.11,1863.51,1,0,12,9,8,122.79,0,17,0,1,122.79,0.00,0.00,0.00,0,0.00,1,339.81,0,0,8,java.lang.Object,0.00,8,0,1,0,8,1,0,0,68,0
"org.apache.jackrabbit.core.query.OrderByTest",21,0.00,1.19,128,1.89,65376.43,21,0,12,48,2,164.42,34,148,1,6,114.42,0.00,0.83,0.00,1,81.00,4,5667.14,3,8,1,org.apache.jackrabbit.core.query.AbstractIndexingTest,0.00,27,5,25,0,27,13,0,18,1126,1
"org.apache.jackrabbit.core.query.ParentNodeTest",8,0.00,1.00,43,0.73,11556.43,8,0,4,20,2,170.04,9,53,1,5,120.04,0.00,0.80,0.00,0,0.00,1,2190.57,1,0,1,org.apache.jackrabbit.core.query.AbstractQueryTest,0.11,12,4,8,0,12,8,0,6,448,1
"org.apache.jackrabbit.core.query.PathQueryNodeTest",2,0.00,1.00,24,0.33,9078.93,3,1,10,10,9,101.95,0,28,1,2,101.95,0.00,0.50,1.00,0,0.00,1,976.05,0,0,8,junit.framework.TestCase,0.00,8,1,2,0,8,2,0,0,212,1
"org.apache.jackrabbit.core.query.PathQueryNodeTest$NamespaceResolver",2,0.00,2.00,7,0.07,1085.66,2,0,10,5,1,131.51,0,11,0,1,131.51,0.00,0.00,0.00,0,2.00,3,203.19,0,2,1,java.lang.Object,0.00,3,0,4,0,3,0,0,0,54,0
"org.apache.jackrabbit.core.query.PropertyTypeRegistry",6,0.00,3.00,67,0.90,45841.49,10,4,17,30,10,83.45,35,84,5,1,101.32,0.00,0.00,0.25,3,6.00,7,2703.02,0,0,5,java.lang.Object,0.00,24,0,18,0,24,6,1,14,504,1
"org.apache.jackrabbit.core.query.PropertyTypeRegistry$TypeMapping",1,3.00,1.00,8,0.06,883.86,4,3,17,1,1,134.73,3,10,0,1,114.11,0.00,0.00,0.00,0,1.00,1,188.02,0,0,1,java.lang.Object,0.00,0,0,1,0,0,1,0,3,50,2
"org.apache.jackrabbit.core.query.QOMQueryFactory",3,0.25,1.00,10,0.10,1411.91,5,2,8,7,3,89.86,22,16,1,1,132.16,0.00,0.00,0.33,0,4.00,1,313.04,0,2,2,java.lang.Object,0.00,4,0,3,0,4,1,1,6,81,1
"org.apache.jackrabbit.core.query.QueryFactory",2,0.00,1.00,3,0.02,166.89,2,0,4,2,5,105.87,18,5,5,1,155.87,0.00,0.00,0.00,0,2.00,1,73.51,0,2,0,,0.00,0,0,2,0,0,0,0,3,24,1
"org.apache.jackrabbit.core.query.QueryHandler",10,0.00,1.00,11,0.10,645.68,10,0,9,10,24,108.64,87,18,18,1,156.75,0.00,0.00,0.00,0,10.00,1,313.32,0,2,7,,0.00,0,0,10,0,0,8,0,11,98,1
"org.apache.jackrabbit.core.query.QueryHandlerContext",12,0.02,1.00,46,0.35,5908.89,22,10,9,16,20,83.90,100,66,11,1,132.00,0.00,0.00,0.12,0,112.00,1,1053.61,0,8,10,java.lang.Object,0.00,4,0,12,0,4,4,0,23,253,1
"org.apache.jackrabbit.core.query.QueryHandlerFactory",1,0.00,1.00,2,0.01,51.00,1,0,1,1,6,146.32,0,4,4,1,146.32,0.00,0.00,0.00,0,1.00,1,34.00,0,0,2,,0.00,0,0,1,0,0,1,0,0,13,1
"org.apache.jackrabbit.core.query.QueryImpl",13,0.03,1.77,86,0.97,26080.59,23,10,23,44,13,73.55,91,124,5,2,115.84,1.00,0.33,0.13,3,71.00,3,2910.30,0,6,8,org.apache.jackrabbit.core.query.AbstractQueryImpl,0.00,31,1,23,1,31,7,0,26,598,1
"org.apache.jackrabbit.core.query.QueryImpl$SessionOperation<QueryResult>",2,0.00,1.00,5,0.04,411.67,2,0,23,2,1,141.55,0,8,0,1,141.55,0.00,0.00,0.00,0,2.00,1,129.16,0,2,1,java.lang.Object,0.00,0,0,2,0,0,0,0,0,36,0
"org.apache.jackrabbit.core.query.QueryManagerImpl",8,0.24,1.00,24,0.25,4337.85,11,3,20,18,11,99.45,55,38,4,1,131.67,0.00,0.00,0.12,1,26.00,1,745.42,0,5,7,java.lang.Object,0.00,10,0,8,0,10,3,1,16,187,1
"org.apache.jackrabbit.core.query.QueryManagerImpl$QueryFactoryImpl",2,0.00,1.00,6,0.06,516.13,2,0,20,7,3,134.21,0,26,0,2,134.21,0.00,0.50,0.00,0,2.00,1,165.07,0,0,3,org.apache.jackrabbit.core.query.CompoundQueryFactory,0.00,5,1,2,0,5,2,0,0,44,1
"org.apache.jackrabbit.core.query.QueryManagerImpl$QueryFactoryImpl$AQTQueryFactory",1,0.00,1.00,3,0.03,436.67,1,0,20,1,0,132.41,0,0,0,1,132.41,0.00,0.00,0.00,0,0.00,1,92.00,0,1,0,java.lang.Object,0.00,0,0,1,0,0,0,0,0,25,0
"org.apache.jackrabbit.core.query.QueryManagerImpl$QueryFactoryImpl$QueryObjectModelFactoryImpl_1",1,0.00,1.00,3,0.04,486.70,1,0,20,1,1,132.04,0,0,0,1,132.04,0.00,0.00,0.00,0,0.00,1,115.91,0,1,1,java.lang.Object,0.00,0,0,1,0,0,0,0,0,30,0
"org.apache.jackrabbit.core.query.QueryManagerImpl$QueryObjectModelFactoryImpl",1,0.00,1.00,3,0.04,371.76,1,0,20,1,1,132.96,0,6,0,1,132.96,0.00,0.00,0.00,0,0.00,1,105.06,0,1,1,java.lang.Object,0.00,0,0,1,0,0,0,0,0,27,0
"org.apache.jackrabbit.core.query.QueryManagerImpl$SessionOperation<Iterable<Node>>",2,0.00,2.00,12,0.15,4776.08,2,0,20,8,2,115.21,0,17,0,1,115.21,0.00,0.00,0.00,0,2.00,3,452.84,0,1,2,java.lang.Object,0.00,6,0,4,0,6,1,0,0,94,0
"org.apache.jackrabbit.core.query.QueryManagerImpl$SessionOperation<Query>",2,0.00,1.00,6,0.06,801.37,2,0,20,4,2,132.71,0,9,0,1,132.71,0.00,0.00,0.00,0,2.00,1,186.91,0,2,2,java.lang.Object,0.00,2,0,2,0,2,0,0,0,48,0
"org.apache.jackrabbit.core.query.QueryManagerImpl$SessionOperation<Query>_0",2,0.00,1.50,10,0.15,4658.57,2,0,20,9,2,118.32,0,17,0,1,118.32,0.00,0.00,0.00,0,2.00,2,448.86,0,2,2,java.lang.Object,0.00,7,0,3,0,7,0,0,0,94,0
"org.apache.jackrabbit.core.query.QueryObjectModelImpl",6,0.40,1.00,22,0.23,3919.31,7,1,11,14,6,88.74,45,36,1,3,131.03,0.00,0.67,0.67,0,0.00,1,695.20,2,4,5,org.apache.jackrabbit.core.query.QueryImpl,0.00,8,2,6,0,8,2,1,9,163,1
"org.apache.jackrabbit.core.query.QueryResultTest",10,0.67,2.90,164,2.21,62628.29,11,1,6,33,2,135.83,20,164,1,5,95.94,0.00,0.80,0.40,0,0.00,4,6633.88,1,0,1,org.apache.jackrabbit.core.query.AbstractQueryTest,0.10,23,4,29,0,23,10,0,17,1170,1
"org.apache.jackrabbit.core.query.SQLTest",3,0.00,1.00,25,0.40,7450.25,3,0,3,10,2,110.58,2,33,1,5,110.58,0.00,0.80,0.00,0,0.00,1,1207.63,1,0,1,org.apache.jackrabbit.core.query.AbstractQueryTest,0.00,7,4,3,0,7,3,0,1,230,1
"org.apache.jackrabbit.core.query.SelectClauseTest",3,0.00,1.00,57,0.98,27451.34,3,0,4,10,2,142.10,3,70,1,5,92.10,0.00,0.80,0.00,0,0.00,1,2925.14,1,0,1,org.apache.jackrabbit.core.query.AbstractQueryTest,0.00,7,4,3,0,7,3,0,1,526,1
"org.apache.jackrabbit.core.query.ShareableNodeTest",2,0.00,1.00,87,1.56,82226.06,2,0,5,19,3,25.63,16,90,1,5,73.73,0.00,0.80,0.00,0,0.00,1,4691.04,1,0,2,org.apache.jackrabbit.core.query.AbstractQueryTest,0.00,17,4,2,0,17,2,0,14,810,1
"org.apache.jackrabbit.core.query.SimilarQueryTest",1,0.00,1.00,4,0.04,617.46,1,0,1,2,2,147.18,3,6,1,5,126.57,0.00,0.80,0.00,0,0.00,1,131.51,1,0,1,org.apache.jackrabbit.core.query.AbstractQueryTest,0.00,1,4,1,0,1,1,0,1,35,1
"org.apache.jackrabbit.core.query.SimpleQueryTest",19,0.00,1.00,366,6.35,288282.02,19,0,5,32,2,90.37,17,397,1,5,90.37,0.00,0.80,0.00,0,0.00,1,19038.39,1,0,1,org.apache.jackrabbit.core.query.AbstractQueryTest,0.00,13,4,19,0,13,19,0,15,3423,1
"org.apache.jackrabbit.core.query.SkipDeletedNodesTest",7,0.17,2.57,107,1.34,34255.15,9,2,8,25,2,55.57,50,124,1,5,97.86,0.00,0.80,0.64,0,0.00,3,4011.71,2,0,1,org.apache.jackrabbit.core.query.AbstractQueryTest,0.22,18,4,18,0,18,7,0,26,724,1
"org.apache.jackrabbit.core.query.SkipDeniedNodesTest",6,0.16,2.00,65,0.94,27810.38,11,5,17,38,8,104.67,4,78,1,5,104.67,0.00,0.80,0.33,3,6.00,4,2810.07,2,2,7,org.apache.jackrabbit.test.api.security.AbstractAccessControlTest,0.25,32,4,12,0,32,4,0,1,542,1
"org.apache.jackrabbit.core.query.SynonymProviderTest",3,0.00,1.33,26,0.34,9995.05,3,0,2,7,2,130.12,11,28,1,5,109.51,0.00,0.80,0.00,0,0.00,2,1017.27,1,0,1,org.apache.jackrabbit.core.query.AbstractQueryTest,0.00,4,4,4,0,4,3,0,2,211,1
"org.apache.jackrabbit.core.query.TestAll",1,0.00,1.00,31,0.43,16888.62,1,0,5,3,28,33.60,10,33,0,2,82.08,0.00,0.50,0.00,0,1.00,1,1279.83,0,1,28,junit.framework.TestCase,0.00,2,1,1,0,2,0,0,2,239,1
"org.apache.jackrabbit.core.query.TextExtractorTest",4,0.17,3.00,60,0.79,29463.18,6,2,7,26,1,117.04,14,72,0,5,96.42,0.00,0.80,0.38,2,0.00,5,2359.76,1,1,1,org.apache.jackrabbit.core.query.AbstractQueryTest,0.00,22,4,12,0,22,3,0,6,436,1
"org.apache.jackrabbit.core.query.UpperLowerCaseQueryTest",13,0.00,1.92,151,2.92,139252.01,13,0,9,55,3,150.27,23,244,1,5,100.27,0.00,0.80,0.00,2,31.00,7,8763.43,3,0,2,org.apache.jackrabbit.core.query.AbstractQueryTest,0.00,42,4,25,0,42,13,0,19,1558,1
"org.apache.jackrabbit.core.query.VersionStoreQueryTest",1,0.00,1.00,16,0.26,8681.74,1,0,3,11,2,46.96,8,19,1,5,95.07,0.00,0.80,0.00,0,0.00,1,770.92,1,0,1,org.apache.jackrabbit.core.query.AbstractQueryTest,0.00,10,4,1,0,10,1,0,3,147,1
"org.apache.jackrabbit.core.query.XPathAxisTest",32,0.16,1.00,117,1.34,20573.89,38,6,2,38,2,131.09,4,151,1,5,131.09,0.00,0.80,0.32,0,0.00,1,4031.82,4,0,1,org.apache.jackrabbit.core.query.AbstractQueryTest,0.14,6,4,32,0,6,32,0,2,919,1
"org.apache.jackrabbit.core.data.AbstractDataRecord",5,0.25,1.00,12,0.09,1318.70,6,1,0,9,3,98.41,37,19,1,1,140.70,0.00,0.00,0.80,0,0.00,1,277.88,0,1,2,java.lang.Object,0.00,4,0,5,2,4,4,1,7,80,2
"org.apache.jackrabbit.core.data.CopyValueTest",4,0.00,4.75,100,1.42,107642.46,4,0,6,29,2,83.85,18,117,1,4,83.61,0.00,0.75,0.00,2,4.00,15,4272.26,0,0,1,org.apache.jackrabbit.test.AbstractJCRTest,0.00,25,3,19,0,25,4,0,8,698,1
"org.apache.jackrabbit.core.data.DBDataStoreTest",5,0.67,3.00,81,0.95,46961.21,8,3,10,37,7,50.42,57,83,0,3,94.55,0.00,0.67,0.87,0,0.00,5,2841.32,0,0,7,org.apache.jackrabbit.test.JUnitTest,0.86,32,2,15,0,32,5,0,12,535,1
"org.apache.jackrabbit.core.data.DataIdentifier",5,0.08,1.20,21,0.25,8547.46,8,3,1,10,16,74.94,44,26,16,1,123.04,0.00,0.00,0.27,0,5.00,2,741.12,0,1,0,java.lang.Object,0.00,5,0,6,0,5,4,1,10,168,2
"org.apache.jackrabbit.core.data.DataRecord",4,0.00,1.00,5,0.02,77.53,4,0,1,4,9,128.64,25,6,7,1,160.86,0.00,0.00,0.00,0,4.00,1,57.02,0,2,2,,0.00,0,0,4,0,0,2,0,5,25,1
"org.apache.jackrabbit.core.data.DataStore",10,0.00,1.00,11,0.07,321.10,10,0,3,10,24,109.14,94,12,21,1,159.14,0.00,0.00,0.00,0,10.00,1,205.55,0,1,3,,0.00,0,0,10,0,0,9,0,11,74,1
"org.apache.jackrabbit.core.data.DataStoreAPITest",3,0.50,1.00,21,0.25,5654.03,4,1,13,19,6,153.57,8,27,1,2,113.68,0.00,0.50,0.67,1,1.00,1,750.26,0,0,5,junit.framework.TestCase,0.00,16,1,3,0,16,3,0,3,151,1
"org.apache.jackrabbit.core.data.DataStoreException",3,0.00,1.00,7,0.04,296.18,3,0,1,3,14,101.77,21,11,14,2,144.07,0.00,0.50,0.00,0,3.00,1,118.69,0,0,0,javax.jcr.RepositoryException,0.00,0,1,3,0,0,3,0,4,39,1
"org.apache.jackrabbit.core.data.DataStoreFactory",1,0.00,1.00,2,0.01,38.26,1,0,1,1,3,156.44,17,3,2,1,147.31,0.00,0.00,0.00,0,1.00,1,25.51,0,0,1,,0.00,0,0,1,0,0,1,0,2,11,1
"org.apache.jackrabbit.core.data.DataStoreTest",8,0.29,3.25,120,1.45,73858.27,10,2,13,54,7,145.63,14,137,1,3,95.63,0.00,0.67,0.25,4,14.00,7,4359.84,0,1,6,org.apache.jackrabbit.test.JUnitTest,0.60,46,2,26,0,46,7,0,10,812,1
"org.apache.jackrabbit.core.data.DataStoreTest$Thread",1,0.00,2.00,5,0.03,429.83,1,0,13,2,0,124.03,0,8,0,1,124.03,0.00,0.00,0.00,0,1.00,2,102.01,0,0,0,java.lang.Object,0.00,1,0,2,0,1,1,0,0,27,0
"org.apache.jackrabbit.core.data.ExportImportTest",7,0.00,2.71,117,1.66,72926.48,7,0,11,42,2,134.10,14,135,1,4,94.21,0.00,0.75,0.00,5,7.00,7,4982.54,1,0,1,org.apache.jackrabbit.test.AbstractJCRTest,0.00,35,3,19,0,35,7,0,7,886,1
"org.apache.jackrabbit.core.data.FileDataRecord",4,0.33,1.25,14,0.12,1981.24,5,1,3,10,5,114.06,21,21,1,2,131.93,0.00,0.50,0.75,0,0.00,2,348.92,0,1,4,org.apache.jackrabbit.core.data.AbstractDataRecord,0.00,6,1,5,0,6,3,0,6,90,1
"org.apache.jackrabbit.core.data.FileDataStore",18,0.02,2.89,150,2.02,102931.30,28,10,19,67,6,65.19,128,213,1,1,107.48,0.00,0.00,0.12,5,130.00,13,6070.19,0,4,5,java.lang.Object,0.00,49,0,52,0,49,14,1,33,1129,1
"org.apache.jackrabbit.core.data.GCConcurrentTest",6,1.00,2.17,70,0.88,38304.69,7,1,15,42,6,102.01,4,77,1,4,102.01,0.00,0.75,0.17,3,10.00,4,2632.92,0,2,5,org.apache.jackrabbit.test.AbstractJCRTest,0.00,36,3,13,0,36,4,0,2,486,1
"org.apache.jackrabbit.core.data.GCConcurrentTest$MarkEventListener",1,0.00,2.00,5,0.05,624.98,1,0,15,6,0,122.75,0,7,0,1,122.75,0.00,0.00,0.00,0,1.00,2,145.61,0,0,0,java.lang.Object,0.00,5,0,2,0,5,1,0,0,37,0
"org.apache.jackrabbit.core.data.GCEventListenerTest",6,0.08,2.17,65,0.81,37152.39,11,5,12,34,7,153.66,7,76,1,4,103.66,0.00,0.75,0.27,2,10.00,6,2424.26,0,1,6,org.apache.jackrabbit.test.AbstractJCRTest,0.00,28,3,13,0,28,5,1,2,421,1
"org.apache.jackrabbit.core.data.GCThread",9,0.09,1.56,44,0.47,11743.27,13,4,9,22,8,123.91,4,61,1,1,123.91,0.00,0.00,0.17,1,21.00,4,1398.04,0,1,7,java.lang.Object,0.00,13,0,14,0,13,8,2,2,293,1
"org.apache.jackrabbit.core.data.GarbageCollector",22,0.02,2.45,137,1.38,43824.94,33,11,32,56,19,116.02,106,188,5,1,115.79,0.00,0.00,0.07,11,202.00,12,4150.80,1,0,14,java.lang.Object,0.00,34,0,54,0,34,22,1,24,838,1
"org.apache.jackrabbit.core.data.GarbageCollector$Listener",3,0.33,3.33,27,0.29,5494.56,6,3,32,13,1,109.43,2,44,0,1,109.43,0.00,0.00,0.56,0,0.00,7,867.03,0,0,1,java.lang.Object,0.00,10,0,10,0,10,3,1,2,181,0
"org.apache.jackrabbit.core.data.GarbageCollectorTest",11,0.60,2.36,135,1.82,55334.50,12,1,16,66,10,101.40,6,156,1,4,101.40,0.00,0.75,0.45,4,19.00,3,5449.56,1,0,9,org.apache.jackrabbit.test.AbstractJCRTest,0.00,55,3,26,0,55,11,1,4,986,1
"org.apache.jackrabbit.core.data.GarbageCollectorTest$MarkEventListener",2,1.00,1.50,9,0.06,849.10,3,1,16,4,0,127.75,0,12,0,1,127.75,0.00,0.00,0.50,1,2.00,2,194.16,0,0,0,java.lang.Object,0.00,2,0,3,0,2,2,0,0,50,0
"org.apache.jackrabbit.core.data.GarbageCollectorTest$Thread",1,0.00,2.00,7,0.06,737.25,1,0,16,8,0,116.73,0,10,0,1,116.73,0.00,0.00,0.00,0,1.00,2,190.84,0,0,0,java.lang.Object,0.00,7,0,2,0,7,1,0,0,45,0
"org.apache.jackrabbit.core.data.GarbageCollectorTest$Thread$InputStream",1,0.00,5.00,13,0.12,4021.03,2,1,16,4,0,150.69,1,17,0,1,100.69,0.00,0.00,1.00,0,0.00,5,356.14,0,0,0,java.lang.Object,0.00,3,0,5,0,3,1,0,1,73,0
"org.apache.jackrabbit.core.data.LazyFileInputStream",13,0.25,1.46,55,0.46,8343.18,16,3,6,20,3,146.96,45,78,3,2,126.35,0.00,0.50,0.10,1,31.00,3,1376.44,7,0,0,org.apache.commons.io.input.AutoCloseInputStream,0.00,7,1,19,0,7,13,0,10,341,1
"org.apache.jackrabbit.core.data.LazyFileInputStreamTest",4,0.00,1.50,69,0.85,94608.83,6,2,5,27,3,90.80,19,78,1,3,90.57,0.00,0.67,0.50,1,4.00,3,2556.80,0,0,2,org.apache.jackrabbit.test.JUnitTest,1.00,23,2,6,0,23,4,0,17,496,1
"org.apache.jackrabbit.core.data.NodeTypeTest",2,0.00,2.00,24,0.37,12329.93,2,0,12,17,5,100.98,8,31,1,4,100.74,0.00,0.75,0.00,1,2.00,3,1102.44,0,0,4,org.apache.jackrabbit.test.AbstractJCRTest,0.00,15,3,4,0,15,2,0,2,193,1
"org.apache.jackrabbit.core.data.OpenFilesTest",1,0.00,3.00,16,0.21,6719.54,1,0,6,15,2,63.47,6,19,1,4,95.69,0.00,0.75,0.00,0,1.00,3,642.56,1,0,1,org.apache.jackrabbit.test.AbstractJCRTest,0.00,14,3,3,0,14,1,0,2,116,1
"org.apache.jackrabbit.core.data.PersistenceManagerIteratorTest",2,1.00,7.00,75,1.14,129206.74,3,1,15,29,8,94.79,7,82,1,4,74.18,0.00,0.75,0.50,1,2.00,13,3427.39,1,0,7,org.apache.jackrabbit.test.AbstractJCRTest,0.00,27,3,14,0,27,2,0,5,523,1
"org.apache.jackrabbit.core.data.RandomInputStream",15,0.08,1.80,83,0.79,28331.41,26,11,3,18,3,118.99,3,107,3,2,118.99,0.00,0.50,0.16,4,42.00,5,2357.82,0,1,0,java.io.InputStream,0.00,3,1,27,0,3,14,0,1,527,1
"org.apache.jackrabbit.core.data.ScanEventListener",0,0.00,0.00,1,0.01,31.02,0,0,1,0,3,171.00,3,2,2,2,171.00,0.00,0.50,0.00,0,0.00,0,15.51,0,0,1,,0.00,0,1,0,0,0,0,0,1,6,1
"org.apache.jackrabbit.core.data.TempFileInputStreamTest",2,0.00,2.00,29,0.34,12533.16,2,0,7,14,3,148.19,3,28,1,3,98.19,0.00,0.67,0.00,0,2.00,3,1019.45,0,0,2,org.apache.jackrabbit.test.JUnitTest,0.00,12,2,4,0,12,2,0,1,203,1
"org.apache.jackrabbit.core.data.TestAll",1,0.00,1.00,17,0.20,7146.68,1,0,4,3,14,46.65,8,19,0,2,94.75,0.00,0.50,0.00,0,1.00,1,603.33,0,1,14,junit.framework.TestCase,0.00,2,1,1,0,2,0,0,2,127,1
"org.apache.jackrabbit.core.data.TestTwoGetStreams",5,0.25,3.00,86,1.33,53234.02,7,2,9,24,4,93.37,23,106,1,4,93.14,0.00,0.75,0.70,1,0.00,3,3983.49,0,0,3,org.apache.jackrabbit.test.AbstractJCRTest,0.00,19,3,15,0,19,5,0,10,723,1
"org.apache.jackrabbit.test.AbstractJCRTest",24,0.03,3.25,316,4.73,255252.87,74,50,24,102,224,68.09,323,397,217,3,97.47,258.00,0.00,0.05,8,124.00,18,14180.19,3,8,7,org.apache.jackrabbit.test.JUnitTest,0.23,78,2,78,516,78,16,0,86,2413,2
"org.apache.jackrabbit.test.ConcurrentTestSuite",8,0.29,1.38,28,0.20,2411.38,10,2,5,16,8,133.61,5,42,8,2,133.61,1.00,0.33,0.25,1,24.00,3,597.55,1,0,0,junit.framework.TestSuite,0.00,8,1,11,1,8,8,0,2,157,1
"org.apache.jackrabbit.test.ConcurrentTestSuite$PooledExecutor",0,0.00,0.00,2,0.01,50.53,0,0,5,0,0,171.00,0,4,0,1,171.00,0.00,0.00,0.00,0,0.00,0,25.27,0,0,0,java.lang.Object,0.00,0,0,0,0,0,0,0,0,9,0
"org.apache.jackrabbit.test.ConcurrentTestSuite$Runnable",1,0.00,1.00,5,0.03,299.16,1,0,5,3,1,125.43,0,8,0,1,125.43,0.00,0.00,0.00,0,1.00,1,90.04,0,0,1,java.lang.Object,0.00,2,0,1,0,2,1,0,0,25,0
"org.apache.jackrabbit.test.ISO8601",4,0.00,7.00,129,1.93,217295.90,4,0,3,26,2,109.03,126,156,2,1,77.12,0.00,0.00,0.00,2,4.00,17,5801.22,0,2,0,java.lang.Object,0.00,22,0,28,0,22,2,0,49,952,2
"org.apache.jackrabbit.test.JCRBenchmark",1,0.00,1.00,3,0.02,158.91,1,0,3,2,0,156.48,3,5,0,2,135.87,0.00,0.50,0.00,0,1.00,1,52.05,0,1,0,junit.framework.TestCase,0.00,1,1,1,0,1,0,0,1,17,1
"org.apache.jackrabbit.test.JCRTestResult",18,0.00,1.33,67,0.77,24472.17,22,4,9,48,3,149.08,64,101,2,2,128.46,0.00,0.50,0.25,2,0.00,3,2312.03,0,3,1,junit.framework.TestResult,0.00,30,1,24,0,30,15,0,13,540,1
"org.apache.jackrabbit.test.JCRTestSuite",1,0.00,1.00,14,0.35,12653.38,1,0,0,13,16,116.56,3,16,4,3,95.94,0.00,0.67,0.00,0,1.00,1,1044.91,0,0,12,org.apache.jackrabbit.test.ConcurrentTestSuite,0.00,12,2,1,0,12,1,0,1,225,1
"org.apache.jackrabbit.test.JNDIRepositoryStub",4,0.33,2.00,21,0.26,8999.03,6,2,8,11,3,138.99,12,31,0,2,118.37,0.00,0.50,0.25,0,6.00,5,777.46,0,3,3,org.apache.jackrabbit.test.RepositoryStub,0.15,7,1,8,0,7,1,0,5,164,1
"org.apache.jackrabbit.test.JUnitTest",2,0.00,1.00,13,0.15,2187.08,4,2,4,8,12,118.28,9,16,11,2,118.04,525.00,0.00,0.50,0,0.00,1,435.27,2,0,1,junit.framework.TestCase,0.00,6,1,2,525,6,2,0,3,102,2
"org.apache.jackrabbit.test.LogPrintWriter",11,0.20,1.36,43,0.35,5553.15,13,2,4,21,2,152.46,43,60,2,2,131.84,0.00,0.50,0.32,1,16.00,4,1047.02,2,0,0,java.io.PrintWriter,0.00,10,1,15,0,10,11,0,13,262,1
"org.apache.jackrabbit.test.LogPrintWriter$NullWriter",3,0.00,1.00,4,0.04,273.44,3,0,4,3,0,205.57,3,8,0,2,155.57,0.00,0.50,0.00,0,3.00,1,110.76,0,0,0,java.io.Writer,0.00,0,1,3,0,0,3,0,3,35,2
"org.apache.jackrabbit.test.NotExecutableException",2,0.00,1.00,4,0.02,118.02,2,0,0,2,248,95.83,19,7,248,2,145.83,0.00,0.50,0.00,0,2.00,1,53.51,0,0,0,java.lang.Exception,0.00,0,1,2,0,0,2,0,3,20,1
"org.apache.jackrabbit.test.RepositoryHelper",15,0.11,1.13,37,0.33,5127.89,17,2,7,27,6,97.50,107,56,3,1,139.79,0.00,0.00,0.40,4,0.00,3,977.23,0,13,3,java.lang.Object,0.00,12,0,17,0,12,2,0,19,259,1
"org.apache.jackrabbit.test.RepositoryHelperPool",2,0.00,1.00,3,0.02,80.78,2,0,0,2,3,116.06,15,4,2,1,158.35,0.00,0.00,0.00,0,2.00,1,47.30,0,1,1,,0.00,0,0,2,0,0,1,0,3,18,1
"org.apache.jackrabbit.test.RepositoryHelperPoolImpl",4,0.17,3.25,39,0.47,17173.63,6,2,8,25,4,156.53,7,51,2,1,106.53,0.00,0.00,0.62,1,0.00,9,1396.05,0,0,2,java.lang.Object,0.00,21,0,13,0,21,4,1,4,264,1
"org.apache.jackrabbit.test.RepositoryStub",9,0.03,2.56,88,1.55,75954.68,43,34,14,28,19,74.89,119,118,17,1,104.27,0.00,0.00,0.06,0,35.00,14,4661.15,0,8,2,java.lang.Object,0.00,19,0,23,7,19,1,0,19,799,2
"org.apache.jackrabbit.test.RepositoryStubException",1,0.00,1.00,3,0.02,106.02,1,0,0,1,9,157.87,3,5,9,2,137.25,0.00,0.50,0.00,0,1.00,1,45.51,0,0,0,java.lang.Exception,0.00,0,1,1,0,0,1,0,1,16,1
"org.apache.jackrabbit.test.TestAll",1,0.00,1.00,3,0.02,158.91,1,0,3,2,1,135.87,0,5,0,2,135.87,0.00,0.50,0.00,0,1.00,1,52.05,0,1,1,junit.framework.TestCase,0.00,1,1,1,0,1,0,0,0,17,1
"org.apache.jackrabbit.test.XMLChar",21,0.03,1.95,724,20.15,1282085.56,30,9,1,23,2,117.51,615,757,2,1,76.03,0.00,0.00,0.08,4,61.00,6,60456.28,0,0,0,java.lang.Object,0.00,2,0,41,0,2,21,0,463,6924,1
"org.apache.jackrabbit.webdav.xml.DomUtil",36,0.50,2.03,206,2.41,71136.00,38,2,14,88,102,68.81,329,259,100,1,118.81,0.00,0.00,0.01,10,70.00,5,7224.86,0,25,3,java.lang.Object,0.00,52,0,73,0,52,11,0,42,1571,1
"org.apache.jackrabbit.webdav.xml.ElementIterator",8,0.00,1.62,42,0.37,8991.24,12,4,7,17,32,102.92,46,53,31,1,120.79,0.00,0.00,0.25,2,8.00,3,1117.55,0,2,2,java.lang.Object,0.00,9,0,13,0,9,6,1,10,256,1
"org.apache.jackrabbit.webdav.xml.Namespace",8,0.05,1.50,32,0.32,7656.66,14,6,2,15,40,124.97,6,47,40,1,124.97,0.00,0.00,0.12,1,20.00,3,965.31,0,4,0,java.lang.Object,0.00,7,0,12,0,7,4,0,4,233,1
"org.apache.jackrabbit.webdav.xml.XmlSerializable",1,0.00,1.00,2,0.01,41.48,1,0,2,1,27,109.47,12,3,27,1,147.03,0.00,0.00,0.00,0,1.00,1,27.65,0,1,0,,0.00,0,0,1,0,0,0,0,2,11,1
"org.apache.jackrabbit.rmi.iterator.ArrayEventIterator",2,0.00,1.00,5,0.03,278.97,2,0,2,2,2,110.66,12,8,1,2,142.88,0.00,0.50,0.00,0,2.00,1,91.87,1,1,1,org.apache.jackrabbit.rmi.iterator.ArrayIterator,0.00,0,1,2,0,0,1,1,3,30,1
"org.apache.jackrabbit.rmi.iterator.ArrayEventListenerIterator",2,0.00,1.00,5,0.03,278.97,2,0,2,2,2,110.66,12,9,1,2,142.88,0.00,0.50,0.00,0,2.00,1,91.87,1,1,1,org.apache.jackrabbit.rmi.iterator.ArrayIterator,0.00,0,1,2,0,0,1,1,3,30,1
"org.apache.jackrabbit.rmi.iterator.ArrayIterator",7,0.08,1.14,21,0.15,2286.63,9,2,2,9,2,173.26,20,31,2,1,133.37,0.00,0.00,0.57,0,0.00,2,440.77,0,1,0,java.lang.Object,0.00,2,0,8,2,2,6,1,10,119,1
"org.apache.jackrabbit.core.nodetype.virtual.VirtualNodeTypeStateManager",8,0.14,2.38,72,1.10,31767.91,16,8,24,38,17,56.87,79,128,1,1,106.87,0.00,0.00,0.25,4,14.00,5,3300.81,0,1,16,java.lang.Object,0.00,30,0,19,0,30,7,1,23,653,1
"org.apache.jackrabbit.core.nodetype.virtual.VirtualNodeTypeStateProvider",12,1.00,2.08,104,1.93,100410.67,13,1,21,60,15,74.03,74,139,1,2,106.25,0.00,0.50,0.08,4,22.00,5,5797.79,3,6,14,org.apache.jackrabbit.core.virtual.AbstractVISProvider,0.05,48,1,25,0,48,6,0,27,1021,1
"org.apache.jackrabbit.webdav.client.methods.AclMethod",3,1.00,1.00,9,0.09,1212.13,4,1,6,4,4,132.91,13,15,0,3,132.68,0.00,0.67,0.00,0,3.00,1,259.63,1,1,4,org.apache.jackrabbit.webdav.client.methods.DavMethodBase,0.29,1,2,3,0,1,2,0,5,68,1
"org.apache.jackrabbit.webdav.client.methods.BaselineControlMethod",4,1.00,1.50,17,0.21,4763.02,5,1,10,12,5,144.84,15,27,0,3,124.23,0.00,0.67,0.00,0,6.00,3,616.62,1,1,5,org.apache.jackrabbit.webdav.client.methods.DavMethodBase,0.27,8,2,6,0,8,3,0,8,135,1
"org.apache.jackrabbit.webdav.client.methods.BindMethod",3,0.00,1.00,8,0.07,1010.78,3,0,3,3,4,140.10,14,14,1,3,139.87,0.00,0.67,0.00,0,3.00,1,212.67,1,1,3,org.apache.jackrabbit.webdav.client.methods.DavMethodBase,0.29,0,2,3,0,0,2,0,5,58,1
"org.apache.jackrabbit.webdav.client.methods.CheckinMethod",4,1.00,1.00,11,0.10,1278.80,5,1,5,8,5,160.66,13,18,1,3,140.05,0.00,0.67,0.00,0,4.00,1,289.63,0,2,4,org.apache.jackrabbit.webdav.client.methods.DavMethodBase,0.27,4,2,4,0,4,2,0,5,78,1
"org.apache.jackrabbit.webdav.client.methods.CheckoutMethod",3,1.00,1.00,8,0.07,1078.98,4,1,4,4,4,139.88,13,14,1,3,139.64,0.00,0.67,0.00,0,3.00,1,223.02,0,1,3,org.apache.jackrabbit.webdav.client.methods.DavMethodBase,0.29,1,2,3,0,1,2,0,5,60,1
"org.apache.jackrabbit.webdav.client.methods.CopyMethod",4,1.00,1.25,14,0.15,2470.28,5,1,7,7,7,98.95,27,22,1,3,131.17,0.00,0.67,0.00,0,4.00,2,461.65,1,1,6,org.apache.jackrabbit.webdav.client.methods.DavMethodBase,0.27,3,2,5,0,3,3,0,7,114,1
"org.apache.jackrabbit.webdav.client.methods.DavMethod",7,0.00,1.00,8,0.05,281.99,7,0,6,7,8,116.07,55,9,5,2,158.36,0.00,0.50,0.00,0,7.00,1,153.73,0,3,3,,0.00,0,1,7,0,0,4,0,8,55,1
"org.apache.jackrabbit.webdav.client.methods.DavMethodBase",18,0.07,1.78,92,0.91,25021.84,23,5,24,42,46,102.17,99,133,37,2,120.04,33.00,0.03,0.13,7,98.00,5,2733.61,1,5,9,org.apache.commons.httpclient.methods.EntityEnclosingMethod,0.00,24,1,32,33,24,13,2,31,600,2
"org.apache.jackrabbit.webdav.client.methods.DavMethodTest",3,1.00,1.00,11,0.11,1719.19,4,1,6,8,3,131.48,1,17,1,2,131.48,0.00,0.50,0.00,0,3.00,1,339.16,2,0,2,junit.framework.TestCase,0.00,5,1,3,0,5,3,0,1,85,1
"org.apache.jackrabbit.webdav.client.methods.DavMethodTest$TestDavMethod",10,0.00,1.00,20,0.14,1651.94,10,0,6,12,2,142.30,0,39,0,3,142.30,0.00,0.67,0.00,0,10.00,1,408.24,0,3,2,org.apache.jackrabbit.webdav.client.methods.DavMethodBase,0.64,2,2,10,0,2,7,0,0,122,1
"org.apache.jackrabbit.webdav.client.methods.DeleteMethod",3,1.00,1.00,8,0.07,1078.98,4,1,4,4,9,189.64,3,14,6,3,139.64,0.00,0.67,0.00,0,3.00,1,223.02,0,1,3,org.apache.jackrabbit.webdav.client.methods.DavMethodBase,0.29,1,2,3,0,1,2,0,1,60,1
"org.apache.jackrabbit.webdav.client.methods.LabelMethod",5,1.00,1.00,14,0.16,2340.41,6,1,7,9,6,106.52,34,23,1,3,138.74,0.00,0.67,0.00,0,5.00,1,487.82,2,1,5,org.apache.jackrabbit.webdav.client.methods.DavMethodBase,0.26,4,2,5,0,4,4,0,8,123,1
"org.apache.jackrabbit.webdav.client.methods.LockMethod",10,0.11,1.90,68,0.72,17231.56,13,3,21,32,17,68.24,82,93,3,3,116.34,0.00,0.67,0.23,2,38.00,3,2160.16,6,3,14,org.apache.jackrabbit.webdav.client.methods.DavMethodBase,0.32,22,2,19,0,22,7,0,23,463,1
"org.apache.jackrabbit.webdav.client.methods.MergeMethod",3,1.00,1.00,9,0.09,1212.13,4,1,6,4,5,132.91,14,15,1,3,132.68,0.00,0.67,0.00,0,3.00,1,259.63,1,1,4,org.apache.jackrabbit.webdav.client.methods.DavMethodBase,0.29,1,2,3,0,1,2,0,6,68,1
"org.apache.jackrabbit.webdav.client.methods.MkActivityMethod",3,1.00,1.00,8,0.07,1078.98,4,1,4,4,3,139.88,12,14,0,3,139.64,0.00,0.67,0.00,0,3.00,1,223.02,0,1,3,org.apache.jackrabbit.webdav.client.methods.DavMethodBase,0.29,1,2,3,0,1,2,0,5,60,1
"org.apache.jackrabbit.webdav.client.methods.MkColMethod",3,1.00,1.00,8,0.07,1078.98,4,1,4,4,6,139.88,12,14,3,3,139.64,0.00,0.67,0.00,0,3.00,1,223.02,0,1,3,org.apache.jackrabbit.webdav.client.methods.DavMethodBase,0.29,1,2,3,0,1,2,0,5,60,1
"org.apache.jackrabbit.webdav.client.methods.MkWorkspaceMethod",3,1.00,1.00,8,0.07,1078.98,4,1,4,4,3,139.88,12,14,0,3,139.64,0.00,0.67,0.00,0,3.00,1,223.02,0,1,3,org.apache.jackrabbit.webdav.client.methods.DavMethodBase,0.29,1,2,3,0,1,2,0,5,60,1
"org.apache.jackrabbit.webdav.client.methods.MoveMethod",3,1.00,1.00,10,0.11,1796.40,4,1,6,5,9,131.57,14,16,4,3,131.33,0.00,0.67,0.00,0,3.00,1,335.07,1,1,5,org.apache.jackrabbit.webdav.client.methods.DavMethodBase,0.29,2,2,3,0,2,2,0,5,84,1
"org.apache.jackrabbit.webdav.client.methods.OptionsMethod",11,0.17,1.55,46,0.49,10853.56,14,3,14,25,8,125.10,53,65,3,3,124.86,0.00,0.67,0.18,0,32.00,5,1473.44,2,4,5,org.apache.jackrabbit.webdav.client.methods.DavMethodBase,0.21,14,2,17,0,14,7,0,12,341,1
"org.apache.jackrabbit.webdav.client.methods.OrderPatchMethod",5,1.00,1.40,21,0.28,6439.25,6,1,8,9,8,73.98,45,29,2,3,123.97,0.00,0.67,0.00,0,5.00,2,850.48,1,1,6,org.apache.jackrabbit.webdav.client.methods.DavMethodBase,0.26,4,2,7,0,4,4,0,8,189,1
"org.apache.jackrabbit.webdav.client.methods.PollMethod",7,0.25,2.00,42,0.43,9241.66,9,2,17,20,11,137.85,25,61,1,3,117.24,0.00,0.67,0.29,1,14.00,3,1286.09,5,2,10,org.apache.jackrabbit.webdav.client.methods.DavMethodBase,0.24,13,2,14,0,13,5,1,8,279,1
"org.apache.jackrabbit.webdav.client.methods.PollMethod$EventBundle",1,0.00,1.00,3,0.02,254.64,1,0,17,2,0,134.26,0,4,0,1,134.26,0.00,0.00,0.00,0,1.00,1,70.91,0,1,0,java.lang.Object,0.00,1,0,1,0,1,0,0,0,21,0
"org.apache.jackrabbit.webdav.client.methods.PropFindMethod",6,1.00,2.33,47,0.71,47335.70,7,1,13,22,12,90.72,35,67,5,3,108.59,0.00,0.67,0.00,0,10.00,9,2119.71,2,1,7,org.apache.jackrabbit.webdav.client.methods.DavMethodBase,0.25,16,2,14,0,16,5,0,11,380,1
"org.apache.jackrabbit.webdav.client.methods.PropPatchMethod",7,0.00,5.00,104,1.52,89351.40,10,3,23,44,17,63.32,43,136,2,3,95.54,0.00,0.67,0.33,0,8.00,11,4563.91,3,3,15,org.apache.jackrabbit.webdav.client.methods.DavMethodBase,0.36,37,2,35,0,37,4,1,17,788,1
"org.apache.jackrabbit.webdav.client.methods.PutMethod",3,1.00,1.00,8,0.08,1371.98,4,1,4,4,5,139.06,14,14,2,3,138.82,0.00,0.67,0.00,0,3.00,1,250.62,0,1,3,org.apache.jackrabbit.webdav.client.methods.DavMethodBase,0.29,1,2,3,0,1,2,0,5,66,1
"org.apache.jackrabbit.webdav.client.methods.RebindMethod",3,0.00,1.00,8,0.07,1010.78,3,0,3,3,4,140.10,13,14,1,3,139.87,0.00,0.67,0.00,0,3.00,1,212.67,1,1,3,org.apache.jackrabbit.webdav.client.methods.DavMethodBase,0.29,0,2,3,0,0,2,0,5,58,1
"org.apache.jackrabbit.webdav.client.methods.ReportMethod",3,0.25,1.33,16,0.17,3731.92,5,2,8,6,8,102.62,16,23,2,3,120.49,0.00,0.67,0.33,0,1.00,2,514.38,2,1,6,org.apache.jackrabbit.webdav.client.methods.DavMethodBase,0.29,3,2,4,0,3,2,0,5,119,1
"org.apache.jackrabbit.webdav.client.methods.SearchMethod",5,1.00,1.20,16,0.18,3348.75,6,1,7,7,6,170.79,14,25,1,3,130.91,0.00,0.67,0.00,0,5.00,2,531.66,1,1,5,org.apache.jackrabbit.webdav.client.methods.DavMethodBase,0.26,2,2,6,0,2,4,0,6,131,1
"org.apache.jackrabbit.webdav.client.methods.SubscribeMethod",8,0.29,2.25,55,0.63,15568.18,10,2,20,30,14,83.66,52,79,1,3,115.89,0.00,0.67,0.25,1,26.00,4,1886.16,6,3,13,org.apache.jackrabbit.webdav.client.methods.DavMethodBase,0.23,22,2,18,0,22,5,1,13,393,1
"org.apache.jackrabbit.webdav.client.methods.UnLockMethod",3,1.00,1.00,10,0.10,1541.33,4,1,8,5,8,132.09,14,16,2,3,131.86,0.00,0.67,0.00,0,3.00,1,305.61,1,1,6,org.apache.jackrabbit.webdav.client.methods.DavMethodBase,0.29,2,2,3,0,2,2,0,5,77,1
"org.apache.jackrabbit.webdav.client.methods.UnSubscribeMethod",3,1.00,1.00,9,0.09,1245.66,4,1,5,4,5,182.58,5,15,1,3,132.58,0.00,0.67,0.00,0,3.00,1,263.33,1,1,4,org.apache.jackrabbit.webdav.client.methods.DavMethodBase,0.29,1,2,3,0,1,2,0,3,69,1
"org.apache.jackrabbit.webdav.client.methods.UnbindMethod",3,0.00,1.00,8,0.06,717.77,3,0,3,3,4,141.27,13,14,1,3,141.04,0.00,0.67,0.00,0,3.00,1,185.08,1,1,3,org.apache.jackrabbit.webdav.client.methods.DavMethodBase,0.29,0,2,3,0,0,2,0,5,52,1
"org.apache.jackrabbit.webdav.client.methods.UncheckoutMethod",3,1.00,1.00,8,0.07,1078.98,4,1,4,4,3,139.88,13,14,0,3,139.64,0.00,0.67,0.00,0,3.00,1,223.02,0,1,3,org.apache.jackrabbit.webdav.client.methods.DavMethodBase,0.29,1,2,3,0,1,2,0,5,60,1
"org.apache.jackrabbit.webdav.client.methods.UpdateMethod",3,1.00,1.00,9,0.09,1212.13,4,1,6,4,5,132.91,13,15,1,3,132.68,0.00,0.67,0.00,0,3.00,1,259.63,1,1,4,org.apache.jackrabbit.webdav.client.methods.DavMethodBase,0.29,1,2,3,0,1,2,0,5,68,1
"org.apache.jackrabbit.webdav.client.methods.VersionControlMethod",3,1.00,1.00,8,0.07,1078.98,4,1,4,4,4,139.88,13,14,1,3,139.64,0.00,0.67,0.00,0,3.00,1,223.02,0,1,3,org.apache.jackrabbit.webdav.client.methods.DavMethodBase,0.29,1,2,3,0,1,2,0,5,60,1
"org.apache.jackrabbit.webdav.client.methods.XmlRequestEntity",5,0.12,1.40,21,0.26,6013.16,7,2,15,18,3,124.21,4,32,2,1,124.21,0.00,0.00,0.40,0,2.00,3,770.88,0,1,1,java.lang.Object,0.00,13,0,7,0,13,4,1,2,170,1
"org.apache.jackrabbit.api.management.DataStoreGarbageCollector",8,0.00,1.00,9,0.04,132.06,8,0,1,8,9,113.31,65,10,8,1,161.41,0.00,0.00,0.00,0,8.00,1,111.55,0,0,1,,0.00,0,0,8,0,0,8,0,9,47,1
"org.apache.jackrabbit.api.management.MarkEventListener",1,0.00,1.00,2,0.01,51.00,1,0,2,1,7,114.10,6,3,7,1,146.32,0.00,0.00,0.00,0,1.00,1,34.00,0,0,0,,0.00,0,0,1,0,0,1,0,2,13,1
"org.apache.jackrabbit.api.management.RepositoryManager",2,0.00,1.00,3,0.01,46.26,2,0,1,2,6,116.13,23,4,5,1,160.26,0.00,0.00,0.00,0,2.00,1,33.51,0,1,1,,0.00,0,0,2,0,0,1,0,3,15,1
"org.apache.jackrabbit.core.virtual.AbstractVISProvider",31,0.02,2.16,180,1.98,59445.40,37,6,22,84,21,101.03,184,252,1,1,118.90,0.00,0.00,0.15,11,309.00,6,5944.24,0,12,21,java.lang.Object,0.00,53,0,67,1,53,19,2,48,1266,2
"org.apache.jackrabbit.core.virtual.VirtualItemStateProvider",8,0.00,1.00,9,0.07,295.61,8,0,8,8,18,116.36,56,15,10,2,158.66,0.00,0.50,0.00,0,8.00,1,203.24,0,3,9,,0.00,0,1,8,0,0,5,0,9,68,1
"org.apache.jackrabbit.core.virtual.VirtualNodeState",11,0.20,1.55,57,0.71,18897.43,14,3,11,25,13,77.06,87,81,5,3,119.35,0.00,0.67,0.15,5,35.00,3,2127.48,3,5,10,org.apache.jackrabbit.core.state.NodeState,0.00,14,2,17,0,14,6,0,16,460,1
"org.apache.jackrabbit.core.virtual.VirtualPropertyState",4,0.67,1.50,13,0.11,2728.81,5,1,4,5,10,112.92,23,19,5,3,130.79,0.00,0.67,0.50,0,4.00,3,327.00,2,2,5,org.apache.jackrabbit.core.state.PropertyState,0.06,1,2,6,0,1,2,0,6,85,1
"org.apache.jackrabbit.core.virtual.VirtualValueProvider",1,0.00,1.00,2,0.01,44.48,1,0,2,1,3,96.79,9,3,1,1,146.79,0.00,0.00,0.00,0,1.00,1,29.65,0,1,2,,0.00,0,0,1,0,0,0,0,2,12,1
"org.apache.jackrabbit.test.api.version.AbstractMergeTest",3,0.50,3.00,41,0.44,12345.80,11,8,7,10,10,63.17,37,52,9,4,100.73,3.00,0.23,0.46,1,1.00,5,1314.98,3,0,1,org.apache.jackrabbit.test.AbstractJCRTest,0.28,7,3,9,9,7,3,0,17,258,2
"org.apache.jackrabbit.test.api.version.AbstractOnParentVersionTest",3,0.30,2.00,24,0.30,6179.15,8,5,5,14,6,78.84,20,31,5,5,111.06,1.25,0.40,0.40,0,0.00,3,901.35,2,1,1,org.apache.jackrabbit.test.api.version.AbstractVersionTest,0.30,11,4,6,5,11,2,0,5,187,2
"org.apache.jackrabbit.test.api.version.AbstractVersionTest",4,0.33,3.75,53,0.66,21531.45,9,5,8,19,22,67.54,27,77,20,4,99.76,8.67,0.10,0.45,0,2.00,10,1982.64,5,1,2,org.apache.jackrabbit.test.AbstractJCRTest,0.27,15,3,15,26,15,3,0,8,371,1
"org.apache.jackrabbit.test.api.version.ActivitiesTest",7,0.00,2.00,80,0.95,27552.95,9,2,7,37,2,153.68,10,111,1,5,103.68,0.00,0.80,0.50,0,0.00,3,2841.40,3,0,1,org.apache.jackrabbit.test.api.version.AbstractVersionTest,0.27,30,4,14,0,30,7,0,2,556,1
"org.apache.jackrabbit.test.api.version.CheckinTest",19,0.00,1.32,104,1.38,22786.02,19,0,7,43,2,88.40,115,136,1,5,120.62,0.00,0.80,0.00,0,0.00,2,4131.45,2,0,1,org.apache.jackrabbit.test.api.version.AbstractVersionTest,0.10,24,4,25,0,24,19,0,25,884,1
"org.apache.jackrabbit.test.api.version.CheckoutTest",11,0.00,2.64,93,1.09,32805.88,11,0,6,29,2,91.86,57,127,1,5,109.73,0.00,0.80,0.00,0,2.00,5,3273.16,1,0,1,org.apache.jackrabbit.test.api.version.AbstractVersionTest,0.12,18,4,29,0,18,11,0,19,661,1
"org.apache.jackrabbit.test.api.version.ConfigurationsTest",14,0.08,1.50,113,1.51,30420.32,18,4,7,39,2,150.83,41,144,1,5,110.94,0.00,0.80,0.32,1,0.00,2,4518.98,3,0,1,org.apache.jackrabbit.test.api.version.AbstractVersionTest,0.23,25,4,21,0,25,14,0,33,931,1
"org.apache.jackrabbit.test.api.version.CopyTest",3,0.00,1.33,26,0.37,6584.43,3,0,7,23,2,62.83,26,34,1,5,110.93,0.00,0.80,0.00,0,1.00,2,1107.28,3,0,1,org.apache.jackrabbit.test.api.version.simple.AbstractVersionTest,0.30,20,4,4,0,20,3,0,6,211,1
"org.apache.jackrabbit.test.api.version.FrozenNodeTest",9,0.00,1.00,81,1.30,19292.60,9,0,5,26,2,129.79,33,93,0,5,109.17,0.00,0.80,0.00,0,0.00,1,3912.34,2,0,2,org.apache.jackrabbit.test.api.version.AbstractVersionTest,0.13,17,4,9,0,17,9,0,10,756,1
"org.apache.jackrabbit.test.api.version.GetContainingHistoryTest",1,0.00,1.00,5,0.06,832.44,1,0,2,7,2,101.79,14,9,1,5,121.93,0.00,0.80,0.00,0,0.00,1,180.51,0,0,1,org.apache.jackrabbit.test.api.version.AbstractVersionTest,0.00,6,4,1,0,6,1,0,3,43,1
"org.apache.jackrabbit.test.api.version.GetCreatedTest",2,0.00,1.00,13,0.16,2111.18,2,0,4,13,2,68.17,19,16,1,5,118.16,0.00,0.80,0.00,0,0.00,1,473.38,0,0,1,org.apache.jackrabbit.test.api.version.AbstractVersionTest,0.00,11,4,2,0,11,2,0,5,104,1
"org.apache.jackrabbit.test.api.version.GetPredecessorsTest",2,0.00,1.00,17,0.26,4912.03,2,0,3,21,2,81.24,26,22,1,5,110.62,0.00,0.80,0.00,0,0.00,1,771.29,0,0,1,org.apache.jackrabbit.test.api.version.AbstractVersionTest,0.00,19,4,2,0,19,2,0,9,157,1
"org.apache.jackrabbit.test.api.version.GetReferencesNodeTest",4,0.33,1.50,36,0.34,5915.42,8,4,6,14,3,68.06,30,44,1,4,110.35,0.00,0.75,0.50,1,0.00,2,1010.45,4,0,2,org.apache.jackrabbit.test.AbstractJCRTest,0.27,10,3,6,0,10,4,0,10,216,1
"org.apache.jackrabbit.test.api.version.GetVersionableUUIDTest",2,0.00,1.00,9,0.13,1749.35,2,0,4,16,2,75.38,19,16,1,5,125.38,0.00,0.80,0.00,0,0.00,1,388.43,0,0,1,org.apache.jackrabbit.test.api.version.AbstractVersionTest,0.00,14,4,2,0,14,2,0,4,90,1
"org.apache.jackrabbit.test.api.version.MergeActivityTest",4,0.17,1.75,53,0.78,23831.48,6,2,4,33,2,99.83,17,61,1,5,99.59,0.00,0.80,0.62,0,0.00,3,2337.06,2,0,1,org.apache.jackrabbit.test.api.version.AbstractMergeTest,0.45,29,4,7,0,29,4,0,8,431,1
"org.apache.jackrabbit.test.api.version.MergeCancelMergeTest",5,0.25,1.80,70,1.12,40203.24,6,1,6,37,2,47.36,48,74,1,5,97.36,0.00,0.80,0.80,0,0.00,3,3355.79,2,0,1,org.apache.jackrabbit.test.api.version.AbstractMergeTest,0.44,32,4,9,0,32,5,0,28,600,1
"org.apache.jackrabbit.test.api.version.MergeCheckedoutSubNodeTest",7,0.17,1.29,58,0.89,17125.51,8,1,4,33,2,62.47,58,70,1,5,110.57,0.00,0.80,0.86,0,0.00,2,2662.94,2,0,1,org.apache.jackrabbit.test.api.version.AbstractMergeTest,0.42,26,4,9,0,26,7,0,30,525,1
"org.apache.jackrabbit.test.api.version.MergeDoneMergeTest",5,0.25,1.80,66,1.02,31238.24,6,1,6,36,2,49.42,46,70,1,5,99.42,0.00,0.80,0.80,0,0.00,3,3067.42,2,0,1,org.apache.jackrabbit.test.api.version.AbstractMergeTest,0.44,31,4,9,0,31,5,0,26,554,1
"org.apache.jackrabbit.test.api.version.MergeNodeIteratorTest",4,0.00,3.75,81,1.27,56862.73,5,1,6,27,2,40.99,42,99,1,5,89.46,0.00,0.80,1.00,0,0.00,6,3808.71,1,0,1,org.apache.jackrabbit.test.api.version.AbstractMergeTest,0.30,23,4,15,0,23,4,0,25,679,1
"org.apache.jackrabbit.test.api.version.MergeNodeTest",21,0.05,2.05,214,3.01,73898.63,22,1,13,67,3,57.50,188,278,1,5,105.61,0.00,0.80,0.95,0,0.00,4,9035.35,5,0,2,org.apache.jackrabbit.test.api.version.AbstractMergeTest,0.30,46,4,43,0,46,21,0,118,1710,1
"org.apache.jackrabbit.test.api.version.MergeNonVersionableSubNodeTest",8,0.00,1.00,83,1.51,32021.84,8,0,2,34,2,56.85,86,93,1,5,105.33,0.00,0.80,0.00,0,0.00,1,4533.70,1,0,1,org.apache.jackrabbit.test.api.version.AbstractMergeTest,0.27,26,4,8,0,26,8,0,54,850,1
"org.apache.jackrabbit.test.api.version.MergeShallowTest",5,0.25,1.80,64,1.08,31785.54,7,2,4,34,2,100.90,24,76,1,5,100.66,0.00,0.80,0.70,0,0.00,3,3228.14,2,0,1,org.apache.jackrabbit.test.api.version.AbstractMergeTest,0.44,29,4,9,0,29,5,0,12,582,1
"org.apache.jackrabbit.test.api.version.MergeSubNodeTest",13,0.08,1.31,147,2.27,49994.35,14,1,4,47,2,53.86,120,159,1,5,103.86,0.00,0.80,0.92,0,0.00,3,6798.43,2,0,1,org.apache.jackrabbit.test.api.version.AbstractMergeTest,0.36,34,4,17,0,34,13,0,62,1301,1
"org.apache.jackrabbit.test.api.version.OnParentVersionAbortTest",5,0.00,1.80,28,0.29,4103.13,5,0,5,20,3,79.55,37,42,1,6,121.84,0.00,0.83,0.00,0,4.00,2,870.36,2,0,2,org.apache.jackrabbit.test.api.version.AbstractOnParentVersionTest,0.16,15,5,9,0,15,5,0,11,195,1
"org.apache.jackrabbit.test.api.version.OnParentVersionComputeTest",3,0.00,1.00,24,0.27,4307.26,3,0,5,20,2,80.23,19,28,1,6,112.45,0.00,0.83,0.00,0,2.00,1,813.77,1,0,1,org.apache.jackrabbit.test.api.version.AbstractOnParentVersionTest,0.17,17,5,3,0,17,3,0,3,172,1
"org.apache.jackrabbit.test.api.version.OnParentVersionCopyTest",4,0.67,1.50,35,0.39,8170.65,5,1,5,22,2,63.05,32,42,1,6,111.15,0.00,0.83,0.50,0,0.00,2,1171.57,2,0,1,org.apache.jackrabbit.test.api.version.AbstractOnParentVersionTest,0.16,18,5,6,0,18,4,0,12,240,1
"org.apache.jackrabbit.test.api.version.OnParentVersionIgnoreTest",5,0.00,1.40,44,0.52,9354.80,5,0,5,26,2,79.25,31,52,1,6,111.47,0.00,0.83,0.00,0,4.00,2,1553.58,2,0,1,org.apache.jackrabbit.test.api.version.AbstractOnParentVersionTest,0.16,21,5,7,0,21,5,0,7,320,1
"org.apache.jackrabbit.test.api.version.OnParentVersionInitializeTest",3,0.00,1.00,24,0.27,4307.26,3,0,5,20,2,80.23,19,28,1,6,112.45,0.00,0.83,0.00,0,2.00,1,813.77,1,0,1,org.apache.jackrabbit.test.api.version.AbstractOnParentVersionTest,0.17,17,5,3,0,17,3,0,3,172,1
"org.apache.jackrabbit.test.api.version.RemoveVersionTest",10,0.25,2.90,113,1.23,37329.74,14,4,12,41,3,71.56,69,141,1,5,103.78,0.00,0.80,0.48,0,0.00,5,3691.05,3,0,2,org.apache.jackrabbit.test.api.version.AbstractVersionTest,0.25,31,4,29,0,31,10,0,26,730,1
"org.apache.jackrabbit.test.api.version.RestoreTest",71,0.10,1.54,676,9.58,254309.84,78,7,14,122,3,75.10,426,811,1,5,107.32,0.00,0.80,0.25,0,0.00,4,28745.61,4,0,2,org.apache.jackrabbit.test.api.version.AbstractVersionTest,0.10,51,4,109,0,51,71,0,177,5473,1
"org.apache.jackrabbit.test.api.version.SessionMoveVersionExceptionTest",2,0.00,2.00,15,0.18,3143.35,2,0,3,10,2,84.77,27,24,1,5,114.15,0.00,0.80,0.00,0,0.00,2,538.64,0,0,1,org.apache.jackrabbit.test.api.version.AbstractVersionTest,0.00,8,4,4,0,8,2,0,11,114,1
"org.apache.jackrabbit.test.api.version.TestAll",1,0.00,1.00,38,0.55,22706.53,1,0,3,3,35,40.20,12,40,1,2,77.77,0.00,0.50,0.00,0,1.00,1,1638.16,0,1,34,junit.framework.TestCase,0.00,2,1,1,0,2,0,0,3,295,1
"org.apache.jackrabbit.test.api.version.VersionGraphTest",8,0.00,1.50,41,0.62,10021.25,8,0,6,28,2,78.15,59,56,1,5,120.44,0.00,0.80,0.00,0,0.00,2,1867.51,0,0,1,org.apache.jackrabbit.test.api.version.AbstractVersionTest,0.00,20,4,12,0,20,8,0,11,389,1
"org.apache.jackrabbit.test.api.version.VersionHistoryTest",79,0.08,1.95,433,5.11,135145.63,82,3,28,211,2,119.55,374,626,1,5,119.31,0.00,0.80,0.41,0,0.00,13,15332.07,4,0,1,org.apache.jackrabbit.test.api.version.AbstractVersionTest,0.09,132,4,154,0,132,79,0,86,3196,1
"org.apache.jackrabbit.test.api.version.VersionHistoryTest$ItemVisitorTest",3,0.50,1.00,7,0.06,477.71,4,1,28,5,0,142.43,0,11,0,1,142.43,0.00,0.00,0.67,0,1.00,1,165.42,0,0,0,java.lang.Object,0.00,2,0,3,0,2,3,1,0,48,1
"org.apache.jackrabbit.test.api.version.VersionLabelTest",23,0.45,2.09,198,2.64,67850.14,28,5,9,60,3,67.53,169,242,2,5,109.82,0.25,0.67,0.63,0,0.00,3,7921.20,3,0,1,org.apache.jackrabbit.test.api.version.AbstractVersionTest,0.19,37,4,48,1,37,23,0,36,1546,1
"org.apache.jackrabbit.test.api.version.VersionStorageTest",3,0.50,1.67,18,0.22,3975.35,4,1,5,15,2,69.16,26,28,1,5,117.27,0.00,0.80,0.67,0,2.00,2,670.04,2,0,1,org.apache.jackrabbit.test.api.version.AbstractVersionTest,0.15,12,4,5,0,12,3,0,11,144,1
"org.apache.jackrabbit.test.api.version.VersionTest",68,0.09,1.84,316,3.67,93469.46,71,3,21,167,2,123.93,301,494,1,5,123.69,0.00,0.80,0.43,0,0.00,13,11008.80,2,0,1,org.apache.jackrabbit.test.api.version.AbstractVersionTest,0.10,99,4,125,0,99,68,0,75,2378,1
"org.apache.jackrabbit.test.api.version.VersionTest$ItemVisitorTest",3,0.50,1.00,7,0.06,477.71,4,1,21,5,0,142.43,0,11,0,1,142.43,0.00,0.00,0.67,0,1.00,1,165.42,0,0,0,java.lang.Object,0.00,2,0,3,0,2,3,1,0,48,1
"org.apache.jackrabbit.test.api.version.WorkspaceMoveVersionExceptionTest",2,0.00,2.00,13,0.17,2838.02,2,0,3,10,2,87.61,26,22,1,5,116.99,0.00,0.80,0.00,0,0.00,2,522.03,0,0,1,org.apache.jackrabbit.test.api.version.AbstractVersionTest,0.00,8,4,4,0,8,2,0,10,110,1
"org.apache.jackrabbit.test.api.version.WorkspaceRestoreTest",16,0.20,2.50,177,2.56,80159.18,26,10,12,53,3,70.59,102,221,1,5,102.81,0.00,0.80,0.29,0,0.00,8,7684.93,2,0,2,org.apache.jackrabbit.test.api.version.AbstractVersionTest,0.22,37,4,40,0,37,16,0,48,1437,1
"org.apache.jackrabbit.servlet.remote.JNDIRemoteBindingServlet",2,0.67,3.50,21,0.31,11939.90,5,3,9,14,3,152.95,49,33,0,3,103.67,0.00,0.67,0.67,0,0.00,5,928.84,0,0,3,org.apache.jackrabbit.servlet.remote.RemoteBindingServlet,0.00,12,2,7,0,12,2,0,6,181,1
"org.apache.jackrabbit.servlet.remote.JNDIRemoteRepositoryServlet",1,1.00,5.00,15,0.28,14192.86,2,1,12,12,6,52.56,44,27,0,4,94.06,0.00,0.75,0.00,0,1.00,5,828.56,1,1,6,org.apache.jackrabbit.servlet.remote.RemoteRepositoryServlet,0.50,11,3,5,0,11,0,0,3,151,1
"org.apache.jackrabbit.servlet.remote.RMIRemoteBindingServlet",2,0.00,4.00,15,0.17,3711.98,4,2,5,5,1,146.80,41,26,0,3,113.42,0.00,0.67,0.50,0,0.00,4,505.58,0,0,1,org.apache.jackrabbit.servlet.remote.RemoteBindingServlet,0.00,3,2,8,0,3,2,0,7,112,1
"org.apache.jackrabbit.servlet.remote.RMIRemoteRepositoryServlet",1,1.00,1.00,4,0.05,807.43,2,1,5,3,3,113.58,38,10,0,4,125.65,0.00,0.75,0.00,0,1.00,1,157.19,1,1,3,org.apache.jackrabbit.servlet.remote.RemoteRepositoryServlet,0.50,2,3,1,0,2,0,0,3,39,1
"org.apache.jackrabbit.servlet.remote.RemoteBindingServlet",3,0.50,3.33,26,0.36,12412.80,5,2,12,17,7,117.69,52,48,3,2,108.55,3.00,0.20,0.17,2,4.00,6,1071.87,0,2,4,javax.servlet.http.HttpServlet,0.00,14,1,10,3,14,1,0,6,218,1
"org.apache.jackrabbit.servlet.remote.RemoteRepositoryServlet",1,0.00,5.00,10,0.18,7230.12,1,0,4,5,6,139.97,30,25,3,3,102.94,1.50,0.33,0.00,0,1.00,5,532.58,1,1,3,org.apache.jackrabbit.servlet.AbstractRepositoryServlet,0.00,4,2,5,3,4,0,0,2,107,2
"org.apache.jackrabbit.servlet.remote.URLRemoteBindingServlet",1,1.00,4.00,13,0.17,5789.08,2,1,5,9,1,113.28,34,22,0,3,99.50,0.00,0.67,0.00,0,1.00,4,520.75,1,0,1,org.apache.jackrabbit.servlet.remote.RemoteBindingServlet,0.00,8,2,4,0,8,1,0,3,104,1
"org.apache.jackrabbit.servlet.remote.URLRemoteRepositoryServlet",1,1.00,3.00,9,0.12,3797.00,2,1,6,5,3,101.19,37,16,0,4,106.96,0.00,0.75,0.00,0,1.00,3,352.11,2,1,3,org.apache.jackrabbit.servlet.remote.RemoteRepositoryServlet,0.50,4,3,3,0,4,0,0,3,74,1
"org.apache.jackrabbit.standalone.cli.query.AbstractQuery",6,0.30,1.00,19,0.20,3179.16,8,2,6,14,3,131.99,26,26,2,1,131.75,0.00,0.00,0.25,1,14.00,1,606.44,0,3,1,java.lang.Object,0.00,8,0,6,2,8,3,1,10,141,2
"org.apache.jackrabbit.standalone.cli.query.SQLQuery",1,0.00,1.00,3,0.02,130.68,1,0,1,1,1,104.32,6,5,0,2,136.54,0.00,0.50,0.00,0,1.00,1,48.73,0,1,1,org.apache.jackrabbit.standalone.cli.query.AbstractQuery,0.29,0,1,1,0,0,0,0,2,16,1
"org.apache.jackrabbit.standalone.cli.query.XPathQuery",1,0.00,1.00,3,0.02,130.68,1,0,1,1,1,104.32,6,5,0,2,136.54,0.00,0.50,0.00,0,1.00,1,48.73,0,1,1,org.apache.jackrabbit.standalone.cli.query.AbstractQuery,0.29,0,1,1,0,0,0,0,2,16,1
"org.apache.jackrabbit.core.security.authorization.principalbased.ACLEditor",19,0.03,3.42,208,2.92,125994.54,23,4,32,84,20,71.10,116,265,3,2,103.32,0.00,0.50,0.22,12,74.00,8,8760.76,4,12,18,org.apache.jackrabbit.core.ProtectedItemModifier,0.00,65,1,65,0,65,7,2,49,1617,1
"org.apache.jackrabbit.core.security.authorization.principalbased.ACLEditor$ItemBasedPrincipal",2,0.00,1.00,5,0.03,261.14,2,0,32,3,1,143.11,0,7,0,1,143.11,0.00,0.00,0.00,0,2.00,1,81.08,0,2,1,java.lang.Object,0.00,1,0,2,0,1,0,0,0,26,0
"org.apache.jackrabbit.core.security.authorization.principalbased.ACLEditor$ItemBasedPrincipal_0",2,0.00,1.00,5,0.03,261.14,2,0,32,3,1,143.11,0,7,0,1,143.11,0.00,0.00,0.00,0,2.00,1,81.08,0,2,1,java.lang.Object,0.00,1,0,2,0,1,0,0,0,26,0
"org.apache.jackrabbit.core.security.authorization.principalbased.ACLProvider",8,0.14,3.88,137,2.33,116623.03,13,5,48,82,23,92.24,37,172,1,2,92.00,0.00,0.50,0.32,1,0.00,9,6999.69,7,4,22,org.apache.jackrabbit.core.security.authorization.AbstractAccessControlProvider,0.11,74,1,31,0,74,4,1,17,1138,1
"org.apache.jackrabbit.core.security.authorization.principalbased.ACLProvider$CompiledPermissionImpl",9,0.00,2.89,95,1.23,58049.32,15,6,48,40,10,71.23,56,125,0,2,103.45,0.00,0.50,0.17,2,30.00,7,3689.06,2,0,10,org.apache.jackrabbit.core.security.authorization.AbstractCompiledPermissions,0.12,31,1,26,0,31,9,1,27,703,1
"org.apache.jackrabbit.core.security.authorization.principalbased.ACLTemplate",13,0.11,2.46,106,1.76,72048.14,20,7,29,56,19,89.75,69,147,10,2,107.62,0.00,0.50,0.24,4,16.00,6,5292.61,1,4,9,org.apache.jackrabbit.core.security.authorization.AbstractACLTemplate,0.09,43,1,32,0,43,9,0,28,985,0
"org.apache.jackrabbit.core.security.authorization.principalbased.ACLTemplate$Entry",6,0.10,1.17,22,0.25,5918.87,8,2,29,12,4,179.59,6,34,0,2,129.59,0.00,0.50,0.42,0,10.00,2,738.91,1,2,4,org.apache.jackrabbit.core.security.authorization.AccessControlEntryImpl,0.18,6,1,7,0,6,4,0,2,167,0
"org.apache.jackrabbit.core.security.authorization.principalbased.ACLTemplateTest",5,1.00,1.00,19,0.27,4153.18,6,1,9,15,6,130.21,3,29,1,6,130.21,0.00,0.83,0.20,2,4.00,1,821.11,0,3,5,org.apache.jackrabbit.core.security.authorization.AbstractACLTemplateTest,0.21,10,5,5,0,10,2,0,1,184,1
"org.apache.jackrabbit.core.security.authorization.principalbased.EffectivePolicyTest",5,0.00,1.60,47,0.82,32420.90,5,0,16,32,8,125.89,18,65,1,7,105.28,0.00,0.86,0.00,0,2.00,3,2466.04,4,2,7,org.apache.jackrabbit.core.security.authorization.AbstractEffectivePolicyTest,0.12,27,6,8,0,27,3,0,13,439,1
"org.apache.jackrabbit.core.security.authorization.principalbased.EntriesCache",5,0.29,4.40,76,1.22,61610.09,11,6,21,46,9,65.19,65,112,1,2,94.58,0.00,0.50,0.40,1,1.00,13,3654.22,2,2,8,org.apache.jackrabbit.core.security.authorization.AccessControlObserver,0.22,41,1,22,0,41,3,1,30,642,0
"org.apache.jackrabbit.core.security.authorization.principalbased.EntryTest",9,0.31,1.56,103,1.88,77394.26,13,4,18,40,9,101.07,7,120,1,6,101.07,0.00,0.83,0.53,1,0.00,3,5629.33,2,2,8,org.apache.jackrabbit.core.security.authorization.AbstractEntryTest,0.11,31,5,14,0,31,7,0,5,1030,1
"org.apache.jackrabbit.core.security.authorization.principalbased.EvaluationUtil",3,0.00,5.33,37,0.43,18096.36,3,0,14,11,10,140.47,6,53,5,1,100.59,0.00,0.00,0.00,0,3.00,8,1295.16,0,2,5,java.lang.Object,0.00,8,0,16,0,8,1,0,4,256,0
"org.apache.jackrabbit.core.security.authorization.principalbased.LockTest",3,0.00,1.00,7,0.09,1319.26,3,0,10,6,6,188.96,3,12,1,7,138.96,0.00,0.86,0.00,0,4.00,1,267.14,0,2,5,org.apache.jackrabbit.core.security.authorization.AbstractLockManagementTest,0.12,3,6,3,0,3,1,0,1,68,1
"org.apache.jackrabbit.core.security.authorization.principalbased.NodeTypeTest",3,0.00,1.00,7,0.09,1319.26,3,0,10,6,6,188.96,3,12,1,7,138.96,0.00,0.86,0.00,0,4.00,1,267.14,0,2,5,org.apache.jackrabbit.core.security.authorization.AbstractNodeTypeManagementTest,0.11,3,6,3,0,3,1,0,1,68,1
"org.apache.jackrabbit.core.security.authorization.principalbased.TestAll",1,0.00,1.00,11,0.11,3828.97,1,0,3,3,7,55.46,10,13,0,2,103.94,0.00,0.50,0.00,0,1.00,1,341.05,0,1,7,junit.framework.TestCase,0.00,2,1,1,0,2,0,0,2,79,1
"org.apache.jackrabbit.core.security.authorization.principalbased.VersionTest",6,0.20,2.00,40,0.55,10551.92,8,2,17,21,7,166.26,9,57,1,7,116.26,0.00,0.86,0.33,0,10.00,5,1646.79,4,2,6,org.apache.jackrabbit.core.security.authorization.AbstractVersionManagementTest,0.11,15,6,12,0,15,4,0,7,337,1
"org.apache.jackrabbit.core.security.authorization.principalbased.WriteTest",9,0.00,2.56,114,1.93,88317.71,9,0,26,50,18,138.98,23,150,1,7,99.09,0.00,0.86,0.00,2,0.00,6,5780.32,5,2,17,org.apache.jackrabbit.core.security.authorization.AbstractWriteTest,0.07,41,6,23,0,41,7,0,13,1034,1
"org.apache.jackrabbit.jcr.AddMixinTest",7,0.25,2.29,69,0.89,29574.69,9,2,10,27,3,88.79,38,87,1,4,106.66,0.00,0.75,0.29,0,0.00,4,2680.46,2,0,2,org.apache.jackrabbit.test.AbstractJCRTest,0.24,20,3,16,0,20,7,0,6,519,1
"org.apache.jackrabbit.jcr.BitsetENTCacheImpl",14,0.08,1.71,85,0.86,26428.92,20,6,6,41,6,73.76,98,108,3,1,116.05,0.00,0.00,0.24,5,6.00,4,2579.49,0,4,3,java.lang.Object,0.00,27,0,24,0,27,10,1,33,584,0
"org.apache.jackrabbit.jcr.BitsetENTCacheImpl$BitsetKey",12,0.09,3.42,124,1.63,104252.54,15,3,6,21,2,60.11,84,152,0,1,102.40,0.00,0.00,0.42,1,0.00,8,4878.71,0,3,2,java.lang.Object,0.00,9,0,41,0,9,9,1,21,968,1
"org.apache.jackrabbit.jcr.DefinitionValidator",6,0.00,11.33,275,4.80,810484.74,9,3,24,65,12,117.86,161,342,1,1,68.37,0.00,0.00,0.33,4,10.00,42,14389.77,0,1,11,java.lang.Object,0.00,59,0,68,0,59,5,0,55,2187,0
"org.apache.jackrabbit.jcr.EffectiveNodeType",21,0.00,1.00,22,0.15,854.90,21,0,6,21,18,198.21,58,25,14,1,158.32,0.00,0.00,0.00,0,21.00,1,449.10,0,13,5,,0.00,0,0,21,0,0,8,0,9,156,1
"org.apache.jackrabbit.jcr.EffectiveNodeTypeCache",8,0.00,1.00,10,0.06,341.36,8,0,2,8,5,125.94,53,11,2,3,158.16,0.00,0.67,0.00,0,8.00,1,182.97,0,0,3,,0.00,0,2,8,0,0,8,0,10,65,1
"org.apache.jackrabbit.jcr.EffectiveNodeTypeCache$Key",3,0.00,1.00,4,0.02,146.25,3,0,2,3,1,115.42,22,5,0,1,157.71,0.00,0.00,0.00,0,3.00,1,66.32,0,2,1,,0.00,0,0,3,0,0,1,0,3,26,0
"org.apache.jackrabbit.jcr.EffectiveNodeTypeImpl",29,0.03,4.24,335,4.83,443718.64,36,7,17,90,9,81.00,155,449,2,1,98.87,0.00,0.00,0.17,6,239.00,27,14502.85,0,18,7,java.lang.Object,0.00,61,0,123,0,61,11,2,77,2679,1
"org.apache.jackrabbit.jcr.EffectiveNodeTypeProvider",4,0.00,1.00,5,0.07,637.00,4,0,5,4,13,103.66,39,11,10,1,153.66,0.00,0.00,0.00,0,4.00,1,205.09,0,0,3,,0.00,0,0,4,0,0,4,0,5,57,1
"org.apache.jackrabbit.jcr.ItemDefinitionProvider",8,0.00,1.00,9,0.15,1205.77,8,0,8,8,19,133.70,117,28,14,1,153.85,0.00,0.00,0.00,0,8.00,1,457.08,0,8,6,,0.00,0,0,8,0,0,0,0,10,122,1
"org.apache.jackrabbit.jcr.ItemDefinitionProviderImpl",17,0.01,3.12,158,1.99,118917.37,22,5,16,38,14,125.48,64,241,1,1,104.87,0.00,0.00,0.21,5,55.00,10,5972.01,0,15,13,java.lang.Object,0.00,21,0,53,0,21,2,1,40,1189,1
"org.apache.jackrabbit.jcr.MandatoryItemTest",3,0.50,6.67,63,0.81,42212.30,6,3,11,26,3,109.19,11,83,1,4,88.58,0.00,0.75,0.67,0,0.00,9,2436.89,2,0,2,org.apache.jackrabbit.test.AbstractJCRTest,0.14,23,3,20,0,23,3,0,11,459,1
"org.apache.jackrabbit.jcr.NodeTypeCache",7,0.33,2.29,61,0.79,44028.54,9,2,13,33,7,74.99,44,84,3,1,107.21,0.00,0.00,0.21,0,18.00,6,2375.86,0,4,4,java.lang.Object,0.00,26,0,16,0,26,3,0,10,471,1
"org.apache.jackrabbit.jcr.NodeTypeCache$NodeTypeStorage",4,0.00,1.00,9,0.12,1776.59,4,0,13,8,3,138.92,0,16,0,1,138.92,0.00,0.00,0.00,0,4.00,1,357.65,0,2,3,java.lang.Object,0.00,4,0,4,0,4,2,0,0,89,0
"org.apache.jackrabbit.jcr.NodeTypeDefinitionProvider",1,0.00,1.00,2,0.01,78.44,1,0,4,1,6,165.47,3,3,4,1,144.85,0.00,0.00,0.00,0,1.00,1,41.22,0,1,2,,0.00,0,0,1,0,0,0,0,1,14,1
"org.apache.jackrabbit.jcr.NodeTypeImpl",17,0.05,2.88,147,1.83,84126.47,21,4,24,52,17,75.75,108,198,3,2,107.98,0.00,0.50,0.29,4,70.00,14,5484.64,0,5,15,org.apache.jackrabbit.spi.commons.nodetype.AbstractNodeType,0.00,35,1,49,0,35,12,1,49,1052,1
"org.apache.jackrabbit.jcr.NodeTypeImplTest",2,1.00,3.00,30,0.30,8863.02,5,3,6,13,5,138.05,5,35,1,4,98.16,0.00,0.75,0.83,0,0.00,3,907.57,2,0,4,org.apache.jackrabbit.test.AbstractJCRTest,0.14,11,3,6,0,11,2,0,3,183,1
"org.apache.jackrabbit.jcr.NodeTypeManagerImpl",20,0.05,3.15,224,3.32,192738.04,27,7,36,105,21,82.64,108,297,3,2,100.52,0.00,0.50,0.19,6,128.00,17,9966.41,0,11,19,org.apache.jackrabbit.spi.commons.nodetype.AbstractNodeTypeManager,0.07,85,1,63,0,85,9,3,36,1774,1
"org.apache.jackrabbit.jcr.NodeTypeRegistry",7,0.00,1.00,8,0.07,493.85,7,0,7,7,8,114.15,53,11,5,1,156.44,0.00,0.00,0.00,0,7.00,1,216.64,0,2,3,,0.00,0,0,7,0,0,5,0,8,68,1
"org.apache.jackrabbit.jcr.NodeTypeRegistryImpl",24,0.09,3.42,326,4.24,369133.96,32,8,32,113,19,53.90,171,383,2,1,96.19,0.00,0.00,0.21,7,100.00,20,12729.91,0,3,17,java.lang.Object,0.00,89,0,82,0,89,21,3,94,2298,1
"org.apache.jackrabbit.jcr.NodeTypeRegistryImpl$NodeTypeDefinitionMap",17,0.44,2.76,137,2.13,175412.70,18,1,32,80,7,155.47,26,167,0,1,105.47,0.00,0.00,0.59,5,0.00,19,6390.03,0,9,7,java.lang.Object,0.00,63,0,47,0,63,8,2,16,1106,1
"org.apache.jackrabbit.jcr.NodeTypeRegistryListener",3,0.00,1.00,4,0.02,61.53,3,0,1,3,4,118.38,22,5,3,1,160.67,0.00,0.00,0.00,0,3.00,1,56.53,0,0,1,,0.00,0,0,3,0,0,3,0,4,23,1
"org.apache.jackrabbit.jcr.RemoveMixinTest",5,0.00,1.60,43,0.56,15577.00,7,2,10,21,3,109.93,22,57,1,4,109.69,0.00,0.75,0.50,0,0.00,2,1694.90,2,0,2,org.apache.jackrabbit.test.AbstractJCRTest,0.26,16,3,8,0,16,5,0,4,335,1
"org.apache.jackrabbit.jcr.TestAll",1,0.00,1.00,8,0.07,2228.14,1,0,3,3,5,131.56,3,10,1,2,110.95,0.00,0.50,0.00,0,1.00,1,223.66,0,1,4,junit.framework.TestCase,0.00,2,1,1,0,2,0,0,1,55,1
"org.apache.jackrabbit.standalone.cli.collect.AbstractCollect",11,0.12,1.36,42,0.55,18205.88,16,5,9,25,5,128.02,54,59,3,1,127.78,0.00,0.00,0.09,0,56.00,5,1654.98,0,4,2,java.lang.Object,0.00,14,0,15,3,14,7,1,18,332,2
"org.apache.jackrabbit.standalone.cli.collect.CollectItems",2,0.00,1.00,5,0.02,151.02,2,0,0,2,1,145.22,9,8,0,2,144.98,0.00,0.50,0.00,0,2.00,1,63.51,0,0,1,org.apache.jackrabbit.standalone.cli.collect.AbstractCollect,0.31,0,1,2,0,0,2,0,3,22,1
"org.apache.jackrabbit.standalone.cli.collect.CollectNodes",2,0.00,1.00,5,0.02,151.02,2,0,0,2,1,145.22,9,8,0,2,144.98,0.00,0.50,0.00,0,2.00,1,63.51,0,0,1,org.apache.jackrabbit.standalone.cli.collect.AbstractCollect,0.31,0,1,2,0,0,2,0,3,22,1
"org.apache.jackrabbit.standalone.cli.collect.CollectProperties",2,0.00,1.00,5,0.02,151.02,2,0,0,2,1,145.22,9,8,0,2,144.98,0.00,0.50,0.00,0,2.00,1,63.51,0,0,1,org.apache.jackrabbit.standalone.cli.collect.AbstractCollect,0.31,0,1,2,0,0,2,0,3,22,1
"org.apache.jackrabbit.commons.AbstractItem",3,0.00,4.00,36,0.42,28344.66,3,0,4,12,2,117.25,54,52,2,1,99.12,0.00,0.00,0.00,0,3.00,7,1264.29,1,2,0,java.lang.Object,0.00,9,0,12,2,9,1,1,5,248,2
"org.apache.jackrabbit.commons.AbstractNode",32,0.00,1.91,182,2.16,72905.60,32,0,19,79,2,88.96,435,250,0,2,118.34,0.00,0.50,0.00,8,32.00,8,6493.79,0,19,2,org.apache.jackrabbit.commons.AbstractItem,0.00,47,1,61,0,47,13,1,44,1373,2
"org.apache.jackrabbit.commons.AbstractProperty",26,0.00,1.65,106,1.41,65521.71,26,0,14,60,1,84.08,324,166,0,2,121.64,0.00,0.50,0.00,3,26.00,8,4244.12,0,6,1,org.apache.jackrabbit.commons.AbstractItem,0.00,34,1,43,0,34,20,2,32,911,2
"org.apache.jackrabbit.commons.AbstractRepository",4,0.00,1.00,11,0.10,1682.59,4,0,6,6,7,90.63,41,16,7,1,139.11,0.00,0.00,0.00,1,4.00,1,308.97,0,3,0,java.lang.Object,0.00,2,0,4,9,2,1,1,6,82,2
"org.apache.jackrabbit.commons.AbstractRepository$HashSet<String>",0,0.00,0.00,49,0.58,17111.25,0,0,6,0,0,171.00,0,49,0,1,171.00,0.00,0.00,0.00,0,0.00,0,1741.26,0,0,0,java.lang.Object,0.00,0,0,0,0,0,0,0,0,296,0
"org.apache.jackrabbit.commons.AbstractRepositoryTest",5,0.00,1.00,32,0.30,5321.55,5,0,4,8,2,85.91,30,38,0,3,118.14,0.00,0.67,0.00,0,5.00,1,893.01,3,0,2,org.apache.jackrabbit.commons.MockCase,0.00,3,2,5,0,3,5,0,6,206,1
"org.apache.jackrabbit.commons.AbstractSession",20,0.79,2.60,147,1.80,63797.09,21,1,26,72,8,74.10,240,227,2,1,111.66,0.00,0.00,0.25,6,70.00,9,5387.22,0,8,6,java.lang.Object,0.00,52,0,52,5,52,12,1,36,1095,2
"org.apache.jackrabbit.commons.AbstractWorkspace",1,0.00,4.00,12,0.14,4857.39,1,0,8,6,2,91.04,15,21,1,1,101.40,0.00,0.00,0.00,0,1.00,4,428.08,0,0,1,java.lang.Object,0.00,5,0,4,1,5,1,1,2,86,2
"org.apache.jackrabbit.commons.Deprecated",0,0.00,0.00,2,0.03,467.14,1,1,0,0,1,171.00,8,3,0,2,171.00,0.00,0.50,0.00,0,0.00,0,81.75,0,0,1,JndiRepositoryFactory,0.00,0,1,0,0,0,0,0,2,20,1
"org.apache.jackrabbit.commons.JcrUtils",24,1.00,2.04,174,2.74,181071.78,25,1,28,92,20,98.42,378,260,17,1,108.78,0.00,0.00,0.00,4,24.00,13,8216.10,0,9,3,java.lang.Object,0.00,68,0,49,0,68,15,0,34,1478,1
"org.apache.jackrabbit.commons.MockCase",4,0.11,1.50,25,0.27,6941.08,7,3,7,18,1,72.24,47,35,1,2,116.37,1.00,0.33,0.42,0,2.00,3,816.71,0,2,0,junit.framework.TestCase,0.00,14,1,6,1,14,2,1,11,175,1
"org.apache.jackrabbit.commons.MockCase$MethodCall",2,2.00,1.00,9,0.09,1223.90,4,2,7,5,0,76.60,18,12,0,1,126.60,0.00,0.00,0.00,0,2.00,1,256.69,0,0,0,java.lang.Object,0.00,3,0,2,0,3,2,0,4,67,2
"org.apache.jackrabbit.commons.NamespaceHelper",8,0.04,2.62,68,0.79,26946.46,12,4,8,30,6,79.93,104,93,5,1,109.31,0.00,0.00,0.28,1,0.00,5,2371.80,0,6,1,java.lang.Object,0.00,22,0,21,0,22,2,0,19,486,1
"org.apache.jackrabbit.commons.SuppressWarnings",2,1.00,4.50,30,0.39,16098.67,3,1,9,15,1,95.55,32,50,0,1,96.03,0.00,0.00,0.50,1,2.00,6,1167.23,0,2,1,java.lang.Object,0.00,13,0,9,0,13,0,1,6,226,1
"org.apache.jackrabbit.server.jcr.JCRWebdavServer",3,0.25,1.33,19,0.19,3810.47,7,4,21,9,9,79.90,38,25,1,1,117.46,0.00,0.00,0.08,0,4.00,2,571.25,0,0,8,java.lang.Object,0.00,6,0,4,0,6,3,1,13,132,1
"org.apache.jackrabbit.server.jcr.JCRWebdavServer$DavSessionImpl",3,0.00,1.00,7,0.05,428.90,3,0,21,3,1,110.58,18,11,0,2,142.80,0.00,0.50,0.00,0,1.00,1,142.37,0,0,1,org.apache.jackrabbit.webdav.jcr.JcrDavSession,0.00,0,1,3,0,0,3,0,3,44,1
"org.apache.jackrabbit.server.jcr.JCRWebdavServer$SessionCache",7,0.00,3.43,79,1.08,48022.34,9,2,21,34,5,59.37,54,103,0,1,101.66,0.00,0.00,0.50,4,0.00,8,3247.87,0,4,5,java.lang.Object,0.00,27,0,24,0,27,3,0,14,609,1
"org.apache.jackrabbit.spi.commons.query.qom.AbstractQOMNode",7,0.83,2.00,35,0.33,8082.26,8,1,4,13,12,141.27,27,51,8,1,120.65,0.00,0.00,0.29,2,13.00,3,976.65,0,6,4,java.lang.Object,0.00,6,0,14,32,6,1,0,5,228,2
"org.apache.jackrabbit.spi.commons.query.qom.AndImpl",5,0.12,1.00,15,0.12,1458.71,7,2,3,6,8,115.92,27,21,6,3,133.79,0.00,0.67,0.40,0,6.00,1,351.27,1,4,3,org.apache.jackrabbit.spi.commons.query.qom.ConstraintImpl,0.00,1,2,5,0,1,1,1,8,96,1
"org.apache.jackrabbit.spi.commons.query.qom.BindVariableValueImpl",5,0.75,1.00,13,0.09,1030.99,6,1,3,6,11,123.67,25,21,8,3,141.55,0.00,0.67,0.40,0,7.00,1,279.22,1,4,4,org.apache.jackrabbit.spi.commons.query.qom.StaticOperandImpl,0.00,1,2,5,0,1,1,1,8,79,1
"org.apache.jackrabbit.spi.commons.query.qom.ChildNodeImpl",7,0.17,1.14,21,0.19,3266.98,9,2,6,11,11,114.28,37,32,7,3,132.15,0.00,0.67,0.36,0,16.00,2,559.01,2,6,5,org.apache.jackrabbit.spi.commons.query.qom.ConstraintImpl,0.00,4,2,8,0,4,1,1,10,142,1
"org.apache.jackrabbit.spi.commons.query.qom.ChildNodeJoinConditionImpl",7,0.25,1.00,21,0.16,1990.95,9,2,3,8,10,116.01,37,33,7,3,133.88,0.00,0.67,0.29,2,19.00,1,466.29,1,6,4,org.apache.jackrabbit.spi.commons.query.qom.JoinConditionImpl,0.00,1,2,7,0,1,1,1,10,128,1
"org.apache.jackrabbit.spi.commons.query.qom.ColumnImpl",8,0.07,1.12,27,0.22,3390.83,12,4,3,9,16,100.26,53,41,13,2,132.49,0.00,0.50,0.19,1,28.00,2,652.66,1,7,4,org.apache.jackrabbit.spi.commons.query.qom.AbstractQOMNode,0.00,1,1,9,0,1,1,1,14,168,1
"org.apache.jackrabbit.spi.commons.query.qom.ComparisonImpl",7,0.00,1.00,21,0.16,1944.41,10,3,6,12,11,101.74,43,32,6,3,133.96,0.00,0.67,0.33,0,12.00,1,489.16,0,6,6,org.apache.jackrabbit.spi.commons.query.qom.ConstraintImpl,0.00,5,2,7,0,5,1,1,11,132,1
"org.apache.jackrabbit.spi.commons.query.qom.ConstraintImpl",1,0.00,1.00,3,0.02,160.59,1,0,2,1,16,136.07,4,7,14,2,135.83,9.00,0.09,0.00,0,1.00,1,58.53,0,0,2,org.apache.jackrabbit.spi.commons.query.qom.AbstractQOMNode,0.00,0,1,1,9,0,1,1,1,19,2
"org.apache.jackrabbit.spi.commons.query.qom.DefaultQOMTreeVisitor",27,0.00,1.00,55,0.46,5451.48,27,0,0,27,32,162.23,85,83,4,1,141.62,0.00,0.00,0.00,0,27.00,1,1370.63,0,27,28,java.lang.Object,0.00,0,0,27,1,0,0,1,28,384,1
"org.apache.jackrabbit.spi.commons.query.qom.DefaultTraversingQOMTreeVisitor",11,0.00,1.27,54,0.67,18052.15,11,0,0,34,21,143.78,43,63,3,2,123.17,0.00,0.50,0.00,0,11.00,4,2006.29,0,11,19,org.apache.jackrabbit.spi.commons.query.qom.DefaultQOMTreeVisitor,0.00,23,1,14,0,23,0,0,12,455,1
"org.apache.jackrabbit.spi.commons.query.qom.DescendantNodeImpl",7,0.17,1.14,21,0.19,3266.98,9,2,6,11,11,114.28,37,36,7,3,132.15,0.00,0.67,0.36,0,16.00,2,559.01,2,6,5,org.apache.jackrabbit.spi.commons.query.qom.ConstraintImpl,0.00,4,2,8,0,4,1,1,10,142,1
"org.apache.jackrabbit.spi.commons.query.qom.DescendantNodeJoinConditionImpl",7,0.25,1.00,21,0.16,1990.95,9,2,3,8,8,116.01,37,33,5,3,133.88,0.00,0.67,0.29,2,19.00,1,466.29,1,6,4,org.apache.jackrabbit.spi.commons.query.qom.JoinConditionImpl,0.00,1,2,7,0,1,1,1,10,128,1
"org.apache.jackrabbit.spi.commons.query.qom.DynamicOperandImpl",3,0.50,1.00,9,0.06,681.71,4,1,3,3,18,116.77,16,15,15,2,134.65,7.00,0.11,0.67,0,1.00,1,179.42,1,2,3,org.apache.jackrabbit.spi.commons.query.qom.AbstractQOMNode,0.00,0,1,3,7,0,1,1,4,51,2
"org.apache.jackrabbit.spi.commons.query.qom.EquiJoinConditionImpl",11,0.08,1.00,31,0.23,3020.48,15,4,3,12,9,122.69,63,50,6,3,140.57,0.00,0.67,0.18,3,67.00,1,694.60,1,10,4,org.apache.jackrabbit.spi.commons.query.qom.JoinConditionImpl,0.00,1,2,11,0,1,1,1,16,192,1
"org.apache.jackrabbit.spi.commons.query.qom.FullTextSearchImpl",8,0.10,1.12,34,0.27,6379.08,11,3,4,12,13,93.44,50,49,10,3,125.66,0.00,0.67,0.25,2,28.00,2,809.19,2,7,4,org.apache.jackrabbit.spi.commons.query.qom.ConstraintImpl,0.00,4,2,9,0,4,1,1,13,200,1
"org.apache.jackrabbit.spi.commons.query.qom.FullTextSearchScoreImpl",3,0.00,1.00,7,0.06,635.73,3,0,3,4,11,162.07,11,13,8,3,141.45,0.00,0.67,0.00,0,3.00,1,184.24,0,2,4,org.apache.jackrabbit.spi.commons.query.qom.DynamicOperandImpl,0.00,1,2,3,0,1,1,1,4,53,1
"org.apache.jackrabbit.spi.commons.query.qom.JoinConditionImpl",1,0.00,1.00,3,0.02,160.59,1,0,2,1,12,156.45,3,7,10,2,135.83,4.00,0.17,0.00,0,1.00,1,58.53,0,0,2,org.apache.jackrabbit.spi.commons.query.qom.AbstractQOMNode,0.00,0,1,1,4,0,1,1,1,19,2
"org.apache.jackrabbit.spi.commons.query.qom.JoinImpl",9,0.06,1.00,32,0.29,7126.27,13,4,5,14,12,112.50,50,47,7,3,130.38,0.00,0.67,0.31,0,22.00,1,855.64,0,7,6,org.apache.jackrabbit.spi.commons.query.qom.SourceImpl,0.17,5,2,9,0,5,2,1,14,217,1
"org.apache.jackrabbit.spi.commons.query.qom.LengthImpl",4,1.00,1.00,11,0.09,1050.79,5,1,3,6,11,140.95,19,16,8,3,140.72,0.00,0.67,0.25,0,6.00,1,272.72,0,3,4,org.apache.jackrabbit.spi.commons.query.qom.DynamicOperandImpl,0.00,2,2,4,0,2,1,1,6,75,1
"org.apache.jackrabbit.spi.commons.query.qom.LiteralImpl",6,0.60,1.17,29,0.39,9199.84,7,1,5,11,7,163.31,14,52,5,3,123.42,0.00,0.67,0.50,0,6.00,2,1168.58,0,5,3,org.apache.jackrabbit.spi.commons.query.qom.StaticOperandImpl,0.00,5,2,7,0,5,1,1,5,247,1
"org.apache.jackrabbit.spi.commons.query.qom.LowerCaseImpl",4,0.67,1.00,11,0.09,1084.13,5,1,3,6,10,140.85,19,16,8,3,140.61,0.00,0.67,0.50,0,4.00,1,267.64,0,3,3,org.apache.jackrabbit.spi.commons.query.qom.DynamicOperandImpl,0.00,2,2,4,0,2,1,1,6,74,1
"org.apache.jackrabbit.spi.commons.query.qom.NodeLocalNameImpl",3,0.00,1.00,7,0.06,635.73,3,0,3,4,11,162.07,11,13,8,3,141.45,0.00,0.67,0.00,0,3.00,1,184.24,0,2,4,org.apache.jackrabbit.spi.commons.query.qom.DynamicOperandImpl,0.00,1,2,3,0,1,1,1,4,53,1
"org.apache.jackrabbit.spi.commons.query.qom.NodeNameImpl",3,0.00,1.00,7,0.06,635.73,3,0,3,4,11,162.07,11,11,8,3,141.45,0.00,0.67,0.00,0,3.00,1,184.24,0,2,4,org.apache.jackrabbit.spi.commons.query.qom.DynamicOperandImpl,0.00,1,2,3,0,1,1,1,4,53,1
"org.apache.jackrabbit.spi.commons.query.qom.NotImpl",4,0.67,1.00,11,0.08,1010.38,5,1,3,5,8,141.09,19,16,6,3,140.85,0.00,0.67,0.50,0,4.00,1,250.88,0,3,3,org.apache.jackrabbit.spi.commons.query.qom.ConstraintImpl,0.00,1,2,4,0,1,1,1,6,70,1
"org.apache.jackrabbit.spi.commons.query.qom.OrImpl",5,0.12,1.00,15,0.12,1458.71,7,2,3,6,8,115.92,27,21,6,3,133.79,0.00,0.67,0.40,0,6.00,1,351.27,1,4,3,org.apache.jackrabbit.spi.commons.query.qom.ConstraintImpl,0.00,1,2,5,0,1,1,1,8,96,1
"org.apache.jackrabbit.spi.commons.query.qom.OrderingImpl",6,0.07,1.17,21,0.18,2774.95,9,3,5,9,14,99.96,36,31,10,2,132.18,0.00,0.50,0.28,0,6.00,2,542.99,0,4,5,org.apache.jackrabbit.spi.commons.query.qom.AbstractQOMNode,0.00,3,1,7,0,3,2,1,10,137,1
"org.apache.jackrabbit.spi.commons.query.qom.PropertyExistenceImpl",7,0.17,1.00,19,0.14,1613.45,9,2,3,8,12,123.29,38,31,9,3,141.17,0.00,0.67,0.36,1,16.00,1,417.19,1,6,4,org.apache.jackrabbit.spi.commons.query.qom.ConstraintImpl,0.00,1,2,7,0,1,1,1,11,117,1
"org.apache.jackrabbit.spi.commons.query.qom.PropertyValueImpl",5,0.50,1.00,13,0.10,1165.69,6,1,3,6,14,123.25,25,23,11,3,141.13,0.00,0.67,0.60,0,2.00,1,309.52,2,4,4,org.apache.jackrabbit.spi.commons.query.qom.DynamicOperandImpl,0.00,1,2,5,0,1,1,1,8,86,1
"org.apache.jackrabbit.spi.commons.query.qom.QOMTreeVisitor",27,0.00,1.00,28,0.29,1512.79,27,0,0,27,30,157.23,3,29,30,1,157.23,0.00,0.00,0.00,0,27.00,1,865.88,0,27,27,,0.00,0,0,27,0,0,0,0,1,275,1
"org.apache.jackrabbit.spi.commons.query.qom.QueryObjectModelFactoryImpl",49,0.08,1.94,212,2.83,100613.48,50,1,43,84,43,73.83,512,432,5,1,122.30,0.00,0.00,0.92,2,0.00,10,8482.56,0,48,38,java.lang.Object,0.00,35,0,95,2,35,1,1,59,1821,2
"org.apache.jackrabbit.spi.commons.query.qom.QueryObjectModelTree",9,0.02,2.22,71,0.78,40939.69,14,5,7,27,28,68.20,63,89,20,2,110.49,0.00,0.50,0.22,2,38.00,8,2341.84,0,6,10,org.apache.jackrabbit.spi.commons.query.qom.AbstractQOMNode,0.00,18,1,20,0,18,3,0,19,480,1
"org.apache.jackrabbit.spi.commons.query.qom.QueryObjectModelTree$DefaultTraversingQOMTreeVisitor",13,0.00,1.15,36,0.41,7358.34,13,0,7,29,14,138.06,0,56,0,1,138.06,0.00,0.00,0.00,1,24.00,3,1223.28,0,13,14,java.lang.Object,0.00,16,0,15,0,16,0,0,0,300,0
"org.apache.jackrabbit.spi.commons.query.qom.SameNodeImpl",6,0.20,1.17,19,0.18,3206.98,8,2,6,10,11,113.81,32,30,7,3,131.68,0.00,0.67,0.33,0,14.00,2,535.01,2,5,5,org.apache.jackrabbit.spi.commons.query.qom.ConstraintImpl,0.00,4,2,7,0,4,1,1,9,134,1
"org.apache.jackrabbit.spi.commons.query.qom.SameNodeJoinConditionImpl",9,0.08,1.11,34,0.26,5663.05,12,3,4,13,10,113.27,50,50,6,3,131.14,0.00,0.67,0.26,2,38.00,2,790.91,3,8,5,org.apache.jackrabbit.spi.commons.query.qom.JoinConditionImpl,0.00,4,2,10,0,4,1,1,13,202,1
"org.apache.jackrabbit.spi.commons.query.qom.SelectorImpl",8,0.21,1.00,21,0.15,1787.58,10,2,3,9,26,109.05,48,32,24,3,141.27,0.00,0.67,0.31,0,22.00,1,451.25,2,7,4,org.apache.jackrabbit.spi.commons.query.qom.SourceImpl,0.18,1,2,8,0,1,1,1,13,128,1
"org.apache.jackrabbit.spi.commons.query.qom.SourceImpl",2,0.00,1.00,4,0.03,209.72,2,0,2,2,9,164.47,6,6,7,2,143.86,2.00,0.25,0.00,0,2.00,1,78.18,0,0,3,org.apache.jackrabbit.spi.commons.query.qom.AbstractQOMNode,0.00,0,1,2,2,0,2,1,2,26,2
"org.apache.jackrabbit.spi.commons.query.qom.StaticOperandImpl",1,0.00,1.00,3,0.02,160.59,1,0,2,1,9,156.45,3,7,7,2,135.83,2.00,0.25,0.00,0,1.00,1,58.53,0,0,2,org.apache.jackrabbit.spi.commons.query.qom.AbstractQOMNode,0.00,0,1,1,2,0,1,1,1,19,2
"org.apache.jackrabbit.spi.commons.query.qom.UpperCaseImpl",4,0.67,1.00,11,0.09,1084.13,5,1,3,6,10,140.85,19,16,8,3,140.61,0.00,0.67,0.50,0,4.00,1,267.64,0,3,3,org.apache.jackrabbit.spi.commons.query.qom.DynamicOperandImpl,0.00,2,2,4,0,2,1,1,6,74,1
"org.apache.jackrabbit.webdav.simple.DavResourceImpl",51,0.02,3.22,392,5.56,202839.06,65,14,66,170,50,92.99,268,577,2,1,110.86,0.00,0.00,0.09,22,1041.00,15,16667.68,0,25,48,java.lang.Object,0.00,119,0,164,4,119,26,3,99,3133,1
"org.apache.jackrabbit.webdav.simple.DavResourceImpl$PropertyExportCtx",9,0.00,2.00,43,0.52,14582.92,9,0,66,18,6,123.11,2,61,0,2,123.11,0.00,0.50,0.00,2,0.00,5,1547.48,0,1,6,org.apache.jackrabbit.server.io.AbstractExportContext,0.00,9,1,18,0,9,8,1,2,338,1
"org.apache.jackrabbit.webdav.simple.DavResourceImpl$ProperyImportCtx",8,0.14,1.25,22,0.16,2342.08,11,3,66,11,4,180.18,17,32,0,1,140.30,0.00,0.00,0.21,1,32.00,2,485.68,0,3,4,java.lang.Object,0.00,3,0,10,0,3,5,1,5,128,1
"org.apache.jackrabbit.webdav.simple.DavSessionImpl",6,0.60,1.00,16,0.16,2444.02,7,1,4,12,3,139.45,24,26,1,2,139.22,0.00,0.50,0.50,0,6.00,1,466.61,2,1,2,org.apache.jackrabbit.webdav.jcr.JcrDavSession,0.14,6,1,6,0,6,5,0,8,124,1
"org.apache.jackrabbit.webdav.simple.DavSessionProviderImpl",3,0.33,3.33,34,0.47,16876.72,6,3,15,18,10,82.20,43,45,1,1,102.35,0.00,0.00,0.56,0,1.00,6,1423.37,0,0,9,java.lang.Object,0.00,15,0,10,0,15,3,1,12,269,1
"org.apache.jackrabbit.webdav.simple.DefaultItemFilter",9,0.00,2.44,54,0.62,16636.60,13,4,9,25,2,116.28,41,77,1,1,116.04,0.00,0.00,0.25,1,27.00,4,1846.04,0,0,1,java.lang.Object,0.00,16,0,22,0,16,9,1,13,399,1
"org.apache.jackrabbit.webdav.simple.DeltaVResourceImpl",13,0.19,2.38,83,1.15,36319.02,16,3,31,45,26,96.76,76,123,3,2,114.64,3.00,0.20,0.15,3,52.00,5,3444.24,7,8,23,org.apache.jackrabbit.webdav.simple.DavResourceImpl,0.06,32,1,31,3,32,5,1,18,701,1
"org.apache.jackrabbit.webdav.simple.ItemFilter",5,0.00,1.00,6,0.04,228.27,5,0,2,5,3,115.64,35,7,3,1,157.93,0.00,0.00,0.00,0,5.00,1,128.18,0,0,0,,0.00,0,0,5,0,0,5,0,6,44,1
"org.apache.jackrabbit.webdav.simple.LitmusTest",3,1.00,1.67,51,0.77,23689.93,4,1,13,42,2,134.18,6,67,0,2,94.29,0.00,0.50,0.33,1,4.00,2,2324.34,0,0,2,junit.framework.TestCase,0.00,39,1,5,0,39,3,0,4,397,1
"org.apache.jackrabbit.webdav.simple.LitmusTest$SimpleWebdavServlet",1,0.00,1.00,3,0.01,149.03,1,0,13,1,0,136.09,0,5,0,1,136.09,0.00,0.00,0.00,0,1.00,1,44.54,0,1,0,java.lang.Object,0.00,0,0,1,0,0,0,0,0,15,0
"org.apache.jackrabbit.webdav.simple.LocatorFactoryImpl",4,0.50,2.25,23,0.34,14951.84,6,2,5,15,3,156.49,8,33,0,1,116.61,0.00,0.00,0.12,1,6.00,6,1024.40,0,3,3,java.lang.Object,0.00,11,0,9,0,11,1,1,6,216,1
"org.apache.jackrabbit.webdav.simple.LocatorFactoryImpl$Locator",13,0.12,1.23,40,0.35,7426.92,17,4,5,21,3,181.44,21,58,0,1,131.44,0.00,0.00,0.13,4,74.00,2,1042.56,0,7,3,java.lang.Object,0.00,8,0,16,0,8,6,1,5,263,1
"org.apache.jackrabbit.webdav.simple.LocatorFactoryImplEx",4,1.00,2.25,21,0.23,7927.97,5,1,3,10,3,119.01,17,32,2,2,118.78,0.00,0.50,0.00,0,4.00,4,688.31,0,2,1,org.apache.jackrabbit.webdav.AbstractLocatorFactory,0.00,6,1,9,0,6,2,0,4,155,1
"org.apache.jackrabbit.webdav.simple.LocatorFactoryImplExTest",2,0.00,1.00,14,0.17,2922.19,3,1,3,12,3,114.79,8,18,0,2,114.55,0.00,0.50,1.00,0,0.00,1,524.97,1,0,3,junit.framework.TestCase,0.00,10,1,2,0,10,2,0,3,112,1
"org.apache.jackrabbit.webdav.simple.ResourceConfig",10,0.16,4.40,152,2.07,119851.78,17,7,24,42,17,46.56,87,195,7,1,94.67,0.00,0.00,0.29,3,0.00,19,6221.39,0,6,10,java.lang.Object,0.00,32,0,44,0,32,4,0,20,1085,1
"org.apache.jackrabbit.webdav.simple.ResourceFactoryImpl",7,0.11,2.43,63,0.78,25831.08,10,3,20,25,16,58.63,70,88,1,1,107.11,0.00,0.00,0.24,3,19.00,4,2329.84,0,5,15,java.lang.Object,0.00,18,0,17,0,18,2,1,11,470,1
"org.apache.jackrabbit.webdav.simple.SimpleWebdavServlet",20,0.00,1.70,95,1.08,33356.21,35,15,23,44,18,73.05,199,146,2,3,123.05,0.50,0.50,0.07,4,212.00,6,3235.05,1,12,16,org.apache.jackrabbit.webdav.server.AbstractWebdavServlet,0.18,24,2,34,1,24,8,0,36,674,2
"org.apache.jackrabbit.webdav.simple.VersionControlledResourceImpl",14,0.85,3.29,121,1.63,57726.95,15,1,29,46,24,58.57,134,177,1,3,108.57,0.00,0.67,0.21,2,58.00,7,4893.35,10,5,23,org.apache.jackrabbit.webdav.simple.DeltaVResourceImpl,0.12,32,2,46,0,32,9,1,37,944,1
"org.apache.jackrabbit.webdav.simple.VersionHistoryResourceImpl",9,0.88,3.00,70,1.20,43557.15,10,1,28,44,22,67.92,66,108,1,3,110.21,0.00,0.67,0.22,0,19.00,5,3610.93,8,3,21,org.apache.jackrabbit.webdav.simple.DeltaVResourceImpl,0.08,35,2,27,0,35,6,1,24,670,1
"org.apache.jackrabbit.webdav.simple.VersionResourceImpl",13,1.00,2.31,76,1.23,44109.50,14,1,34,49,26,74.64,96,116,1,3,116.93,0.00,0.67,0.08,1,35.00,6,3699.73,7,4,25,org.apache.jackrabbit.webdav.simple.DeltaVResourceImpl,0.16,36,2,30,0,36,9,1,26,698,1
"org.apache.jackrabbit.core.observation.ChangeLogBasedHierarchyMgr",3,0.00,1.00,11,0.12,1409.98,4,1,17,8,14,102.78,41,20,1,3,132.16,0.00,0.67,1.00,0,0.00,1,365.23,0,2,13,org.apache.jackrabbit.core.CachingHierarchyManager,0.00,5,2,3,0,5,1,0,6,91,0
"org.apache.jackrabbit.core.observation.ChangeLogBasedHierarchyMgr$AtticItemStateManager",5,0.50,1.40,18,0.18,3890.90,6,1,17,12,8,98.14,33,27,0,1,130.36,0.00,0.00,0.60,0,2.00,2,536.47,0,2,8,java.lang.Object,0.00,7,0,7,0,7,3,1,6,130,2
"org.apache.jackrabbit.core.observation.ChangeLogBasedHierarchyMgr$ChangeLogItemStateManager",5,0.12,1.80,22,0.20,4078.84,7,2,17,9,8,77.37,42,35,0,1,125.48,0.00,0.00,0.40,0,7.00,3,601.53,0,2,8,java.lang.Object,0.00,4,0,9,0,4,3,1,11,145,2
"org.apache.jackrabbit.core.observation.DelegatingObservationDispatcher",7,0.25,1.29,30,0.33,8716.27,9,2,7,23,10,81.82,50,46,4,2,124.11,0.00,0.50,0.29,1,10.00,3,999.95,0,0,6,org.apache.jackrabbit.core.observation.EventDispatcher,0.40,16,1,9,0,16,7,0,13,222,1
"org.apache.jackrabbit.core.observation.DispatchAction",3,0.25,1.00,10,0.07,874.66,5,2,1,3,3,83.79,27,14,1,1,133.79,0.00,0.00,0.33,0,5.00,1,203.24,0,1,2,java.lang.Object,0.00,0,0,3,0,0,2,0,6,57,0
"org.apache.jackrabbit.core.observation.EventConsumer",9,0.18,4.00,101,1.41,57316.29,16,7,19,49,15,57.75,106,140,5,1,101.88,0.00,0.00,0.30,0,0.00,8,4240.78,0,2,10,java.lang.Object,0.00,40,0,36,0,40,7,0,25,784,0
"org.apache.jackrabbit.core.observation.EventDispatcher",3,0.00,1.00,4,0.03,113.75,3,0,1,3,4,116.28,22,5,3,1,158.57,0.00,0.00,0.00,0,3.00,1,75.83,0,0,2,java.lang.Object,0.00,0,0,3,2,0,3,0,4,27,1
"org.apache.jackrabbit.core.observation.EventFilter",4,0.15,3.75,62,0.77,48873.06,13,9,10,20,12,138.58,88,78,5,1,94.64,0.00,0.00,0.22,0,6.00,12,2302.74,0,2,7,java.lang.Object,0.00,16,0,15,1,16,2,0,22,414,1
"org.apache.jackrabbit.core.observation.EventFilter$BlockAllFilter",2,0.00,1.00,5,0.03,264.06,2,0,10,2,2,143.31,8,8,0,2,143.07,0.00,0.50,0.00,0,2.00,1,97.53,0,0,2,org.apache.jackrabbit.core.observation.EventFilter,0.33,0,1,2,0,0,2,0,2,32,3
"org.apache.jackrabbit.core.observation.EventImpl",17,0.05,1.65,89,1.04,34131.89,23,6,14,52,14,86.58,118,123,5,1,118.80,0.00,0.00,0.22,5,19.00,3,3109.50,0,9,9,java.lang.Object,0.00,35,0,28,0,35,8,2,27,670,2
"org.apache.jackrabbit.core.observation.EventJournalImpl",12,0.05,2.42,107,1.34,58922.74,22,10,27,57,14,59.94,97,150,1,1,108.04,0.00,0.00,0.14,4,34.00,8,4018.64,0,3,13,java.lang.Object,0.00,45,0,29,0,45,9,1,39,763,1
"org.apache.jackrabbit.core.observation.EventJournalImpl$EventBundle",1,2.00,1.00,6,0.08,1337.61,3,2,27,3,2,97.21,14,12,0,1,117.35,0.00,0.00,0.00,0,1.00,1,236.46,0,0,2,java.lang.Object,0.00,2,0,1,0,2,1,0,3,55,3
"org.apache.jackrabbit.core.observation.EventJournalImpl$RecordProcessor",7,0.25,1.29,19,0.18,3832.29,9,2,27,14,8,178.03,20,30,0,1,138.15,0.00,0.00,0.29,0,14.00,3,541.96,0,0,8,java.lang.Object,0.00,7,0,9,0,7,7,1,10,132,1
"org.apache.jackrabbit.core.observation.EventListenerIteratorImpl",9,0.06,1.78,44,0.35,7794.80,13,4,7,19,2,93.06,61,62,1,1,125.28,0.00,0.00,0.19,3,21.00,4,1049.56,0,2,1,java.lang.Object,0.00,10,0,16,0,10,7,1,15,251,0
"org.apache.jackrabbit.core.observation.EventState",35,0.00,1.60,176,2.61,86192.14,54,19,23,70,25,73.98,418,335,15,1,118.11,0.00,0.00,0.05,8,541.00,7,7844.59,0,27,10,java.lang.Object,0.00,35,0,56,0,35,8,0,60,1592,1
"org.apache.jackrabbit.core.observation.EventStateCollection",25,0.01,3.08,278,5.02,683243.82,32,7,27,100,33,52.83,286,440,15,1,96.96,0.00,0.00,0.14,7,313.00,26,15057.22,0,14,20,java.lang.Object,0.00,75,0,77,0,75,11,0,119,2460,2
"org.apache.jackrabbit.core.observation.EventStateCollectionFactory",1,0.00,1.00,2,0.01,38.26,1,0,1,1,9,97.31,9,3,8,1,147.31,0.00,0.00,0.00,0,1.00,1,25.51,0,0,1,,0.00,0,0,1,0,0,1,0,2,11,1
"org.apache.jackrabbit.core.observation.FilteredEventIterator",9,0.03,1.67,45,0.44,10914.69,17,8,7,19,4,72.42,72,67,1,1,120.53,0.00,0.00,0.15,2,21.00,5,1315.78,0,2,3,java.lang.Object,0.00,10,0,15,0,10,7,1,19,292,0
"org.apache.jackrabbit.core.observation.MixinTest",5,0.00,1.20,67,0.98,31253.22,5,0,6,18,3,81.64,27,81,1,5,99.51,0.00,0.80,0.00,1,0.00,2,2925.22,2,0,2,org.apache.jackrabbit.test.api.observation.AbstractObservationTest,0.00,13,4,6,0,13,5,0,7,555,1
"org.apache.jackrabbit.core.observation.MoveInPlaceTest",1,0.00,1.00,15,0.24,5008.72,1,0,4,14,2,118.61,3,17,1,5,97.99,0.00,0.80,0.00,0,0.00,1,734.94,1,0,1,org.apache.jackrabbit.core.query.AbstractQueryTest,0.00,13,4,1,0,13,1,0,1,137,1
"org.apache.jackrabbit.core.observation.ObservationDispatcher",10,0.18,3.00,107,1.36,43563.34,22,12,11,52,9,54.79,93,143,4,2,104.79,0.00,0.50,0.24,2,30.00,11,4082.74,0,2,5,org.apache.jackrabbit.core.observation.EventDispatcher,0.31,42,1,30,0,42,8,1,35,772,2
"org.apache.jackrabbit.core.observation.ObservationManagerImpl",11,0.08,2.18,82,1.05,47856.81,17,6,18,39,18,60.65,99,134,4,1,110.64,0.00,0.00,0.24,4,15.00,7,3158.23,0,4,16,java.lang.Object,0.00,28,0,24,0,28,7,2,23,623,1
"org.apache.jackrabbit.core.observation.ReorderTest",1,0.00,3.00,28,0.42,18576.03,1,0,6,13,4,96.93,34,31,1,5,83.15,0.00,0.80,0.00,0,0.00,3,1246.25,4,0,3,org.apache.jackrabbit.test.api.observation.AbstractObservationTest,0.00,12,4,3,0,12,1,0,6,217,1
"org.apache.jackrabbit.core.observation.ShareableNodesTest",4,0.00,1.25,43,0.63,16727.23,4,0,7,18,4,105.13,3,48,1,5,105.13,0.00,0.80,0.00,1,0.00,2,1877.45,3,0,3,org.apache.jackrabbit.test.api.observation.AbstractObservationTest,0.00,14,4,5,0,14,4,0,1,353,1
"org.apache.jackrabbit.core.observation.SynchronousEventListener",0,0.00,0.00,1,0.01,31.02,0,0,2,0,7,171.00,12,2,7,2,171.00,0.00,0.50,0.00,0,0.00,0,15.51,0,0,0,,0.00,0,1,0,0,0,0,0,1,6,1
"org.apache.jackrabbit.core.observation.TestAll",1,0.00,1.00,9,0.09,2740.87,1,0,3,3,5,64.20,11,11,0,2,108.33,0.00,0.50,0.00,0,1.00,1,261.86,0,1,5,junit.framework.TestCase,0.00,2,1,1,0,2,0,0,2,63,1
"org.apache.jackrabbit.core.observation.VersionEventsTest",5,0.00,2.00,109,1.60,53339.81,5,0,12,30,4,47.51,35,108,1,5,89.80,0.00,0.80,0.00,0,0.00,2,4794.56,3,0,3,org.apache.jackrabbit.test.api.observation.AbstractObservationTest,0.00,25,4,10,0,25,5,0,17,813,1
"org.apache.jackrabbit.core.security.authentication.AbstractLoginModule",26,0.04,3.08,216,2.86,156563.30,41,15,25,81,11,87.15,384,299,2,1,107.29,0.00,0.00,0.10,11,258.00,19,8567.69,0,10,9,java.lang.Object,0.00,55,0,80,3,55,16,1,55,1583,2
"org.apache.jackrabbit.core.security.authentication.AuthContext",3,0.00,1.00,4,0.02,69.53,3,0,2,3,10,111.77,30,5,10,1,160.25,0.00,0.00,0.00,0,3.00,1,49.02,0,1,0,,0.00,0,0,3,0,0,2,0,4,21,1
"org.apache.jackrabbit.core.security.authentication.AuthContextProvider",6,0.05,2.67,49,0.52,17722.08,10,4,13,20,8,67.47,47,72,2,1,109.76,0.00,0.00,0.29,3,10.00,5,1573.20,0,2,6,java.lang.Object,0.00,14,0,16,0,14,4,0,13,329,1
"org.apache.jackrabbit.core.security.authentication.Authentication",2,0.00,1.00,3,0.02,66.51,2,0,2,2,6,148.66,31,4,6,1,159.02,0.00,0.00,0.00,0,2.00,1,49.51,0,0,0,,0.00,0,0,2,0,0,2,0,3,19,1
"org.apache.jackrabbit.core.security.authentication.CallbackHandlerImpl",2,0.67,6.00,45,0.57,27028.74,8,6,13,16,7,58.60,27,55,2,1,87.98,0.00,0.00,0.50,0,2.00,9,1704.50,0,0,5,java.lang.Object,0.00,14,0,12,0,14,2,1,4,315,1
"org.apache.jackrabbit.core.security.authentication.CredentialsCallback",2,1.00,1.00,6,0.04,373.42,3,1,3,2,2,103.10,13,9,2,1,135.32,0.00,0.00,0.50,0,2.00,1,110.49,0,1,0,java.lang.Object,0.00,0,0,2,0,0,1,2,3,33,1
"org.apache.jackrabbit.core.security.authentication.CryptedSimpleCredentials",10,0.11,1.90,64,0.81,26442.68,15,5,12,39,6,72.58,70,87,4,1,114.88,0.00,0.00,0.30,3,22.00,4,2430.55,0,7,2,java.lang.Object,0.00,29,0,19,0,29,3,1,11,494,1
"org.apache.jackrabbit.core.security.authentication.CryptedSimpleCredentialsTest",8,0.21,2.62,71,0.86,27173.94,12,4,7,34,3,159.28,13,83,1,2,109.28,0.00,0.50,0.44,0,0.00,5,2576.41,1,0,2,junit.framework.TestCase,0.00,26,1,21,0,26,8,0,11,536,1
"org.apache.jackrabbit.core.security.authentication.DefaultLoginModule",4,0.44,3.25,40,0.54,17247.88,7,3,15,22,8,67.24,48,61,1,2,104.80,0.00,0.50,0.67,0,0.00,4,1615.21,2,2,7,org.apache.jackrabbit.core.security.authentication.AbstractLoginModule,0.00,18,1,13,0,18,2,0,8,313,1
"org.apache.jackrabbit.core.security.authentication.GuestLoginTest",3,0.00,1.33,11,0.09,1194.65,4,1,4,9,2,172.55,6,16,1,4,132.66,0.00,0.75,1.00,0,0.00,2,282.86,2,0,1,org.apache.jackrabbit.test.AbstractJCRTest,0.28,6,3,4,0,6,3,0,2,74,1
"org.apache.jackrabbit.core.security.authentication.ImpersonationCallback",2,1.00,1.50,7,0.05,702.65,3,1,2,2,2,88.93,23,11,2,1,133.06,0.00,0.00,0.50,0,2.00,2,140.50,0,1,0,java.lang.Object,0.00,0,0,3,0,0,1,1,4,40,1
"org.apache.jackrabbit.core.security.authentication.JAASAuthContext",4,0.00,1.50,18,0.18,5346.82,5,1,4,12,3,144.45,13,28,2,1,123.83,0.00,0.00,1.00,0,0.00,3,542.87,0,1,1,java.lang.Object,0.00,8,0,6,0,8,3,1,5,123,1
"org.apache.jackrabbit.core.security.authentication.LocalAuthContext",4,0.27,3.00,37,0.52,24690.02,9,5,13,23,4,125.92,13,53,1,1,105.30,0.00,0.00,0.40,0,0.00,7,1562.45,0,1,3,java.lang.Object,0.00,19,0,12,0,19,3,1,2,295,1
"org.apache.jackrabbit.core.security.authentication.LoginModuleTest",1,0.00,1.00,10,0.17,2569.75,2,1,18,15,6,58.37,10,16,1,4,106.85,0.00,0.75,1.00,0,0.00,1,504.60,0,0,5,org.apache.jackrabbit.test.AbstractJCRTest,0.00,14,3,1,0,14,1,0,1,104,1
"org.apache.jackrabbit.core.security.authentication.LoginModuleTest$TestAppConfigurationEntry",1,0.00,2.00,7,0.10,2339.98,3,2,18,4,0,112.78,0,11,0,2,112.78,0.00,0.50,1.00,0,0.00,2,309.90,0,0,0,javax.security.auth.login.AppConfigurationEntry,0.00,3,1,2,0,3,1,0,0,73,1
"org.apache.jackrabbit.core.security.authentication.LoginModuleTest$TestConfiguration",2,0.00,1.00,4,0.06,1142.91,2,0,18,3,0,138.06,0,12,0,2,138.06,0.00,0.50,0.00,0,2.00,1,189.24,0,1,0,javax.security.auth.login.Configuration,0.00,1,1,2,0,1,1,0,0,49,1
"org.apache.jackrabbit.core.security.authentication.LoginModuleTest$TestLoginModule",4,0.33,1.75,17,0.16,2471.44,5,1,18,8,3,126.44,0,35,0,2,126.44,0.00,0.50,0.75,0,0.00,2,492.22,0,2,3,org.apache.jackrabbit.core.security.authentication.AbstractLoginModule,0.00,4,1,7,0,4,2,0,0,116,2
"org.apache.jackrabbit.core.security.authentication.LoginModuleTest$TestLoginModule$Authentication",2,0.00,1.00,5,0.03,224.11,2,0,18,2,0,143.63,0,8,0,1,143.63,0.00,0.00,0.00,0,2.00,1,84.24,0,0,0,java.lang.Object,0.00,0,0,2,0,0,2,0,0,26,0
"org.apache.jackrabbit.core.security.authentication.NullLoginTest",1,0.00,1.00,10,0.13,3672.38,1,0,3,9,2,155.62,1,14,1,4,105.62,0.00,0.75,0.00,0,1.00,1,396.31,1,0,1,org.apache.jackrabbit.test.AbstractJCRTest,0.00,8,3,1,0,8,1,0,1,88,1
"org.apache.jackrabbit.core.security.authentication.RepositoryCallback",8,0.14,1.00,21,0.13,1334.14,12,4,3,8,3,142.27,4,30,2,1,142.27,0.00,0.00,0.12,0,32.00,1,377.47,0,4,1,java.lang.Object,0.00,0,0,8,0,0,4,1,1,110,1
"org.apache.jackrabbit.core.security.authentication.SimpleCredentialsAuthentication",3,0.25,3.67,26,0.36,13870.55,5,2,8,14,5,78.77,40,39,2,1,108.15,0.00,0.00,0.67,0,0.00,5,1067.00,0,0,3,java.lang.Object,0.00,11,0,11,0,11,3,1,5,217,0
"org.apache.jackrabbit.core.security.authentication.SimpleCredentialsAuthenticationTest",4,0.44,1.25,55,0.75,33102.92,10,6,12,17,9,148.54,7,62,1,4,98.54,0.00,0.75,0.50,0,0.00,2,2249.69,2,0,8,org.apache.jackrabbit.test.AbstractJCRTest,0.27,13,3,5,0,13,4,0,3,474,1
"org.apache.jackrabbit.core.security.authentication.SimpleCredentialsAuthenticationTest$Credentials",0,0.00,0.00,1,0.00,12.00,0,0,12,0,0,171.00,0,0,0,1,171.00,0.00,0.00,0.00,0,0.00,0,8.00,0,0,0,java.lang.Object,0.00,0,0,0,0,0,0,0,0,4,0
"org.apache.jackrabbit.core.security.authentication.SimpleCredentialsAuthenticationTest$DummyUserImpl",21,1.00,1.00,39,0.28,2740.18,22,1,12,21,2,154.34,0,61,0,1,154.34,0.00,0.00,0.05,0,40.00,1,833.21,0,10,2,java.lang.Object,0.00,0,0,21,0,0,11,1,0,242,1
"org.apache.jackrabbit.core.security.authentication.TestAll",1,0.00,1.00,9,0.09,2740.87,1,0,3,3,5,158.33,1,11,0,2,108.33,0.00,0.50,0.00,0,1.00,1,261.86,0,1,5,junit.framework.TestCase,0.00,2,1,1,0,2,0,0,1,63,1
"org.apache.jackrabbit.rmi.jackrabbit.JackrabbitClientAdapterFactory",0,0.00,0.00,1,0.01,31.02,0,0,1,0,1,171.00,3,2,0,2,171.00,0.00,0.50,0.00,0,0.00,0,15.51,0,0,1,org.apache.jackrabbit.rmi.client.ClientAdapterFactory,0.00,0,1,0,0,0,0,0,1,6,1
"org.apache.jackrabbit.webdav.ordering.OrderPatch",6,0.13,2.00,48,0.68,36262.98,9,3,12,28,15,58.90,61,61,7,1,107.38,0.00,0.00,0.22,0,14.00,5,2051.25,0,4,8,java.lang.Object,0.00,22,0,12,0,22,2,2,17,384,1
"org.apache.jackrabbit.webdav.ordering.OrderPatch$Member",4,0.00,1.00,15,0.12,1744.76,6,2,12,8,3,114.54,22,20,0,1,132.42,0.00,0.00,0.50,0,2.00,1,358.30,0,2,3,java.lang.Object,0.00,4,0,4,0,4,2,1,5,93,2
"org.apache.jackrabbit.webdav.ordering.OrderingConstants",0,0.00,0.00,18,0.33,7696.03,17,17,3,1,11,171.00,55,19,8,1,171.00,0.00,0.00,0.00,0,0.00,0,999.83,0,0,3,,0.00,1,0,0,0,1,0,0,13,180,1
"org.apache.jackrabbit.webdav.ordering.OrderingDavServletRequest",3,0.00,1.00,4,0.02,105.15,3,0,2,3,4,110.73,25,5,0,2,158.84,0.00,0.50,0.00,0,3.00,1,58.38,0,2,4,,0.00,0,1,3,0,0,1,0,4,23,1
"org.apache.jackrabbit.webdav.ordering.OrderingResource",2,1.00,1.00,4,0.03,209.39,3,1,2,2,5,95.76,17,5,2,2,143.86,0.00,0.50,0.00,0,2.00,1,85.11,0,0,3,,0.00,0,1,2,0,0,2,0,3,27,1
"org.apache.jackrabbit.webdav.ordering.OrderingType",2,0.00,1.50,5,0.04,429.68,2,0,1,2,3,97.19,22,8,1,3,141.31,0.00,0.67,0.00,0,2.00,2,120.69,0,0,2,org.apache.jackrabbit.webdav.property.HrefProperty,0.00,0,2,3,0,0,2,1,4,35,1
"org.apache.jackrabbit.webdav.ordering.Position",6,0.00,2.17,45,0.54,16433.48,10,4,9,20,11,68.10,66,60,7,1,112.23,0.00,0.00,0.25,0,14.00,3,1623.41,0,4,4,java.lang.Object,0.00,14,0,13,0,14,2,2,11,348,1
"org.apache.jackrabbit.test.api.nodetype.CanAddChildNodeCallWithNodeTypeTest",9,0.38,2.78,92,1.31,38162.67,11,2,8,32,4,72.68,57,145,1,4,104.90,0.00,0.75,0.83,0,0.00,5,3936.29,2,0,3,org.apache.jackrabbit.test.AbstractJCRTest,0.23,23,3,25,0,23,9,0,14,743,1
"org.apache.jackrabbit.test.api.nodetype.CanAddChildNodeCallWithoutNodeTypeTest",7,0.00,1.86,44,0.59,13456.94,8,1,6,17,4,83.75,44,79,1,4,115.97,0.00,0.75,1.00,0,0.00,2,1782.37,2,0,3,org.apache.jackrabbit.test.AbstractJCRTest,0.24,10,3,13,0,10,7,0,9,362,1
"org.apache.jackrabbit.test.api.nodetype.CanRemoveItemTest",8,0.00,1.88,53,0.77,18594.34,9,1,7,22,4,83.10,51,105,1,4,115.32,0.00,0.75,1.00,0,0.00,2,2313.41,2,0,3,org.apache.jackrabbit.test.AbstractJCRTest,0.24,14,3,15,0,14,8,0,10,464,1
"org.apache.jackrabbit.test.api.nodetype.CanSetPropertyBinaryTest",6,0.00,2.17,80,1.62,82466.43,7,1,9,17,4,78.81,35,144,1,4,96.68,0.00,0.75,1.00,0,0.00,3,4856.97,2,0,3,org.apache.jackrabbit.test.AbstractJCRTest,0.25,11,3,13,0,11,6,0,8,850,1
"org.apache.jackrabbit.test.api.nodetype.CanSetPropertyBooleanTest",6,0.00,2.17,80,1.64,83154.56,7,1,9,17,4,64.43,36,145,1,4,96.65,0.00,0.75,1.00,0,0.00,3,4919.18,2,0,3,org.apache.jackrabbit.test.AbstractJCRTest,0.25,11,3,13,0,11,6,0,8,857,1
"org.apache.jackrabbit.test.api.nodetype.CanSetPropertyDateTest",6,0.00,2.17,90,2.09,113338.30,7,1,9,20,4,61.06,37,174,1,4,93.28,0.00,0.75,1.00,0,0.00,3,6256.90,2,0,3,org.apache.jackrabbit.test.AbstractJCRTest,0.25,14,3,13,0,14,6,0,10,1045,1
"org.apache.jackrabbit.test.api.nodetype.CanSetPropertyDoubleTest",6,0.00,2.17,90,2.08,114779.83,7,1,9,20,4,75.36,35,174,1,4,93.23,0.00,0.75,1.00,0,0.00,3,6241.18,2,0,3,org.apache.jackrabbit.test.AbstractJCRTest,0.25,14,3,13,0,14,6,0,8,1045,1
"org.apache.jackrabbit.test.api.nodetype.CanSetPropertyLongTest",6,0.00,2.17,90,2.08,114498.20,7,1,9,20,4,75.37,35,174,1,4,93.24,0.00,0.75,1.00,0,0.00,3,6247.57,2,0,3,org.apache.jackrabbit.test.AbstractJCRTest,0.25,14,3,13,0,14,6,0,8,1045,1
"org.apache.jackrabbit.test.api.nodetype.CanSetPropertyMultipleTest",5,0.00,1.80,33,0.50,13732.89,6,1,7,17,4,82.54,31,57,1,4,114.76,0.00,0.75,1.00,0,0.00,2,1499.47,2,0,3,org.apache.jackrabbit.test.AbstractJCRTest,0.26,12,3,9,0,12,5,0,8,299,1
"org.apache.jackrabbit.test.api.nodetype.CanSetPropertyNameTest",6,0.00,2.17,95,2.22,119071.67,7,1,9,19,4,75.24,35,183,1,4,93.11,0.00,0.75,1.00,0,0.00,3,6660.69,2,0,3,org.apache.jackrabbit.test.AbstractJCRTest,0.25,13,3,13,0,13,6,0,8,1096,1
"org.apache.jackrabbit.test.api.nodetype.CanSetPropertyPathTest",6,0.00,2.17,92,2.09,112084.70,7,1,9,19,4,75.44,35,174,1,4,93.32,0.00,0.75,1.00,0,0.00,3,6259.42,2,0,3,org.apache.jackrabbit.test.AbstractJCRTest,0.25,13,3,13,0,13,6,0,8,1045,1
"org.apache.jackrabbit.test.api.nodetype.CanSetPropertyStringTest",6,0.00,2.17,80,1.64,80937.52,7,1,9,17,4,78.87,35,146,1,4,96.75,0.00,0.75,1.00,0,0.00,3,4914.22,2,0,3,org.apache.jackrabbit.test.AbstractJCRTest,0.25,11,3,13,0,11,6,0,8,854,1
"org.apache.jackrabbit.test.api.nodetype.CanSetPropertyTest",5,0.00,1.80,31,0.46,11069.07,6,1,7,17,4,83.27,31,55,1,4,115.50,0.00,0.75,1.00,0,0.00,2,1368.70,2,0,3,org.apache.jackrabbit.test.AbstractJCRTest,0.26,12,3,9,0,12,5,0,8,277,1
"org.apache.jackrabbit.test.api.nodetype.NodeDefTest",11,0.07,3.36,148,1.64,54891.64,14,3,14,47,3,57.76,86,168,1,4,100.05,0.00,0.75,0.27,3,26.00,5,4921.81,2,0,2,org.apache.jackrabbit.test.AbstractJCRTest,0.22,36,3,37,0,36,11,0,30,937,1
"org.apache.jackrabbit.test.api.nodetype.NodeTypeCreationTest",17,0.04,2.18,306,4.34,174371.11,20,3,19,125,2,132.30,41,352,1,4,92.41,0.00,0.75,0.37,1,0.00,8,13006.66,3,1,1,org.apache.jackrabbit.test.AbstractJCRTest,0.19,108,3,37,0,108,16,0,30,2353,1
"org.apache.jackrabbit.test.api.nodetype.NodeTypeManagerTest",6,0.20,1.83,37,0.47,9737.72,8,2,7,27,2,84.33,37,61,1,4,116.55,0.00,0.75,0.67,0,0.00,3,1396.74,3,0,1,org.apache.jackrabbit.test.AbstractJCRTest,0.25,21,3,11,0,21,6,0,12,299,1
"org.apache.jackrabbit.test.api.nodetype.NodeTypeTest",17,0.02,3.12,189,2.27,71495.72,20,3,16,64,3,85.48,101,267,1,4,103.36,0.00,0.75,0.31,3,0.00,6,6817.91,3,4,2,org.apache.jackrabbit.test.AbstractJCRTest,0.19,47,3,53,0,47,13,0,30,1307,1
"org.apache.jackrabbit.test.api.nodetype.NodeTypeUtil",11,1.00,12.55,470,6.28,1340856.21,12,1,14,60,18,40.44,145,589,17,1,69.82,0.00,0.00,0.09,3,20.00,71,18844.77,0,10,1,java.lang.Object,0.00,49,0,138,0,49,1,0,63,3002,1
"org.apache.jackrabbit.test.api.nodetype.PredefinedNodeTypeTest",39,0.29,1.56,247,3.30,149952.11,42,3,25,104,3,134.26,127,308,1,4,113.64,0.00,0.75,0.05,5,163.00,9,9895.19,2,4,2,org.apache.jackrabbit.test.AbstractJCRTest,0.12,65,3,61,0,65,35,0,49,1871,1
"org.apache.jackrabbit.test.api.nodetype.PredefinedNodeTypeTest$Comparator",1,0.00,3.00,10,0.14,6990.64,1,0,25,4,0,103.17,0,12,0,1,103.17,0.00,0.00,0.00,0,1.00,3,416.66,0,0,0,java.lang.Object,0.00,3,0,3,0,3,1,0,0,92,0
"org.apache.jackrabbit.test.api.nodetype.PredefinedNodeTypeTest$Comparator_0",1,0.00,6.00,17,0.22,14237.38,1,0,25,5,0,91.98,0,21,0,1,91.98,0.00,0.00,0.00,0,1.00,6,668.69,0,0,0,java.lang.Object,0.00,4,0,6,0,4,1,0,0,140,0
"org.apache.jackrabbit.test.api.nodetype.PredefinedNodeTypeTest$Comparator_1",1,0.00,3.00,10,0.11,4798.70,1,0,25,4,0,104.46,0,12,0,1,104.46,0.00,0.00,0.00,0,1.00,3,338.12,0,0,0,java.lang.Object,0.00,3,0,3,0,3,1,0,0,76,0
"org.apache.jackrabbit.test.api.nodetype.PropertyDefTest",11,0.08,4.36,165,2.36,117097.65,19,8,16,47,4,45.08,104,242,1,4,95.08,0.00,0.75,0.19,3,1.00,16,7069.16,2,0,3,org.apache.jackrabbit.test.AbstractJCRTest,0.22,36,3,48,0,36,11,0,35,1259,1
"org.apache.jackrabbit.test.api.nodetype.TestAll",1,0.00,1.00,23,0.29,11494.77,1,0,3,3,20,58.85,13,25,1,2,88.23,0.00,0.50,0.00,0,1.00,1,875.29,0,1,19,junit.framework.TestCase,0.00,2,1,1,0,2,0,0,4,175,1
"org.apache.jackrabbit.webdav.util.HttpDateFormat",3,0.00,1.00,11,0.11,1664.26,6,3,3,5,6,89.30,21,15,6,2,131.59,0.00,0.50,0.33,0,6.00,1,315.03,1,2,0,java.text.SimpleDateFormat,0.00,2,1,3,0,2,1,0,5,80,1
"org.apache.jackrabbit.core.state.AbstractISMLockingTest",11,0.02,1.45,77,0.78,17368.64,15,4,8,38,10,71.91,82,88,2,2,114.20,2.00,0.25,0.27,4,16.00,2,2332.91,1,3,8,junit.framework.TestCase,0.00,27,1,16,2,27,8,0,15,505,2
"org.apache.jackrabbit.core.state.AbstractISMLockingTest$Runnable",1,0.00,2.00,6,0.06,833.70,1,0,8,3,0,118.81,0,9,0,1,118.81,0.00,0.00,0.00,0,0.00,2,174.91,0,0,0,java.lang.Object,0.00,2,0,2,0,2,1,0,0,42,0
"org.apache.jackrabbit.core.state.AbstractISMLockingTest$Runnable_0",1,0.00,2.00,5,0.04,435.25,1,0,8,5,0,123.99,0,8,0,1,123.99,0.00,0.00,0.00,0,1.00,2,128.93,0,0,0,java.lang.Object,0.00,4,0,2,0,4,1,0,0,33,0
"org.apache.jackrabbit.core.state.AbstractISMLockingTest$Runnable_1",1,0.00,2.00,5,0.04,435.25,1,0,8,5,0,123.99,0,8,0,1,123.99,0.00,0.00,0.00,0,1.00,2,128.93,0,0,0,java.lang.Object,0.00,4,0,2,0,4,1,0,0,33,0
"org.apache.jackrabbit.core.state.Cache",6,0.00,1.00,7,0.02,78.02,6,0,0,6,4,162.46,27,8,4,1,162.23,0.00,0.00,0.00,0,6.00,1,73.02,0,0,1,,0.00,0,0,6,0,0,6,0,7,33,1
"org.apache.jackrabbit.core.state.CacheAccessListener",2,1.00,1.00,4,0.02,110.68,3,1,0,2,3,113.82,13,5,3,1,146.04,0.00,0.00,0.00,0,2.00,1,58.38,0,0,1,,0.00,0,0,2,0,0,2,0,4,21,1
"org.apache.jackrabbit.core.state.CacheManager",13,0.00,2.15,100,1.35,118992.62,25,12,4,37,4,108.34,64,135,2,1,108.10,0.00,0.00,0.08,2,73.00,14,4040.23,0,0,2,java.lang.Object,0.00,24,0,28,0,24,13,1,34,737,1
"org.apache.jackrabbit.core.state.CacheManager$CacheInfo",7,0.03,1.00,25,0.16,2214.50,12,5,4,11,1,183.51,7,33,0,1,133.51,0.00,0.00,0.23,0,25.00,1,480.16,0,1,1,java.lang.Object,0.00,4,0,7,0,4,6,0,7,129,2
"org.apache.jackrabbit.core.state.ChangeLog",22,0.17,2.14,134,1.42,52220.42,26,4,5,53,51,72.93,168,174,44,1,115.22,0.00,0.00,0.41,1,0.00,7,4249.61,0,1,8,java.lang.Object,0.00,31,0,47,0,31,21,0,36,971,1
"org.apache.jackrabbit.core.state.ChangeLogTest",4,0.00,1.75,39,0.53,14629.86,5,1,5,21,9,107.45,16,45,1,4,107.22,0.00,0.75,1.00,0,0.00,4,1599.12,1,0,8,org.apache.jackrabbit.test.AbstractJCRTest,0.13,17,3,7,0,17,4,0,4,315,1
"org.apache.jackrabbit.core.state.ChildNodeEntries",21,0.05,3.14,177,2.18,124527.22,24,3,9,60,6,89.46,110,243,2,1,107.34,0.00,0.00,0.38,5,0.00,9,6533.51,1,12,4,java.lang.Object,0.00,39,0,66,0,39,9,1,45,1297,0
"org.apache.jackrabbit.core.state.ChildNodeEntry",7,0.25,1.86,39,0.35,10200.48,11,4,2,13,40,169.87,9,54,38,1,119.87,0.00,0.00,0.46,0,0.00,4,1043.48,0,3,2,java.lang.Object,0.00,6,0,13,0,6,4,0,4,247,2
"org.apache.jackrabbit.core.state.DefaultISMLocking",6,0.15,2.83,48,0.44,12078.19,10,4,4,14,6,61.06,59,69,2,1,111.06,0.00,0.00,0.38,1,2.00,4,1324.76,0,3,4,java.lang.Object,0.00,8,0,17,0,8,3,1,13,287,1
"org.apache.jackrabbit.core.state.DefaultISMLocking$ReadLock",1,0.00,1.00,3,0.01,56.92,1,0,4,2,0,139.38,0,4,0,1,139.38,0.00,0.00,0.00,0,1.00,1,30.46,0,0,0,java.lang.Object,0.00,1,0,1,0,1,1,0,0,12,0
"org.apache.jackrabbit.core.state.DefaultISMLocking$WriteLock",2,0.00,1.00,6,0.02,165.66,2,0,4,3,0,138.10,0,8,0,1,138.10,0.00,0.00,0.00,0,2.00,1,74.86,0,1,0,java.lang.Object,0.00,1,0,2,0,1,1,0,0,25,0
"org.apache.jackrabbit.core.state.DefaultISMLockingTest",1,0.00,1.00,3,0.02,126.12,1,0,0,2,4,136.89,4,5,1,3,136.66,0.00,0.67,0.00,0,1.00,1,47.21,0,1,3,org.apache.jackrabbit.core.state.AbstractISMLockingTest,0.25,1,2,1,0,1,0,0,1,16,1
"org.apache.jackrabbit.core.state.FineGrainedISMLocking",5,0.22,3.20,69,0.72,22739.85,13,8,13,29,8,51.90,50,90,2,1,100.38,0.00,0.00,0.30,0,5.00,4,2169.27,0,2,6,java.lang.Object,0.00,24,0,16,0,24,3,1,24,429,1
"org.apache.jackrabbit.core.state.FineGrainedISMLocking$LockMap",5,0.25,3.80,61,0.62,23880.88,7,2,13,20,5,83.59,28,80,0,1,101.47,0.00,0.00,0.70,0,0.00,6,1864.41,0,0,5,java.lang.Object,0.00,15,0,19,0,15,5,0,6,375,3
"org.apache.jackrabbit.core.state.FineGrainedISMLocking$ReadLockImpl",3,1.00,2.00,21,0.14,2826.80,4,1,13,8,1,165.90,3,27,0,1,115.90,0.00,0.00,0.33,0,4.00,4,414.55,0,0,1,java.lang.Object,0.00,5,0,6,0,5,3,1,3,96,2
"org.apache.jackrabbit.core.state.FineGrainedISMLocking$WriteLockImpl",3,1.00,2.33,37,0.23,4596.59,4,1,13,8,1,155.47,5,45,0,1,105.47,0.00,0.00,0.00,0,1.00,3,690.32,0,1,1,java.lang.Object,0.00,5,0,7,0,5,2,1,5,150,2
"org.apache.jackrabbit.core.state.FineGrainedISMLockingTest",1,0.00,1.00,3,0.02,126.12,1,0,0,2,4,136.89,4,5,1,3,136.66,0.00,0.67,0.00,0,1.00,1,47.21,0,1,3,org.apache.jackrabbit.core.state.AbstractISMLockingTest,0.25,1,2,1,0,1,0,0,1,16,1
"org.apache.jackrabbit.core.state.ISMLocking",2,0.00,1.00,5,0.03,122.41,2,0,1,2,16,154.83,35,6,14,1,145.70,0.00,0.00,0.00,0,2.00,1,81.60,0,2,2,,0.00,0,0,2,0,0,0,0,3,29,1
"org.apache.jackrabbit.core.state.ISMLocking$ReadLock",1,0.00,1.00,2,0.01,23.00,1,0,1,1,0,169.66,3,3,0,1,149.05,0.00,0.00,0.00,0,1.00,1,18.00,0,0,0,,0.00,0,0,1,0,0,1,0,1,9,1
"org.apache.jackrabbit.core.state.ISMLocking$WriteLock",2,0.00,1.00,3,0.01,31.00,2,0,1,2,0,143.75,10,4,0,1,161.63,0.00,0.00,0.00,0,2.00,1,26.00,0,1,0,,0.00,0,0,2,0,0,1,0,2,13,1
"org.apache.jackrabbit.core.state.ISMLockingFactory",1,0.00,1.00,2,0.01,38.26,1,0,1,1,4,127.16,14,3,3,1,147.31,0.00,0.00,0.00,0,1.00,1,25.51,0,0,1,,0.00,0,0,1,0,0,1,0,2,11,1
"org.apache.jackrabbit.core.state.ItemState",30,0.03,1.50,110,0.97,21040.88,42,12,4,41,57,98.48,183,169,55,1,130.70,0.00,0.00,0.12,4,358.00,3,2904.26,0,4,3,java.lang.Object,0.00,11,0,45,4,11,26,0,49,679,2
"org.apache.jackrabbit.core.state.ItemStateCache",9,0.00,1.00,10,0.04,133.96,9,0,1,9,8,129.54,58,11,6,1,161.76,0.00,0.00,0.00,0,9.00,1,123.16,0,0,2,,0.00,0,0,9,0,0,9,0,10,52,1
"org.apache.jackrabbit.core.state.ItemStateCacheFactory",1,0.00,1.00,2,0.01,23.00,1,0,0,1,11,100.94,8,3,10,1,149.05,0.00,0.00,0.00,0,1.00,1,18.00,0,0,1,,0.00,0,0,1,0,0,1,0,2,9,1
"org.apache.jackrabbit.core.state.ItemStateException",2,0.00,1.00,5,0.03,221.18,2,0,0,2,90,93.68,18,8,90,2,143.68,2.00,0.25,0.00,0,2.00,1,88.69,0,0,0,java.lang.Exception,0.00,0,1,2,2,0,2,0,3,29,1
"org.apache.jackrabbit.core.state.ItemStateListener",4,0.00,1.00,5,0.02,77.04,4,0,0,4,10,118.59,29,6,10,1,160.88,0.00,0.00,0.00,0,4.00,1,72.04,0,0,1,,0.00,0,0,4,0,0,4,0,5,29,1
"org.apache.jackrabbit.core.state.ItemStateManager",4,0.00,1.00,5,0.03,131.61,4,0,2,4,31,110.95,32,8,25,1,159.05,0.00,0.00,0.00,0,4.00,1,98.08,0,2,6,,0.00,0,0,4,0,0,2,0,5,35,1
"org.apache.jackrabbit.core.state.ItemStateMap",13,0.12,1.77,51,0.54,11775.38,15,2,10,32,6,179.78,17,73,2,1,129.79,0.00,0.00,0.38,2,0.00,9,1608.74,0,3,4,java.lang.Object,0.00,19,0,23,1,19,10,2,7,368,1
"org.apache.jackrabbit.core.state.ItemStateReferenceCache",12,0.12,1.08,39,0.36,5970.26,15,3,5,35,8,89.66,85,53,2,1,131.95,0.00,0.00,0.44,0,0.00,2,1086.47,0,0,6,java.lang.Object,0.00,23,0,13,0,23,12,2,30,278,1
"org.apache.jackrabbit.core.state.ItemStateReferenceMap",1,0.00,1.00,3,0.02,263.49,1,0,1,2,2,90.01,11,5,1,2,134.14,0.00,0.50,0.00,0,1.00,1,70.86,0,0,1,org.apache.jackrabbit.core.state.ItemStateMap,0.00,1,1,1,0,1,1,0,2,22,1
"org.apache.jackrabbit.core.state.ItemStateStore",9,0.00,1.00,10,0.05,179.65,9,0,3,9,4,118.47,63,11,2,1,160.76,0.00,0.00,0.00,0,9.00,1,135.34,0,2,2,,0.00,0,0,9,0,0,7,0,10,55,1
"org.apache.jackrabbit.core.state.LocalItemStateManager",29,0.13,2.10,176,1.80,45486.82,35,6,6,82,26,74.35,217,252,5,1,116.64,0.00,0.00,0.29,1,33.00,5,5411.20,0,5,21,java.lang.Object,0.00,53,0,61,1,53,24,2,76,1185,1
"org.apache.jackrabbit.core.state.MLRUItemStateCache",19,0.07,1.53,100,0.92,22281.08,27,8,5,41,6,120.90,83,143,1,1,120.66,0.00,0.00,0.19,3,0.00,3,2758.66,0,2,5,java.lang.Object,0.00,22,0,29,0,22,17,2,30,618,1
"org.apache.jackrabbit.core.state.MLRUItemStateCache$Entry",2,0.00,1.00,8,0.06,829.00,4,2,5,3,1,127.93,0,11,0,1,127.93,0.00,0.00,0.50,0,2.00,1,194.73,0,0,1,java.lang.Object,0.00,1,0,2,0,1,2,0,0,53,2
"org.apache.jackrabbit.core.state.ManagedMLRUItemStateCacheFactory",2,1.00,1.00,9,0.06,1012.34,3,1,0,5,5,84.95,14,12,1,1,127.25,0.00,0.00,0.50,0,2.00,1,181.89,0,1,4,java.lang.Object,0.00,3,0,2,0,3,1,1,4,50,1
"org.apache.jackrabbit.core.state.NameSet",20,0.01,1.30,76,0.62,13451.86,24,4,5,37,4,113.00,111,103,3,1,130.87,0.00,0.00,0.24,2,0.00,3,1863.18,1,4,1,java.lang.Object,0.00,17,0,26,0,17,16,2,33,462,1
"org.apache.jackrabbit.core.state.NameSet$Iterator",3,0.50,1.00,8,0.05,548.45,4,1,5,6,0,141.96,0,11,0,1,141.96,0.00,0.00,0.67,0,1.00,1,147.94,0,1,0,java.lang.Object,0.00,3,0,3,0,3,2,0,0,46,0
"org.apache.jackrabbit.core.state.NameSet$NameSetCache",3,0.50,2.67,32,0.37,18839.71,5,2,5,13,0,59.44,35,44,0,1,103.56,0.00,0.00,0.83,0,0.00,4,1110.92,0,3,0,java.lang.Object,0.00,10,0,8,0,10,0,0,5,234,3
"org.apache.jackrabbit.core.state.NameSetTest",2,1.00,1.00,17,0.19,4590.37,4,2,3,8,4,150.73,4,20,1,2,110.85,0.00,0.50,1.00,0,0.00,1,571.34,0,0,3,junit.framework.TestCase,0.00,6,1,2,0,6,2,0,1,137,1
"org.apache.jackrabbit.core.state.NoSuchItemStateException",2,0.00,1.00,5,0.03,221.18,2,0,0,2,45,93.68,18,8,44,3,143.68,0.00,0.67,0.00,0,2.00,1,88.69,0,0,1,org.apache.jackrabbit.core.state.ItemStateException,0.00,0,2,2,0,0,2,0,3,29,1
"org.apache.jackrabbit.core.state.NodeReferences",9,0.08,1.00,22,0.18,2606.91,12,3,6,16,40,122.51,47,32,38,1,140.38,0.00,0.00,0.26,0,14.00,1,544.90,0,3,2,java.lang.Object,0.00,7,0,9,0,7,6,1,12,146,1
"org.apache.jackrabbit.core.state.NodeState",53,0.01,1.81,278,3.01,141054.60,62,9,9,106,99,69.71,434,379,91,2,117.82,1.00,0.33,0.12,4,1154.00,15,9025.09,4,20,9,org.apache.jackrabbit.core.state.ItemState,0.12,53,1,96,1,53,33,0,90,1949,1
"org.apache.jackrabbit.core.state.NodeStateListener",4,0.00,1.00,5,0.05,153.25,4,0,2,4,8,110.43,35,7,6,2,158.53,0.00,0.50,0.00,0,4.00,1,135.15,0,0,3,,0.00,0,1,4,0,0,4,0,5,43,1
"org.apache.jackrabbit.core.state.NodeStateMerger",1,0.00,22.00,60,0.95,102097.88,1,0,6,31,7,58.67,63,83,1,1,64.52,0.00,0.00,0.00,0,1.00,22,2846.98,0,0,6,java.lang.Object,0.00,30,0,22,0,30,1,0,32,467,0
"org.apache.jackrabbit.core.state.NodeStateMerger$MergeContext",4,0.00,1.00,5,0.02,77.04,4,0,6,4,2,160.88,0,6,0,1,160.88,0.00,0.00,0.00,0,4.00,1,72.04,0,0,2,,0.00,0,0,4,0,0,4,0,0,29,1
"org.apache.jackrabbit.core.state.PropertyState",15,0.00,1.07,47,0.34,4638.79,19,4,6,18,63,101.36,104,66,57,2,133.58,1.00,0.33,0.25,0,65.00,2,1007.28,2,5,6,org.apache.jackrabbit.core.state.ItemState,0.22,3,1,16,1,3,10,0,22,264,1
"org.apache.jackrabbit.core.state.SessionItemStateManager",48,0.05,2.06,297,3.40,147058.60,56,8,25,140,32,72.06,380,429,6,1,114.35,0.00,0.00,0.17,10,492.00,19,10195.80,0,10,26,java.lang.Object,0.00,92,0,99,0,92,38,3,129,2111,1
"org.apache.jackrabbit.core.state.SessionItemStateManager$AtticItemStateManager",4,0.00,1.25,13,0.11,2329.66,4,0,25,7,7,151.99,14,21,0,1,131.38,0.00,0.00,0.00,0,4.00,2,338.65,0,2,7,java.lang.Object,0.00,3,0,5,0,3,2,1,6,85,1
"org.apache.jackrabbit.core.state.SharedItemStateManager",37,0.01,3.35,425,5.24,263601.10,49,12,29,137,45,57.41,436,568,11,1,101.54,0.00,0.00,0.09,13,579.00,18,15732.86,0,4,35,java.lang.Object,0.00,100,0,124,1,100,33,3,137,2983,1
"org.apache.jackrabbit.core.state.SharedItemStateManager$Update",19,0.03,4.74,265,3.41,186442.13,28,9,29,81,22,49.55,161,364,0,1,97.66,0.00,0.00,0.14,10,117.00,23,10228.64,0,4,22,java.lang.Object,0.00,62,0,90,0,62,15,1,72,1812,0
"org.apache.jackrabbit.core.state.SharedItemStateManager$Update$NodeStateMerger.MergeContext",5,0.00,1.80,25,0.32,7904.39,5,0,29,14,9,119.60,0,39,0,1,119.60,0.00,0.00,0.00,1,0.00,3,957.06,0,0,9,java.lang.Object,0.00,9,0,9,0,9,5,0,0,204,0
"org.apache.jackrabbit.core.state.StaleItemStateException",2,0.00,1.00,5,0.03,221.18,2,0,0,2,11,93.68,19,8,10,3,143.68,0.00,0.67,0.00,0,2.00,1,88.69,0,0,1,org.apache.jackrabbit.core.state.ItemStateException,0.00,0,2,2,0,0,2,0,3,29,1
"org.apache.jackrabbit.core.state.StateChangeDispatcher",11,0.35,3.00,71,0.78,24208.32,13,2,6,24,9,97.53,59,94,3,1,115.40,0.00,0.00,0.18,1,25.00,5,2352.47,0,1,6,java.lang.Object,0.00,13,0,33,0,13,10,0,14,508,1
"org.apache.jackrabbit.core.state.TestAll",1,0.00,1.00,8,0.07,2228.14,1,0,3,3,4,62.47,10,10,0,2,110.95,0.00,0.50,0.00,0,1.00,1,223.66,0,1,4,junit.framework.TestCase,0.00,2,1,1,0,2,0,0,2,55,1
"org.apache.jackrabbit.core.state.UpdatableItemStateManager",9,0.00,1.00,10,0.07,333.40,9,0,3,9,17,110.54,76,15,10,2,158.65,0.00,0.50,0.00,0,9.00,1,216.38,0,2,7,,0.00,0,1,9,0,0,7,0,10,74,1
"org.apache.jackrabbit.core.state.XAItemStateManager",22,0.01,4.09,239,2.95,188652.47,29,7,19,70,23,60.11,175,331,4,2,102.40,0.00,0.50,0.16,6,178.00,18,8860.18,5,3,19,org.apache.jackrabbit.core.state.LocalItemStateManager,0.08,48,1,90,0,48,19,1,50,1713,1
"org.apache.jackrabbit.core.state.XAItemStateManager$Iterable<PropertyState>",1,0.00,1.00,3,0.04,808.23,1,0,19,4,0,130.31,0,6,0,1,130.31,0.00,0.00,0.00,0,1.00,1,125.93,0,1,0,java.lang.Object,0.00,3,0,1,0,3,0,0,0,33,0
"org.apache.jackrabbit.core.state.XAItemStateManager$Iterable<PropertyState>$Predicate",1,0.00,2.00,7,0.07,1400.39,1,0,19,3,2,114.54,0,9,0,1,114.54,0.00,0.00,0.00,0,1.00,2,197.99,0,0,2,java.lang.Object,0.00,2,0,2,0,2,1,0,0,46,0
"org.apache.jackrabbit.rmi.client.BrokenRemoteRepository",9,0.38,1.00,20,0.14,1329.56,10,1,4,10,3,100.40,65,31,1,1,142.69,0.00,0.00,0.67,0,0.00,1,406.69,0,6,2,java.lang.Object,0.00,1,0,9,0,1,3,1,12,118,1
"org.apache.jackrabbit.rmi.client.ClientAdapterFactory",37,0.00,1.16,100,0.96,19875.23,37,0,79,74,77,138.47,166,153,8,1,138.24,0.00,0.00,0.00,0,37.00,2,2868.19,0,37,69,java.lang.Object,0.00,37,0,43,1,37,0,1,36,733,1
"org.apache.jackrabbit.rmi.client.ClientItem",15,0.14,1.87,61,0.54,10599.67,17,2,7,31,8,126.20,64,99,3,1,125.96,0.00,0.00,0.37,3,0.00,4,1605.61,2,5,5,org.apache.jackrabbit.rmi.client.ClientObject,0.00,16,1,28,4,16,10,1,18,391,1
"org.apache.jackrabbit.rmi.client.ClientItemDefinition",7,0.17,2.00,33,0.27,5776.31,8,1,5,15,8,146.03,26,54,3,1,125.42,0.00,0.00,0.86,0,0.00,3,802.19,1,2,5,org.apache.jackrabbit.rmi.client.ClientObject,0.00,8,1,14,2,8,5,1,9,196,1
"org.apache.jackrabbit.rmi.client.ClientLock",10,0.11,1.80,40,0.34,6259.58,12,2,7,21,6,166.27,25,66,1,1,126.38,0.00,0.00,0.40,1,0.00,3,1009.28,0,3,5,org.apache.jackrabbit.rmi.client.ClientObject,0.00,11,1,18,0,11,7,1,11,253,1
"org.apache.jackrabbit.rmi.client.ClientLockManager",9,0.06,1.89,39,0.43,8903.92,11,2,6,19,5,124.81,1,70,1,1,124.81,0.00,0.00,0.56,0,0.00,2,1276.71,1,3,4,org.apache.jackrabbit.rmi.client.ClientObject,0.00,10,1,17,0,10,6,1,1,295,1
"org.apache.jackrabbit.rmi.client.ClientNamespaceRegistry",7,0.17,1.86,29,0.28,6048.57,8,1,4,14,5,145.89,23,52,1,1,125.27,0.00,0.00,0.86,0,0.00,2,841.90,0,4,4,org.apache.jackrabbit.rmi.client.ClientObject,0.00,7,1,13,0,7,3,1,9,202,1
"org.apache.jackrabbit.rmi.client.ClientNode",74,0.29,1.92,316,3.66,89261.40,75,1,24,131,10,174.13,92,546,3,2,124.13,2.00,0.25,0.72,2,0.00,4,10967.50,4,45,7,org.apache.jackrabbit.rmi.client.ClientItem,0.02,57,2,142,2,57,29,1,68,2450,1
"org.apache.jackrabbit.rmi.client.ClientNodeDefinition",6,0.60,1.67,25,0.20,4313.38,7,1,5,12,6,146.54,19,39,1,2,125.93,0.00,0.50,0.50,0,6.00,3,612.53,2,4,5,org.apache.jackrabbit.rmi.client.ClientItemDefinition,0.00,6,2,10,0,6,2,1,6,151,1
"org.apache.jackrabbit.rmi.client.ClientNodeType",26,0.36,1.88,110,1.03,26338.08,27,1,11,47,8,164.61,54,173,1,1,124.73,0.00,0.00,0.65,2,0.00,3,3088.05,1,13,7,org.apache.jackrabbit.rmi.client.ClientObject,0.00,21,1,49,0,21,13,1,23,726,1
"org.apache.jackrabbit.rmi.client.ClientNodeTypeManager",14,0.62,1.43,43,0.44,7653.77,15,1,11,24,5,181.56,21,80,1,1,131.56,0.00,0.00,0.43,1,26.00,2,1316.57,1,10,4,org.apache.jackrabbit.rmi.client.ClientObject,0.00,10,1,20,0,10,4,1,7,322,1
"org.apache.jackrabbit.rmi.client.ClientObject",5,0.25,2.20,31,0.28,9762.21,6,1,10,11,22,71.75,55,38,15,1,115.88,0.00,0.00,0.80,1,0.00,3,840.77,0,4,7,java.lang.Object,0.00,6,0,11,35,6,1,0,8,196,1
"org.apache.jackrabbit.rmi.client.ClientObservationManager",8,0.10,1.50,32,0.38,7934.29,11,3,11,19,6,106.98,40,57,1,1,124.85,0.00,0.00,0.25,1,16.00,2,1139.84,0,4,5,org.apache.jackrabbit.rmi.client.ClientObject,0.00,11,1,12,0,11,4,1,10,259,1
"org.apache.jackrabbit.rmi.client.ClientProperty",31,0.73,1.84,136,1.59,59949.80,32,1,19,64,6,122.76,147,219,1,2,122.52,0.00,0.50,0.29,5,148.00,8,4761.01,3,10,5,org.apache.jackrabbit.rmi.client.ClientItem,0.00,33,2,57,0,33,21,1,36,1048,1
"org.apache.jackrabbit.rmi.client.ClientPropertyDefinition",8,0.57,1.50,27,0.21,3637.85,9,1,4,14,5,172.07,20,45,1,2,132.18,0.00,0.50,0.50,0,8.00,2,627.88,0,3,4,org.apache.jackrabbit.rmi.client.ClientItemDefinition,0.00,6,2,12,0,6,5,1,7,164,1
"org.apache.jackrabbit.rmi.client.ClientQuery",10,0.17,1.50,35,0.32,5445.85,12,2,9,20,6,171.45,23,58,1,1,131.56,0.00,0.00,0.35,0,10.00,2,966.80,2,6,5,org.apache.jackrabbit.rmi.client.ClientObject,0.00,10,1,15,0,10,4,1,9,239,1
"org.apache.jackrabbit.rmi.client.ClientQueryManager",5,0.00,1.60,23,0.24,5105.46,7,2,9,13,7,124.97,21,38,1,1,124.74,0.00,0.00,0.50,0,2.00,2,727.93,1,4,6,org.apache.jackrabbit.rmi.client.ClientObject,0.00,8,1,8,0,8,1,1,8,168,1
"org.apache.jackrabbit.rmi.client.ClientQueryResult",5,0.12,1.60,21,0.20,3668.07,7,2,8,12,5,126.10,21,35,1,1,125.87,0.00,0.00,0.40,0,2.00,2,611.15,1,4,4,org.apache.jackrabbit.rmi.client.ClientObject,0.00,7,1,8,0,7,1,1,7,148,1
"org.apache.jackrabbit.rmi.client.ClientRepository",11,0.35,1.45,43,0.40,8281.16,13,2,11,21,7,112.59,57,65,1,1,130.46,0.00,0.00,0.18,3,26.00,2,1188.99,0,8,6,java.lang.Object,0.00,10,0,16,0,10,3,1,15,289,1
"org.apache.jackrabbit.rmi.client.ClientRepository$HashSet<String>",0,0.00,0.00,49,0.58,17111.25,0,0,11,0,0,171.00,0,49,0,1,171.00,0.00,0.00,0.00,0,0.00,0,1741.26,0,0,0,java.lang.Object,0.00,0,0,0,0,0,0,0,0,296,0
"org.apache.jackrabbit.rmi.client.ClientRepositoryFactory",4,0.50,1.75,18,0.19,4674.34,6,2,12,9,6,86.69,50,30,2,1,124.26,0.00,0.00,0.12,1,6.00,4,574.76,0,2,4,java.lang.Object,0.00,5,0,7,0,5,2,1,7,129,1
"org.apache.jackrabbit.rmi.client.ClientRepositoryFactory$SafeClientRepository",1,0.00,4.00,7,0.10,3232.39,1,0,12,3,1,111.52,0,13,0,1,111.52,0.00,0.00,0.00,0,1.00,4,290.24,0,1,1,java.lang.Object,0.00,2,0,4,0,2,0,0,0,65,0
"org.apache.jackrabbit.rmi.client.ClientRow",9,0.88,1.22,24,0.21,3208.69,10,1,7,13,3,189.63,16,38,1,1,139.63,0.00,0.00,0.22,0,19.00,2,625.98,0,6,2,java.lang.Object,0.00,4,0,11,0,4,3,1,5,163,1
"org.apache.jackrabbit.rmi.client.ClientSession",42,0.00,2.10,200,2.32,56986.72,47,5,33,99,10,163.59,116,351,2,1,123.70,0.00,0.00,0.20,2,0.00,5,6971.71,1,20,8,org.apache.jackrabbit.rmi.client.ClientObject,0.00,57,1,88,1,57,22,1,49,1516,1
"org.apache.jackrabbit.rmi.client.ClientSession$DefaultContentHandler",1,0.00,2.00,6,0.06,1047.39,1,0,33,3,0,118.03,0,9,0,1,118.03,0.00,0.00,0.00,0,0.00,2,178.98,1,0,0,java.lang.Object,0.00,2,0,2,0,2,1,0,0,42,0
"org.apache.jackrabbit.rmi.client.ClientVersion",9,0.62,1.67,38,0.37,9937.62,10,1,9,17,5,145.08,32,56,1,3,124.46,0.00,0.67,0.44,1,13.00,3,1103.31,2,8,4,org.apache.jackrabbit.rmi.client.ClientNode,0.00,8,3,15,0,8,1,1,9,259,1
"org.apache.jackrabbit.rmi.client.ClientVersionHistory",17,0.31,1.71,63,0.69,13765.88,18,1,10,32,5,180.18,31,114,1,3,130.18,0.00,0.67,0.71,0,0.00,2,2057.77,2,11,4,org.apache.jackrabbit.rmi.client.ClientNode,0.00,15,3,29,0,15,6,1,17,479,1
"org.apache.jackrabbit.rmi.client.ClientVersionManager",22,0.00,1.59,75,0.91,17396.79,24,2,10,40,5,130.27,1,148,1,1,130.27,0.00,0.00,0.50,0,0.00,2,2734.35,1,11,4,org.apache.jackrabbit.rmi.client.ClientObject,0.00,18,1,35,0,18,11,1,1,629,1
"org.apache.jackrabbit.rmi.client.ClientWorkspace",20,0.03,2.05,100,1.08,27736.45,25,5,21,49,10,159.90,46,170,1,1,120.02,0.00,0.00,0.23,1,0.00,3,3250.30,1,10,9,org.apache.jackrabbit.rmi.client.ClientObject,0.00,29,1,41,0,29,10,1,22,721,1
"org.apache.jackrabbit.rmi.client.ClientWorkspace$DefaultContentHandler",1,0.00,2.00,6,0.06,1083.98,1,0,21,3,0,117.91,0,10,0,1,117.91,0.00,0.00,0.00,0,0.00,2,194.37,1,0,0,java.lang.Object,0.00,2,0,2,0,2,1,0,0,46,0
"org.apache.jackrabbit.rmi.client.ClientXASession",12,0.18,1.75,47,0.50,9917.17,13,1,7,24,6,180.10,20,81,2,2,130.10,0.00,0.50,0.83,1,0.00,2,1503.76,0,2,4,org.apache.jackrabbit.rmi.client.ClientSession,0.00,12,2,21,0,12,10,1,4,354,1
"org.apache.jackrabbit.rmi.client.DefaultContentHandler",12,0.09,1.00,26,0.26,3664.93,13,1,5,23,3,97.91,88,47,3,2,140.20,1.00,0.33,0.92,0,0.00,1,792.03,0,0,0,org.xml.sax.helpers.DefaultHandler,0.00,11,1,12,1,11,12,0,15,215,0
"org.apache.jackrabbit.rmi.client.LocalAdapterFactory",37,0.00,1.00,38,0.25,829.28,37,0,62,37,77,118.07,278,44,49,1,160.37,0.00,0.00,0.00,0,37.00,1,762.06,0,37,28,,0.00,0,0,37,0,0,0,0,36,270,1
"org.apache.jackrabbit.rmi.client.RemoteRepositoryException",1,0.00,1.00,3,0.02,106.02,1,0,2,1,21,107.87,13,5,21,2,137.25,0.00,0.50,0.00,0,1.00,1,45.51,0,0,0,javax.jcr.RepositoryException,0.00,0,1,1,0,0,1,0,2,16,1
"org.apache.jackrabbit.rmi.client.RemoteRuntimeException",1,0.00,1.00,3,0.02,106.02,1,0,1,1,17,107.87,13,5,17,2,137.25,0.00,0.50,0.00,0,1.00,1,45.51,0,0,0,java.lang.RuntimeException,0.00,0,1,1,0,0,1,0,2,16,1
"org.apache.jackrabbit.rmi.client.SafeClientRepository",13,0.75,1.54,49,0.47,11806.49,14,1,8,21,8,169.69,31,81,1,1,129.81,0.00,0.00,0.31,2,33.00,3,1416.36,1,10,7,org.apache.jackrabbit.rmi.client.ClientObject,0.00,8,1,20,0,8,3,1,10,340,2
"org.apache.jackrabbit.rmi.client.SerializingContentHandler",13,0.01,3.23,153,2.12,118066.44,23,10,21,56,3,63.15,160,193,2,3,100.71,0.00,0.67,0.09,5,63.00,14,6360.21,6,3,1,org.apache.jackrabbit.rmi.client.DefaultContentHandler,0.24,43,2,42,0,43,10,0,65,1175,0
"org.apache.jackrabbit.core.persistence.xml.XMLPersistenceManager",24,0.12,4.46,456,7.41,406477.01,54,30,41,140,25,57.43,162,614,1,2,89.65,0.00,0.50,0.15,5,0.00,12,22244.91,1,8,24,org.apache.jackrabbit.core.persistence.AbstractPersistenceManager,0.00,116,1,107,0,116,16,0,96,3649,1
"org.apache.jackrabbit.test.api.version.simple.AbstractVersionTest",4,0.33,3.50,52,0.66,20359.47,9,5,8,18,8,67.75,27,75,6,4,99.97,2.33,0.27,0.45,0,2.00,10,1968.32,5,1,2,org.apache.jackrabbit.test.AbstractJCRTest,0.27,14,3,14,7,14,3,0,8,368,1
"org.apache.jackrabbit.test.api.version.simple.BasicTest",3,0.00,1.00,8,0.07,725.56,3,0,1,7,2,108.78,18,15,1,5,141.00,0.00,0.80,0.00,0,1.00,1,218.48,1,0,1,org.apache.jackrabbit.test.api.version.simple.AbstractVersionTest,0.15,4,4,3,0,4,3,0,3,59,1
"org.apache.jackrabbit.test.api.version.simple.CheckinTest",13,0.00,1.54,75,0.87,15138.38,13,0,5,29,2,88.46,80,103,1,5,120.68,0.00,0.80,0.00,0,0.00,2,2624.30,3,0,1,org.apache.jackrabbit.test.api.version.simple.AbstractVersionTest,0.12,16,4,20,0,16,13,0,19,570,1
"org.apache.jackrabbit.test.api.version.simple.CheckoutTest",9,0.00,2.44,70,0.78,23286.29,9,0,5,23,2,94.52,45,98,1,5,112.39,0.00,0.80,0.00,0,8.00,5,2325.78,2,0,1,org.apache.jackrabbit.test.api.version.simple.AbstractVersionTest,0.13,14,4,22,0,14,9,0,13,483,1
"org.apache.jackrabbit.test.api.version.simple.CopyTest",3,0.00,1.33,23,0.31,5149.17,3,0,5,18,2,81.72,20,32,1,5,113.94,0.00,0.80,0.00,0,1.00,2,917.79,3,0,1,org.apache.jackrabbit.test.api.version.simple.AbstractVersionTest,0.30,15,4,4,0,15,3,0,5,181,1
"org.apache.jackrabbit.test.api.version.simple.FrozenNodeTest",9,0.00,1.11,84,1.33,20132.63,9,0,5,26,3,129.62,34,98,1,5,109.00,0.00,0.80,0.00,0,0.00,2,3988.66,3,0,2,org.apache.jackrabbit.test.api.version.simple.AbstractVersionTest,0.13,17,4,10,0,17,9,0,10,769,1
"org.apache.jackrabbit.test.api.version.simple.RestoreTest",69,0.11,1.77,710,10.38,288895.73,76,7,13,124,3,72.82,436,868,1,5,105.05,0.00,0.80,0.25,0,0.00,4,31133.85,5,0,2,org.apache.jackrabbit.test.api.version.simple.AbstractVersionTest,0.10,55,4,122,0,55,69,0,192,5918,1
"org.apache.jackrabbit.test.api.version.simple.TestAll",1,0.00,1.00,10,0.10,3275.34,1,0,3,3,7,156.02,1,12,1,2,106.02,0.00,0.50,0.00,0,1.00,1,301.01,0,1,6,junit.framework.TestCase,0.00,2,1,1,0,2,0,0,1,71,1
"org.apache.jackrabbit.webdav.jcr.version.VersionHistoryItemCollection",5,1.00,2.60,42,0.66,20849.98,6,1,21,31,15,60.48,42,68,1,4,108.59,0.00,0.75,0.20,0,2.00,4,1966.87,6,2,14,org.apache.jackrabbit.webdav.jcr.DefaultItemCollection,0.08,26,3,13,0,26,3,1,13,386,1
"org.apache.jackrabbit.webdav.jcr.version.VersionItemCollection",7,1.00,3.00,62,1.00,34569.82,8,1,29,47,19,59.87,61,92,1,4,107.97,0.00,0.75,0.14,1,15.00,6,3010.08,6,3,18,org.apache.jackrabbit.webdav.jcr.DefaultItemCollection,0.12,40,3,21,0,40,4,1,20,552,1
"org.apache.jackrabbit.jcr.NodeIteratorImpl",10,0.10,1.80,65,0.60,16551.69,19,9,12,24,7,66.49,96,86,1,1,116.49,0.00,0.00,0.20,2,26.00,4,1798.20,0,2,6,java.lang.Object,0.00,14,0,18,0,14,8,1,28,386,1
"org.apache.jackrabbit.jcr.QueryImpl",11,0.07,1.64,68,0.95,28465.79,22,11,28,43,13,72.69,87,98,2,1,114.98,0.00,0.00,0.16,0,51.00,4,2858.00,0,7,11,java.lang.Object,0.00,32,0,18,1,32,4,1,24,567,1
"org.apache.jackrabbit.jcr.QueryManagerImpl",6,0.24,1.67,38,0.51,13616.94,11,5,18,22,11,67.32,49,56,1,1,115.43,0.00,0.00,0.40,1,0.00,4,1527.42,0,4,10,java.lang.Object,0.00,16,0,10,0,16,2,1,13,310,1
"org.apache.jackrabbit.jcr.QueryManagerImpl$QOMFactory",2,1.00,1.00,7,0.07,891.59,3,1,18,3,4,132.34,0,13,0,2,132.34,0.00,0.50,0.50,0,2.00,1,211.89,0,1,4,org.apache.jackrabbit.spi.commons.query.qom.QueryObjectModelFactoryImpl,0.00,1,1,2,0,1,1,0,0,54,1
"org.apache.jackrabbit.jcr.QueryObjectModelImpl",7,0.50,1.00,18,0.19,2737.78,8,1,24,14,7,159.97,21,35,1,2,139.36,0.00,0.50,0.57,0,3.00,1,575.92,0,6,6,org.apache.jackrabbit.jcr2spi.query.QueryImpl,0.11,7,1,7,0,7,1,1,7,145,1
"org.apache.jackrabbit.jcr.QueryObjectModelImpl$DummyQOM",14,0.77,1.00,30,0.22,2475.08,15,1,24,19,1,192.07,15,51,0,1,142.07,0.00,0.00,0.29,0,38.00,1,673.50,0,10,1,java.lang.Object,0.00,5,0,14,0,5,4,1,5,191,2
"org.apache.jackrabbit.jcr.QueryResultImpl",6,0.20,1.17,26,0.26,5823.30,9,3,9,15,9,107.11,35,36,1,1,124.98,0.00,0.00,0.50,1,0.00,2,769.03,0,5,8,java.lang.Object,0.00,9,0,7,0,9,1,1,10,184,0
"org.apache.jackrabbit.jcr.QueryTest",2,0.00,2.50,26,0.32,10401.48,2,0,8,14,3,120.59,7,27,1,5,99.97,0.00,0.80,0.00,0,0.00,3,971.25,1,0,2,org.apache.jackrabbit.test.api.query.AbstractQueryTest,0.00,12,4,5,0,12,2,0,2,184,1
"org.apache.jackrabbit.jcr.RowIteratorImpl",8,0.07,1.00,29,0.25,3048.34,14,6,21,17,10,88.75,91,40,1,1,132.88,0.00,0.00,0.10,1,0.00,1,755.97,0,2,9,java.lang.Object,0.00,9,0,8,0,9,6,1,19,190,0
"org.apache.jackrabbit.jcr.RowIteratorImpl$RowImpl",10,0.07,2.10,64,0.69,29064.45,13,3,21,22,5,72.24,70,82,0,1,114.53,0.00,0.00,0.27,2,22.00,6,2067.46,0,7,5,java.lang.Object,0.00,12,0,21,0,12,3,1,17,440,0
"org.apache.jackrabbit.jcr.ScoreNodeIterator",1,0.00,1.00,2,0.01,48.43,1,0,1,1,2,117.12,13,3,2,2,146.50,0.00,0.50,0.00,0,1.00,1,27.12,0,0,0,,0.00,0,1,1,0,0,1,0,2,11,1
"org.apache.jackrabbit.jcr.TestAll",1,0.00,1.00,5,0.04,864.35,1,0,3,3,2,142.42,3,7,1,2,121.80,0.00,0.50,0.00,0,1.00,1,115.51,0,1,1,junit.framework.TestCase,0.00,2,1,1,0,2,0,0,1,31,1
"org.apache.jackrabbit.commons.query.GQL",16,0.03,5.00,283,3.97,230763.46,41,25,26,82,5,131.28,346,389,2,1,91.98,0.00,0.00,0.07,7,90.00,17,11905.90,0,9,3,java.lang.Object,0.00,66,0,80,0,66,7,0,74,2054,2
"org.apache.jackrabbit.commons.query.GQL$ContainsExpression",2,1.00,5.50,41,0.53,33407.12,3,1,26,14,2,128.71,4,53,0,2,88.82,0.00,0.50,0.50,0,2.00,10,1599.25,0,0,2,org.apache.jackrabbit.commons.query.PropertyExpression,0.00,12,1,11,0,12,2,0,4,287,2
"org.apache.jackrabbit.commons.query.GQL$Expression",1,0.00,1.00,2,0.01,51.00,1,0,26,1,0,146.32,0,3,0,1,146.32,0.00,0.00,0.00,0,1.00,1,34.00,0,0,0,,0.00,0,0,1,0,0,1,0,0,13,1
"org.apache.jackrabbit.commons.query.GQL$Filter",1,0.00,1.00,2,0.01,69.06,1,0,26,1,0,96.81,10,3,0,1,145.29,0.00,0.00,0.00,0,1.00,1,36.53,0,0,0,,0.00,0,0,1,0,0,1,0,1,13,1
"org.apache.jackrabbit.commons.query.GQL$FilteredRowIterator",9,0.12,1.56,36,0.25,4550.91,12,3,26,12,0,127.38,39,54,0,1,127.15,0.00,0.00,0.22,2,21.00,4,736.45,0,2,0,java.lang.Object,0.00,3,0,14,0,3,7,1,13,186,2
"org.apache.jackrabbit.commons.query.GQL$MixinComparision",1,0.00,1.00,3,0.02,90.19,1,0,26,1,0,137.81,0,5,0,2,137.81,0.00,0.50,0.00,0,0.00,1,48.09,0,0,0,org.apache.jackrabbit.commons.query.ValueComparison,0.00,0,1,1,0,0,1,0,0,17,1
"org.apache.jackrabbit.commons.query.GQL$NAryExpression",4,0.33,1.75,18,0.17,4271.60,5,1,26,9,0,124.56,0,25,0,1,124.56,0.00,0.00,0.75,0,0.00,4,507.98,0,1,0,java.lang.Object,0.00,5,0,7,0,5,3,1,0,119,2
"org.apache.jackrabbit.commons.query.GQL$OptionalExpression",1,0.00,1.00,3,0.01,91.02,1,0,26,1,0,137.77,0,5,0,2,137.77,0.00,0.50,0.00,0,1.00,1,39.51,0,1,0,org.apache.jackrabbit.commons.query.NAryExpression,0.00,0,1,1,0,0,0,0,0,14,1
"org.apache.jackrabbit.commons.query.GQL$OrderByExpression",5,1.00,2.80,49,0.55,25902.95,6,1,26,19,2,105.92,2,59,0,1,105.92,0.00,0.00,0.20,1,7.00,7,1650.24,0,1,2,java.lang.Object,0.00,14,0,14,0,14,4,1,2,321,1
"org.apache.jackrabbit.commons.query.GQL$ParserCallback",1,0.00,1.00,2,0.02,116.86,1,0,26,1,0,95.01,10,4,0,1,143.49,0.00,0.00,0.00,0,1.00,1,54.60,0,0,0,,0.00,0,0,1,0,0,1,0,1,17,1
"org.apache.jackrabbit.commons.query.GQL$ParserCallback_0",1,0.00,1.00,3,0.03,273.23,1,0,26,2,0,134.02,0,5,0,1,134.02,0.00,0.00,0.00,0,1.00,1,80.34,0,0,0,java.lang.Object,0.00,1,0,1,0,1,1,0,0,23,0
"org.apache.jackrabbit.commons.query.GQL$PrimaryTypeComparision",1,0.00,1.00,3,0.02,90.19,1,0,26,1,0,137.81,0,5,0,2,137.81,0.00,0.50,0.00,0,0.00,1,48.09,0,0,0,org.apache.jackrabbit.commons.query.ValueComparison,0.00,0,1,1,0,0,1,0,0,17,1
"org.apache.jackrabbit.commons.query.GQL$PropertyExpression",1,2.00,1.00,6,0.04,684.62,3,2,26,1,0,119.64,0,8,0,1,119.64,0.00,0.00,0.00,0,1.00,1,133.42,0,0,0,java.lang.Object,0.00,0,0,1,0,0,1,1,0,38,2
"org.apache.jackrabbit.commons.query.GQL$RequiredExpression",1,0.00,1.00,3,0.01,91.02,1,0,26,1,0,137.77,0,5,0,2,137.77,0.00,0.50,0.00,0,1.00,1,39.51,0,1,0,org.apache.jackrabbit.commons.query.NAryExpression,0.00,0,1,1,0,0,0,0,0,14,1
"org.apache.jackrabbit.commons.query.GQL$RowAdapter",9,0.00,1.11,24,0.22,3516.07,11,2,26,15,0,139.34,0,35,0,1,139.34,0.00,0.00,0.50,0,0.00,2,660.36,0,6,0,java.lang.Object,0.00,6,0,10,0,6,3,1,0,176,3
"org.apache.jackrabbit.commons.query.GQL$RowIterAdapter",4,1.00,1.25,17,0.12,2746.39,5,1,26,5,1,126.15,0,23,0,3,126.15,0.00,0.67,0.25,0,8.00,2,370.32,1,1,1,org.apache.jackrabbit.commons.iterator.RowIteratorAdapter,0.40,1,2,5,0,1,3,0,0,97,2
"org.apache.jackrabbit.commons.query.GQL$ValueComparison",2,0.00,1.00,7,0.08,939.94,2,0,26,6,1,132.16,0,11,0,2,132.16,0.00,0.50,0.00,0,2.00,1,235.66,0,0,1,org.apache.jackrabbit.commons.query.PropertyExpression,0.00,4,1,2,0,4,2,0,0,61,2
"org.apache.jackrabbit.commons.query.QueryObjectModelBuilder",4,0.00,1.00,5,0.04,187.53,4,0,5,4,2,107.84,38,10,2,1,157.84,0.00,0.00,0.00,0,4.00,1,112.42,0,3,0,,0.00,0,0,4,0,0,1,0,5,37,1
"org.apache.jackrabbit.commons.query.QueryObjectModelBuilderRegistry",2,0.50,2.00,19,0.25,6391.33,4,2,9,7,5,70.09,25,27,4,1,107.65,0.00,0.00,0.25,0,2.00,3,761.39,0,1,1,java.lang.Object,0.00,5,0,4,0,5,1,0,5,164,1
"org.apache.jackrabbit.core.jndi.provider.DummyContext",34,0.42,1.41,121,1.23,26112.70,36,2,17,57,2,151.02,113,169,2,2,130.40,0.00,0.50,0.09,14,198.00,3,3702.92,1,21,0,java.util.Hashtable,0.00,23,1,48,0,23,13,2,39,879,0
"org.apache.jackrabbit.core.jndi.provider.DummyContext$BindingEnum",2,0.00,1.00,6,0.05,692.27,2,0,17,5,0,133.21,0,9,0,2,133.21,0.00,0.50,0.00,0,2.00,1,143.20,0,1,0,org.apache.jackrabbit.core.jndi.provider.NamingEnum,0.00,3,1,2,0,3,1,0,0,41,0
"org.apache.jackrabbit.core.jndi.provider.DummyContext$FlatNameParser",1,0.00,1.00,7,0.06,832.71,2,1,17,3,0,137.09,3,10,0,1,116.48,0.00,0.00,1.00,0,0.00,1,180.99,0,1,0,java.lang.Object,0.00,2,0,1,0,2,0,1,1,49,1
"org.apache.jackrabbit.core.jndi.provider.DummyContext$NamingEnum",6,0.20,1.00,17,0.13,1732.88,8,2,17,13,0,140.39,0,24,0,1,140.39,0.00,0.00,0.33,2,6.00,1,398.94,0,2,0,java.lang.Object,0.00,7,0,6,0,7,4,1,0,110,0
"org.apache.jackrabbit.core.jndi.provider.DummyInitialContextFactory",1,0.00,3.00,12,0.15,6408.85,2,1,5,7,3,50.52,9,17,2,1,100.51,0.00,0.00,1.00,0,0.00,3,443.66,0,1,1,java.lang.Object,0.00,6,0,3,0,6,0,1,3,94,1
"org.apache.jackrabbit.core.fs.mem.MemoryFile",3,1.00,1.00,8,0.06,741.03,4,1,0,3,2,190.93,3,12,1,2,140.93,0.00,0.50,0.33,0,4.00,1,167.44,0,0,1,org.apache.jackrabbit.core.fs.mem.MemoryFileSystemEntry,0.33,0,1,3,0,0,3,0,1,48,1
"org.apache.jackrabbit.core.fs.mem.MemoryFileSystem",23,0.77,1.78,110,1.26,42521.69,24,1,12,51,9,122.68,3,149,4,1,122.68,0.00,0.00,0.26,10,89.00,4,3767.85,0,8,5,java.lang.Object,0.00,28,0,41,0,28,15,1,1,819,1
"org.apache.jackrabbit.core.fs.mem.MemoryFileSystem$ByteArrayOutputStream",2,0.00,1.00,6,0.06,833.77,2,0,12,6,0,132.57,0,8,0,1,132.57,0.00,0.00,0.00,0,2.00,1,187.38,0,0,0,java.lang.Object,0.00,4,0,2,0,4,2,0,0,50,0
"org.apache.jackrabbit.core.fs.mem.MemoryFileSystemEntry",3,0.50,1.00,7,0.04,295.74,4,1,0,4,3,194.07,3,10,3,1,144.07,0.00,0.00,0.67,0,1.00,1,107.75,0,0,0,java.lang.Object,0.00,1,0,3,2,1,3,0,1,35,2
"org.apache.jackrabbit.core.fs.mem.MemoryFileSystemTest",1,0.00,1.00,3,0.02,126.12,1,0,2,2,4,157.27,3,5,1,3,136.66,0.00,0.67,0.00,0,1.00,1,47.21,0,1,3,org.apache.jackrabbit.core.fs.AbstractFileSystemTest,0.43,1,2,1,0,1,0,0,1,16,1
"org.apache.jackrabbit.core.fs.mem.MemoryFolder",1,0.00,1.00,3,0.01,91.02,1,0,0,1,2,158.39,3,5,1,2,137.77,0.00,0.50,0.00,0,1.00,1,39.51,0,0,1,org.apache.jackrabbit.core.fs.mem.MemoryFileSystemEntry,0.50,0,1,1,0,0,1,0,1,14,1
"org.apache.jackrabbit.core.journal.AbstractJournal",22,0.04,1.64,111,1.15,34980.73,31,9,11,49,16,87.38,151,162,7,1,119.60,0.00,0.00,0.08,5,262.00,7,3443.04,0,5,11,java.lang.Object,0.00,27,0,36,6,27,17,1,36,731,2
"org.apache.jackrabbit.core.journal.AbstractRecord",14,0.00,2.36,110,1.26,40723.64,19,5,22,53,19,112.24,65,153,2,1,112.00,0.00,0.00,0.20,4,62.00,4,3784.64,0,6,17,java.lang.Object,0.00,39,0,33,2,39,8,1,20,782,2
"org.apache.jackrabbit.core.journal.AppendRecord",26,0.03,1.88,156,1.52,37940.28,39,13,12,59,7,117.15,108,226,5,2,116.91,0.00,0.50,0.10,5,134.00,6,4552.89,0,4,3,org.apache.jackrabbit.core.journal.AbstractRecord,0.00,33,1,49,0,33,22,0,33,963,1
"org.apache.jackrabbit.core.journal.DatabaseJournal",43,0.02,1.67,231,2.73,85771.62,72,29,20,97,18,86.60,269,342,5,2,118.82,3.00,0.20,0.05,11,985.00,8,8200.37,2,15,14,org.apache.jackrabbit.core.journal.AbstractJournal,0.06,54,1,72,3,54,28,1,67,1638,1
"org.apache.jackrabbit.core.journal.DatabaseJournal$DatabaseRevision",4,0.17,2.50,32,0.34,11146.17,6,2,20,9,3,77.75,27,45,0,1,109.97,0.00,0.00,0.62,0,0.00,4,1031.56,0,0,3,java.lang.Object,0.00,5,0,10,0,5,4,1,10,205,1
"org.apache.jackrabbit.core.journal.DatabaseJournal$RevisionTableJanitor",2,0.00,4.00,25,0.31,8266.89,2,0,20,9,1,122.56,7,37,0,1,101.95,0.00,0.00,0.00,1,0.00,4,938.27,0,0,1,java.lang.Object,0.00,7,0,8,0,7,2,1,3,180,1
"org.apache.jackrabbit.core.journal.DatabaseRecordIterator",6,0.23,2.33,51,0.50,10793.95,13,7,9,19,7,63.38,50,69,1,1,111.49,0.00,0.00,0.33,2,0.00,3,1501.61,0,0,7,java.lang.Object,0.00,13,0,14,0,13,6,1,14,320,0
"org.apache.jackrabbit.core.journal.DefaultRecordProducer",3,0.00,1.33,17,0.13,2872.50,5,2,0,7,5,79.09,23,24,1,1,121.38,0.00,0.00,0.50,0,1.00,2,400.29,0,1,5,java.lang.Object,0.00,4,0,4,0,4,2,1,6,98,1
"org.apache.jackrabbit.core.journal.FileJournal",16,0.06,1.94,108,1.29,44349.86,28,12,6,42,13,96.84,91,140,2,2,114.71,0.00,0.50,0.14,2,78.00,7,3857.01,5,3,11,org.apache.jackrabbit.core.journal.AbstractJournal,0.11,26,1,31,0,26,13,0,26,753,1
"org.apache.jackrabbit.core.journal.FileJournalTest",5,0.35,1.60,48,0.52,11721.59,10,5,8,24,8,58.76,45,62,1,3,108.76,0.00,0.67,0.48,0,0.00,2,1554.04,2,0,7,org.apache.jackrabbit.test.JUnitTest,0.86,19,2,8,0,19,5,0,11,324,1
"org.apache.jackrabbit.core.journal.FileJournalTest$JournalFactory",1,0.00,1.00,3,0.01,95.05,1,0,8,1,2,137.63,0,4,0,1,137.63,0.00,0.00,0.00,0,1.00,1,41.22,0,1,2,java.lang.Object,0.00,0,0,1,0,0,0,0,0,14,0
"org.apache.jackrabbit.core.journal.FileJournalTest$JournalFactory_0",1,0.00,1.00,3,0.02,238.65,1,0,8,2,2,134.48,0,5,0,1,134.48,0.00,0.00,0.00,0,1.00,1,63.51,0,1,2,java.lang.Object,0.00,1,0,1,0,1,0,0,0,19,0
"org.apache.jackrabbit.core.journal.FileJournalTest$JournalFactory_1",1,0.00,2.00,7,0.06,1662.59,1,0,8,4,4,163.95,1,11,0,1,113.95,0.00,0.00,0.00,0,0.00,2,191.40,0,1,4,java.lang.Object,0.00,3,0,2,0,3,0,0,1,44,0
"org.apache.jackrabbit.core.journal.FileRecordIterator",5,0.14,3.20,56,0.55,27326.11,12,7,5,15,8,52.45,48,74,1,1,102.45,0.00,0.00,0.26,1,9.00,9,1643.87,0,1,7,java.lang.Object,0.00,10,0,16,0,10,4,1,13,337,1
"org.apache.jackrabbit.core.journal.FileRecordLog",18,0.08,2.00,144,1.62,55587.45,31,13,16,58,5,59.67,171,189,2,1,109.67,0.00,0.00,0.15,4,114.00,4,4868.29,0,1,3,java.lang.Object,0.00,40,0,36,0,40,17,0,33,981,1
"org.apache.jackrabbit.core.journal.FileRecordLog$DataBuffer",2,0.00,1.00,6,0.06,774.15,2,0,16,5,0,133.06,8,9,0,2,132.82,0.00,0.50,0.00,0,2.00,1,177.19,0,0,0,java.io.DataOutputStream,0.00,3,1,2,0,3,2,0,1,47,3
"org.apache.jackrabbit.core.journal.FileRevision",4,0.42,3.00,36,0.38,10377.56,8,4,5,17,4,58.27,36,53,2,1,108.27,0.00,0.00,0.56,1,0.00,4,1141.10,0,0,2,java.lang.Object,0.00,13,0,12,0,13,4,1,9,239,1
"org.apache.jackrabbit.core.journal.InstanceRevision",3,0.00,1.00,4,0.02,82.26,3,0,0,3,9,127.45,18,5,8,1,159.68,0.00,0.00,0.00,0,3.00,1,57.51,0,0,1,,0.00,0,0,3,0,0,3,0,4,23,1
"org.apache.jackrabbit.core.journal.JNDIDatabaseJournal",4,0.67,1.25,15,0.13,3543.68,5,1,5,9,2,81.46,41,23,0,3,129.94,0.00,0.67,0.50,0,4.00,2,396.19,0,2,2,org.apache.jackrabbit.core.journal.DatabaseJournal,0.04,5,2,5,0,5,2,0,8,96,1
"org.apache.jackrabbit.core.journal.Journal",9,0.00,1.00,10,0.06,266.13,9,0,1,9,18,127.20,60,12,12,1,159.42,0.00,0.00,0.00,0,9.00,1,185.26,0,3,6,,0.00,0,0,9,0,0,6,0,10,67,1
"org.apache.jackrabbit.core.journal.JournalException",2,0.00,1.00,5,0.03,221.18,2,0,0,2,37,93.68,18,8,37,2,143.68,0.00,0.50,0.00,0,2.00,1,88.69,0,0,0,java.lang.Exception,0.00,0,1,2,0,0,2,0,3,29,1
"org.apache.jackrabbit.core.journal.JournalFactory",1,0.00,1.00,2,0.01,51.00,1,0,2,1,6,116.94,13,3,4,1,146.32,0.00,0.00,0.00,0,1.00,1,34.00,0,0,2,,0.00,0,0,1,0,0,1,0,2,13,1
"org.apache.jackrabbit.core.journal.LockableFileRevision",5,0.35,3.80,57,0.67,26638.60,10,5,6,21,3,54.40,43,86,2,1,102.50,0.00,0.00,0.48,2,0.00,6,2012.58,0,0,1,java.lang.Object,0.00,16,0,19,0,16,5,0,11,398,0
"org.apache.jackrabbit.core.journal.LockableFileRevisionTest",3,0.00,1.00,13,0.09,1039.01,5,2,5,7,3,178.54,4,16,1,5,128.54,0.00,0.80,0.50,0,1.00,1,273.79,3,0,2,org.apache.jackrabbit.core.AbstractConcurrencyTest,0.29,4,4,3,0,4,3,0,1,72,1
"org.apache.jackrabbit.core.journal.LockableFileRevisionTest$Task",1,0.00,3.00,10,0.08,2211.08,1,0,5,2,0,107.11,0,12,0,1,107.11,0.00,0.00,0.00,0,0.00,3,250.76,0,0,0,java.lang.Object,0.00,1,0,3,0,1,1,0,0,53,0
"org.apache.jackrabbit.core.journal.MSSqlDatabaseJournal",4,0.67,1.25,14,0.12,2334.85,5,1,1,7,2,113.49,22,22,0,3,131.37,0.00,0.67,0.50,0,4.00,2,365.02,3,2,2,org.apache.jackrabbit.core.journal.DatabaseJournal,0.04,3,2,5,0,3,2,0,6,93,1
"org.apache.jackrabbit.core.journal.MemoryJournal",14,0.04,1.43,61,0.69,22832.06,22,8,11,29,8,90.94,87,88,1,2,123.16,0.00,0.50,0.09,1,102.00,5,2075.12,2,3,7,org.apache.jackrabbit.core.journal.AbstractJournal,0.11,15,1,20,0,15,11,0,25,437,1
"org.apache.jackrabbit.core.journal.MemoryJournal$MemoryRecord",4,0.11,1.00,14,0.09,1339.84,7,3,11,4,0,91.03,31,19,0,1,133.32,0.00,0.00,0.25,0,10.00,1,258.64,0,2,0,java.lang.Object,0.00,0,0,4,0,0,2,0,7,74,1
"org.apache.jackrabbit.core.journal.MemoryJournal$MemoryRecordIterator",4,0.17,1.25,19,0.22,5415.73,6,2,11,13,4,105.96,22,30,0,1,123.83,0.00,0.00,0.38,0,4.00,2,663.36,0,1,4,java.lang.Object,0.00,9,0,5,0,9,3,1,7,141,1
"org.apache.jackrabbit.core.journal.MemoryRevision",3,1.00,1.00,7,0.05,455.14,4,1,0,3,3,124.72,16,11,1,1,142.60,0.00,0.00,0.33,0,4.00,1,138.48,0,0,2,java.lang.Object,0.00,0,0,3,0,0,3,1,6,41,1
"org.apache.jackrabbit.core.journal.OracleDatabaseJournal",5,0.38,1.20,20,0.19,3828.42,7,2,4,10,4,126.02,22,31,0,3,125.79,0.00,0.67,0.20,0,7.00,2,562.63,4,3,4,org.apache.jackrabbit.core.journal.DatabaseJournal,0.04,5,2,6,0,5,2,0,7,138,1
"org.apache.jackrabbit.core.journal.ReadRecord",24,0.02,1.54,104,0.90,22199.41,30,6,5,35,9,164.97,69,152,4,2,125.08,0.00,0.50,0.15,2,144.00,4,2687.85,0,3,5,org.apache.jackrabbit.core.journal.AbstractRecord,0.00,11,1,37,0,11,21,0,21,625,1
"org.apache.jackrabbit.core.journal.Record",31,0.00,1.00,32,0.20,950.73,31,0,5,31,27,141.42,184,33,21,1,159.29,0.00,0.00,0.00,0,31.00,1,606.40,0,9,6,,0.00,0,0,31,0,0,22,0,32,217,1
"org.apache.jackrabbit.core.journal.RecordConsumer",4,0.00,1.00,5,0.02,62.02,4,0,0,4,4,129.40,24,6,3,1,161.63,0.00,0.00,0.00,0,4.00,1,57.02,0,1,1,,0.00,0,0,4,0,0,3,0,5,25,1
"org.apache.jackrabbit.core.journal.RecordIterator",3,0.00,1.00,4,0.02,60.48,3,0,1,3,11,118.44,21,5,9,1,160.73,0.00,0.00,0.00,0,3.00,1,45.65,0,0,2,,0.00,0,0,3,0,0,3,0,4,20,1
"org.apache.jackrabbit.core.journal.RecordProducer",1,0.00,1.00,2,0.01,38.26,1,0,0,1,6,103.18,11,3,4,1,147.31,0.00,0.00,0.00,0,1.00,1,25.51,0,0,2,,0.00,0,0,1,0,0,1,0,2,11,1
"org.apache.jackrabbit.core.journal.RotatingLogFile",6,0.20,2.33,51,0.71,32356.21,12,6,7,28,3,57.73,54,72,3,1,107.73,0.00,0.00,0.33,1,6.00,7,2142.26,0,2,0,java.lang.Object,0.00,22,0,14,0,22,4,1,13,419,1
"org.apache.jackrabbit.core.journal.RotatingLogFile$Comparator<RotatingLogFile>",1,0.00,1.00,3,0.03,307.25,1,0,7,2,1,133.61,0,4,0,1,133.61,0.00,0.00,0.00,0,1.00,1,77.01,0,0,1,java.lang.Object,0.00,1,0,1,0,1,1,0,0,23,0
"org.apache.jackrabbit.core.journal.RotatingLogFile$FilenameFilter",1,0.00,1.00,3,0.03,292.00,1,0,7,2,0,133.79,0,4,0,1,133.79,0.00,0.00,0.00,0,0.00,1,80.00,0,0,0,java.lang.Object,0.00,1,0,1,0,1,1,0,0,22,0
"org.apache.jackrabbit.core.journal.TestAll",1,0.00,1.00,6,0.05,1311.02,1,0,3,3,2,79.86,12,8,0,2,117.42,0.00,0.50,0.00,0,1.00,1,143.51,0,1,2,junit.framework.TestCase,0.00,2,1,1,0,2,0,0,2,38,1
"org.apache.jackrabbit.servlet.jackrabbit.JackrabbitRepositoryServlet",4,0.17,2.25,35,0.44,16611.67,6,2,12,21,5,98.28,60,59,1,3,108.63,0.00,0.67,0.38,1,0.00,4,1323.38,3,1,4,org.apache.jackrabbit.servlet.AbstractRepositoryServlet,0.90,17,2,9,0,17,3,0,7,260,1
"org.apache.jackrabbit.spi.BatchReadConfig",1,0.00,1.00,2,0.02,88.11,1,0,3,1,6,134.10,15,3,4,1,144.45,0.00,0.00,0.00,0,1.00,1,46.05,0,0,2,,0.00,0,0,1,0,0,1,0,2,15,1
"org.apache.jackrabbit.spi.BatchTest",32,0.71,1.72,491,9.07,300330.80,36,4,30,103,19,95.72,9,570,1,3,95.72,0.00,0.67,0.94,3,0.00,5,27209.23,2,3,18,org.apache.jackrabbit.spi.AbstractSPITest,0.17,71,2,55,0,71,29,0,7,4788,1
"org.apache.jackrabbit.spi.BatchTest$AbstractNamespaceResolver",2,0.00,2.00,5,0.05,880.08,2,0,30,3,0,138.79,0,7,0,1,138.79,0.00,0.00,0.00,0,2.00,2,152.68,0,2,0,java.lang.Object,0.00,1,0,4,0,1,0,0,0,42,0
"org.apache.jackrabbit.spi.BinaryPart",3,0.00,1.67,18,0.21,6024.21,3,0,5,10,2,155.73,7,25,1,2,115.85,0.00,0.50,0.00,0,3.00,2,631.25,0,0,1,org.apache.commons.httpclient.methods.multipart.FilePart,0.00,7,1,5,0,7,3,0,1,142,0
"org.apache.jackrabbit.spi.BinaryPartSource",5,0.25,1.60,17,0.14,2388.90,6,1,5,12,4,132.00,3,28,2,1,132.00,0.00,0.00,0.80,0,0.00,2,431.59,0,2,2,java.lang.Object,0.00,7,0,8,0,7,3,1,1,113,1
"org.apache.jackrabbit.spi.ChildInfoImpl",7,0.25,2.14,42,0.47,18778.25,11,4,3,16,5,96.93,38,58,2,1,114.80,0.00,0.00,0.46,0,0.00,4,1414.11,0,3,3,java.lang.Object,0.00,9,0,15,0,9,4,1,13,313,1
"org.apache.jackrabbit.spi.CloneTest",4,0.78,2.75,47,0.67,21415.20,10,6,15,28,13,152.56,5,63,1,3,102.56,0.00,0.67,0.75,1,0.00,6,2008.31,2,1,12,org.apache.jackrabbit.spi.AbstractSPITest,0.86,24,2,11,0,24,3,0,3,388,1
"org.apache.jackrabbit.spi.CloneTest$AbstractNamespaceResolver",2,0.00,2.00,5,0.06,1092.00,2,0,15,3,0,138.06,0,7,0,1,138.06,0.00,0.00,0.00,0,2.00,2,176.00,0,2,0,java.lang.Object,0.00,1,0,4,0,1,0,0,0,46,0
"org.apache.jackrabbit.spi.ConnectionTest",2,0.50,1.00,13,0.13,2250.65,4,2,10,11,8,167.95,3,19,1,3,117.95,0.00,0.67,0.75,0,0.00,1,404.42,1,0,7,org.apache.jackrabbit.spi.AbstractSPITest,0.60,9,2,2,0,9,2,0,1,92,1
"org.apache.jackrabbit.spi.ConnectionTest$AbstractNamespaceResolver",2,0.00,2.00,5,0.05,880.08,2,0,10,3,0,138.79,0,7,0,1,138.79,0.00,0.00,0.00,0,2.00,2,152.68,0,2,0,java.lang.Object,0.00,1,0,4,0,1,0,0,0,42,0
"org.apache.jackrabbit.spi.CopyTest",5,0.67,2.80,64,0.95,33576.25,11,6,14,29,13,150.37,5,84,1,3,100.37,0.00,0.67,0.70,1,0.00,6,2842.87,2,1,12,org.apache.jackrabbit.spi.AbstractSPITest,0.75,24,2,14,0,24,4,0,3,534,1
"org.apache.jackrabbit.spi.CopyTest$AbstractNamespaceResolver",2,0.00,2.00,5,0.05,880.08,2,0,14,3,0,138.79,0,7,0,1,138.79,0.00,0.00,0.00,0,2.00,2,152.68,0,2,0,java.lang.Object,0.00,1,0,4,0,1,0,0,0,42,0
"org.apache.jackrabbit.spi.CreateFileTest",7,0.50,1.14,63,1.08,27022.21,14,7,22,33,16,107.13,3,78,1,3,107.13,0.00,0.67,0.57,2,0.00,2,3248.33,2,1,15,org.apache.jackrabbit.spi.AbstractSPITest,0.60,26,2,8,0,26,6,0,1,610,1
"org.apache.jackrabbit.spi.CreateFileTest$AbstractNamespaceResolver",2,0.00,2.00,5,0.05,880.08,2,0,22,3,0,138.79,0,7,0,1,138.79,0.00,0.00,0.00,0,2.00,2,152.68,0,2,0,java.lang.Object,0.00,1,0,4,0,1,0,0,0,42,0
"org.apache.jackrabbit.spi.ExtensionTest",12,0.20,1.25,64,0.80,16606.26,16,4,17,35,15,120.14,7,84,1,3,120.14,0.00,0.67,0.44,4,0.00,3,2395.29,2,1,14,org.apache.jackrabbit.spi.AbstractSPITest,0.40,23,2,15,0,23,11,0,5,505,1
"org.apache.jackrabbit.spi.ExtensionTest$AbstractNamespaceResolver",2,0.00,2.00,5,0.05,880.08,2,0,17,3,0,138.79,0,7,0,1,138.79,0.00,0.00,0.00,0,2.00,2,152.68,0,2,0,java.lang.Object,0.00,1,0,4,0,1,0,0,0,42,0
"org.apache.jackrabbit.spi.GetMethod",3,1.00,1.00,8,0.07,1002.03,4,1,5,4,4,189.90,3,14,1,3,139.90,0.00,0.67,0.00,0,3.00,1,217.25,0,1,3,org.apache.jackrabbit.webdav.client.methods.DavMethodBase,0.29,1,2,3,0,1,2,0,1,59,0
"org.apache.jackrabbit.spi.ItemInfoImpl",4,0.17,1.25,14,0.10,2052.58,6,2,5,7,5,99.59,26,20,2,1,131.81,0.00,0.00,0.38,0,6.00,2,312.83,0,2,3,java.lang.Object,0.00,3,0,5,2,3,2,2,7,83,2
"org.apache.jackrabbit.spi.ItemInfoJsonHandler",15,0.20,3.20,174,2.56,95885.39,31,16,25,81,20,122.53,53,237,1,1,101.92,0.00,0.00,0.25,4,2.00,7,7677.29,0,4,19,java.lang.Object,0.00,66,0,48,0,66,11,1,30,1399,0
"org.apache.jackrabbit.spi.NodeInfoImpl",13,0.03,1.77,61,0.70,23184.56,18,5,14,36,13,172.81,13,77,2,2,122.81,0.00,0.50,0.23,0,67.00,8,2090.16,1,7,11,org.apache.jackrabbit.spi2davex.ItemInfoImpl,0.00,23,1,23,0,23,6,1,5,440,1
"org.apache.jackrabbit.spi.PostMethod",7,0.06,1.43,35,0.42,9426.41,10,3,12,22,5,140.82,24,58,2,3,120.20,0.00,0.67,0.29,0,11.00,2,1258.11,3,2,3,org.apache.jackrabbit.webdav.client.methods.DavMethodBase,0.24,15,2,10,0,15,5,0,14,279,0
"org.apache.jackrabbit.spi.PropertyInfoImpl",8,0.04,1.38,34,0.30,5390.09,12,4,6,10,7,126.19,7,47,2,2,126.19,0.00,0.50,0.28,0,26.00,3,899.54,0,2,5,org.apache.jackrabbit.spi2davex.ItemInfoImpl,0.00,2,1,11,0,2,6,1,5,214,1
"org.apache.jackrabbit.spi.QValueFactoryImpl",4,0.11,1.25,18,0.20,3672.69,7,3,37,9,17,77.05,32,23,2,3,125.16,0.00,0.67,0.25,0,6.00,2,614.32,0,1,15,org.apache.jackrabbit.spi.commons.value.QValueFactoryImpl,0.14,5,2,5,0,5,3,0,7,139,0
"org.apache.jackrabbit.spi.QValueFactoryImpl$BinaryQValue",19,0.07,3.53,190,2.37,139335.30,29,10,37,63,9,60.68,143,265,0,2,102.97,0.00,0.50,0.16,7,73.00,15,7115.68,1,4,9,org.apache.jackrabbit.spi.commons.value.AbstractQValue,0.27,44,1,67,0,44,15,1,61,1369,1
"org.apache.jackrabbit.spi.QValueFactoryImpl$Serializable",0,0.00,0.00,2,0.02,233.13,1,1,37,0,0,171.00,0,2,0,1,171.00,0.00,0.00,0.00,0,0.00,0,51.81,0,0,0,java.lang.Object,0.00,0,0,0,0,0,0,0,0,14,0
"org.apache.jackrabbit.spi.ReadTest",9,0.50,1.56,51,0.60,10895.77,13,4,15,27,13,120.55,8,75,1,3,120.55,0.00,0.67,0.69,2,0.00,2,1789.77,2,2,12,org.apache.jackrabbit.spi.AbstractSPITest,0.50,18,2,14,0,18,7,0,6,381,1
"org.apache.jackrabbit.spi.ReadTest$AbstractNamespaceResolver",2,0.00,2.00,5,0.05,880.08,2,0,15,3,0,138.79,0,7,0,1,138.79,0.00,0.00,0.00,0,2.00,2,152.68,0,2,0,java.lang.Object,0.00,1,0,4,0,1,0,0,0,42,0
"org.apache.jackrabbit.spi.RepositoryServiceImpl",18,0.03,2.56,178,2.92,136602.31,33,15,48,83,39,144.52,52,244,3,2,104.63,0.00,0.50,0.04,5,158.00,7,8756.23,9,10,36,org.apache.jackrabbit.spi2dav.RepositoryServiceImpl,0.00,65,1,46,0,65,8,0,22,1575,1
"org.apache.jackrabbit.spi.RepositoryServiceImpl$BatchImpl",26,0.04,2.54,240,3.18,105872.18,34,8,48,96,23,127.38,87,295,0,1,106.76,0.00,0.00,0.16,9,142.00,7,9546.88,0,3,23,java.lang.Object,0.00,70,0,66,0,70,23,1,43,1836,1
"org.apache.jackrabbit.spi.RepositoryServiceImpl$BatchReadConfig",1,0.00,1.00,3,0.02,119.55,1,0,48,1,2,136.84,0,4,0,1,136.84,0.00,0.00,0.00,0,1.00,1,51.02,0,0,2,java.lang.Object,0.00,0,0,1,0,0,1,0,0,16,0
"org.apache.jackrabbit.spi.RepositoryStubImpl",2,1.00,1.00,7,0.08,1492.99,3,1,8,5,6,130.81,9,11,0,3,130.58,0.00,0.67,0.00,0,2.00,1,251.24,0,1,6,org.apache.jackrabbit.spi2dav.RepositoryStubImpl,0.00,3,2,2,0,3,1,0,3,62,1
"org.apache.jackrabbit.spi.RepositoryStubImpl$BatchReadConfig",1,0.00,1.00,3,0.02,171.91,1,0,8,1,2,135.60,0,4,0,1,135.60,0.00,0.00,0.00,0,1.00,1,61.30,0,0,2,java.lang.Object,0.00,0,0,1,0,0,1,0,0,18,0
"org.apache.jackrabbit.spi.ServiceStubImpl",2,0.33,1.50,11,0.12,2404.69,5,3,7,5,6,141.19,6,16,0,3,120.58,0.00,0.67,0.17,0,2.00,2,372.20,1,1,6,org.apache.jackrabbit.spi2dav.ServiceStubImpl,0.25,3,2,3,0,3,1,0,2,85,1
"org.apache.jackrabbit.spi.ServiceStubImpl$BatchReadConfig",1,0.00,3.00,7,0.06,1159.41,1,0,7,3,2,165.09,1,11,0,1,115.09,0.00,0.00,0.00,0,0.00,3,193.44,0,0,2,java.lang.Object,0.00,2,0,3,0,2,1,0,1,43,0
"org.apache.jackrabbit.spi.Spi2davexRepositoryServiceFactory",1,0.00,10.00,24,0.34,21149.66,5,4,6,7,7,134.92,25,37,1,1,84.92,0.00,0.00,1.00,0,0.00,10,1009.46,0,1,6,java.lang.Object,0.00,6,0,10,0,6,0,1,6,189,1
"org.apache.jackrabbit.spi.StringPart",2,0.00,1.00,8,0.10,1430.07,2,0,5,5,1,146.68,7,12,1,2,126.06,0.00,0.50,0.00,0,2.00,1,297.80,0,0,0,org.apache.commons.httpclient.methods.multipart.StringPart,0.00,3,1,2,0,3,2,0,1,76,0
"org.apache.jackrabbit.spi.TestAll",1,0.00,1.00,12,0.15,4357.64,1,0,3,5,8,141.97,2,14,0,2,102.09,0.00,0.50,0.00,0,1.00,1,448.17,0,1,8,junit.framework.TestCase,0.00,4,1,1,0,4,0,0,2,96,1
"org.apache.jackrabbit.spi.ValueLoader",4,0.33,3.00,48,0.72,32800.43,5,1,21,33,14,149.67,7,66,3,1,99.67,0.00,0.00,0.75,0,0.00,6,2163.58,0,1,11,java.lang.Object,0.00,29,0,12,0,29,3,0,3,385,0
"org.apache.jackrabbit.spi.ValueLoader$Target",2,0.00,1.00,3,0.01,50.34,2,0,21,2,0,160.20,8,4,0,1,159.97,0.00,0.00,0.00,0,2.00,1,38.34,0,0,0,,0.00,0,0,2,0,0,2,0,2,16,0
"org.apache.jackrabbit.jcr.ReadPerformanceTest",13,0.01,1.92,113,1.51,64189.22,24,11,31,49,13,108.31,55,140,0,3,108.08,0.00,0.67,0.08,4,78.00,6,4538.53,1,8,13,org.apache.jackrabbit.jcr2spi.AbstractJCR2SPITest,0.03,36,2,25,0,36,5,0,18,854,1
"org.apache.jackrabbit.jcr.ReadPerformanceTest$Callable<Long>",2,0.00,1.50,11,0.17,5341.56,2,0,31,5,0,117.85,0,16,0,1,117.85,0.00,0.00,0.00,0,2.00,2,509.42,0,2,0,java.lang.Object,0.00,3,0,3,0,3,0,0,0,105,0
"org.apache.jackrabbit.jcr.ReadPerformanceTest$Callable<Long>_0",2,0.00,1.00,10,0.12,1985.23,2,0,31,5,0,121.33,0,13,0,1,121.33,0.00,0.00,0.00,0,2.00,1,345.70,0,2,0,java.lang.Object,0.00,3,0,2,0,3,0,0,0,77,0
"org.apache.jackrabbit.jcr.ReadPerformanceTest$Callable<Long>_1",2,0.00,1.00,10,0.12,1985.23,2,0,31,5,0,121.33,0,13,0,1,121.33,0.00,0.00,0.00,0,2.00,1,345.70,0,2,0,java.lang.Object,0.00,3,0,2,0,3,0,0,0,77,0
"org.apache.jackrabbit.jcr.ReadPerformanceTest$Callable<Long>_2",2,0.00,1.50,11,0.12,2441.28,2,0,31,7,0,120.53,0,15,0,1,120.53,0.00,0.00,0.00,0,2.00,2,362.25,0,2,0,java.lang.Object,0.00,5,0,3,0,5,0,0,0,81,0
"org.apache.jackrabbit.jcr.ReadPerformanceTest$Predicate<ItemInfo>",1,0.00,1.00,3,0.03,267.91,1,0,31,1,1,134.08,0,4,0,1,134.08,0.00,0.00,0.00,0,0.00,1,82.16,0,0,1,java.lang.Object,0.00,0,0,1,0,0,1,0,0,23,0
"org.apache.jackrabbit.jcr.ChildNodeAttic",11,0.30,2.27,52,0.43,9082.49,13,2,8,25,3,175.38,17,72,1,1,125.38,0.00,0.00,0.23,0,16.00,4,1285.15,0,4,3,java.lang.Object,0.00,14,0,25,0,14,7,0,6,307,0
"org.apache.jackrabbit.jcr.ChildNodeEntries",12,0.00,1.00,13,0.09,349.12,12,0,7,12,5,111.37,106,14,2,1,159.47,0.00,0.00,0.00,0,12.00,1,262.11,0,2,3,,0.00,0,0,12,0,0,10,0,13,94,1
"org.apache.jackrabbit.jcr.ChildNodeEntriesImpl",20,0.10,3.25,183,2.34,98293.28,26,6,20,64,10,57.96,178,231,2,1,106.06,0.00,0.00,0.26,6,6.00,9,7009.38,0,10,8,java.lang.Object,0.00,44,0,65,0,44,10,1,65,1400,1
"org.apache.jackrabbit.jcr.ChildNodeEntriesImpl$LinkedEntries",10,0.00,1.60,50,0.47,12259.45,10,0,20,19,2,88.28,67,66,0,2,120.50,0.00,0.50,0.00,1,10.00,3,1400.25,0,6,2,org.apache.commons.collections.list.AbstractLinkedList,0.00,9,1,16,0,9,4,0,15,334,2
"org.apache.jackrabbit.jcr.ChildNodeEntriesImpl$LinkedEntries$LinkNode",8,0.71,1.50,31,0.32,11203.93,9,1,20,13,3,168.22,16,44,0,2,128.33,0.00,0.50,0.38,1,14.00,4,946.21,4,4,3,Node,0.00,5,1,12,0,5,4,0,8,221,2
"org.apache.jackrabbit.jcr.ChildNodeEntriesImpl$LinkedEntries$LinkNodeIterator",4,0.17,1.50,18,0.15,3252.60,6,2,20,9,0,125.53,0,25,0,1,125.53,0.00,0.00,0.38,1,6.00,2,460.27,0,1,0,java.lang.Object,0.00,5,0,6,0,5,3,1,0,114,1
"org.apache.jackrabbit.jcr.ChildNodeEntriesImpl$LinkedEntries$NameMap",10,0.11,3.60,105,1.42,65275.13,12,2,20,33,3,103.60,49,135,0,1,103.36,0.00,0.00,0.60,3,0.00,7,4245.81,0,7,3,java.lang.Object,0.00,23,0,36,0,23,3,0,25,844,2
"org.apache.jackrabbit.jcr.ChildPropertyEntries",7,0.00,1.00,8,0.06,332.96,7,0,2,7,4,125.57,45,9,2,1,157.79,0.00,0.00,0.00,0,7.00,1,167.83,0,2,2,,0.00,0,0,7,0,0,5,0,8,58,1
"org.apache.jackrabbit.jcr.ChildPropertyEntriesImpl",8,0.00,1.62,46,0.48,11948.63,12,4,11,23,6,140.43,26,61,1,1,119.82,0.00,0.00,0.25,2,0.00,3,1448.20,0,2,5,java.lang.Object,0.00,15,0,13,0,15,6,1,10,325,1
"org.apache.jackrabbit.jcr.EntryFactory",12,0.05,1.25,46,0.39,6720.86,19,7,7,21,15,152.12,47,63,6,1,131.51,0.00,0.00,0.10,0,88.00,2,1169.85,0,5,11,java.lang.Object,0.00,9,0,15,0,9,7,0,17,287,1
"org.apache.jackrabbit.jcr.EntryFactory$InvalidationStrategy",2,0.00,1.00,3,0.02,84.27,2,0,7,2,1,110.10,17,4,0,1,158.21,0.00,0.00,0.00,0,2.00,1,56.18,0,0,1,,0.00,0,0,2,0,0,2,0,2,20,1
"org.apache.jackrabbit.jcr.EntryFactory$NodeEntryListener",2,0.00,1.00,3,0.02,84.27,2,0,7,2,1,158.21,0,4,0,1,158.21,0.00,0.00,0.00,0,2.00,1,56.18,0,0,1,,0.00,0,0,2,0,0,2,0,0,20,1
"org.apache.jackrabbit.jcr.EntryValidation",4,1.00,3.50,33,0.32,9460.13,5,1,6,12,4,72.89,48,50,1,1,110.46,0.00,0.00,0.00,0,4.00,5,973.87,0,0,3,java.lang.Object,0.00,8,0,14,0,8,4,0,16,215,1
"org.apache.jackrabbit.jcr.HierarchyEntry",17,0.00,1.00,18,0.10,510.71,17,0,9,17,25,117.07,119,19,20,1,159.36,0.00,0.00,0.00,0,17.00,1,295.32,0,4,7,,0.00,0,0,17,0,0,13,0,18,111,1
"org.apache.jackrabbit.jcr.HierarchyEntryImpl",26,0.07,2.15,152,1.64,54489.57,32,6,17,58,17,86.37,175,214,4,1,118.60,0.00,0.00,0.10,11,294.00,6,4926.22,0,12,14,java.lang.Object,0.00,32,0,56,2,32,14,1,70,1018,1
"org.apache.jackrabbit.jcr.HierarchyEntryImpl$LazyInvalidation",3,0.75,4.00,35,0.31,8860.68,7,4,17,4,2,75.13,40,49,0,1,104.51,0.00,0.00,0.75,1,0.00,4,933.15,0,0,2,java.lang.Object,0.00,1,0,12,0,1,3,1,11,203,1
"org.apache.jackrabbit.jcr.HierarchyEventListener",5,0.00,5.20,86,1.28,113883.65,8,3,19,35,12,46.28,58,110,1,1,90.41,0.00,0.00,0.33,2,5.00,17,3848.19,0,2,12,java.lang.Object,0.00,30,0,26,0,30,3,1,29,652,1
"org.apache.jackrabbit.jcr.HierarchyManager",12,0.00,1.00,13,0.12,656.89,12,0,9,12,22,109.21,107,14,13,1,157.31,0.00,0.00,0.00,0,12.00,1,346.08,0,6,9,,0.00,0,0,12,0,0,6,0,13,110,1
"org.apache.jackrabbit.jcr.HierarchyManagerImpl",14,0.08,2.36,107,1.14,33890.81,19,5,16,47,20,133.25,45,148,2,1,112.63,0.00,0.00,0.27,3,42.00,4,3432.70,0,6,18,java.lang.Object,0.00,33,0,33,0,33,8,1,18,728,1
"org.apache.jackrabbit.jcr.NodeEntry",29,0.00,1.00,30,0.32,2072.41,29,0,17,29,61,108.29,253,31,52,2,156.40,0.00,0.50,0.00,0,29.00,1,955.12,0,19,11,,0.00,0,1,29,0,0,10,0,30,288,1
"org.apache.jackrabbit.jcr.NodeEntryImpl",72,0.03,3.58,752,10.14,469574.65,79,7,45,268,42,71.15,489,971,6,2,103.37,0.00,0.50,0.11,23,2050.00,15,30428.04,12,24,40,org.apache.jackrabbit.jcr2spi.hierarchy.HierarchyEntryImpl,0.16,196,1,258,0,196,48,1,238,5662,1
"org.apache.jackrabbit.jcr.NodeEntryImpl$RevertInfo",3,0.00,2.00,24,0.29,5116.14,8,5,45,9,4,111.70,1,32,0,1,111.70,0.00,0.00,0.20,0,5.00,4,861.34,0,0,4,java.lang.Object,0.00,6,0,6,0,6,3,0,1,186,1
"org.apache.jackrabbit.jcr.PropertyEntry",3,0.00,1.00,4,0.03,175.02,3,0,5,3,30,114.80,22,5,29,2,157.09,0.00,0.50,0.00,0,3.00,1,87.51,0,3,2,,0.00,0,1,3,0,0,0,0,4,30,1
"org.apache.jackrabbit.jcr.PropertyEntryImpl",9,0.00,1.56,32,0.37,9959.49,9,0,11,19,13,111.26,53,50,3,2,129.13,0.00,0.50,0.00,1,18.00,6,1120.39,4,5,12,org.apache.jackrabbit.jcr2spi.hierarchy.HierarchyEntryImpl,0.11,10,1,14,0,10,4,1,19,256,1
"org.apache.jackrabbit.jcr.UniqueIdResolver",10,0.04,3.00,73,0.86,23320.09,13,3,13,37,9,94.83,52,108,1,1,112.70,0.00,0.00,0.37,2,0.00,6,2582.42,0,2,8,java.lang.Object,0.00,27,0,30,0,27,8,2,26,548,1
"org.apache.jackrabbit.core.query.lucene.join.AbstractCondition",4,0.67,1.00,10,0.09,1072.60,5,1,4,8,11,98.36,31,15,8,1,140.65,0.00,0.00,0.50,0,4.00,1,265.94,0,1,3,java.lang.Object,0.00,4,0,4,8,4,3,1,6,73,2
"org.apache.jackrabbit.core.query.lucene.join.AncestorNodeJoin",3,0.40,2.67,32,0.39,12355.37,8,5,8,11,7,84.86,42,42,1,2,105.01,0.00,0.50,0.47,1,0.00,4,1182.63,1,1,6,org.apache.jackrabbit.core.query.lucene.join.AbstractCondition,0.00,8,1,8,0,8,2,0,10,239,1
"org.apache.jackrabbit.core.query.lucene.join.AncestorPathNodeJoin",2,0.67,2.50,21,0.29,7379.15,5,3,8,12,9,95.04,30,33,1,2,105.40,0.00,0.50,0.67,0,0.00,3,862.09,1,1,8,org.apache.jackrabbit.core.query.lucene.join.AbstractCondition,0.00,10,1,5,0,10,1,0,8,173,1
"org.apache.jackrabbit.core.query.lucene.join.ChildNodeJoin",2,0.80,3.50,29,0.38,11453.63,7,5,8,13,7,97.89,33,39,1,2,98.37,0.00,0.50,0.60,0,0.00,5,1138.39,1,1,6,org.apache.jackrabbit.core.query.lucene.join.AbstractCondition,0.00,11,1,7,0,11,1,0,8,224,1
"org.apache.jackrabbit.core.query.lucene.join.Condition",3,0.00,1.00,4,0.03,191.29,3,0,3,3,5,124.57,19,6,3,1,156.79,0.00,0.00,0.00,0,3.00,1,78.03,0,2,2,,0.00,0,0,3,0,0,1,0,4,28,1
"org.apache.jackrabbit.core.query.lucene.join.DescendantNodeJoin",3,0.42,3.67,41,0.51,17485.38,9,6,8,14,7,79.35,44,53,1,2,99.50,0.00,0.50,0.44,1,0.00,5,1540.50,1,1,6,org.apache.jackrabbit.core.query.lucene.join.AbstractCondition,0.00,11,1,11,0,11,2,0,11,307,1
"org.apache.jackrabbit.core.query.lucene.join.DescendantPathNodeJoin",2,0.50,2.50,20,0.28,7767.12,4,2,8,12,9,85.08,28,32,1,2,105.22,0.00,0.50,0.75,0,0.00,3,836.08,1,1,8,org.apache.jackrabbit.core.query.lucene.join.AbstractCondition,0.00,10,1,5,0,10,1,0,7,165,1
"org.apache.jackrabbit.core.query.lucene.join.EquiJoin",3,0.50,5.33,62,1.21,74961.38,6,3,17,35,8,37.45,28,89,1,2,87.45,0.00,0.50,0.67,0,0.00,10,3622.59,0,2,7,org.apache.jackrabbit.core.query.lucene.join.AbstractCondition,0.00,32,1,16,0,32,1,0,9,630,1
"org.apache.jackrabbit.core.query.lucene.join.Join",9,0.04,2.67,75,1.00,61224.66,16,7,19,28,18,56.91,83,114,3,1,106.91,0.00,0.00,0.17,1,25.00,6,3001.03,0,4,15,java.lang.Object,0.00,19,0,24,0,19,5,1,23,613,1
"org.apache.jackrabbit.core.query.lucene.join.Join$DefaultQOMTreeVisitor",4,0.89,2.50,74,1.23,64087.13,7,3,19,28,18,140.85,7,99,0,1,90.85,0.00,0.00,1.00,0,0.00,4,3687.10,0,4,18,java.lang.Object,0.00,24,0,10,0,24,0,0,7,668,0
"org.apache.jackrabbit.core.query.lucene.join.ParentNodeJoin",2,0.50,2.00,16,0.22,6198.59,4,2,6,8,7,65.53,22,25,1,2,109.66,0.00,0.50,0.75,0,0.00,3,649.65,1,1,6,org.apache.jackrabbit.core.query.lucene.join.AbstractCondition,0.00,6,1,4,0,6,1,0,5,133,1
"org.apache.jackrabbit.core.query.lucene.join.SameNodeJoin",2,0.50,1.50,12,0.16,3197.01,4,2,5,6,6,68.17,21,19,1,2,116.65,0.00,0.50,0.75,0,0.00,2,465.51,1,1,5,org.apache.jackrabbit.core.query.lucene.join.AbstractCondition,0.00,4,1,3,0,4,1,0,5,103,1
"org.apache.jackrabbit.core.query.lucene.join.ScoreNodeMap",2,0.00,3.00,24,0.30,16394.53,3,1,5,9,8,117.81,36,29,7,1,99.67,0.00,0.00,1.00,0,0.00,3,914.88,0,1,1,java.lang.Object,0.00,7,0,6,0,7,1,0,6,194,2
"org.apache.jackrabbit.commons.flat.BTreeManager",21,0.06,2.24,141,1.83,88298.88,28,7,13,61,10,81.03,144,180,3,1,113.25,0.00,0.00,0.08,8,149.00,10,5504.12,0,8,7,java.lang.Object,0.00,40,0,47,0,40,13,1,21,1088,1
"org.apache.jackrabbit.commons.flat.BTreeManager$Comparator<Item>",1,0.00,2.00,5,0.07,1386.96,1,0,13,4,1,120.02,0,9,0,1,120.02,0.00,0.00,0.00,0,1.00,2,198.03,0,0,1,java.lang.Object,0.00,3,0,2,0,3,1,0,0,47,0
"org.apache.jackrabbit.commons.flat.BTreeManager$Predicate",1,0.00,2.00,6,0.05,987.50,1,0,13,2,0,118.23,0,10,0,1,118.23,0.00,0.00,0.00,0,0.00,2,164.08,0,0,0,java.lang.Object,0.00,1,0,2,0,1,1,0,0,39,0
"org.apache.jackrabbit.commons.flat.BTreeManager$SizedIterator<T>",4,0.00,1.00,9,0.05,488.08,4,0,13,7,0,143.34,0,13,0,1,143.34,0.00,0.00,0.00,0,4.00,1,143.39,0,0,0,java.lang.Object,0.00,3,0,4,0,3,4,0,0,47,0
"org.apache.jackrabbit.commons.flat.BTreeManager$WrappedRepositoryException",2,1.00,1.00,7,0.04,429.84,3,1,13,2,0,134.84,0,10,0,2,134.84,0.00,0.50,0.50,0,2.00,1,121.21,0,1,0,java.lang.RuntimeException,0.00,0,1,2,0,0,1,0,0,36,2
"org.apache.jackrabbit.commons.flat.FilterIterator",4,0.00,1.75,23,0.19,4842.06,7,3,3,8,3,141.14,14,32,2,1,120.52,0.00,0.00,0.33,1,4.00,3,573.56,0,0,1,java.lang.Object,0.00,4,0,7,0,4,4,1,3,140,1
"org.apache.jackrabbit.commons.flat.ItemSequence",14,0.02,2.29,91,1.17,44201.12,19,5,13,37,8,76.66,170,124,6,1,114.23,0.00,0.00,0.19,1,46.00,5,3497.82,0,6,3,java.lang.Object,0.00,23,0,32,2,23,8,0,30,721,2
"org.apache.jackrabbit.commons.flat.ItemSequence$NodeSequenceImpl",8,0.00,2.00,48,0.56,18429.39,8,0,13,28,4,115.34,0,67,0,2,115.34,0.00,0.50,0.00,2,14.00,5,1665.51,4,5,4,org.apache.jackrabbit.commons.flat.ItemSequence,0.00,20,1,16,0,20,3,1,0,359,2
"org.apache.jackrabbit.commons.flat.ItemSequence$NodeSequenceImpl$InclusionPolicy<Node>",1,0.00,2.00,5,0.04,485.12,1,0,13,1,0,123.62,0,9,0,1,123.62,0.00,0.00,0.00,0,0.00,2,117.75,0,0,0,java.lang.Object,0.00,0,0,2,0,0,1,0,0,31,0
"org.apache.jackrabbit.commons.flat.ItemSequence$NodeSequenceImpl$PropertySequenceImpl",8,0.00,1.62,37,0.41,8510.25,8,0,13,24,4,124.59,0,53,0,2,124.59,0.00,0.50,0.00,2,20.00,3,1215.52,4,5,4,org.apache.jackrabbit.commons.flat.ItemSequence,0.00,16,1,13,0,16,3,1,0,276,2
"org.apache.jackrabbit.commons.flat.ItemSequence$NodeSequenceImpl$PropertySequenceImpl$InclusionPolicy<Property>",1,0.00,2.00,6,0.07,1017.95,2,1,13,3,0,118.13,0,10,0,1,118.13,0.00,0.00,1.00,0,0.00,2,204.78,0,0,0,java.lang.Object,0.00,2,0,2,0,2,1,0,0,49,0
"org.apache.jackrabbit.commons.flat.NodeSequence",2,0.00,1.00,3,0.03,186.57,2,0,2,2,3,105.49,19,4,3,1,155.49,0.00,0.00,0.00,0,2.00,1,87.40,0,1,0,,0.00,0,0,2,0,0,1,0,3,28,1
"org.apache.jackrabbit.commons.flat.PropertySequence",2,0.00,1.00,3,0.03,180.93,2,0,3,2,9,105.59,19,4,9,1,155.59,0.00,0.00,0.00,0,2.00,1,88.92,0,1,0,,0.00,0,0,2,0,0,1,0,3,28,1
"org.apache.jackrabbit.commons.flat.Rank",14,0.18,2.29,78,1.15,70028.32,17,3,9,28,5,67.50,119,104,5,1,115.61,0.00,0.00,0.17,3,46.00,10,3451.17,0,6,0,java.lang.Object,0.00,14,0,32,0,14,8,0,23,736,1
"org.apache.jackrabbit.commons.flat.Rank$Comparator<T>",1,0.00,1.00,3,0.03,307.25,1,0,9,2,0,133.61,0,4,0,1,133.61,0.00,0.00,0.00,0,1.00,1,77.01,0,0,0,java.lang.Object,0.00,1,0,1,0,1,1,0,0,23,0
"org.apache.jackrabbit.commons.flat.RankTest",10,0.78,2.70,110,1.60,57812.62,11,1,12,44,1,102.30,1,124,0,2,102.30,0.00,0.50,0.30,4,22.00,4,4786.65,0,1,1,junit.framework.TestCase,0.00,34,1,27,0,34,9,0,1,925,1
"org.apache.jackrabbit.commons.flat.Sequence",3,0.00,1.00,4,0.04,319.24,3,0,6,3,0,106.56,31,6,0,1,155.04,0.00,0.00,0.00,0,3.00,1,131.53,0,1,0,,0.00,0,0,3,0,0,2,0,4,41,1
"org.apache.jackrabbit.commons.flat.SizedIterator",1,0.00,1.00,2,0.02,172.84,1,0,1,1,1,98.02,11,3,1,1,142.15,0.00,0.00,0.00,0,1.00,1,49.21,0,0,0,,0.00,0,0,1,0,0,1,0,2,17,1
"org.apache.jackrabbit.commons.flat.TreeManager",10,0.00,1.00,11,0.10,471.47,10,0,5,10,6,113.69,110,12,6,1,157.82,0.00,0.00,0.00,0,10.00,1,286.72,0,3,1,,0.00,0,0,10,0,0,7,0,11,92,1
"org.apache.jackrabbit.commons.flat.TreeTraverser",2,3.00,2.00,12,0.14,3595.68,5,3,9,2,6,142.47,39,14,5,1,116.18,0.00,0.00,0.00,0,2.00,3,415.33,0,0,1,java.lang.Object,0.00,0,0,4,0,0,2,1,4,97,2
"org.apache.jackrabbit.commons.flat.TreeTraverser$ErrorHandler",1,0.00,1.00,5,0.04,763.20,1,0,9,2,0,155.61,20,6,0,1,122.23,0.00,0.00,0.00,0,1.00,1,120.00,0,0,0,,0.00,1,0,1,0,1,1,0,3,32,1
"org.apache.jackrabbit.commons.flat.TreeTraverser$ErrorHandler$ErrorHandler_0",1,0.00,1.00,2,0.01,54.79,1,0,9,1,0,196.08,1,2,0,1,146.08,0.00,0.00,0.00,0,1.00,1,36.53,0,0,0,java.lang.Object,0.00,0,0,1,0,0,1,0,1,13,0
"org.apache.jackrabbit.commons.flat.TreeTraverser$ErrorHandler$InclusionPolicy",14,0.00,1.36,39,0.59,13567.73,14,0,9,25,3,103.96,97,65,0,1,136.18,0.00,0.00,0.00,8,50.00,2,1755.38,0,13,3,,0.00,11,0,19,0,11,1,0,16,417,1
"org.apache.jackrabbit.commons.flat.TreeTraverser$ErrorHandler$InclusionPolicy$InclusionPolicy<Item>",1,0.00,1.00,3,0.02,132.18,1,0,9,1,0,136.50,0,4,0,1,136.50,0.00,0.00,0.00,0,1.00,1,52.87,0,0,0,java.lang.Object,0.00,0,0,1,0,0,1,0,0,17,0
"org.apache.jackrabbit.commons.flat.TreeTraverser$ErrorHandler$InclusionPolicy$InclusionPolicy<Node>",1,0.00,2.00,5,0.04,545.76,1,0,9,2,0,123.21,0,9,0,1,123.21,0.00,0.00,0.00,0,1.00,2,117.75,0,0,0,java.lang.Object,0.00,1,0,2,0,1,1,0,0,31,0
"org.apache.jackrabbit.commons.flat.TreeTraverser$ErrorHandler$InclusionPolicy$Iterator<Iterator<Node>>",3,0.00,1.00,7,0.05,583.52,3,0,9,7,0,141.75,0,10,0,1,141.75,0.00,0.00,0.00,0,3.00,1,155.56,0,1,0,java.lang.Object,0.00,4,0,3,0,4,2,0,0,47,0
"org.apache.jackrabbit.commons.flat.TreeTraverser$ErrorHandler$InclusionPolicy$Iterator<Iterator<Property>>",3,0.00,1.33,11,0.10,1935.31,3,0,9,8,0,131.01,0,17,0,1,131.01,0.00,0.00,0.00,0,4.00,2,301.46,0,1,0,java.lang.Object,0.00,5,0,4,0,5,2,0,0,75,0
"org.apache.jackrabbit.commons.flat.TreeTraverser$ErrorHandler$InclusionPolicy$Predicate",1,0.00,1.00,3,0.03,323.11,1,0,9,1,0,133.44,0,5,0,1,133.44,0.00,0.00,0.00,0,0.00,1,88.00,0,0,0,java.lang.Object,0.00,0,0,1,0,0,1,0,0,24,0
"org.apache.jackrabbit.jcr.EventImpl",10,0.02,2.30,67,0.77,22856.24,15,5,14,32,11,83.11,62,86,2,1,115.33,0.00,0.00,0.22,4,10.00,8,2322.92,0,7,9,java.lang.Object,0.00,22,0,23,0,22,3,1,19,490,1
"org.apache.jackrabbit.jcr.EventJournalImpl",10,0.05,1.80,53,0.49,10928.82,17,7,12,24,7,141.48,37,76,1,1,120.86,0.00,0.00,0.19,3,22.00,4,1460.92,0,2,6,java.lang.Object,0.00,14,0,18,0,14,8,1,15,332,1
"org.apache.jackrabbit.jcr.FilteredEventIterator",9,0.02,1.44,41,0.40,7697.39,16,7,7,14,7,83.08,70,58,2,1,125.37,0.00,0.00,0.16,2,21.00,3,1189.53,0,2,5,java.lang.Object,0.00,5,0,13,0,5,7,1,17,269,0
"org.apache.jackrabbit.jcr.InternalEventListener",2,0.00,1.00,3,0.02,101.48,2,0,3,2,5,107.57,19,4,3,1,157.57,0.00,0.00,0.00,0,2.00,1,51.65,0,1,2,,0.00,0,0,2,0,0,1,0,3,19,1
"org.apache.jackrabbit.jcr.ObservationManagerImpl",11,0.20,2.09,86,1.11,43012.28,17,6,22,44,14,93.15,62,135,1,1,111.02,0.00,0.00,0.35,3,0.00,6,3334.99,0,5,13,java.lang.Object,0.00,33,0,23,0,33,6,2,18,655,1
"org.apache.jackrabbit.jcr.ObservationTest",3,0.00,1.00,27,0.36,8272.24,5,2,10,19,3,148.20,7,38,2,4,108.31,0.00,0.75,0.50,0,0.00,1,1071.52,3,0,1,org.apache.jackrabbit.test.AbstractJCRTest,0.28,16,3,3,0,16,3,0,2,209,1
"org.apache.jackrabbit.jcr.ObservationTest$WaitableEventListener",1,0.00,1.00,2,0.01,83.85,1,0,10,1,0,144.62,0,3,0,2,144.62,0.00,0.50,0.00,0,1.00,1,44.83,0,0,0,,0.00,0,1,1,0,0,1,0,0,15,0
"org.apache.jackrabbit.jcr.ObservationTest$WaitableEventListener_0",2,1.00,3.50,19,0.19,4056.60,4,2,10,10,0,109.07,0,30,0,1,109.07,0.00,0.00,1.00,0,0.00,4,567.52,0,0,0,java.lang.Object,0.00,8,0,7,0,8,2,0,0,120,0
"org.apache.jackrabbit.jcr.TestAll",1,0.00,1.00,5,0.04,864.35,1,0,3,3,2,142.42,3,7,1,2,121.80,0.00,0.50,0.00,0,1.00,1,115.51,0,1,1,junit.framework.TestCase,0.00,2,1,1,0,2,0,0,1,31,1
"org.apache.jackrabbit.rmi.observation.ClientEventPoll",7,0.07,2.29,58,0.70,20498.11,16,9,14,25,4,118.95,123,78,1,2,109.82,0.00,0.50,0.17,1,8.00,6,2113.96,0,2,3,java.lang.Thread,0.00,18,1,16,0,18,5,0,29,428,1
"org.apache.jackrabbit.rmi.observation.ClientEventPoll$JCREvent",8,0.10,1.00,22,0.16,1789.03,11,3,14,12,0,191.27,15,31,0,1,141.27,0.00,0.00,0.25,0,20.00,1,482.87,0,5,0,java.lang.Object,0.00,4,0,8,0,4,3,1,7,132,2
"org.apache.jackrabbit.rmi.observation.Queue",3,0.00,1.67,15,0.11,1823.67,4,1,1,9,2,78.76,34,23,2,1,122.89,0.00,0.00,1.00,0,0.00,3,323.22,0,1,0,java.lang.Object,0.00,6,0,5,0,6,2,0,8,84,1
"org.apache.jackrabbit.rmi.observation.ServerEventListenerProxy",5,0.12,1.80,26,0.26,5539.95,9,4,7,10,5,91.44,69,37,2,1,120.82,0.00,0.00,0.35,0,0.00,3,792.67,0,1,3,java.lang.Object,0.00,5,0,9,0,5,4,1,11,182,1
"org.apache.jackrabbit.webdav.lock.AbstractActiveLock",3,1.00,2.33,23,0.32,12277.01,4,1,4,16,5,68.55,23,31,2,1,110.84,0.00,0.00,0.33,1,5.00,5,972.96,0,2,3,java.lang.Object,0.00,13,0,7,3,13,1,2,11,193,2
"org.apache.jackrabbit.webdav.lock.AbstractLockEntry",1,1.00,1.00,7,0.09,1748.72,2,1,6,7,5,65.46,10,9,2,1,113.94,0.00,0.00,0.00,0,0.00,1,274.40,0,1,3,java.lang.Object,0.00,6,0,1,3,6,0,2,2,65,2
"org.apache.jackrabbit.webdav.lock.ActiveLock",13,0.00,1.00,14,0.07,317.72,13,0,1,13,21,142.20,76,15,19,2,160.07,0.00,0.50,0.00,0,13.00,1,206.64,0,4,2,,0.00,0,1,13,0,0,9,0,14,81,1
"org.apache.jackrabbit.webdav.lock.ActiveLockTest",2,1.00,1.00,20,0.28,6127.58,3,1,7,22,5,126.86,6,23,1,2,106.24,0.00,0.50,0.00,0,2.00,1,850.83,0,0,4,junit.framework.TestCase,0.00,20,1,2,0,20,2,0,2,166,1
"org.apache.jackrabbit.webdav.lock.DefaultActiveLock",13,0.08,1.23,36,0.34,6056.19,17,4,2,24,7,138.95,60,53,2,2,138.71,1.00,0.33,0.17,1,77.00,3,1005.53,0,4,5,org.apache.jackrabbit.webdav.lock.AbstractActiveLock,0.00,11,1,16,1,11,9,0,16,248,1
"org.apache.jackrabbit.webdav.lock.LockDiscovery",7,0.83,1.71,33,0.37,10320.88,8,1,9,21,13,81.17,55,45,7,2,123.47,0.00,0.50,0.29,1,13.00,3,1111.49,1,3,6,org.apache.jackrabbit.webdav.property.AbstractDavProperty,0.00,14,1,12,0,14,4,0,11,246,1
"org.apache.jackrabbit.webdav.lock.LockDiscovery$ALockImpl",15,0.50,1.40,53,0.50,8740.41,16,1,9,29,5,131.35,3,75,0,1,131.35,0.00,0.00,0.53,1,7.00,3,1500.09,0,6,5,java.lang.Object,0.00,14,0,21,0,14,9,1,3,364,2
"org.apache.jackrabbit.webdav.lock.LockEntry",2,0.00,1.00,3,0.01,65.85,2,0,1,2,6,126.83,13,4,3,2,159.05,0.00,0.50,0.00,0,2.00,1,38.73,0,2,3,,0.00,0,1,2,0,0,0,0,3,16,1
"org.apache.jackrabbit.webdav.lock.LockInfo",12,0.04,2.08,68,0.75,25973.41,19,7,10,29,21,70.39,100,89,14,1,118.49,0.00,0.00,0.18,0,64.00,9,2245.87,0,3,7,java.lang.Object,0.00,17,0,25,0,17,9,2,15,454,1
"org.apache.jackrabbit.webdav.lock.LockManager",5,0.00,1.00,6,0.07,360.30,5,0,2,5,12,107.89,51,10,7,1,156.37,0.00,0.00,0.00,0,5.00,1,198.80,0,3,6,,0.00,0,0,5,0,0,2,0,6,59,1
"org.apache.jackrabbit.webdav.lock.Scope",5,0.00,2.00,35,0.47,15423.11,10,5,8,23,30,69.55,36,47,26,1,111.84,0.00,0.00,0.20,1,10.00,3,1424.11,0,3,4,java.lang.Object,0.00,18,0,10,0,18,2,1,7,304,1
"org.apache.jackrabbit.webdav.lock.SimpleLockManager",7,0.50,4.14,68,1.08,53239.05,8,1,7,34,12,54.52,64,99,1,1,104.51,0.00,0.00,0.57,1,3.00,9,3254.60,0,4,11,java.lang.Object,0.00,27,0,29,0,27,3,1,17,624,1
"org.apache.jackrabbit.webdav.lock.SupportedLock",7,0.50,1.57,27,0.28,5594.46,8,1,7,18,6,87.95,52,38,2,2,130.24,0.00,0.50,0.57,0,3.00,3,831.26,1,3,4,org.apache.jackrabbit.webdav.property.AbstractDavProperty,0.00,11,1,11,0,11,4,0,10,198,1
"org.apache.jackrabbit.webdav.lock.SupportedLock$WriteLockEntry",3,1.00,1.67,12,0.13,3382.38,4,1,7,7,2,92.17,19,18,0,2,124.39,0.00,0.50,0.33,0,4.00,3,379.23,0,1,2,org.apache.jackrabbit.webdav.lock.AbstractLockEntry,0.00,4,1,5,0,4,2,0,4,92,3
"org.apache.jackrabbit.webdav.lock.TestAll",1,0.00,1.00,5,0.04,864.35,1,0,3,3,1,121.80,0,7,0,2,121.80,0.00,0.50,0.00,0,1.00,1,115.51,0,1,1,junit.framework.TestCase,0.00,2,1,1,0,2,0,0,0,31,1
"org.apache.jackrabbit.webdav.lock.Type",6,0.08,2.00,41,0.54,16909.85,11,5,8,29,25,96.77,35,56,21,1,114.65,0.00,0.00,0.27,1,10.00,3,1621.22,0,3,4,java.lang.Object,0.00,23,0,12,0,23,3,1,7,346,1
"org.apache.jackrabbit.webdav.property.AbstractDavProperty",6,0.27,3.50,52,0.67,48536.48,9,3,9,17,27,57.77,61,64,22,1,106.25,0.00,0.00,0.11,1,14.00,11,2005.35,0,2,5,java.lang.Object,0.00,11,0,21,22,11,4,1,8,404,2
"org.apache.jackrabbit.webdav.property.DavProperty",3,0.00,1.00,4,0.02,166.40,3,0,2,3,44,137.12,42,5,41,4,157.27,0.00,0.75,0.00,0,3.00,1,72.88,0,1,3,,0.00,0,3,3,0,0,2,0,4,26,1
"org.apache.jackrabbit.webdav.property.DavPropertyIterator",1,0.00,1.00,2,0.02,255.79,1,0,2,1,4,92.33,10,3,3,1,140.81,0.00,0.00,0.00,0,1.00,1,73.08,0,1,1,,0.00,0,0,1,0,0,0,0,2,22,1
"org.apache.jackrabbit.webdav.property.DavPropertyName",10,0.01,1.70,58,0.86,35304.69,25,15,8,29,59,68.76,81,79,54,1,116.87,0.00,0.00,0.07,1,14.00,4,2580.15,0,7,5,java.lang.Object,0.00,19,0,17,0,19,3,3,20,526,1
"org.apache.jackrabbit.webdav.property.DavPropertyNameIterator",1,0.00,1.00,2,0.01,103.00,1,0,1,1,5,164.54,3,3,4,1,143.92,0.00,0.00,0.00,0,1.00,1,40.14,0,1,1,,0.00,0,0,1,0,0,0,0,1,14,1
"org.apache.jackrabbit.webdav.property.DavPropertyNameSet",12,0.18,1.25,34,0.36,6754.53,14,2,9,29,31,120.19,67,55,25,2,138.06,0.00,0.50,0.33,2,18.00,3,1065.04,0,1,6,org.apache.jackrabbit.webdav.property.PropContainer,0.42,17,1,15,0,17,11,0,16,261,1
"org.apache.jackrabbit.webdav.property.DavPropertyNameSet$PropertyNameIterator",5,0.25,1.00,12,0.08,799.16,6,1,9,8,2,142.42,0,18,0,1,142.42,0.00,0.00,0.80,0,0.00,1,231.44,0,2,2,java.lang.Object,0.00,3,0,5,0,3,3,1,0,70,1
"org.apache.jackrabbit.webdav.property.DavPropertySet",16,0.20,1.19,40,0.49,9986.91,18,2,8,35,23,95.43,114,63,17,2,137.72,0.00,0.50,0.31,3,12.00,3,1473.15,0,1,6,org.apache.jackrabbit.webdav.property.PropContainer,0.43,19,1,19,0,19,15,0,21,362,1
"org.apache.jackrabbit.webdav.property.DavPropertySet$PropIter",7,0.06,1.57,28,0.23,4813.62,10,3,8,14,3,146.71,25,39,0,1,126.09,0.00,0.00,0.29,2,11.00,3,697.47,0,0,3,java.lang.Object,0.00,7,0,11,0,7,7,1,10,175,1
"org.apache.jackrabbit.webdav.property.DefaultDavProperty",6,0.50,1.83,33,0.42,21013.05,8,2,7,17,22,68.40,65,44,18,2,116.88,0.00,0.50,0.08,0,10.00,6,1274.94,0,1,4,org.apache.jackrabbit.webdav.property.AbstractDavProperty,0.00,11,1,11,0,11,5,0,9,268,1
"org.apache.jackrabbit.webdav.property.HrefProperty",6,0.20,3.17,49,0.70,40362.99,8,2,8,26,23,58.43,63,64,19,2,106.90,1.00,0.33,0.33,1,6.00,10,2099.95,1,3,4,org.apache.jackrabbit.webdav.property.AbstractDavProperty,0.00,20,1,19,1,20,3,0,9,409,1
"org.apache.jackrabbit.webdav.property.PropContainer",7,1.00,1.43,21,0.19,4017.89,8,1,8,12,8,83.29,58,26,3,1,131.39,0.00,0.00,0.14,1,12.00,3,576.04,0,2,5,java.lang.Object,0.00,5,0,10,2,5,5,2,8,142,2
"org.apache.jackrabbit.webdav.property.PropEntry",0,0.00,0.00,1,0.00,12.00,0,0,0,0,25,171.00,5,2,25,1,171.00,0.00,0.00,0.00,0,0.00,0,8.00,0,0,0,,0.00,0,0,0,0,0,0,0,1,4,1
"org.apache.jackrabbit.webdav.property.ResourceType",6,0.03,2.33,48,0.60,21444.46,13,7,10,17,12,65.01,71,62,6,2,109.14,0.00,0.50,0.12,0,10.00,4,1803.29,0,1,6,org.apache.jackrabbit.webdav.property.AbstractDavProperty,0.00,11,1,14,0,11,5,0,17,385,1
"org.apache.jackrabbit.webdav.property.ResourceType$TypeName",4,0.11,1.25,16,0.15,2412.78,7,3,10,7,3,126.60,0,24,0,1,126.60,0.00,0.00,0.42,0,0.00,2,439.41,0,1,3,java.lang.Object,0.00,3,0,5,0,3,3,1,0,113,2
"org.apache.jackrabbit.commons.predicate.DeclaringTypePredicate",3,0.25,1.33,13,0.18,3539.13,5,2,4,8,1,74.29,28,20,0,2,124.29,0.00,0.50,0.33,0,4.00,2,529.36,0,0,1,org.apache.jackrabbit.commons.predicate.DepthPredicate,0.00,5,1,4,0,5,3,0,6,124,1
"org.apache.jackrabbit.commons.predicate.DepthPredicate",3,0.25,1.67,15,0.14,3891.23,5,2,2,4,6,70.30,29,22,5,1,120.30,0.00,0.00,0.33,0,4.00,3,434.21,0,0,1,java.lang.Object,0.00,1,0,5,5,1,3,1,6,103,1
"org.apache.jackrabbit.commons.predicate.IsMandatoryPredicate",4,1.00,1.25,13,0.13,2506.27,5,1,4,7,1,181.13,7,20,0,2,131.13,0.00,0.50,0.25,0,6.00,2,400.55,0,0,1,org.apache.jackrabbit.commons.predicate.DepthPredicate,0.00,3,1,5,0,3,4,0,2,102,1
"org.apache.jackrabbit.commons.predicate.IsNodePredicate",4,0.67,1.00,11,0.09,1111.55,5,1,2,5,2,98.23,30,17,1,2,140.53,0.00,0.50,0.50,0,4.00,1,264.47,0,0,1,org.apache.jackrabbit.commons.predicate.DepthPredicate,0.00,1,1,4,0,1,4,0,6,73,1
"org.apache.jackrabbit.commons.predicate.NamePredicate",3,1.00,1.00,9,0.09,1118.10,4,1,2,5,1,90.66,22,14,0,2,132.95,0.00,0.50,0.33,0,4.00,1,261.58,0,0,1,org.apache.jackrabbit.commons.predicate.DepthPredicate,0.00,2,1,3,0,2,3,0,5,69,1
"org.apache.jackrabbit.commons.predicate.NodeTypePredicate",3,0.25,2.00,17,0.18,3489.42,5,2,3,8,1,72.15,30,27,0,2,120.63,0.00,0.50,0.33,0,4.00,4,542.14,0,0,1,org.apache.jackrabbit.commons.predicate.DepthPredicate,0.00,5,1,6,0,5,3,0,7,126,1
"org.apache.jackrabbit.commons.predicate.NtFilePredicate",5,0.14,2.60,36,0.41,12385.23,14,9,3,13,1,70.24,35,51,0,1,112.53,0.00,0.00,0.22,0,6.00,9,1243.15,0,0,1,java.lang.Object,0.00,8,0,13,0,8,5,1,10,258,1
"org.apache.jackrabbit.commons.predicate.PathPredicate",2,0.00,3.50,21,0.26,7308.33,3,1,3,11,1,61.23,22,29,0,1,105.35,0.00,0.00,1.00,0,0.00,4,766.48,0,0,1,java.lang.Object,0.00,9,0,7,0,9,2,1,4,158,1
"org.apache.jackrabbit.commons.predicate.Predicate",1,0.00,1.00,6,0.03,639.48,1,0,0,2,19,119.41,16,7,19,1,119.88,0.00,0.00,0.00,0,1.00,1,91.91,0,0,0,,0.00,1,0,1,0,1,1,0,4,29,1
"org.apache.jackrabbit.commons.predicate.Predicate$Predicate",1,0.00,1.00,3,0.01,95.05,1,0,0,1,0,137.63,0,4,0,1,137.63,0.00,0.00,0.00,0,1.00,1,41.22,0,0,0,java.lang.Object,0.00,0,0,1,0,0,1,0,0,14,0
"org.apache.jackrabbit.commons.predicate.Predicate$Predicate_0",1,0.00,1.00,3,0.01,95.05,1,0,0,1,0,137.63,0,4,0,1,137.63,0.00,0.00,0.00,0,1.00,1,41.22,0,0,0,java.lang.Object,0.00,0,0,1,0,0,1,0,0,14,0
"org.apache.jackrabbit.commons.predicate.Predicates",3,0.00,1.00,7,0.04,625.33,3,0,0,4,1,91.51,29,11,0,1,141.51,0.00,0.00,0.00,0,3.00,1,127.57,0,3,1,java.lang.Object,0.00,1,0,3,0,1,0,0,4,39,1
"org.apache.jackrabbit.commons.predicate.Predicates$Predicate",1,0.00,3.00,7,0.04,833.27,1,0,0,2,0,116.22,0,9,0,1,116.22,0.00,0.00,0.00,0,1.00,3,131.19,0,0,0,java.lang.Object,0.00,1,0,3,0,1,1,0,0,33,0
"org.apache.jackrabbit.commons.predicate.Predicates$Predicate_0",1,0.00,3.00,7,0.04,712.55,1,0,0,2,0,116.76,0,9,0,1,116.76,0.00,0.00,0.00,0,1.00,3,124.76,0,0,0,java.lang.Object,0.00,1,0,3,0,1,1,0,0,32,0
"org.apache.jackrabbit.commons.predicate.Predicates$Predicate_1",1,0.00,1.00,3,0.02,275.49,1,0,0,2,0,133.99,0,4,0,1,133.99,0.00,0.00,0.00,0,1.00,1,61.77,0,0,0,java.lang.Object,0.00,1,0,1,0,1,1,0,0,19,0
"org.apache.jackrabbit.commons.predicate.RowPredicate",5,1.00,1.60,20,0.15,3248.77,6,1,3,7,1,94.06,33,30,0,1,126.28,0.00,0.00,0.20,1,8.00,3,455.51,0,0,1,java.lang.Object,0.00,2,0,8,0,2,5,1,7,114,1
"org.apache.jackrabbit.webdav.bind.BindConstants",0,0.00,0.00,11,0.18,3428.54,10,10,3,1,10,171.00,14,12,7,1,171.00,0.00,0.00,0.00,0,0.00,0,529.10,0,0,3,,0.00,1,0,0,0,1,0,0,4,104,1
"org.apache.jackrabbit.webdav.bind.BindInfo",5,0.33,2.60,49,0.64,36819.71,8,3,9,16,12,144.62,11,62,6,1,104.73,0.00,0.00,0.07,0,8.00,9,1906.72,0,4,6,java.lang.Object,0.00,11,0,13,0,11,1,1,2,373,1
"org.apache.jackrabbit.webdav.bind.BindServletRequest",5,0.00,1.00,6,0.04,216.44,5,0,2,5,6,125.89,32,7,1,1,158.11,0.00,0.00,0.00,0,5.00,1,115.14,0,3,5,,0.00,0,0,5,0,0,2,0,6,41,1
"org.apache.jackrabbit.webdav.bind.BindableResource",3,0.00,1.00,4,0.04,242.53,3,0,3,3,4,123.76,19,5,2,1,155.98,0.00,0.00,0.00,0,3.00,1,105.08,0,1,2,,0.00,0,0,3,0,0,2,0,3,34,1
"org.apache.jackrabbit.webdav.bind.ParentElement",5,0.33,2.60,49,0.64,36970.61,8,3,9,16,10,144.60,14,62,4,1,104.72,0.00,0.00,0.07,0,8.00,9,1917.59,0,4,6,java.lang.Object,0.00,11,0,13,0,11,1,1,3,375,1
"org.apache.jackrabbit.webdav.bind.ParentSet",2,1.00,1.00,7,0.07,1135.77,3,1,2,2,4,113.64,10,10,1,2,131.51,0.00,0.50,0.00,0,2.00,1,217.98,0,1,3,org.apache.jackrabbit.webdav.property.AbstractDavProperty,0.00,0,1,2,0,0,1,0,3,56,1
"org.apache.jackrabbit.webdav.bind.RebindInfo",5,0.33,2.60,49,0.64,36819.71,8,3,9,16,12,144.62,11,62,6,1,104.73,0.00,0.00,0.07,0,8.00,9,1906.72,0,4,6,java.lang.Object,0.00,11,0,13,0,11,1,1,2,373,1
"org.apache.jackrabbit.webdav.bind.UnbindInfo",5,0.50,2.00,34,0.43,19571.21,7,2,9,16,12,153.41,11,44,6,1,113.52,0.00,0.00,0.10,0,8.00,6,1287.02,0,3,6,java.lang.Object,0.00,11,0,10,0,11,2,1,2,259,1
"org.apache.jackrabbit.core.security.authorization.combined.CombinedEditor",7,0.25,2.71,55,0.80,28951.74,9,2,12,23,3,111.00,32,74,1,1,110.77,0.00,0.00,0.29,0,3.00,3,2406.90,0,4,2,java.lang.Object,0.00,16,0,19,0,16,3,1,18,473,0
"org.apache.jackrabbit.core.security.authorization.combined.CombinedProvider",9,0.44,2.33,71,0.88,26149.04,11,2,26,36,14,94.14,45,93,0,2,112.01,0.00,0.50,0.11,0,23.00,4,2649.89,5,4,14,org.apache.jackrabbit.core.security.authorization.AbstractAccessControlProvider,0.10,27,1,21,0,27,5,0,23,536,1
"org.apache.jackrabbit.core.security.authorization.combined.CombinedProvider$CompiledPermissionImpl",5,1.00,2.20,32,0.39,10856.16,6,1,26,18,5,115.75,21,41,0,2,115.52,0.00,0.50,0.20,1,8.00,3,1160.14,2,0,5,org.apache.jackrabbit.core.security.authorization.AbstractCompiledPermissions,0.15,13,1,11,0,13,5,0,10,245,1
"org.apache.jackrabbit.core.security.authorization.combined.TestAll",1,0.00,1.00,5,0.04,864.35,1,0,3,3,1,73.32,10,7,0,2,121.80,0.00,0.50,0.00,0,1.00,1,115.51,0,1,1,junit.framework.TestCase,0.00,2,1,1,0,2,0,0,2,31,1
"org.apache.jackrabbit.core.security.authorization.combined.WriteTest",8,1.00,2.25,98,1.66,58896.31,9,1,21,35,10,57.81,56,126,1,8,100.11,0.00,0.88,0.00,3,0.00,4,4965.30,7,4,9,org.apache.jackrabbit.core.security.authorization.acl.WriteTest,0.15,27,7,18,0,27,4,0,26,913,1
"org.apache.jackrabbit.commons.xml.DefaultContentHandler",12,0.09,1.00,26,0.27,3700.60,13,1,5,23,2,97.88,90,47,2,2,140.17,2.00,0.25,0.92,0,0.00,1,797.01,0,0,0,org.xml.sax.helpers.DefaultHandler,0.00,11,1,12,2,11,12,0,15,216,1
"org.apache.jackrabbit.commons.xml.DocumentViewExporter",4,0.00,1.50,19,0.28,6322.83,4,0,11,12,5,73.26,36,33,1,2,123.26,0.00,0.50,0.00,0,6.00,3,837.70,6,0,4,org.apache.jackrabbit.commons.xml.Exporter,0.00,8,1,6,0,8,4,0,11,171,1
"org.apache.jackrabbit.commons.xml.Exporter",20,0.04,2.20,156,2.13,63069.14,29,9,21,76,4,82.36,260,218,3,1,111.74,0.00,0.00,0.14,6,116.00,5,6389.91,0,5,1,java.lang.Object,0.00,56,0,44,2,56,15,0,41,1276,2
"org.apache.jackrabbit.commons.xml.ParsingContentHandler",3,0.00,1.33,11,0.13,2469.34,3,0,9,10,6,82.07,25,18,5,3,130.18,0.00,0.67,0.00,0,3.00,2,384.70,0,1,1,org.apache.jackrabbit.commons.xml.DefaultContentHandler,0.00,7,2,4,0,7,2,0,4,90,1
"org.apache.jackrabbit.commons.xml.ParsingContentHandlerTest",3,0.00,1.67,28,0.32,6730.76,3,0,5,13,2,158.90,5,40,0,2,108.90,0.00,0.50,0.00,1,3.00,2,957.09,0,0,2,junit.framework.TestCase,0.00,10,1,5,0,10,3,0,1,194,1
"org.apache.jackrabbit.commons.xml.ProxyContentHandler",13,0.08,1.00,28,0.28,3804.40,14,1,5,25,1,98.06,96,50,1,2,140.35,1.00,0.33,0.92,0,0.00,1,826.90,0,1,0,org.xml.sax.helpers.DefaultHandler,0.00,12,1,13,1,12,12,0,16,226,1
"org.apache.jackrabbit.commons.xml.SerializingContentHandler",13,0.01,3.23,153,2.12,118108.95,23,10,21,56,8,63.15,162,193,7,3,100.71,0.00,0.67,0.09,5,63.00,14,6365.41,6,3,1,org.apache.jackrabbit.commons.xml.DefaultContentHandler,0.24,43,2,42,0,43,10,0,65,1176,1
"org.apache.jackrabbit.commons.xml.SerializingContentHandlerTest",3,0.00,1.33,64,0.84,25297.86,3,0,4,18,1,140.70,5,71,0,2,90.70,0.00,0.50,0.00,1,3.00,2,2522.96,0,0,1,junit.framework.TestCase,0.00,15,1,4,0,15,3,0,1,451,1
"org.apache.jackrabbit.commons.xml.SystemViewExporter",6,0.07,2.17,55,0.66,16429.55,9,3,10,15,4,60.05,51,72,2,2,108.16,0.00,0.50,0.39,2,0.00,4,1971.90,6,0,2,org.apache.jackrabbit.commons.xml.Exporter,0.00,9,1,13,0,9,6,0,16,395,1
"org.apache.jackrabbit.commons.xml.SystemViewExporter$Writer",3,0.00,1.33,9,0.08,2192.23,3,0,10,6,1,130.58,0,15,0,1,130.58,0.00,0.00,0.00,0,3.00,2,254.70,0,0,1,java.lang.Object,0.00,3,0,4,0,3,3,0,0,61,0
"org.apache.jackrabbit.commons.xml.ToXmlContentHandler",14,0.08,2.21,92,1.02,41628.61,17,3,10,24,3,82.22,96,135,3,2,114.44,0.00,0.50,0.26,4,26.00,8,3046.68,0,1,0,org.xml.sax.helpers.DefaultHandler,0.00,10,1,31,0,10,13,0,21,630,1
"org.apache.jackrabbit.commons.xml.ToXmlContentHandlerTest",8,0.00,1.00,103,1.45,45411.68,8,0,4,21,1,101.18,0,141,0,2,101.18,0.00,0.50,0.00,0,8.00,1,4341.69,0,0,1,junit.framework.TestCase,0.00,13,1,8,0,13,8,0,0,832,1
"org.apache.jackrabbit.commons.xml.XmlnsContentHandler",3,0.00,2.00,23,0.33,11850.10,5,2,7,14,2,78.77,20,38,1,3,110.99,0.00,0.67,0.50,0,1.00,4,980.31,2,0,1,org.apache.jackrabbit.commons.xml.ProxyContentHandler,0.00,11,2,6,0,11,3,0,6,194,1
"org.apache.jackrabbit.commons.xml.XmlnsContentHandlerTest",1,0.00,1.00,18,0.24,8530.38,1,0,4,12,2,93.22,0,26,0,2,93.22,0.00,0.50,0.00,0,1.00,1,723.79,0,0,2,junit.framework.TestCase,0.00,11,1,1,0,11,1,0,0,143,1
"org.apache.jackrabbit.jcr.ConformanceTest",1,0.00,2.00,9,0.08,2196.41,1,0,6,7,2,129.55,3,12,0,2,108.93,0.00,0.50,0.00,0,1.00,2,248.87,0,1,2,junit.framework.TestCase,0.00,6,1,2,0,6,0,0,1,61,1
"org.apache.jackrabbit.jcr.ConformanceTest$StopRepository",2,0.00,1.50,7,0.05,555.48,2,0,6,4,1,133.87,0,12,0,1,133.87,0.00,0.00,0.00,0,2.00,2,149.93,0,0,1,java.lang.Object,0.00,2,0,3,0,2,2,1,0,41,2
"org.apache.jackrabbit.jcr.RepositoryStubImpl",3,0.25,3.33,36,0.43,18225.12,7,4,11,21,6,100.67,0,56,1,3,100.67,0.00,0.67,0.42,0,1.00,7,1277.38,1,1,5,org.apache.jackrabbit.core.JackrabbitRepositoryStub,0.15,18,2,10,0,18,2,0,0,242,1
"org.apache.jackrabbit.jcr.RepositoryStubImpl$JcrRemotingServlet",1,0.00,1.00,3,0.01,72.00,1,0,11,1,0,138.58,0,4,0,1,138.58,0.00,0.00,0.00,0,0.00,1,32.00,0,1,0,java.lang.Object,0.00,0,0,1,0,0,0,0,0,12,0
"org.apache.jackrabbit.jcr.SuppressWarnings",2,0.00,4.50,28,0.38,14650.50,4,2,13,16,6,77.32,28,48,0,1,97.47,0.00,0.00,0.50,1,2.00,7,1141.61,0,2,6,java.lang.Object,0.00,14,0,9,0,14,0,1,6,219,1
"org.apache.jackrabbit.standalone.cli.namespace.RegisterNamespace",5,0.17,1.20,19,0.22,4301.59,8,3,5,13,1,130.29,24,27,0,1,130.05,0.00,0.00,0.20,0,14.00,2,660.57,0,2,1,java.lang.Object,0.00,8,0,6,0,8,3,1,10,150,1
"org.apache.jackrabbit.standalone.cli.namespace.SetNamespacePrefix",5,0.17,1.20,19,0.21,4107.39,8,3,5,11,1,130.44,24,26,0,1,130.21,0.00,0.00,0.20,0,14.00,2,624.17,0,2,1,java.lang.Object,0.00,6,0,6,0,6,3,1,10,144,1
"org.apache.jackrabbit.standalone.cli.namespace.UnregisterNamespace",3,0.25,1.33,13,0.15,2672.18,5,2,5,11,1,107.37,16,19,0,1,125.25,0.00,0.00,0.33,0,5.00,2,458.45,0,1,1,java.lang.Object,0.00,8,0,4,0,8,2,1,7,104,1
"org.apache.jackrabbit.commons.query.sql.Parser",37,0.07,5.41,665,8.04,468187.30,69,32,24,121,3,142.41,43,854,1,1,92.41,0.00,0.00,0.10,26,396.00,23,24125.75,0,26,2,java.lang.Object,0.00,84,0,200,1,84,11,0,17,4304,1
"org.apache.jackrabbit.commons.query.sql.Parser$ColumnOrWildcard",0,0.00,0.00,4,0.02,232.53,3,3,24,0,0,171.00,0,5,0,1,171.00,0.00,0.00,0.00,0,0.00,0,66.44,0,0,0,java.lang.Object,0.00,0,0,0,0,0,0,0,0,20,2
"org.apache.jackrabbit.commons.query.sql.QOMFormatter",42,0.23,2.48,349,2.97,77449.23,46,4,38,115,3,111.39,28,431,3,1,111.39,0.00,0.00,0.03,7,158.00,14,8913.70,0,2,0,java.lang.Object,0.00,73,0,104,0,73,40,1,7,2030,1
"org.apache.jackrabbit.commons.query.sql.SQL2QOMBuilder",4,0.67,1.25,12,0.17,3532.51,5,1,10,14,3,112.08,23,24,0,1,129.95,0.00,0.00,0.50,0,4.00,2,524.89,0,3,3,java.lang.Object,0.00,10,0,5,0,10,1,1,6,124,1
"org.apache.jackrabbit.jcr.NamespaceRegistryTest",9,0.25,1.67,88,1.16,31855.80,15,6,12,31,3,89.47,47,117,1,4,107.34,0.00,0.75,0.39,2,0.00,2,3493.16,3,2,2,org.apache.jackrabbit.test.AbstractJCRTest,0.23,22,3,15,0,22,7,0,12,686,1
"org.apache.jackrabbit.jcr.TestAll",1,0.00,1.00,5,0.04,864.35,1,0,3,3,2,142.42,3,7,1,2,121.80,0.00,0.50,0.00,0,1.00,1,115.51,0,1,1,junit.framework.TestCase,0.00,2,1,1,0,2,0,0,1,31,1
"org.apache.jackrabbit.commons.query.qom.JoinType",5,0.25,1.40,19,0.21,4798.80,7,2,6,8,7,81.54,41,32,7,1,129.64,0.00,0.00,0.30,0,10.00,3,640.56,0,4,0,java.lang.Object,0.00,3,0,7,0,3,1,0,6,155,1
"org.apache.jackrabbit.commons.query.qom.Operator",8,0.19,1.38,30,0.40,8664.86,11,3,6,18,11,86.94,58,59,11,1,129.23,0.00,0.00,0.17,0,28.00,3,1207.60,0,6,0,java.lang.Object,0.00,10,0,11,0,10,2,0,10,280,1
"org.apache.jackrabbit.commons.query.qom.Order",3,1.00,1.67,13,0.11,2627.10,4,1,1,5,2,93.03,19,19,2,1,125.25,0.00,0.00,0.33,0,4.00,3,321.78,0,2,0,java.lang.Object,0.00,2,0,5,0,2,1,0,4,80,1
"org.apache.jackrabbit.core.security.user.AdministratorTest",7,0.00,3.00,115,1.59,81577.43,8,1,14,46,13,51.52,53,147,1,5,93.81,0.00,0.80,1.00,0,0.00,4,4764.12,3,0,12,org.apache.jackrabbit.api.security.user.AbstractUserTest,0.11,39,4,21,0,39,7,0,31,853,1
"org.apache.jackrabbit.core.security.user.AuthorizableImpl",23,0.02,3.00,187,2.51,90831.11,27,4,27,96,27,76.52,143,253,14,1,108.74,0.00,0.00,0.27,9,0.00,6,7522.78,1,12,14,java.lang.Object,0.00,73,0,69,2,73,11,2,45,1461,1
"org.apache.jackrabbit.core.security.user.AuthorizableImpl$NodeBasedPrincipal",3,0.00,1.00,7,0.04,389.05,3,0,27,3,3,163.75,11,11,0,2,143.13,0.00,0.50,0.00,0,1.00,1,122.70,0,2,3,org.apache.jackrabbit.core.security.principal.PrincipalImpl,0.00,0,1,3,0,0,1,1,3,40,0
"org.apache.jackrabbit.core.security.user.AuthorizableImplTest",16,0.47,3.19,178,2.32,72388.56,18,2,23,62,16,153.10,17,237,1,5,103.10,0.00,0.80,0.06,1,0.00,5,6947.85,5,0,15,org.apache.jackrabbit.api.security.user.AbstractUserTest,0.09,46,4,51,0,46,16,0,15,1382,1
"org.apache.jackrabbit.core.security.user.AuthorizableImplTest$Authorizable",13,0.00,1.00,27,0.25,3720.13,13,0,23,24,0,140.43,0,40,0,1,140.43,0.00,0.00,0.00,0,13.00,1,755.56,0,7,0,java.lang.Object,0.00,11,0,13,0,11,6,0,0,206,0
"org.apache.jackrabbit.core.security.user.DefaultPrincipalProviderTest",6,0.00,2.50,81,1.05,45058.06,7,1,15,42,13,119.33,22,101,1,5,98.72,0.00,0.80,1.00,0,0.00,8,3163.88,5,0,12,org.apache.jackrabbit.api.security.user.AbstractUserTest,0.22,36,4,15,0,36,6,0,13,605,1
"org.apache.jackrabbit.core.security.user.GroupAdministratorTest",22,0.19,2.36,285,3.61,124161.84,29,7,15,68,14,151.00,37,355,1,5,101.00,0.00,0.80,0.32,1,0.00,6,10828.50,8,1,13,org.apache.jackrabbit.api.security.user.AbstractUserTest,0.16,46,4,52,0,46,21,0,35,2043,1
"org.apache.jackrabbit.core.security.user.GroupImpl",16,0.40,2.00,95,1.17,36272.68,18,2,37,46,25,138.96,60,126,9,2,118.34,0.00,0.50,0.12,3,60.00,5,3515.83,3,9,17,org.apache.jackrabbit.core.security.user.AuthorizableImpl,0.00,30,1,32,0,30,7,1,20,731,0
"org.apache.jackrabbit.core.security.user.GroupImpl$AuthorizableIterator",1,0.00,2.00,4,0.05,1122.76,2,1,37,2,0,124.36,0,8,0,1,124.36,0.00,0.00,1.00,0,0.00,2,152.10,0,1,0,java.lang.Object,0.00,1,0,2,0,1,0,0,0,37,0
"org.apache.jackrabbit.core.security.user.GroupImpl$AuthorizableIterator_1",1,0.00,2.00,3,0.04,692.36,1,0,37,4,0,130.68,0,7,0,1,130.68,0.00,0.00,0.00,0,1.00,2,122.06,0,1,0,java.lang.Object,0.00,3,0,2,0,3,0,0,0,31,0
"org.apache.jackrabbit.core.security.user.GroupImpl$AuthorizableIterator_2",6,0.20,2.17,34,0.37,11920.65,8,2,37,15,3,118.78,4,53,0,1,118.78,0.00,0.00,0.33,2,6.00,7,1097.95,0,2,3,java.lang.Object,0.00,9,0,13,0,9,4,1,1,229,2
"org.apache.jackrabbit.core.security.user.GroupImpl$Iterator<Iterator<Authorizable>>",4,0.00,1.50,14,0.15,3198.41,4,0,37,12,3,130.25,3,22,0,1,130.25,0.00,0.00,0.00,0,6.00,3,457.63,0,2,3,java.lang.Object,0.00,8,0,6,0,8,2,0,1,111,0
"org.apache.jackrabbit.core.security.user.GroupImpl$MembershipProvider",3,0.00,1.00,4,0.04,207.26,3,0,37,3,1,156.51,0,5,0,1,156.51,0.00,0.00,0.00,0,3.00,1,106.11,0,1,1,,0.00,0,0,3,0,0,2,0,0,34,1
"org.apache.jackrabbit.core.security.user.GroupImpl$NodeBasedGroup",7,1.00,1.86,33,0.34,9373.74,8,1,37,15,0,105.90,35,45,0,2,123.78,0.00,0.50,0.14,1,12.00,4,1017.88,0,2,0,org.apache.jackrabbit.core.security.user.NodeBasedPrincipal,0.00,8,1,13,0,8,5,1,11,226,1
"org.apache.jackrabbit.core.security.user.GroupImpl$NodeBasedMembershipProvider",4,0.67,1.75,21,0.23,4832.88,5,1,37,15,5,120.53,0,31,0,1,120.53,0.00,0.00,0.50,0,4.00,3,696.77,0,1,5,java.lang.Object,0.00,11,0,7,0,11,3,1,0,154,1
"org.apache.jackrabbit.core.security.user.GroupImpl$NodeBasedMembershipProvider$SessionWriteOperation<Boolean>",1,0.00,6.00,21,0.30,10848.93,1,0,37,13,4,89.49,0,30,0,1,89.49,0.00,0.00,0.00,0,0.00,6,904.21,0,1,4,java.lang.Object,0.00,12,0,6,0,12,0,0,0,158,0
"org.apache.jackrabbit.core.security.user.GroupImpl$NodeBasedMembershipProvider$SessionWriteOperation<Boolean>_0",1,0.00,5.00,19,0.24,7507.71,1,0,37,11,4,92.41,0,26,0,1,92.41,0.00,0.00,0.00,0,0.00,5,710.26,0,1,4,java.lang.Object,0.00,10,0,5,0,10,0,0,0,130,0
"org.apache.jackrabbit.core.security.user.GroupImpl$PropertyBasedMembershipProvider",4,0.33,3.25,52,0.72,30418.99,5,1,37,28,4,98.61,2,68,0,1,98.61,0.00,0.00,0.75,0,0.00,5,2154.13,0,1,4,java.lang.Object,0.00,24,0,13,0,24,3,1,2,392,1
"org.apache.jackrabbit.core.security.user.ImpersonationImpl",7,0.11,3.57,91,1.19,51583.35,10,3,19,43,14,119.31,22,115,1,1,98.70,0.00,0.00,0.43,2,0.00,5,3582.43,0,2,14,java.lang.Object,0.00,36,0,25,0,36,5,2,12,669,0
"org.apache.jackrabbit.core.security.user.ImpersonationImplTest",4,0.73,2.00,52,0.66,15709.67,9,5,11,26,8,140.87,8,64,1,5,100.99,0.00,0.80,0.75,0,0.00,3,1993.98,6,0,7,org.apache.jackrabbit.api.security.user.AbstractUserTest,0.23,22,4,8,0,22,4,0,6,395,1
"org.apache.jackrabbit.core.security.user.IndexNodeResolver",10,0.33,2.70,114,1.71,71869.95,12,2,17,36,9,69.33,64,143,2,2,101.56,0.00,0.50,0.20,2,18.00,8,5139.66,2,9,7,org.apache.jackrabbit.core.security.user.NodeResolver,0.00,26,1,27,0,26,1,0,14,936,0
"org.apache.jackrabbit.core.security.user.IndexNodeResolver$ResultFilteringNodeIterator",2,1.00,3.00,16,0.21,8698.79,3,1,17,8,2,108.41,0,25,0,2,108.41,0.00,0.50,0.50,0,2.00,5,627.21,0,1,2,org.apache.jackrabbit.commons.iterator.FilteringNodeIterator,0.18,6,1,6,0,6,1,0,0,126,1
"org.apache.jackrabbit.core.security.user.IndexNodeResolverTest",4,1.00,1.00,46,0.73,14147.61,5,1,8,20,9,144.09,8,60,1,5,104.21,0.00,0.80,0.00,1,0.00,1,2199.89,2,1,8,org.apache.jackrabbit.core.security.user.NodeResolverTest,0.00,16,4,4,0,16,3,0,2,403,1
"org.apache.jackrabbit.core.security.user.MembershipCache",16,0.02,2.88,138,1.96,76544.61,22,6,29,65,15,65.80,126,201,5,1,108.09,0.00,0.00,0.19,7,54.00,8,5881.13,0,10,11,java.lang.Object,0.00,49,0,46,0,49,6,3,52,1137,1
"org.apache.jackrabbit.core.security.user.MembershipCache$TraversingItemVisitor.Default",1,0.00,7.00,17,0.28,12661.63,1,0,29,13,2,132.23,2,24,0,1,92.35,0.00,0.00,0.00,0,1.00,7,832.03,0,0,2,java.lang.Object,0.00,12,0,7,0,12,1,0,2,153,0
"org.apache.jackrabbit.core.security.user.NodeCreationTest",12,0.44,2.08,202,3.37,134894.15,18,6,18,55,14,76.14,69,230,1,5,94.02,0.00,0.80,0.57,1,0.00,4,10114.54,3,0,13,org.apache.jackrabbit.api.security.user.AbstractUserTest,0.20,43,4,25,0,43,12,0,42,1754,1
"org.apache.jackrabbit.core.security.user.NodeResolver",12,0.05,1.25,43,0.45,7478.00,18,6,16,18,15,83.04,100,63,6,1,131.14,0.00,0.00,0.12,1,50.00,3,1359.59,0,9,9,java.lang.Object,0.00,6,0,15,2,6,3,0,14,325,1
"org.apache.jackrabbit.core.security.user.NodeResolver$AuthorizableTypePredicate",4,0.33,2.50,28,0.31,8339.10,6,2,16,10,5,163.13,5,44,0,1,113.13,0.00,0.00,0.25,2,8.00,6,932.11,0,1,5,java.lang.Object,0.00,6,0,10,0,6,3,1,3,206,0
"org.apache.jackrabbit.core.security.user.NodeResolverTest",17,0.01,1.82,180,2.80,102023.36,22,5,18,64,19,103.81,12,227,2,4,103.81,0.67,0.50,0.21,3,0.00,4,8407.88,1,3,17,org.apache.jackrabbit.test.AbstractJCRTest,0.09,47,3,31,2,47,14,0,8,1567,2
"org.apache.jackrabbit.core.security.user.NotUserAdministratorTest",9,0.54,2.78,98,1.23,28384.48,12,3,14,33,11,145.80,24,134,1,5,105.91,0.00,0.80,0.81,0,0.00,4,3682.23,6,0,10,org.apache.jackrabbit.api.security.user.AbstractUserTest,0.21,24,4,25,0,24,9,0,22,711,1
"org.apache.jackrabbit.core.security.user.TestAll",1,0.00,1.00,18,0.22,7785.13,1,0,4,3,15,75.66,5,20,0,2,93.53,0.00,0.50,0.00,0,1.00,1,648.50,0,1,15,junit.framework.TestCase,0.00,2,1,1,0,2,0,0,1,135,1
"org.apache.jackrabbit.core.security.user.TraversingNodeResolver",11,0.20,4.27,123,2.10,101896.77,12,1,25,50,11,68.36,73,185,2,2,100.58,0.00,0.50,0.82,4,0.00,10,6289.29,4,6,9,org.apache.jackrabbit.core.security.user.NodeResolver,0.00,39,1,47,0,39,5,0,20,1122,0
"org.apache.jackrabbit.core.security.user.TraversingNodeResolverTest",1,1.00,1.00,4,0.05,906.67,2,1,5,3,6,175.25,1,7,1,5,125.25,0.00,0.80,0.00,0,1.00,1,160.00,0,1,5,org.apache.jackrabbit.core.security.user.NodeResolverTest,0.00,2,4,1,0,2,0,0,1,40,1
"org.apache.jackrabbit.core.security.user.UserAccessControlProvider",15,0.01,2.67,119,1.60,68090.99,25,10,35,52,24,92.58,81,160,2,2,110.45,0.00,0.50,0.09,3,88.00,9,4803.09,4,8,22,org.apache.jackrabbit.core.security.authorization.AbstractAccessControlProvider,0.00,37,1,40,0,37,7,1,24,924,1
"org.apache.jackrabbit.core.security.user.UserAccessControlProvider$CompiledPermissionsImpl",7,0.33,4.57,85,1.35,86255.00,9,2,35,31,10,48.18,69,124,0,2,98.18,0.00,0.50,0.21,1,12.00,19,4037.97,3,1,10,org.apache.jackrabbit.core.security.authorization.AbstractCompiledPermissions,0.27,24,1,32,0,24,6,1,40,698,1
"org.apache.jackrabbit.core.security.user.UserAccessControlProviderTest",4,0.67,2.25,51,0.77,25047.08,6,2,18,33,13,140.55,8,64,1,5,100.66,0.00,0.80,1.00,0,0.00,3,2306.93,5,0,12,org.apache.jackrabbit.api.security.user.AbstractUserTest,0.23,29,4,9,0,29,4,0,4,420,1
"org.apache.jackrabbit.core.security.user.UserAccessControlProviderTest$ItemBasedPrincipal",2,0.00,1.00,5,0.02,211.48,2,0,18,3,0,143.83,0,7,0,1,143.83,0.00,0.00,0.00,0,2.00,1,66.87,0,2,0,java.lang.Object,0.00,1,0,2,0,1,0,0,0,23,0
"org.apache.jackrabbit.core.security.user.UserAdministratorTest",17,0.22,3.00,228,2.94,109381.69,21,4,17,61,12,139.09,46,302,1,5,99.20,0.00,0.80,0.46,1,0.00,6,8817.44,9,1,11,org.apache.jackrabbit.api.security.user.AbstractUserTest,0.18,44,4,51,0,44,16,0,39,1655,1
"org.apache.jackrabbit.core.security.user.UserConstants",0,0.00,0.00,22,0.46,12388.73,21,21,3,2,19,171.00,27,23,16,1,171.00,0.00,0.00,0.00,0,0.00,0,1370.18,0,0,3,,0.00,2,0,0,0,2,0,0,7,237,0
"org.apache.jackrabbit.core.security.user.UserImpl",11,0.45,2.09,55,0.56,11372.07,13,2,13,23,20,121.25,46,82,12,2,121.02,0.00,0.50,0.09,3,43.00,4,1693.63,4,5,10,org.apache.jackrabbit.core.security.user.AuthorizableImpl,0.00,12,1,23,0,12,6,1,18,384,1
"org.apache.jackrabbit.core.security.user.UserImpl$NodeBasedAdminPrincipal",2,0.00,1.00,5,0.03,346.89,2,0,13,4,2,142.14,0,8,0,2,142.14,0.00,0.50,0.00,0,2.00,1,102.43,0,1,2,org.apache.jackrabbit.core.security.principal.AdminPrincipal,0.00,2,1,2,0,2,1,1,0,32,1
"org.apache.jackrabbit.core.security.user.UserImplTest",8,0.29,1.75,95,1.49,68725.37,12,4,20,46,11,151.05,12,114,1,5,101.05,0.00,0.80,0.50,0,0.00,4,4470.14,7,0,10,org.apache.jackrabbit.api.security.user.AbstractUserTest,0.21,38,4,14,0,38,8,0,10,816,1
"org.apache.jackrabbit.core.security.user.UserImporter",13,0.11,5.77,254,4.23,355503.74,25,12,39,105,29,39.48,137,318,3,1,87.96,0.00,0.00,0.19,1,17.00,31,12691.47,0,1,26,java.lang.Object,0.00,92,0,75,0,92,12,2,61,1956,1
"org.apache.jackrabbit.core.security.user.UserImporter$Membership",3,0.50,1.00,12,0.11,1910.91,5,2,39,6,1,126.70,12,17,0,1,126.46,0.00,0.00,0.17,1,4.00,1,336.61,0,0,1,java.lang.Object,0.00,3,0,3,0,3,3,0,3,85,2
"org.apache.jackrabbit.core.security.user.UserImporter$Membership$Impersonators",1,2.00,1.00,6,0.05,685.44,3,2,39,1,0,119.64,0,8,0,1,119.64,0.00,0.00,0.00,0,1.00,1,139.98,0,0,0,java.lang.Object,0.00,0,0,1,0,0,1,0,0,39,2
"org.apache.jackrabbit.core.security.user.UserImporter$Membership$ImportBehavior",2,1.17,2.50,23,0.25,4959.31,8,6,39,4,0,62.92,14,32,0,1,105.21,0.00,0.00,0.75,0,0.00,4,748.43,0,1,0,java.lang.Object,0.00,2,0,5,0,2,1,0,3,163,3
"org.apache.jackrabbit.core.security.user.UserImporter$Membership$Member",1,2.00,1.00,7,0.05,603.76,3,2,39,1,1,117.58,0,9,0,1,117.58,0.00,0.00,0.00,0,1.00,1,140.46,0,0,1,java.lang.Object,0.00,0,0,1,0,0,1,0,0,39,1
"org.apache.jackrabbit.core.security.user.UserImporter$SessionWriteOperation<Object>",1,0.00,5.00,16,0.27,8794.56,1,0,39,10,5,144.65,1,21,0,1,94.65,0.00,0.00,0.00,0,0.00,5,816.34,0,1,5,java.lang.Object,0.00,9,0,5,0,9,0,0,1,143,0
"org.apache.jackrabbit.core.security.user.UserImporterTest",40,0.25,3.02,616,10.19,366676.18,43,3,66,133,28,135.56,115,997,1,4,95.67,0.00,0.75,0.58,3,0.00,11,30562.11,2,1,27,org.apache.jackrabbit.test.AbstractJCRTest,0.12,93,3,121,0,93,39,0,77,5197,1
"org.apache.jackrabbit.core.security.user.UserImporterTest$DummySession",44,0.00,1.00,74,0.65,5473.97,44,0,66,45,3,154.50,0,119,0,1,154.50,0.00,0.00,0.00,0,44.00,1,1944.35,0,22,3,java.lang.Object,0.00,1,0,44,0,1,22,1,0,540,2
"org.apache.jackrabbit.core.security.user.UserImporterTest$DummySession$UserManager",10,0.00,1.00,20,0.18,1839.38,10,0,66,10,4,141.94,0,30,0,1,141.94,0.00,0.00,0.00,0,10.00,1,539.97,0,8,4,java.lang.Object,0.00,0,0,10,0,0,2,0,0,144,0
"org.apache.jackrabbit.core.security.user.UserImporterTest$PseudoConfig",3,0.50,1.00,9,0.09,1107.20,4,1,66,6,2,132.99,0,15,0,2,132.99,0.00,0.50,0.67,0,1.00,1,256.89,0,1,2,org.apache.jackrabbit.core.config.ImportConfig,0.33,3,1,3,0,3,2,0,0,68,2
"org.apache.jackrabbit.core.security.user.UserManagerImpl",39,0.01,2.46,268,3.76,141040.70,57,18,40,110,41,93.60,577,376,20,2,113.75,1.00,0.33,0.06,11,523.00,9,11269.70,4,21,26,org.apache.jackrabbit.core.ProtectedItemModifier,0.00,71,1,96,1,71,18,3,80,2160,1
"org.apache.jackrabbit.core.security.user.UserManagerImpl$AuthorizableIterator",5,0.00,2.00,28,0.26,6710.52,8,3,40,14,2,160.02,13,40,0,1,120.14,0.00,0.00,0.33,0,5.00,5,794.38,0,2,2,java.lang.Object,0.00,9,0,10,0,9,3,1,7,181,2
"org.apache.jackrabbit.core.security.user.UserManagerImpl$NodeCreator",9,0.02,4.78,134,1.94,97424.94,15,6,40,48,5,63.90,62,176,0,1,96.12,0.00,0.00,0.19,3,15.00,9,5830.62,0,6,5,java.lang.Object,0.00,39,0,43,0,39,3,0,52,1054,1
"org.apache.jackrabbit.core.security.user.UserManagerImplTest",18,0.71,3.50,278,3.92,182541.28,19,1,20,73,13,145.29,32,374,1,5,95.29,0.00,0.80,0.33,1,0.00,10,11754.79,7,1,12,org.apache.jackrabbit.api.security.user.AbstractUserTest,0.09,55,4,63,0,55,17,0,27,2140,1
"org.apache.jackrabbit.core.security.user.UserPerWorkspaceUserManager",5,0.75,1.00,12,0.12,1311.42,6,1,5,5,6,92.62,42,21,3,3,140.72,0.00,0.67,0.40,0,7.00,1,354.18,0,0,3,org.apache.jackrabbit.core.security.user.UserManagerImpl,0.10,0,2,5,0,0,5,0,7,95,1
"org.apache.jackrabbit.rmi.server.RemoteAdapterFactory",39,0.00,1.00,40,0.36,2025.90,39,0,65,39,75,115.20,290,69,46,1,157.49,0.00,0.00,0.00,0,39.00,1,1066.49,0,38,29,,0.00,0,0,39,0,0,1,0,38,343,1
"org.apache.jackrabbit.rmi.server.ServerAdapterFactory",43,0.27,1.23,131,1.49,40308.95,46,3,88,98,73,150.37,159,220,4,1,129.75,0.00,0.00,0.07,1,300.00,4,4471.42,0,39,70,java.lang.Object,0.00,55,0,53,0,55,4,1,39,1043,1
"org.apache.jackrabbit.rmi.server.ServerEventCollection",3,0.25,1.00,12,0.10,1568.36,5,2,2,3,4,78.66,31,19,1,2,127.14,0.00,0.50,0.33,0,5.00,1,292.08,0,1,3,org.apache.jackrabbit.rmi.server.ServerObject,0.00,0,2,3,0,0,2,1,7,75,1
"org.apache.jackrabbit.rmi.server.ServerEventCollection$ServerEvent",4,0.11,1.00,15,0.11,1504.93,7,3,2,4,2,153.54,14,22,0,2,132.92,0.00,0.50,0.25,0,10.00,1,328.31,0,2,2,org.apache.jackrabbit.rmi.server.ServerObject,0.00,0,2,4,0,0,2,1,7,86,2
"org.apache.jackrabbit.rmi.server.ServerItem",11,0.10,1.73,41,0.37,6995.17,12,1,5,21,7,170.89,30,72,3,2,131.00,4.00,0.17,0.91,0,0.00,2,1101.01,3,4,4,org.apache.jackrabbit.rmi.server.ServerObject,0.00,10,2,19,4,10,7,1,13,274,1
"org.apache.jackrabbit.rmi.server.ServerItemDefinition",7,0.17,1.14,21,0.17,2690.33,8,1,5,14,7,133.05,28,31,3,2,132.82,2.00,0.25,0.86,0,0.00,2,496.55,1,2,4,org.apache.jackrabbit.rmi.server.ServerObject,0.00,7,2,8,2,7,5,1,9,132,1
"org.apache.jackrabbit.rmi.server.ServerLock",8,0.14,1.00,19,0.15,1924.72,9,1,6,15,5,180.90,23,29,1,2,141.02,0.00,0.50,0.88,0,0.00,1,453.57,1,3,4,org.apache.jackrabbit.rmi.server.ServerObject,0.00,7,2,8,0,7,5,1,10,127,1
"org.apache.jackrabbit.rmi.server.ServerLockManager",9,0.12,1.89,37,0.39,8157.26,10,1,5,18,5,125.11,1,70,1,2,125.11,0.00,0.50,0.89,0,0.00,2,1163.68,2,3,4,org.apache.jackrabbit.rmi.server.ServerObject,0.00,9,2,17,0,9,6,1,1,276,1
"org.apache.jackrabbit.rmi.server.ServerNamespaceRegistry",7,0.17,1.86,29,0.28,5980.53,8,1,4,13,4,145.93,25,56,1,2,125.31,0.00,0.50,0.86,0,0.00,2,840.22,1,4,3,org.apache.jackrabbit.rmi.server.ServerObject,0.00,6,2,13,0,6,3,1,9,204,1
"org.apache.jackrabbit.rmi.server.ServerNode",53,0.02,2.02,225,2.46,54418.55,54,1,17,104,14,174.67,84,425,3,3,124.67,1.00,0.40,0.98,1,0.00,3,7390.17,5,30,11,org.apache.jackrabbit.rmi.server.ServerItem,0.00,51,3,107,2,51,23,1,61,1702,1
"org.apache.jackrabbit.rmi.server.ServerNodeDefinition",4,0.33,1.25,15,0.13,2442.93,5,1,5,8,5,113.34,21,22,1,3,131.21,0.00,0.67,0.75,0,0.00,2,392.74,2,2,4,org.apache.jackrabbit.rmi.server.ServerItemDefinition,0.00,4,3,5,0,4,2,1,6,100,1
"org.apache.jackrabbit.rmi.server.ServerNodeType",20,0.26,1.20,63,0.62,17052.51,21,1,8,36,6,169.97,59,91,1,2,130.08,0.00,0.50,0.75,4,0.00,3,1849.60,1,10,5,org.apache.jackrabbit.rmi.server.ServerObject,0.00,16,2,24,0,16,10,1,24,452,1
"org.apache.jackrabbit.rmi.server.ServerNodeTypeManager",7,0.17,1.86,29,0.31,5970.50,8,1,6,15,6,145.93,23,61,1,2,125.32,0.00,0.50,0.86,0,0.00,2,915.52,2,4,5,org.apache.jackrabbit.rmi.server.ServerObject,0.00,8,2,13,0,8,3,1,7,218,1
"org.apache.jackrabbit.rmi.server.ServerObject",8,0.57,4.62,86,0.98,52411.23,9,1,36,41,23,59.17,91,104,18,1,103.29,0.00,0.00,0.50,2,8.00,20,2945.03,0,7,5,java.rmi.server.UnicastRemoteObject,0.00,33,1,37,40,33,1,0,12,619,1
"org.apache.jackrabbit.rmi.server.ServerObservationManager",6,0.07,2.17,41,0.42,11436.92,9,3,9,16,7,67.86,50,66,1,2,115.96,0.00,0.50,0.39,1,10.00,3,1248.78,1,2,6,org.apache.jackrabbit.rmi.server.ServerObject,0.00,10,2,13,0,10,4,1,18,267,1
"org.apache.jackrabbit.rmi.server.ServerProperty",9,0.12,1.89,37,0.36,7304.42,10,1,7,18,6,165.37,26,67,1,3,125.49,0.00,0.67,0.89,0,0.00,2,1076.05,3,3,5,org.apache.jackrabbit.rmi.server.ServerItem,0.00,9,3,17,0,9,6,1,11,260,1
"org.apache.jackrabbit.rmi.server.ServerPropertyDefinition",5,0.25,1.20,15,0.13,2178.33,6,1,6,10,5,132.61,23,25,1,3,132.38,0.00,0.67,0.80,0,0.00,2,394.12,1,2,4,org.apache.jackrabbit.rmi.server.ServerItemDefinition,0.00,5,3,6,0,5,3,1,7,103,1
"org.apache.jackrabbit.rmi.server.ServerQuery",6,0.20,1.00,15,0.14,1757.58,7,1,6,12,6,160.96,22,26,1,2,140.35,0.00,0.50,0.83,0,0.00,1,411.45,2,5,5,org.apache.jackrabbit.rmi.server.ServerObject,0.00,6,2,6,0,6,1,1,8,111,1
"org.apache.jackrabbit.rmi.server.ServerQueryManager",4,0.00,2.00,23,0.27,6559.51,6,2,10,11,4,101.58,23,41,1,2,119.45,0.00,0.50,0.50,0,0.00,3,800.95,2,3,4,org.apache.jackrabbit.rmi.server.ServerObject,0.00,7,2,8,0,7,1,1,7,176,1
"org.apache.jackrabbit.rmi.server.ServerQueryResult",4,0.33,1.00,11,0.11,1384.30,5,1,5,9,5,121.90,20,19,1,2,139.78,0.00,0.50,0.75,0,0.00,1,324.93,1,3,4,org.apache.jackrabbit.rmi.server.ServerObject,0.00,5,2,4,0,5,1,1,6,86,1
"org.apache.jackrabbit.rmi.server.ServerRepository",7,0.17,1.57,29,0.32,6558.95,8,1,7,11,5,145.65,24,50,1,2,125.04,0.00,0.50,0.86,0,0.00,2,947.88,2,6,4,org.apache.jackrabbit.rmi.server.ServerObject,0.00,4,2,11,0,4,1,1,9,219,1
"org.apache.jackrabbit.rmi.server.ServerRow",3,0.50,1.00,9,0.09,1200.54,4,1,6,6,5,100.49,19,15,1,2,132.71,0.00,0.50,0.67,0,1.00,1,273.47,1,2,4,org.apache.jackrabbit.rmi.server.ServerObject,0.00,3,2,3,0,3,1,1,5,71,1
"org.apache.jackrabbit.rmi.server.ServerSession",34,0.00,1.62,119,1.27,26770.28,36,2,14,73,10,180.28,57,222,2,2,130.28,1.00,0.33,0.50,0,0.00,2,3796.17,4,16,8,org.apache.jackrabbit.rmi.server.ServerObject,0.00,39,2,55,1,39,18,1,37,902,1
"org.apache.jackrabbit.rmi.server.ServerVersion",6,0.40,2.00,32,0.31,9777.06,7,1,6,12,5,77.18,42,48,1,4,119.47,0.00,0.75,0.67,1,0.00,3,937.06,2,5,4,org.apache.jackrabbit.rmi.server.ServerNode,0.00,6,4,12,0,6,1,1,18,216,1
"org.apache.jackrabbit.rmi.server.ServerVersionHistory",13,0.08,1.77,52,0.57,12521.79,14,1,7,26,6,164.80,31,97,1,4,124.91,0.00,0.75,0.92,0,0.00,3,1716.76,3,7,5,org.apache.jackrabbit.rmi.server.ServerNode,0.00,13,4,23,0,13,6,1,16,399,1
"org.apache.jackrabbit.rmi.server.ServerVersionManager",14,0.08,1.93,57,0.68,14264.54,15,1,8,30,8,124.70,0,122,1,2,124.70,0.00,0.50,0.93,0,0.00,2,2053.11,2,9,7,org.apache.jackrabbit.rmi.server.ServerObject,0.00,16,2,27,0,16,5,1,0,473,1
"org.apache.jackrabbit.rmi.server.ServerWorkspace",16,0.00,2.00,77,0.83,19209.79,20,4,18,37,10,164.02,36,144,1,2,124.13,0.00,0.50,0.25,2,0.00,3,2476.15,2,8,9,org.apache.jackrabbit.rmi.server.ServerObject,0.00,21,2,32,0,21,8,1,16,563,1
"org.apache.jackrabbit.rmi.server.ServerXASession",11,0.20,1.91,49,0.48,12670.82,12,1,7,23,5,174.29,12,79,1,3,124.29,0.00,0.67,0.82,1,0.00,3,1444.51,0,2,4,org.apache.jackrabbit.rmi.server.ServerSession,0.00,12,3,21,0,12,9,1,3,341,1
"org.apache.jackrabbit.core.persistence.pool.AbstractBundlePersistenceManager",32,0.01,2.75,271,3.58,272518.35,43,11,31,99,28,63.84,252,357,3,1,106.13,0.00,0.00,0.08,13,328.00,27,10732.51,0,15,25,java.lang.Object,0.00,67,0,88,9,67,17,3,67,2034,2
"org.apache.jackrabbit.core.persistence.pool.BundleDbPersistenceManager",63,0.02,2.32,511,6.89,424841.84,98,35,42,170,32,74.75,427,703,7,2,106.97,7.00,0.11,0.05,18,2111.00,22,20668.78,5,24,25,org.apache.jackrabbit.core.persistence.pool.AbstractBundlePersistenceManager,0.06,107,1,146,7,107,39,1,147,3687,1
"org.apache.jackrabbit.core.persistence.pool.BundleDbPersistenceManager$CloseableBLOBStore",1,0.00,1.00,2,0.01,64.15,1,0,42,1,0,145.54,0,3,0,2,145.54,0.00,0.50,0.00,0,1.00,1,30.46,0,0,0,,0.00,0,1,1,0,0,1,0,0,12,2
"org.apache.jackrabbit.core.persistence.pool.BundleDbPersistenceManager$DbBlobStore",6,0.16,1.67,53,0.63,19350.16,11,5,42,24,3,130.18,18,65,0,1,109.57,0.00,0.00,0.33,0,0.00,4,1881.95,0,2,3,java.lang.Object,0.00,18,0,10,0,18,4,1,10,384,1
"org.apache.jackrabbit.core.persistence.pool.BundleDbPersistenceManager$DbBlobStore$FilterInputStream",1,0.00,1.00,5,0.03,464.14,1,0,42,3,1,173.93,1,8,0,1,123.93,0.00,0.00,0.00,0,1.00,1,95.37,0,0,1,java.lang.Object,0.00,2,0,1,0,2,1,0,1,27,0
"org.apache.jackrabbit.core.persistence.pool.BundleDbPersistenceManager$FSBlobStore",3,1.00,1.33,11,0.09,1127.40,4,1,42,6,3,132.86,1,17,0,2,132.86,0.00,0.50,0.33,0,4.00,2,256.14,0,1,3,org.apache.jackrabbit.core.persistence.util.FileSystemBLOBStore,0.00,3,1,4,0,3,2,1,1,69,1
"org.apache.jackrabbit.core.persistence.pool.BundleFsPersistenceManager",25,0.03,2.52,228,2.99,121535.07,34,9,28,91,19,73.94,151,304,1,2,106.16,0.00,0.50,0.14,5,244.00,7,8983.87,3,10,18,org.apache.jackrabbit.core.persistence.pool.AbstractBundlePersistenceManager,0.07,66,1,63,0,66,15,0,41,1703,1
"org.apache.jackrabbit.core.persistence.pool.BundleFsPersistenceManager$CloseableBLOBStore",1,0.00,1.00,2,0.01,64.15,1,0,28,1,0,145.54,0,3,0,2,145.54,0.00,0.50,0.00,0,1.00,1,30.46,0,0,0,,0.00,0,1,1,0,0,1,0,0,12,2
"org.apache.jackrabbit.core.persistence.pool.BundleFsPersistenceManager$FSBlobStore",3,1.00,1.33,11,0.09,1158.56,4,1,28,6,3,132.77,1,17,0,2,132.77,0.00,0.50,0.33,0,4.00,2,265.04,0,1,3,org.apache.jackrabbit.core.persistence.util.FileSystemBLOBStore,0.00,3,1,4,0,3,2,1,1,71,1
"org.apache.jackrabbit.core.persistence.pool.DbNameIndex",8,0.14,2.62,82,0.95,35494.08,14,6,6,23,8,62.46,58,112,5,1,104.76,0.00,0.00,0.29,2,10.00,4,2848.43,0,2,3,java.lang.Object,0.00,15,0,21,2,15,6,1,17,561,1
"org.apache.jackrabbit.core.persistence.pool.DerbyPersistenceManager",14,0.04,1.36,50,0.59,9809.98,20,6,6,23,5,93.16,168,80,1,3,130.72,0.00,0.67,0.13,0,86.00,6,1756.20,10,6,4,org.apache.jackrabbit.core.persistence.pool.BundleDbPersistenceManager,0.06,9,2,19,0,9,8,0,23,397,1
"org.apache.jackrabbit.core.persistence.pool.H2PersistenceManager",3,0.50,2.33,17,0.18,2742.69,4,1,1,8,3,77.29,33,25,1,3,121.41,0.00,0.67,0.67,0,1.00,5,544.33,9,1,2,org.apache.jackrabbit.core.persistence.pool.BundleDbPersistenceManager,0.00,5,2,7,0,5,2,0,6,119,1
"org.apache.jackrabbit.core.persistence.pool.MSSqlPersistenceManager",4,0.67,1.25,14,0.13,2564.32,5,1,1,7,2,88.76,30,22,0,3,131.05,0.00,0.67,0.50,0,4.00,2,378.59,3,2,2,org.apache.jackrabbit.core.persistence.pool.BundleDbPersistenceManager,0.03,3,2,5,0,3,2,0,5,96,1
"org.apache.jackrabbit.core.persistence.pool.MySqlPersistenceManager",1,0.00,3.00,7,0.06,831.10,1,0,1,1,2,155.53,21,11,0,3,116.23,0.00,0.67,0.00,0,1.00,3,178.03,5,0,2,org.apache.jackrabbit.core.persistence.pool.BundleDbPersistenceManager,0.00,0,2,3,0,0,1,0,3,43,1
"org.apache.jackrabbit.core.persistence.pool.NGKDbNameIndex",3,0.00,1.33,14,0.15,3065.56,3,0,3,6,3,76.67,24,23,1,2,124.78,0.00,0.50,0.00,0,1.00,2,449.79,1,0,2,org.apache.jackrabbit.core.persistence.pool.DbNameIndex,0.00,3,1,4,0,3,3,0,5,103,1
"org.apache.jackrabbit.core.persistence.pool.Oracle9PersistenceManager",1,0.00,1.00,5,0.05,971.04,1,0,3,3,3,147.69,19,8,0,4,121.40,0.00,0.75,0.00,0,0.00,1,140.85,0,1,3,org.apache.jackrabbit.core.persistence.pool.OraclePersistenceManager,0.00,2,3,1,0,2,0,0,2,35,1
"org.apache.jackrabbit.core.persistence.pool.OraclePersistenceManager",7,0.83,1.71,29,0.29,5556.62,8,1,6,15,8,93.36,45,45,1,3,125.58,0.50,0.50,0.29,0,23.00,5,868.91,11,4,7,org.apache.jackrabbit.core.persistence.pool.BundleDbPersistenceManager,0.06,8,2,12,1,8,3,0,10,202,1
"org.apache.jackrabbit.core.persistence.pool.PostgreSQLNameIndex",4,0.67,1.75,28,0.30,7747.64,5,1,4,10,4,81.24,26,41,1,2,113.46,0.00,0.50,0.50,1,0.00,3,894.55,0,0,3,org.apache.jackrabbit.core.persistence.pool.DbNameIndex,0.00,6,1,7,0,6,4,0,5,189,1
"org.apache.jackrabbit.core.persistence.pool.PostgreSQLPersistenceManager",4,1.00,2.00,31,0.37,12332.14,5,1,12,18,9,61.84,39,46,0,3,111.84,0.00,0.67,0.25,0,6.00,3,1098.81,5,2,9,org.apache.jackrabbit.core.persistence.pool.BundleDbPersistenceManager,0.06,14,2,8,0,14,2,0,7,214,1
"org.apache.jackrabbit.spi.TestAll",1,0.00,1.00,3,0.02,158.91,1,0,3,2,1,185.87,1,5,0,2,135.87,0.00,0.50,0.00,0,1.00,1,52.05,0,1,1,junit.framework.TestCase,0.00,1,1,1,0,1,0,0,1,17,1
"org.apache.jackrabbit.jcr.AbstractItemStateFactory",5,0.25,1.40,27,0.25,5489.34,7,2,4,14,5,103.03,26,32,2,1,120.91,0.00,0.00,0.30,1,2.00,2,760.33,0,0,3,java.lang.Object,0.00,9,0,7,2,9,5,1,11,179,2
"org.apache.jackrabbit.jcr.ChangeLog",8,0.07,3.75,74,1.15,72264.24,12,4,12,29,12,55.84,68,106,5,1,103.95,0.00,0.00,0.31,0,6.00,16,3458.75,0,2,7,java.lang.Object,0.00,21,0,30,0,21,6,0,31,619,1
"org.apache.jackrabbit.jcr.ItemState",20,0.07,1.70,92,1.04,37721.04,26,6,15,46,38,74.52,166,135,30,1,122.63,0.00,0.00,0.10,4,118.00,7,3114.72,0,7,11,java.lang.Object,0.00,26,0,34,2,26,13,0,41,666,2
"org.apache.jackrabbit.jcr.ItemState$MergeResult",2,0.00,1.00,3,0.01,46.83,2,0,15,2,0,160.45,8,4,0,1,160.22,0.00,0.00,0.00,0,2.00,1,31.22,0,0,0,,0.00,0,0,2,0,0,2,0,2,14,1
"org.apache.jackrabbit.jcr.ItemState$SimpleMergeResult",3,1.00,1.00,7,0.04,426.32,4,1,15,3,0,192.82,4,11,0,1,142.82,0.00,0.00,0.33,0,4.00,1,115.44,0,0,0,java.lang.Object,0.00,0,0,3,0,0,3,1,2,37,1
"org.apache.jackrabbit.jcr.ItemStateCreationListener",1,0.00,1.00,2,0.01,60.50,1,0,0,1,5,103.45,7,3,4,2,145.74,0.00,0.50,0.00,0,1.00,1,35.16,0,0,1,,0.00,0,1,1,0,0,1,0,2,13,1
"org.apache.jackrabbit.jcr.ItemStateFactory",9,0.00,1.00,10,0.12,759.12,9,0,9,9,18,105.83,83,14,11,1,155.83,0.00,0.00,0.00,0,9.00,1,354.01,0,2,9,,0.00,0,0,9,0,0,7,0,10,103,1
"org.apache.jackrabbit.jcr.ItemStateLifeCycleListener",1,0.00,1.00,2,0.01,54.79,1,0,0,1,1,101.95,11,3,1,1,146.08,0.00,0.00,0.00,0,1.00,1,36.53,0,0,1,,0.00,0,0,1,0,0,1,0,2,13,1
"org.apache.jackrabbit.jcr.ItemStateValidator",16,0.06,3.12,140,2.28,84344.40,26,10,25,69,21,134.02,310,213,5,1,107.74,0.00,0.00,0.16,8,0.00,7,6838.84,0,1,16,java.lang.Object,0.00,53,0,50,0,53,15,0,69,1282,1
"org.apache.jackrabbit.jcr.NodeState",26,0.17,1.69,131,1.52,51767.91,30,4,19,61,70,70.72,211,186,58,2,118.83,0.00,0.50,0.09,8,186.00,6,4565.70,4,13,16,org.apache.jackrabbit.jcr2spi.state.ItemState,0.22,35,1,44,0,35,13,0,46,968,1
"org.apache.jackrabbit.jcr.PropertyState",15,0.04,2.47,106,1.27,51046.73,20,5,13,39,31,62.98,150,147,23,2,111.46,0.00,0.50,0.16,3,62.00,6,3802.91,4,5,10,org.apache.jackrabbit.jcr2spi.state.ItemState,0.29,24,1,37,0,24,10,0,34,783,1
"org.apache.jackrabbit.jcr.PropertyState$PropertyData",4,0.22,2.00,23,0.23,5757.06,7,3,13,8,3,169.90,5,28,0,1,119.90,0.00,0.00,0.17,2,6.00,4,688.15,0,0,3,java.lang.Object,0.00,4,0,8,0,4,4,0,5,159,2
"org.apache.jackrabbit.jcr.PropertyState$PropertyDiffer",3,0.00,1.67,15,0.13,2623.10,5,2,13,5,0,121.64,1,20,0,1,121.64,0.00,0.00,0.50,0,1.00,3,399.40,0,0,0,java.lang.Object,0.00,2,0,5,0,2,3,1,1,98,2
"org.apache.jackrabbit.jcr.SessionItemStateManager",23,0.08,2.30,222,3.84,151505.84,29,6,45,126,33,57.04,192,301,2,2,105.14,0.00,0.50,0.25,6,0.00,9,11534.30,0,4,32,org.apache.jackrabbit.jcr2spi.operation.TransientOperationVisitor,0.00,103,1,53,0,103,19,1,86,2067,1
"org.apache.jackrabbit.jcr.Status",7,0.21,3.00,67,0.80,41355.43,18,11,0,8,26,114.58,122,111,26,1,105.45,0.00,0.00,0.27,0,13.00,7,2413.21,0,1,0,java.lang.Object,0.00,1,0,21,0,1,6,0,33,495,2
"org.apache.jackrabbit.jcr.TransientISFactory",12,0.06,1.08,42,0.50,9327.74,15,3,17,27,19,151.04,45,61,1,2,130.42,0.00,0.50,0.28,0,24.00,2,1497.21,1,2,18,org.apache.jackrabbit.jcr2spi.state.AbstractItemStateFactory,0.00,15,1,13,0,15,10,2,21,350,2
"org.apache.jackrabbit.jcr.TransientItemStateFactory",2,0.00,1.00,3,0.04,248.10,2,0,7,2,13,110.39,22,9,5,2,154.51,0.00,0.50,0.00,0,2.00,1,117.56,0,0,8,,0.00,0,1,2,0,0,2,0,3,33,1
"org.apache.jackrabbit.jcr.TransientItemStateManager",13,0.21,3.54,142,1.93,109758.34,19,6,19,55,15,73.11,172,204,1,1,102.49,0.00,0.00,0.36,1,4.00,15,5796.96,0,2,14,java.lang.Object,0.00,42,0,46,0,42,11,1,60,1083,1
"org.apache.jackrabbit.jcr.UpdatableItemStateManager",3,0.00,1.00,4,0.02,134.12,3,0,2,3,5,125.78,19,5,3,1,158.00,0.00,0.00,0.00,0,3.00,1,73.06,0,0,2,,0.00,0,0,3,0,0,3,0,4,26,1
"org.apache.jackrabbit.jcr.WorkspaceItemStateFactory",18,0.07,3.56,208,3.00,145655.49,23,5,30,87,23,68.87,120,283,1,2,101.09,0.00,0.50,0.27,8,70.00,8,8994.57,2,6,22,org.apache.jackrabbit.jcr2spi.state.AbstractItemStateFactory,0.00,69,1,64,0,69,12,0,54,1646,1
"org.apache.jackrabbit.core.persistence.util.BLOBStore",4,0.00,1.00,5,0.04,175.53,4,0,2,4,10,109.59,43,6,9,1,158.07,0.00,0.00,0.00,0,4.00,1,125.02,0,2,1,,0.00,0,0,4,0,0,2,0,5,41,1
"org.apache.jackrabbit.core.persistence.util.BundleBinding",8,0.19,12.62,409,6.69,687770.58,11,3,20,96,19,67.39,134,555,7,2,67.86,0.00,0.50,0.50,3,0.00,29,20082.33,10,1,13,org.apache.jackrabbit.core.persistence.util.ItemStateBinding,0.00,88,1,101,0,88,7,0,75,3038,1
"org.apache.jackrabbit.core.persistence.util.BundleCache",8,0.19,1.88,54,0.63,28087.10,14,6,4,20,4,63.91,72,69,2,1,113.91,0.00,0.00,0.33,0,0.00,5,1880.17,0,0,2,java.lang.Object,0.00,12,0,15,0,12,8,0,18,391,1
"org.apache.jackrabbit.core.persistence.util.BundleCache$Entry",1,2.00,1.00,6,0.04,560.40,3,2,4,1,1,82.77,12,8,0,1,120.33,0.00,0.00,0.00,0,1.00,1,127.05,0,0,1,java.lang.Object,0.00,0,0,1,0,0,1,0,3,36,3
"org.apache.jackrabbit.core.persistence.util.ErrorHandling",4,0.00,1.75,21,0.19,5763.63,7,3,1,11,6,87.70,27,27,6,1,119.92,0.00,0.00,0.33,0,4.00,3,575.16,0,1,0,java.lang.Object,0.00,7,0,7,0,7,3,0,8,137,2
"org.apache.jackrabbit.core.persistence.util.FileSystemBLOBStore",6,0.60,1.67,42,0.48,19257.25,7,1,7,22,17,79.52,37,53,12,1,111.75,0.00,0.00,0.50,1,6.00,4,1427.50,0,3,5,java.lang.Object,0.00,16,0,10,4,16,3,1,16,293,1
"org.apache.jackrabbit.core.persistence.util.HashMapIndex",5,0.35,2.80,63,0.77,28461.80,10,5,9,31,5,56.81,56,82,2,1,100.94,0.00,0.00,0.48,2,0.00,5,2298.44,0,1,3,java.lang.Object,0.00,26,0,14,0,26,4,1,11,458,1
"org.apache.jackrabbit.core.persistence.util.ItemStateBinding",20,0.04,2.00,172,2.06,80053.93,29,9,18,71,12,58.79,185,194,1,1,108.79,0.00,0.00,0.07,9,104.00,8,6175.28,0,8,11,java.lang.Object,0.00,51,0,40,1,51,12,0,59,1209,1
"org.apache.jackrabbit.core.persistence.util.LRUNodeIdCache",4,0.33,2.00,25,0.29,7936.68,9,5,4,13,3,65.85,38,34,2,1,115.85,0.00,0.00,0.45,0,0.00,3,876.31,0,0,1,java.lang.Object,0.00,9,0,8,0,9,4,0,10,190,1
"org.apache.jackrabbit.core.persistence.util.NodePropBundle",32,0.03,1.31,127,1.46,32983.28,45,13,17,88,20,97.19,208,170,12,1,129.41,0.00,0.00,0.10,4,448.00,5,4367.41,0,10,9,java.lang.Object,0.00,56,0,42,0,56,22,0,69,949,1
"org.apache.jackrabbit.core.persistence.util.NodePropBundle$ChildNodeEntry",3,0.25,1.00,10,0.06,727.65,5,2,17,3,2,102.20,19,14,0,1,134.42,0.00,0.00,0.33,0,5.00,1,180.64,0,2,2,java.lang.Object,0.00,0,0,3,0,0,1,0,5,53,2
"org.apache.jackrabbit.core.persistence.util.NodePropBundle$PropertyEntry",16,0.02,1.31,54,0.45,9284.30,22,6,17,23,5,113.50,86,74,0,1,131.38,0.00,0.00,0.15,0,112.00,5,1344.97,0,4,5,java.lang.Object,0.00,7,0,21,0,7,12,0,23,327,2
"org.apache.jackrabbit.core.persistence.util.ResourceBasedBLOBStore",1,0.00,1.00,2,0.01,72.19,1,0,1,1,5,124.99,14,3,4,2,145.14,0.00,0.50,0.00,0,1.00,1,42.09,0,1,1,,0.00,0,1,1,0,0,0,0,2,15,1
"org.apache.jackrabbit.core.persistence.util.Serializer",6,0.20,4.00,157,2.25,132366.24,8,2,22,74,21,132.97,146,173,9,1,83.69,0.00,0.00,0.33,0,14.00,6,6753.09,0,0,12,java.lang.Object,0.00,68,0,24,0,68,6,0,78,1162,2
"org.apache.jackrabbit.webdav.security.AclProperty",6,1.00,1.50,23,0.39,11472.65,7,1,13,18,16,84.98,43,32,5,2,127.27,0.00,0.50,0.17,0,10.00,3,1155.58,0,2,12,org.apache.jackrabbit.webdav.property.AbstractDavProperty,0.00,12,1,9,0,12,4,0,6,246,1
"org.apache.jackrabbit.webdav.security.AclProperty$Ace",11,0.10,2.09,85,1.19,57241.96,23,12,13,31,9,149.93,23,109,0,1,110.04,0.00,0.00,0.17,0,60.00,6,3558.17,0,3,9,java.lang.Object,0.00,20,0,23,0,20,8,2,3,673,2
"org.apache.jackrabbit.webdav.security.AclResource",2,1.00,1.00,4,0.03,249.04,3,1,6,2,9,161.41,37,5,3,2,143.27,0.00,0.50,0.00,0,2.00,1,102.03,0,1,7,,0.00,0,1,2,0,0,1,0,4,31,1
"org.apache.jackrabbit.webdav.security.AclRestrictionsProperty",7,0.10,1.57,35,0.32,6934.53,14,7,5,12,5,141.85,25,48,0,2,121.23,0.00,0.50,0.22,0,16.00,5,970.65,1,2,5,org.apache.jackrabbit.webdav.property.AbstractDavProperty,0.00,5,1,11,0,5,5,0,6,224,1
"org.apache.jackrabbit.webdav.security.CurrentUserPrivilegeSetProperty",3,0.50,4.33,25,0.33,14689.64,4,1,9,10,9,65.63,21,34,3,2,107.92,0.00,0.50,0.67,0,1.00,9,985.99,1,1,6,org.apache.jackrabbit.webdav.property.AbstractDavProperty,0.00,7,1,13,0,7,2,0,5,197,1
"org.apache.jackrabbit.webdav.security.Principal",13,0.08,2.31,92,1.15,40973.83,33,20,10,31,11,161.73,22,118,4,1,111.73,0.00,0.00,0.12,2,106.00,8,3442.36,0,10,7,java.lang.Object,0.00,18,0,30,0,18,3,2,7,674,1
"org.apache.jackrabbit.webdav.security.Privilege",6,0.01,1.67,44,0.69,27727.60,21,15,9,20,15,128.63,110,55,9,1,110.50,0.00,0.00,0.08,1,14.00,4,2071.15,0,5,6,java.lang.Object,0.00,14,0,10,0,14,1,1,20,405,1
"org.apache.jackrabbit.webdav.security.SecurityConstants",0,0.00,0.00,15,0.36,11418.95,14,14,6,2,21,171.00,65,16,15,1,171.00,0.00,0.00,0.00,0,0.00,0,1070.05,0,0,6,,0.00,2,0,0,0,2,0,0,17,196,1
"org.apache.jackrabbit.webdav.security.SupportedPrivilege",2,0.75,4.00,31,0.37,11582.42,10,8,5,9,7,54.89,14,41,2,1,97.18,0.00,0.00,0.50,0,2.00,6,1123.70,0,1,5,java.lang.Object,0.00,7,0,8,0,7,1,1,3,228,1
"org.apache.jackrabbit.webdav.security.SupportedPrivilegeSetProperty",2,1.00,1.50,12,0.11,2499.66,3,1,4,4,3,79.93,24,16,0,2,117.49,0.00,0.50,0.50,0,2.00,2,330.75,0,1,3,org.apache.jackrabbit.webdav.property.AbstractDavProperty,0.00,2,1,3,0,2,1,0,3,79,1
"org.apache.jackrabbit.standalone.cli.fs.ExportFileSystem",9,0.16,2.11,59,0.87,31338.34,13,4,16,37,2,71.62,68,95,0,1,113.91,0.00,0.00,0.11,2,37.00,5,2595.49,0,3,2,java.lang.Object,0.00,28,0,19,0,28,6,1,18,494,1
"org.apache.jackrabbit.standalone.cli.fs.ExportPropertyToFile",10,0.11,1.70,60,0.82,31841.84,15,5,20,44,2,96.39,59,84,0,1,114.27,0.00,0.00,0.10,1,50.00,6,2450.18,0,4,2,java.lang.Object,0.00,34,0,17,0,34,6,1,19,467,1
"org.apache.jackrabbit.standalone.cli.fs.FileToInputStream",5,0.17,1.00,19,0.21,3976.95,8,3,8,13,0,170.25,11,26,0,1,130.36,0.00,0.00,0.20,0,14.00,1,643.41,0,2,0,java.lang.Object,0.00,8,0,5,0,8,3,1,6,146,1
"org.apache.jackrabbit.standalone.cli.fs.ImportFileSystem",6,0.20,2.17,48,0.61,19830.36,9,3,15,30,3,61.32,48,70,0,1,109.42,0.00,0.00,0.17,2,18.00,5,1832.54,0,2,3,java.lang.Object,0.00,24,0,13,0,24,4,1,11,365,1
"org.apache.jackrabbit.spi.commons.iterator.Iterators",11,0.00,1.73,23,0.42,10985.98,11,0,12,18,8,93.73,81,47,6,1,136.03,0.00,0.00,0.00,0,11.00,3,1271.12,0,10,2,java.lang.Object,0.00,7,0,19,0,7,1,0,11,299,2
"org.apache.jackrabbit.spi.commons.iterator.Iterators$org.apache.commons.collections.Predicate",1,0.00,1.00,3,0.03,305.52,1,0,12,2,0,133.63,0,4,0,1,133.63,0.00,0.00,0.00,0,1.00,1,95.40,0,0,0,java.lang.Object,0.00,1,0,1,0,1,1,0,0,28,0
"org.apache.jackrabbit.spi.commons.iterator.Iterators$org.apache.commons.collections.Transformer",1,0.00,1.00,3,0.03,341.76,1,0,12,2,0,133.25,0,4,0,1,133.25,0.00,0.00,0.00,0,1.00,1,93.39,0,1,0,java.lang.Object,0.00,1,0,1,0,1,0,0,0,28,0
"org.apache.jackrabbit.spi.commons.iterator.Predicate",1,0.00,1.00,2,0.01,78.61,1,0,0,1,5,100.72,11,3,5,1,144.84,0.00,0.00,0.00,0,1.00,1,39.30,0,0,0,,0.00,0,0,1,0,0,1,0,2,14,1
"org.apache.jackrabbit.spi.commons.iterator.Transformer",1,0.00,1.00,2,0.01,89.48,1,0,0,1,3,106.84,12,3,3,1,144.40,0.00,0.00,0.00,0,1.00,1,43.65,0,0,0,,0.00,0,0,1,0,0,1,0,2,15,1
"org.apache.jackrabbit.jcr.CacheBehaviour",1,2.00,1.00,4,0.03,1028.34,3,2,0,2,15,158.21,20,6,15,1,124.82,0.00,0.00,0.00,0,1.00,1,104.79,0,0,0,java.lang.Object,0.00,1,0,1,0,1,1,0,3,31,2
"org.apache.jackrabbit.jcr.RepositoryConfig",4,0.00,1.00,5,0.02,103.55,4,0,2,4,14,180.49,12,6,12,1,159.87,0.00,0.00,0.00,0,4.00,1,62.48,0,2,2,,0.00,0,0,4,0,0,2,0,2,26,1
"org.apache.jackrabbit.webdav.search.QueryGrammerSet",5,0.50,1.60,28,0.31,12522.30,6,1,9,14,9,75.76,36,34,3,2,118.05,0.00,0.50,0.60,0,5.00,3,930.46,1,3,6,org.apache.jackrabbit.webdav.property.AbstractDavProperty,0.00,9,1,8,0,9,2,1,6,207,1
"org.apache.jackrabbit.webdav.search.QueryGrammerSet$Grammer",4,0.00,1.50,21,0.20,3395.54,7,3,9,9,4,121.77,3,30,0,1,121.77,0.00,0.00,0.33,0,6.00,3,600.40,0,1,4,java.lang.Object,0.00,5,0,6,0,5,3,1,1,147,1
"org.apache.jackrabbit.webdav.search.SearchConstants",0,0.00,0.00,9,0.15,3100.00,8,8,3,2,8,171.00,51,10,5,1,171.00,0.00,0.00,0.00,0,0.00,0,440.00,0,0,3,,0.00,2,0,0,0,2,0,0,12,88,1
"org.apache.jackrabbit.webdav.search.SearchInfo",12,0.07,2.08,87,1.22,62438.27,25,13,16,38,14,61.94,100,115,7,1,110.04,0.00,0.00,0.14,0,64.00,10,3668.43,0,6,7,java.lang.Object,0.00,26,0,25,0,26,6,2,18,693,1
"org.apache.jackrabbit.webdav.search.SearchResource",2,1.00,1.00,4,0.03,161.65,3,1,2,2,10,107.19,25,5,6,1,144.75,0.00,0.00,0.00,0,2.00,1,75.01,0,2,4,,0.00,0,0,2,0,0,0,0,4,25,1
"org.apache.jackrabbit.rmi.remote.ArrayIterator",4,0.33,2.25,32,0.30,14589.92,6,2,2,7,2,60.97,33,41,1,1,109.08,0.00,0.00,0.75,0,0.00,4,899.62,0,1,1,java.lang.Object,0.00,3,0,9,0,3,3,2,7,195,1
"org.apache.jackrabbit.rmi.remote.BufferIterator",4,0.11,2.00,29,0.30,13246.12,7,3,3,9,2,61.60,39,38,1,1,111.60,0.00,0.00,0.42,0,6.00,4,912.13,0,1,1,java.lang.Object,0.00,5,0,8,0,5,3,2,8,198,1
"org.apache.jackrabbit.rmi.remote.RemoteEventCollection",2,0.00,1.00,4,0.03,202.57,2,0,2,2,7,106.42,25,5,7,2,143.98,0.00,0.50,0.00,0,2.00,1,77.16,0,0,0,,0.00,0,1,2,0,0,2,0,4,27,1
"org.apache.jackrabbit.rmi.remote.RemoteEventCollection$RemoteEvent",3,0.00,1.00,4,0.02,125.94,3,0,2,3,0,126.00,18,5,0,2,158.22,0.00,0.50,0.00,0,3.00,1,68.99,0,2,0,,0.00,0,1,3,0,0,1,0,3,26,2
"org.apache.jackrabbit.rmi.remote.RemoteItem",10,0.00,1.00,11,0.07,345.17,10,0,3,10,13,108.89,97,14,13,2,158.89,0.00,0.50,0.00,0,10.00,1,224.08,0,3,1,,0.00,0,1,10,0,0,7,0,11,79,1
"org.apache.jackrabbit.rmi.remote.RemoteItemDefinition",6,0.00,1.00,7,0.04,175.78,6,0,2,6,7,115.32,71,8,6,2,159.45,0.00,0.50,0.00,0,6.00,1,111.15,0,2,1,,0.00,0,1,6,0,0,4,0,7,43,1
"org.apache.jackrabbit.rmi.remote.RemoteIterator",3,0.00,1.00,4,0.03,150.25,3,0,3,3,30,120.05,38,5,30,2,157.62,0.00,0.50,0.00,0,3.00,1,86.13,0,1,0,,0.00,0,1,3,0,0,2,0,4,30,1
"org.apache.jackrabbit.rmi.remote.RemoteLock",7,0.00,1.00,8,0.05,217.68,7,0,3,7,11,110.77,71,9,11,2,159.25,0.00,0.50,0.00,0,7.00,1,139.09,0,2,1,,0.00,0,1,7,0,0,5,0,8,52,1
"org.apache.jackrabbit.rmi.remote.RemoteLockManager",8,0.00,1.00,9,0.09,457.18,8,0,3,8,9,157.16,0,18,8,2,157.16,0.00,0.50,0.00,0,8.00,1,279.69,0,3,1,,0.00,0,1,8,0,0,5,0,0,86,1
"org.apache.jackrabbit.rmi.remote.RemoteNamespaceRegistry",6,0.00,1.00,7,0.06,334.83,6,0,3,6,9,119.68,76,10,9,2,157.25,0.00,0.50,0.00,0,6.00,1,185.17,0,4,0,,0.00,0,1,6,0,0,2,0,7,61,1
"org.apache.jackrabbit.rmi.remote.RemoteNode",51,0.00,1.00,52,0.48,2312.93,51,0,3,51,26,107.96,503,77,20,2,157.95,0.00,0.50,0.00,0,51.00,1,1447.43,0,18,8,,0.00,0,1,51,0,0,33,0,52,459,1
"org.apache.jackrabbit.rmi.remote.RemoteNodeDefinition",3,0.00,1.00,4,0.02,122.02,3,0,1,3,11,147.97,45,5,11,2,158.33,0.00,0.50,0.00,0,3.00,1,68.77,0,0,1,,0.00,0,1,3,0,0,3,0,4,26,1
"org.apache.jackrabbit.rmi.remote.RemoteNodeType",17,0.00,1.00,18,0.13,677.74,17,0,3,17,21,109.92,170,19,20,2,158.40,0.00,0.50,0.00,0,17.00,1,388.52,0,8,2,,0.00,0,1,17,0,0,9,0,18,134,1
"org.apache.jackrabbit.rmi.remote.RemoteNodeTypeManager",6,0.00,1.00,7,0.06,276.65,6,0,3,6,11,109.42,60,14,9,2,157.90,0.00,0.50,0.00,0,6.00,1,167.33,0,0,2,,0.00,0,1,6,0,0,6,0,5,56,1
"org.apache.jackrabbit.rmi.remote.RemoteObservationManager",3,0.00,1.00,4,0.06,349.47,3,0,3,3,10,198.67,68,10,9,2,154.73,0.00,0.50,0.00,0,3.00,1,168.33,0,0,1,,0.00,0,1,3,0,0,3,0,4,47,1
"org.apache.jackrabbit.rmi.remote.RemoteProperty",8,0.00,1.00,9,0.07,359.33,8,0,3,8,14,120.43,97,11,13,2,157.99,0.00,0.50,0.00,0,8.00,1,206.45,0,2,1,,0.00,0,1,8,0,0,6,0,9,70,1
"org.apache.jackrabbit.rmi.remote.RemotePropertyDefinition",4,0.00,1.00,5,0.03,161.32,4,0,2,4,11,138.21,56,6,11,2,158.36,0.00,0.50,0.00,0,4.00,1,88.42,0,2,0,,0.00,0,1,4,0,0,2,0,5,33,1
"org.apache.jackrabbit.rmi.remote.RemoteQuery",5,0.00,1.00,6,0.04,184.47,5,0,3,5,11,108.66,46,7,9,2,158.66,0.00,0.50,0.00,0,5.00,1,116.95,0,4,2,,0.00,0,1,5,0,0,1,0,6,42,1
"org.apache.jackrabbit.rmi.remote.RemoteQueryManager",3,0.00,1.00,4,0.04,189.63,3,0,3,3,10,119.26,37,8,9,2,156.82,0.00,0.50,0.00,0,3.00,1,107.17,0,3,1,,0.00,0,1,3,0,0,0,0,4,35,1
"org.apache.jackrabbit.rmi.remote.RemoteQueryResult",3,0.00,1.00,4,0.03,143.14,3,0,3,3,9,113.65,33,5,8,2,157.78,0.00,0.50,0.00,0,3.00,1,81.40,0,1,1,,0.00,0,1,3,0,0,2,0,4,29,1
"org.apache.jackrabbit.rmi.remote.RemoteRepository",6,0.00,1.00,7,0.06,289.75,6,0,4,6,19,120.18,76,11,18,2,157.74,0.00,0.50,0.00,0,6.00,1,174.97,0,2,1,,0.00,0,1,6,0,0,4,0,7,58,1
"org.apache.jackrabbit.rmi.remote.RemoteRow",2,0.00,1.00,3,0.02,126.98,2,0,4,2,7,127.42,27,5,7,2,156.80,0.00,0.50,0.00,0,2.00,1,70.62,0,2,0,,0.00,0,1,2,0,0,0,0,3,24,1
"org.apache.jackrabbit.rmi.remote.RemoteSession",33,0.00,1.00,34,0.32,1612.64,33,0,7,33,17,109.22,353,49,12,2,157.70,0.00,0.50,0.00,0,33.00,1,948.66,0,11,5,,0.00,0,1,33,0,0,22,0,34,301,1
"org.apache.jackrabbit.rmi.remote.RemoteVersion",4,0.00,1.00,5,0.04,191.14,4,0,3,4,15,147.42,61,6,15,2,157.78,0.00,0.50,0.00,0,4.00,1,105.40,0,4,1,,0.00,0,1,4,0,0,0,0,7,37,1
"org.apache.jackrabbit.rmi.remote.RemoteVersionHistory",12,0.00,1.00,13,0.12,602.99,12,0,2,12,14,120.04,152,21,13,2,157.60,0.00,0.50,0.00,0,12.00,1,358.54,0,3,2,,0.00,0,1,12,0,0,9,0,15,115,1
"org.apache.jackrabbit.rmi.remote.RemoteVersionManager",13,0.00,1.00,14,0.15,740.95,13,0,3,13,12,207.17,15,31,8,2,157.17,0.00,0.50,0.00,0,13.00,1,461.30,0,4,4,,0.00,0,1,13,0,0,9,0,15,140,1
"org.apache.jackrabbit.rmi.remote.RemoteWorkspace",15,0.00,1.00,16,0.16,816.48,15,0,4,15,14,109.23,127,31,8,2,157.33,0.00,0.50,0.00,0,15.00,1,472.75,0,4,6,,0.00,0,1,15,0,0,11,0,12,148,1
"org.apache.jackrabbit.rmi.remote.RemoteXASession",9,0.00,1.00,10,0.10,483.25,9,0,4,9,3,157.61,40,12,3,3,157.38,0.00,0.67,0.00,0,9.00,1,303.61,0,1,0,,0.00,0,2,9,0,0,8,0,10,94,1
"org.apache.jackrabbit.rmi.remote.SerializableXid",6,0.25,1.00,20,0.20,3362.43,10,4,3,14,2,131.56,5,32,2,1,131.56,0.00,0.00,0.46,0,0.00,1,589.63,0,0,0,java.lang.Object,0.00,8,0,6,0,8,6,2,1,150,1
"org.apache.jackrabbit.core.security.simple.SimpleAccessManager",22,0.08,2.23,128,1.51,38598.86,31,9,25,43,17,119.43,91,182,2,2,119.20,0.00,0.50,0.19,5,118.00,5,4518.62,0,5,15,org.apache.jackrabbit.core.security.AbstractAccessControlManager,0.12,21,1,49,0,21,17,1,43,941,1
"org.apache.jackrabbit.core.security.simple.SimpleLoginModule",4,1.00,1.75,20,0.22,4901.64,5,1,13,8,2,88.26,26,32,0,2,120.48,0.00,0.50,0.25,0,8.00,2,654.83,2,2,2,org.apache.jackrabbit.core.security.authentication.AbstractLoginModule,0.00,4,1,7,0,4,2,0,7,147,1
"org.apache.jackrabbit.core.security.simple.SimpleLoginModule$Authentication",2,0.00,1.00,5,0.03,224.11,2,0,13,2,0,143.63,0,7,0,1,143.63,0.00,0.00,0.00,0,2.00,1,84.24,0,0,0,java.lang.Object,0.00,0,0,2,0,0,2,0,0,26,0
"org.apache.jackrabbit.core.security.simple.SimpleSecurityManager",10,0.12,3.00,108,1.39,67701.84,19,9,45,52,29,60.99,78,138,2,1,103.28,0.00,0.00,0.22,2,26.00,12,4181.01,0,6,28,java.lang.Object,0.00,42,0,30,0,42,4,1,32,744,1
"org.apache.jackrabbit.core.security.simple.SimpleSecurityManager$SimplePrincipalProvider",9,0.75,2.00,46,0.54,17029.57,10,1,45,24,8,118.96,3,67,0,1,118.96,0.00,0.00,0.33,2,18.00,4,1623.92,0,5,8,java.lang.Object,0.00,15,0,18,0,15,4,1,3,352,1
"org.apache.jackrabbit.core.security.simple.SimpleWorkspaceAccessManager",3,0.00,1.00,5,0.04,377.75,3,0,5,3,2,122.24,18,10,1,1,154.46,0.00,0.00,0.00,0,3.00,1,124.30,0,0,1,java.lang.Object,0.00,0,0,3,0,0,3,1,6,37,1
"org.apache.jackrabbit.server.util.HttpMultipartPost",12,0.07,2.67,106,1.21,46317.88,16,4,17,49,1,58.85,111,132,1,1,108.84,0.00,0.00,0.31,4,14.00,5,3637.18,0,7,0,java.lang.Object,0.00,37,0,32,0,37,5,0,18,732,0
"org.apache.jackrabbit.server.util.RequestData",7,0.17,1.43,23,0.28,7115.65,9,2,6,21,3,87.15,52,32,2,1,129.44,0.00,0.00,0.64,0,0.00,2,835.79,0,5,1,java.lang.Object,0.00,14,0,10,0,14,2,0,7,204,1
"org.apache.jackrabbit.core.AbstractConcurrencyTest",6,1.00,3.83,87,1.12,62100.79,7,1,8,30,15,46.32,57,89,14,4,96.32,4.33,0.18,0.17,3,14.00,10,3347.88,1,0,1,org.apache.jackrabbit.test.AbstractJCRTest,0.00,24,3,23,13,24,6,0,14,620,2
"org.apache.jackrabbit.core.AbstractConcurrencyTest$Executor",3,0.25,1.33,16,0.13,1816.98,7,4,8,5,0,122.95,0,23,0,1,122.95,0.00,0.00,0.42,0,1.00,2,380.67,0,1,0,java.lang.Object,0.00,2,0,4,0,2,2,1,0,96,2
"org.apache.jackrabbit.core.AbstractConcurrencyTest$Task",1,0.00,1.00,2,0.02,119.55,1,0,8,1,0,143.41,0,4,0,1,143.41,0.00,0.00,0.00,0,1.00,1,51.02,0,0,0,,0.00,0,0,1,0,0,1,0,0,16,1
"org.apache.jackrabbit.core.AbstractNodeData",9,0.88,1.22,24,0.16,1900.81,10,1,5,12,11,123.55,52,36,7,2,141.42,2.00,0.25,0.22,0,19.00,2,471.79,3,4,5,org.apache.jackrabbit.core.ItemData,0.19,3,1,11,2,3,5,0,11,136,2
"org.apache.jackrabbit.core.AddMixinOperation",3,0.00,4.67,53,0.93,61977.26,5,2,24,38,13,46.64,33,82,1,1,90.77,0.00,0.00,0.50,0,1.00,12,2779.03,0,2,13,java.lang.Object,0.00,35,0,14,0,35,1,1,29,439,0
"org.apache.jackrabbit.core.BatchedItemOperations",36,0.07,4.72,566,10.20,728041.72,43,7,49,174,38,132.16,761,940,2,2,92.86,0.00,0.50,0.21,16,0.00,35,30612.49,3,17,36,org.apache.jackrabbit.core.ItemValidator,0.00,138,1,170,0,138,19,0,210,4891,1
"org.apache.jackrabbit.core.CachingHierarchyManager",28,0.05,3.86,309,4.43,203444.84,37,9,24,104,20,53.33,235,436,4,2,101.44,1.00,0.33,0.16,12,102.00,9,13278.25,8,5,16,org.apache.jackrabbit.core.HierarchyManagerImpl,0.00,76,1,108,1,76,23,2,74,2448,1
"org.apache.jackrabbit.core.CachingHierarchyManager$LRUEntry",10,0.03,1.90,59,0.54,22597.81,14,4,24,12,2,100.49,56,77,0,1,118.37,0.00,0.00,0.22,2,50.00,5,1611.69,0,4,2,java.lang.Object,0.00,2,0,19,0,2,6,0,14,370,1
"org.apache.jackrabbit.core.CachingHierarchyManager$PathMap.ElementVisitor<LRUEntry>",1,0.00,2.00,6,0.08,1766.27,1,0,24,5,0,116.24,0,8,0,1,116.24,0.00,0.00,0.00,0,0.00,2,236.61,0,0,0,java.lang.Object,0.00,4,0,2,0,4,1,0,0,55,0
"org.apache.jackrabbit.core.CachingHierarchyManager$PathMap.ElementVisitor<LRUEntry>_0",1,0.00,3.00,17,0.21,8463.37,1,0,24,8,0,93.92,0,17,0,1,93.92,0.00,0.00,0.00,0,1.00,3,615.21,0,0,0,java.lang.Object,0.00,7,0,3,0,7,1,0,0,120,0
"org.apache.jackrabbit.core.CachingHierarchyManager$PathMapElementCounter",1,0.00,5.00,21,0.31,18344.84,2,1,24,5,0,87.73,0,30,0,1,87.73,0.00,0.00,1.00,0,0.00,5,932.35,0,0,0,java.lang.Object,0.00,4,0,5,0,4,1,1,0,172,0
"org.apache.jackrabbit.core.CachingHierarchyManagerTest",15,0.05,1.33,186,2.74,79157.38,18,3,20,54,19,101.60,69,203,1,2,101.37,0.00,0.50,0.29,3,0.00,4,8210.06,0,2,18,junit.framework.TestCase,0.00,39,1,20,0,39,13,0,21,1579,1
"org.apache.jackrabbit.core.CachingHierarchyManagerTest$Runnable",1,0.00,3.00,7,0.05,939.05,1,0,20,1,0,115.81,0,11,0,1,115.81,0.00,0.00,0.00,0,0.00,3,150.62,0,0,0,java.lang.Object,0.00,0,0,3,0,0,1,0,0,37,0
"org.apache.jackrabbit.core.CachingHierarchyManagerTest$StaticItemStateManager",16,0.03,2.00,96,1.24,45144.65,21,5,20,54,13,96.77,91,132,0,1,114.64,0.00,0.00,0.18,2,76.00,6,3721.30,0,7,13,java.lang.Object,0.00,38,0,32,0,38,9,1,22,778,1
"org.apache.jackrabbit.core.ConcurrencyTest",3,0.00,2.67,40,0.44,22767.67,7,4,7,14,2,138.55,8,42,1,4,98.67,0.00,0.75,0.25,0,4.00,6,1315.97,3,0,1,org.apache.jackrabbit.test.AbstractJCRTest,0.28,11,3,8,0,11,3,0,6,247,1
"org.apache.jackrabbit.core.ConcurrencyTest$TestSession",3,0.33,3.00,51,0.57,25876.47,6,3,7,17,0,143.86,3,62,0,1,93.86,0.00,0.00,0.56,1,0.00,6,1711.16,0,0,0,java.lang.Object,0.00,14,0,9,0,14,3,1,3,304,0
"org.apache.jackrabbit.core.ConcurrencyTest3",8,0.06,1.88,81,0.89,39134.63,13,5,11,36,2,104.50,7,84,0,2,104.50,0.00,0.50,0.25,5,14.00,7,2668.86,0,1,2,junit.framework.TestCase,0.00,28,1,15,0,28,7,0,5,519,1
"org.apache.jackrabbit.core.ConcurrencyTest3$JcrTestThread",2,0.60,5.00,40,0.56,30555.88,7,5,11,23,0,139.15,3,49,0,2,89.15,0.00,0.50,0.50,0,0.00,9,1665.32,0,0,0,java.lang.Thread,0.00,21,1,10,0,21,2,0,3,290,0
"org.apache.jackrabbit.core.ConcurrentAddRemoveMoveTest",11,0.00,1.91,86,1.00,18333.42,11,0,2,23,2,113.96,5,118,1,5,113.96,0.00,0.80,0.00,0,0.00,2,3008.80,1,0,1,org.apache.jackrabbit.core.ConcurrentModificationBase,0.13,12,4,21,0,12,11,0,3,626,2
"org.apache.jackrabbit.core.ConcurrentAddRemoveNodeTest",1,1.00,1.00,5,0.04,547.26,2,1,4,4,2,105.49,5,6,1,5,123.36,0.00,0.80,0.00,0,0.00,1,116.42,1,0,1,org.apache.jackrabbit.core.AbstractConcurrencyTest,0.00,3,4,1,0,3,1,0,1,31,1
"org.apache.jackrabbit.core.ConcurrentAddRemoveNodeTest$Task",1,0.00,3.00,12,0.11,3082.65,1,0,4,6,0,103.02,0,13,0,1,103.02,0.00,0.00,0.00,0,0.00,3,338.69,0,0,0,java.lang.Object,0.00,5,0,3,0,5,1,0,0,69,0
"org.apache.jackrabbit.core.ConcurrentAddRemovePropertyTest",4,0.00,2.00,41,0.50,10095.69,4,0,2,16,2,156.75,4,54,1,5,106.75,0.00,0.80,0.00,0,0.00,2,1501.16,0,0,1,org.apache.jackrabbit.core.ConcurrentModificationBase,0.00,12,4,8,0,12,4,0,1,303,1
"org.apache.jackrabbit.core.ConcurrentCheckinMixedTransactionTest",1,0.00,1.00,8,0.09,1521.10,3,2,10,3,4,94.38,5,10,2,5,112.25,0.00,0.80,1.00,0,0.00,1,255.81,1,0,2,org.apache.jackrabbit.core.AbstractConcurrencyTest,0.00,2,4,1,0,2,1,0,2,58,1
"org.apache.jackrabbit.core.ConcurrentCheckinMixedTransactionTest$Task",1,0.00,12.00,31,0.42,29895.48,1,0,10,11,2,129.55,1,46,0,1,79.55,0.00,0.00,0.00,0,1.00,12,1253.15,0,0,2,java.lang.Object,0.00,10,0,12,0,10,1,0,1,210,0
"org.apache.jackrabbit.core.ConcurrentImportTest",6,0.20,2.33,78,1.28,133404.28,9,3,14,32,3,95.26,27,86,0,5,95.02,0.00,0.80,0.17,1,14.00,8,3850.77,1,1,3,org.apache.jackrabbit.core.AbstractConcurrencyTest,0.00,26,4,14,0,26,5,0,8,651,1
"org.apache.jackrabbit.core.ConcurrentImportTest$Task",1,0.00,7.00,24,0.28,10340.82,1,0,14,11,1,127.34,2,35,0,1,87.45,0.00,0.00,0.00,0,1.00,7,827.75,0,0,1,java.lang.Object,0.00,10,0,7,0,10,1,0,2,150,0
"org.apache.jackrabbit.core.ConcurrentLoginTest",1,2.00,6.00,25,0.27,11976.42,3,2,7,11,2,75.97,15,24,1,4,86.33,0.00,0.75,0.00,0,1.00,6,811.19,0,0,1,org.apache.jackrabbit.test.AbstractJCRTest,0.00,10,3,6,0,10,1,0,6,155,1
"org.apache.jackrabbit.core.ConcurrentLoginTest$Runnable",1,0.00,3.00,12,0.10,2740.25,1,0,7,6,0,153.42,1,13,0,1,103.42,0.00,0.00,0.00,0,1.00,3,310.21,0,0,0,java.lang.Object,0.00,5,0,3,0,5,1,0,1,65,0
"org.apache.jackrabbit.core.ConcurrentMixinModificationTest",1,0.00,2.00,10,0.11,1928.55,1,0,2,8,2,89.80,5,14,1,5,107.67,0.00,0.80,0.00,0,0.00,2,316.70,0,0,1,org.apache.jackrabbit.core.ConcurrentModificationBase,0.00,7,4,2,0,7,1,0,2,68,1
"org.apache.jackrabbit.core.ConcurrentModificationBase",2,0.00,1.50,10,0.08,1213.60,3,1,2,4,7,162.80,4,14,6,4,122.92,2.00,0.30,1.00,0,0.00,2,225.66,2,0,1,org.apache.jackrabbit.test.AbstractJCRTest,0.29,2,3,3,6,2,2,0,1,59,2
"org.apache.jackrabbit.core.ConcurrentModificationWithSNSTest",6,0.00,1.83,45,0.45,7405.00,6,0,2,15,2,114.99,5,62,1,5,114.99,0.00,0.80,0.00,0,0.00,2,1347.40,2,0,1,org.apache.jackrabbit.core.ConcurrentModificationBase,0.15,9,4,11,0,9,6,0,2,297,1
"org.apache.jackrabbit.core.ConcurrentMoveTest",2,1.33,1.50,17,0.17,2803.42,5,3,1,7,2,152.33,4,22,1,5,112.44,0.00,0.80,1.00,0,0.00,2,510.17,1,0,1,org.apache.jackrabbit.core.ConcurrentModificationBase,0.17,5,4,3,0,5,2,0,2,117,1
"org.apache.jackrabbit.core.ConcurrentNodeModificationTest",1,3.00,4.00,23,0.24,8278.76,6,5,7,7,2,59.65,13,24,1,4,89.03,0.00,0.75,0.40,0,0.00,4,732.87,0,0,1,org.apache.jackrabbit.test.AbstractJCRTest,0.00,6,3,4,0,6,1,0,4,146,1
"org.apache.jackrabbit.core.ConcurrentNodeModificationTest$TestSession",3,0.00,2.33,48,0.50,16764.12,5,2,7,13,0,146.38,5,49,0,1,96.38,0.00,0.00,0.50,1,1.00,3,1505.98,0,0,0,java.lang.Object,0.00,10,0,7,0,10,3,1,5,287,0
"org.apache.jackrabbit.core.ConcurrentReadWriteTest",1,3.00,5.00,33,0.48,22274.13,4,3,10,24,2,79.98,4,36,1,5,79.75,0.00,0.80,0.00,0,0.00,5,1452.68,0,0,1,org.apache.jackrabbit.core.AbstractConcurrencyTest,0.00,23,4,5,0,23,1,0,1,248,1
"org.apache.jackrabbit.core.ConcurrentReadWriteTest$Runnable",1,0.00,2.00,6,0.03,369.78,1,0,10,4,0,121.59,0,8,0,1,121.59,0.00,0.00,0.00,0,0.00,2,100.00,0,0,0,java.lang.Object,0.00,3,0,2,0,3,1,0,0,27,0
"org.apache.jackrabbit.core.ConcurrentReadWriteTest$Runnable$Task",1,0.00,5.00,21,0.27,12862.94,1,0,10,11,0,138.95,1,26,0,1,88.95,0.00,0.00,0.00,0,1.00,5,796.27,0,0,0,java.lang.Object,0.00,10,0,5,0,10,1,0,1,138,0
"org.apache.jackrabbit.core.ConcurrentRenameTest",1,1.00,1.00,6,0.05,660.23,3,2,4,3,2,140.38,3,7,0,5,119.77,0.00,0.80,0.50,0,0.00,1,151.51,1,0,2,org.apache.jackrabbit.core.AbstractConcurrencyTest,0.00,2,4,1,0,2,1,0,1,39,1
"org.apache.jackrabbit.core.ConcurrentRenameTest$Task",1,0.00,2.00,15,0.18,5170.61,1,0,4,9,1,137.61,2,15,0,1,97.73,0.00,0.00,0.00,0,1.00,2,549.11,0,0,1,java.lang.Object,0.00,8,0,2,0,8,1,0,2,105,0
"org.apache.jackrabbit.core.ConcurrentReorderTest",3,0.00,1.67,21,0.19,2535.46,3,0,1,10,2,156.20,6,29,1,5,116.31,0.00,0.80,0.00,0,0.00,2,581.61,1,0,1,org.apache.jackrabbit.core.ConcurrentModificationBase,0.16,7,4,5,0,7,3,0,3,131,1
"org.apache.jackrabbit.core.ConcurrentSaveTest",3,0.12,2.00,29,0.27,7158.82,7,4,8,14,2,129.26,9,38,1,4,108.65,0.00,0.75,0.33,0,2.00,3,806.70,2,0,1,org.apache.jackrabbit.test.AbstractJCRTest,0.28,11,3,6,0,11,3,0,3,180,1
"org.apache.jackrabbit.core.ConcurrentSaveTest$Thread",1,0.00,3.00,15,0.16,3935.02,1,0,8,7,0,148.57,1,16,0,1,98.57,0.00,0.00,0.00,0,0.00,3,465.69,0,0,0,java.lang.Object,0.00,6,0,3,0,6,1,0,1,90,0
"org.apache.jackrabbit.core.ConcurrentSaveTest$Thread_0",1,0.00,4.00,16,0.19,6143.03,1,0,8,7,0,135.82,2,18,0,1,95.93,0.00,0.00,0.00,0,0.00,4,573.66,0,0,0,java.lang.Object,0.00,6,0,4,0,6,1,0,2,107,0
"org.apache.jackrabbit.core.ConcurrentVersioningTest",4,0.00,1.00,15,0.08,859.13,6,2,7,5,2,174.72,11,16,1,5,134.84,0.00,0.80,0.50,0,0.00,1,242.16,1,0,1,org.apache.jackrabbit.core.AbstractConcurrencyTest,0.00,1,4,4,0,1,4,0,3,68,1
"org.apache.jackrabbit.core.ConcurrentVersioningTest$Task",1,0.00,2.00,9,0.08,2015.65,1,0,7,4,0,159.22,1,8,0,1,109.22,0.00,0.00,0.00,0,1.00,2,248.44,0,0,0,java.lang.Object,0.00,3,0,2,0,3,1,0,1,53,0
"org.apache.jackrabbit.core.ConcurrentVersioningTest$Task_0",1,0.00,2.00,12,0.11,2546.07,1,0,7,6,0,103.76,0,11,0,1,103.76,0.00,0.00,0.00,0,1.00,2,315.16,0,0,0,java.lang.Object,0.00,5,0,2,0,5,1,0,0,66,0
"org.apache.jackrabbit.core.ConcurrentVersioningTest$Task_1",1,0.00,2.00,12,0.11,2988.00,1,0,7,6,0,153.22,1,11,0,1,103.22,0.00,0.00,0.00,0,1.00,2,328.00,0,0,0,java.lang.Object,0.00,5,0,2,0,5,1,0,1,68,0
"org.apache.jackrabbit.core.ConcurrentVersioningTest$Task_2",1,0.00,3.00,20,0.22,6623.70,1,0,7,13,0,132.01,2,17,0,1,92.13,0.00,0.00,0.00,0,1.00,3,665.30,0,0,0,java.lang.Object,0.00,12,0,3,0,12,1,0,2,123,0
"org.apache.jackrabbit.core.ConcurrentVersioningWithTransactionsTest",6,0.20,1.50,30,0.25,7334.10,8,2,10,16,4,160.41,17,43,1,5,120.52,0.00,0.80,0.33,0,0.00,3,755.87,1,2,3,org.apache.jackrabbit.core.AbstractConcurrencyTest,0.00,10,4,9,0,10,4,0,5,176,1
"org.apache.jackrabbit.core.ConcurrentVersioningWithTransactionsTest$Task",1,0.00,5.00,20,0.30,15726.18,1,0,10,14,1,109.67,3,24,0,1,89.05,0.00,0.00,0.00,0,1.00,5,911.36,0,0,1,java.lang.Object,0.00,13,0,5,0,13,1,0,3,154,0
"org.apache.jackrabbit.core.ConcurrentVersioningWithTransactionsTest$Task_0",1,0.00,4.00,22,0.30,15439.21,1,0,10,15,1,137.62,1,25,0,1,87.62,0.00,0.00,0.00,0,1.00,4,892.64,0,0,1,java.lang.Object,0.00,14,0,4,0,14,1,0,1,152,0
"org.apache.jackrabbit.core.ConcurrentVersioningWithTransactionsTest$Task_1",1,0.00,4.00,21,0.29,14996.60,1,0,10,15,1,128.36,2,24,0,1,88.47,0.00,0.00,0.00,0,1.00,4,880.68,0,0,1,java.lang.Object,0.00,14,0,4,0,14,1,0,2,150,0
"org.apache.jackrabbit.core.ConcurrentVersioningWithTransactionsTest$Task_2",1,0.00,5.00,27,0.38,20615.41,1,0,10,18,0,103.88,3,28,0,1,83.26,0.00,0.00,0.00,0,1.00,5,1127.25,0,0,0,java.lang.Object,0.00,17,0,5,0,17,1,0,3,186,0
"org.apache.jackrabbit.core.ConcurrentWorkspaceCopyTest",2,1.00,3.00,41,0.47,15632.29,8,6,5,18,1,131.45,5,42,0,4,91.56,0.00,0.75,0.67,0,0.00,5,1416.99,2,0,1,org.apache.jackrabbit.test.AbstractJCRTest,0.14,16,3,6,0,16,2,0,5,266,1
"org.apache.jackrabbit.core.ConcurrentWorkspaceCopyTest$TestSession",3,0.17,1.67,18,0.15,1855.71,6,3,5,10,0,119.87,1,27,0,1,119.87,0.00,0.00,0.44,1,0.00,2,441.68,0,0,0,java.lang.Object,0.00,7,0,5,0,7,3,1,1,107,0
"org.apache.jackrabbit.core.DefaultSecurityManager",22,0.05,3.18,225,3.02,160557.65,34,12,47,104,35,53.01,209,306,2,1,103.01,0.00,0.00,0.13,8,258.00,13,9068.90,0,17,33,java.lang.Object,0.00,82,0,70,1,82,5,1,76,1627,1
"org.apache.jackrabbit.core.DefaultSecurityManager$WorkspaceAccessManagerImpl",3,0.00,1.00,6,0.07,936.76,3,0,47,5,3,140.36,12,10,0,1,140.13,0.00,0.00,0.00,0,3.00,1,197.04,0,0,3,java.lang.Object,0.00,2,0,3,0,2,3,2,6,52,2
"org.apache.jackrabbit.core.HierarchyManager",11,0.00,1.00,12,0.12,547.91,11,0,7,11,33,128.25,151,18,28,1,157.63,0.00,0.00,0.00,0,11.00,1,354.83,0,6,5,,0.00,0,0,11,0,0,5,0,13,111,1
"org.apache.jackrabbit.core.HierarchyManagerImpl",23,0.01,3.52,269,3.52,189841.72,30,7,23,69,23,58.73,176,383,6,1,101.02,0.00,0.00,0.16,8,128.00,10,10561.41,0,14,17,java.lang.Object,0.00,46,0,81,3,46,9,1,47,1962,1
"org.apache.jackrabbit.core.InternalXAResource",6,0.00,1.00,7,0.04,169.53,6,0,0,6,5,127.35,37,8,4,1,159.57,0.00,0.00,0.00,0,6.00,1,128.53,0,0,2,,0.00,0,0,6,0,0,6,0,7,47,1
"org.apache.jackrabbit.core.InvalidDateTest",1,0.00,4.00,16,0.21,5443.88,1,0,6,9,2,64.12,6,25,1,4,96.35,0.00,0.75,0.00,0,0.00,4,636.99,0,0,1,org.apache.jackrabbit.test.AbstractJCRTest,0.00,8,3,4,0,8,1,0,4,122,1
"org.apache.jackrabbit.core.ItemData",12,0.11,1.17,39,0.29,5289.96,17,5,7,16,10,114.47,70,54,5,1,132.34,0.00,0.00,0.10,3,48.00,3,874.12,0,5,7,java.lang.Object,0.00,4,0,14,4,4,7,0,18,230,2
"org.apache.jackrabbit.core.ItemImpl",33,0.04,1.27,104,1.03,20583.43,42,9,20,69,30,113.26,172,146,21,1,131.14,0.00,0.00,0.07,7,266.00,4,3086.54,0,15,13,java.lang.Object,0.00,36,0,42,4,36,18,1,50,742,2
"org.apache.jackrabbit.core.ItemImpl$SessionOperation<Integer>",2,0.00,1.50,9,0.07,1247.54,2,0,20,6,2,126.44,1,13,0,1,126.44,0.00,0.00,0.00,0,2.00,2,224.76,0,2,2,java.lang.Object,0.00,4,0,3,0,4,0,0,1,54,0
"org.apache.jackrabbit.core.ItemImpl$SessionOperation<Item>",2,0.00,3.00,16,0.19,7277.78,2,0,20,9,3,159.02,3,23,0,1,109.02,0.00,0.00,0.00,0,2.00,5,575.49,0,2,3,java.lang.Object,0.00,7,0,6,0,7,0,0,3,115,0
"org.apache.jackrabbit.core.ItemImpl$SessionOperation<String>",2,0.00,1.00,5,0.04,368.03,2,0,20,4,1,141.94,0,8,0,1,141.94,0.00,0.00,0.00,0,2.00,1,108.38,0,2,1,java.lang.Object,0.00,2,0,2,0,2,0,0,0,32,0
"org.apache.jackrabbit.core.ItemLifeCycleListener",3,0.00,1.00,4,0.02,78.51,3,0,1,3,2,115.71,33,5,0,1,159.84,0.00,0.00,0.00,0,3.00,1,73.51,0,0,2,,0.00,0,0,3,0,0,3,0,4,27,1
"org.apache.jackrabbit.core.ItemManager",44,0.02,2.82,385,5.34,188773.74,52,8,43,159,55,58.47,433,569,29,1,108.47,0.00,0.00,0.15,17,710.00,10,16009.48,0,22,38,java.lang.Object,0.00,115,0,124,0,115,22,2,128,3072,1
"org.apache.jackrabbit.core.ItemManager$ShareableNodesCache",7,0.00,2.00,37,0.41,11888.28,8,1,43,19,2,101.46,40,54,0,1,119.33,0.00,0.00,1.00,0,0.00,4,1242.75,0,2,2,java.lang.Object,0.00,12,0,14,0,12,5,0,8,277,0
"org.apache.jackrabbit.core.ItemRefreshOperation",3,0.17,5.67,44,0.60,39561.35,6,3,9,21,5,45.40,27,73,1,1,95.40,0.00,0.00,0.44,0,1.00,15,1808.45,0,2,4,java.lang.Object,0.00,18,0,17,0,18,1,1,23,324,1
"org.apache.jackrabbit.core.ItemRemoveOperation",3,0.25,2.00,22,0.28,7663.03,5,2,11,16,9,80.26,18,36,2,1,112.49,0.00,0.00,0.33,0,4.00,4,848.86,0,2,8,java.lang.Object,0.00,13,0,6,0,13,1,1,9,167,0
"org.apache.jackrabbit.core.ItemSaveOperation",12,0.14,8.83,338,6.11,573236.01,14,2,50,131,35,123.61,275,519,1,1,79.67,0.00,0.00,0.38,8,22.00,39,18335.99,0,5,35,java.lang.Object,0.00,119,0,106,0,119,7,1,129,2733,0
"org.apache.jackrabbit.core.ItemValidator",19,0.08,3.79,180,2.72,111369.91,31,12,28,73,27,55.43,175,289,12,1,105.43,0.00,0.00,0.16,8,0.00,18,8145.40,0,6,17,java.lang.Object,0.00,54,0,72,1,54,13,0,33,1532,1
"org.apache.jackrabbit.core.JackrabbitRepositoryStub",8,0.14,2.25,76,0.85,30033.64,12,4,18,35,10,107.31,35,116,3,2,107.07,3.00,0.20,0.12,3,22.00,5,2543.46,0,7,7,org.apache.jackrabbit.test.RepositoryStub,0.12,27,1,18,3,27,1,0,10,524,1
"org.apache.jackrabbit.core.JackrabbitRepositoryStub$Principal",1,0.00,1.00,3,0.01,72.00,1,0,18,1,0,138.58,0,4,0,1,138.58,0.00,0.00,0.00,0,1.00,1,32.00,0,1,0,java.lang.Object,0.00,0,0,1,0,0,0,0,0,12,0
"org.apache.jackrabbit.core.JackrabbitRepositoryStub$Runnable",1,0.00,3.00,7,0.05,1044.06,1,0,18,2,1,115.45,0,10,0,1,115.45,0.00,0.00,0.00,0,0.00,3,145.61,0,0,1,java.lang.Object,0.00,1,0,3,0,1,1,0,0,37,0
"org.apache.jackrabbit.core.LazyItemIterator",11,0.08,2.36,70,0.73,29813.67,17,6,15,23,6,66.64,93,96,4,1,114.74,0.00,0.00,0.24,2,14.00,8,2194.78,0,3,3,java.lang.Object,0.00,12,0,26,0,12,8,2,37,455,1
"org.apache.jackrabbit.core.LockTest",3,3.00,5.00,72,0.74,24317.84,6,3,10,15,3,56.14,19,64,1,4,88.36,0.00,0.75,0.00,0,0.00,5,2209.51,0,0,2,org.apache.jackrabbit.test.AbstractJCRTest,0.00,12,3,15,0,12,3,0,4,410,1
"org.apache.jackrabbit.core.LockTest$Thread",1,1.00,5.00,18,0.23,6929.19,2,1,10,14,1,143.56,1,23,0,1,93.56,0.00,0.00,0.00,0,1.00,5,677.62,0,0,1,java.lang.Object,0.00,13,0,5,0,13,1,0,1,127,0
"org.apache.jackrabbit.core.LockTest$Thread$Locked",1,0.00,2.00,10,0.10,2274.72,1,0,10,7,0,107.10,0,12,0,1,107.10,0.00,0.00,0.00,0,0.00,2,297.51,0,1,0,java.lang.Object,0.00,6,0,2,0,6,0,0,0,63,0
"org.apache.jackrabbit.core.LockTest$Thread_0",1,0.00,5.00,20,0.27,8464.80,2,1,10,13,1,141.17,1,24,0,1,91.17,0.00,0.00,1.00,0,0.00,5,820.91,0,0,1,java.lang.Object,0.00,12,0,5,0,12,1,0,1,148,0
"org.apache.jackrabbit.core.LockTest$Thread_0$Locked_1",1,0.00,1.00,7,0.07,1442.31,1,0,10,6,0,114.60,0,8,0,1,114.60,0.00,0.00,0.00,0,1.00,1,212.33,0,1,0,java.lang.Object,0.00,5,0,1,0,5,0,0,0,48,0
"org.apache.jackrabbit.core.LockTest$Thread_2",1,0.00,6.00,24,0.34,14038.84,2,1,10,14,1,126.33,2,29,0,1,86.44,0.00,0.00,1.00,0,0.00,6,1025.11,0,0,1,java.lang.Object,0.00,13,0,6,0,13,1,0,2,176,0
"org.apache.jackrabbit.core.LockTest$Thread_2$Locked_3",1,0.00,1.00,7,0.07,1442.31,1,0,10,6,0,114.60,0,8,0,1,114.60,0.00,0.00,0.00,0,1.00,1,212.33,0,1,0,java.lang.Object,0.00,5,0,1,0,5,0,0,0,48,0
"org.apache.jackrabbit.core.MoveAtRootTest",1,0.00,3.00,26,0.39,14484.58,1,0,4,19,1,135.20,1,30,0,4,85.20,0.00,0.75,0.00,0,1.00,3,1177.75,1,0,1,org.apache.jackrabbit.test.AbstractJCRTest,0.00,18,3,3,0,18,1,0,1,213,1
"org.apache.jackrabbit.core.MoveTest",2,0.00,2.50,32,0.38,16468.56,2,0,5,19,1,77.17,10,36,0,4,95.04,0.00,0.75,0.00,1,2.00,4,1145.38,0,0,1,org.apache.jackrabbit.test.AbstractJCRTest,0.00,17,3,5,0,17,2,0,6,212,1
"org.apache.jackrabbit.core.MultiWorkspaceShareableNodeTest",5,0.39,2.20,59,0.59,13990.49,12,7,7,24,3,56.72,43,70,1,4,104.83,0.00,0.75,0.46,2,0.00,4,1782.61,4,1,2,org.apache.jackrabbit.test.AbstractJCRTest,0.26,19,3,11,0,19,4,0,21,374,1
"org.apache.jackrabbit.core.NamespaceRegistryImpl",18,0.08,2.89,200,2.67,133066.30,31,13,20,58,14,59.15,142,281,6,1,101.44,0.00,0.00,0.15,6,82.00,11,7999.50,0,7,8,java.lang.Object,0.00,40,0,52,0,40,11,3,57,1521,1
"org.apache.jackrabbit.core.NodeData",1,0.00,1.00,3,0.02,96.98,1,0,1,1,3,93.43,11,5,1,3,137.56,0.00,0.67,0.00,0,1.00,1,51.97,0,0,3,org.apache.jackrabbit.core.AbstractNodeData,0.00,0,2,1,0,0,1,0,2,18,0
"org.apache.jackrabbit.core.NodeDataRef",5,0.25,1.00,14,0.10,1201.25,6,1,4,10,4,108.80,32,20,1,3,141.02,0.00,0.67,0.80,0,0.00,1,298.75,1,2,3,org.apache.jackrabbit.core.AbstractNodeData,0.23,5,2,5,0,5,3,0,7,86,0
"org.apache.jackrabbit.core.NodeImpl",136,0.21,2.58,1150,17.82,1019957.89,139,3,95,454,139,58.47,1148,1758,93,2,106.58,2.00,0.25,0.12,39,4312.00,26,53474.24,16,75,54,org.apache.jackrabbit.core.ItemImpl,0.09,318,1,351,2,318,61,2,429,9444,1
"org.apache.jackrabbit.core.NodeImpl$SessionOperation<Boolean>",2,0.00,1.50,6,0.10,1846.02,2,0,95,6,2,129.76,0,11,0,1,129.76,0.00,0.00,0.00,0,2.00,2,299.67,0,2,2,java.lang.Object,0.00,4,0,3,0,4,0,0,0,68,0
"org.apache.jackrabbit.core.NodeImpl$SessionOperation<Boolean>_0",2,0.00,1.00,5,0.07,937.77,2,0,95,7,2,138.74,0,10,0,1,138.74,0.00,0.00,0.00,0,2.00,1,208.33,0,2,2,java.lang.Object,0.00,5,0,2,0,5,0,0,0,52,0
"org.apache.jackrabbit.core.NodeImpl$SessionOperation<Node>",2,0.00,1.50,9,0.08,1747.23,2,0,95,6,2,125.29,0,14,0,1,125.29,0.00,0.00,0.00,0,2.00,2,236.37,0,2,2,java.lang.Object,0.00,4,0,3,0,4,0,0,0,56,0
"org.apache.jackrabbit.core.NodeImpl$SessionOperation<Node>_2",2,0.00,3.50,18,0.21,9001.43,2,0,95,9,4,156.35,3,27,0,1,106.35,0.00,0.00,0.00,0,2.00,6,638.14,0,2,4,java.lang.Object,0.00,7,0,7,0,7,0,0,3,126,0
"org.apache.jackrabbit.core.NodeImpl$SessionOperation<NodeImpl>",2,0.00,2.50,11,0.15,3976.02,2,0,95,7,3,118.74,0,19,0,1,118.74,0.00,0.00,0.00,0,2.00,4,438.27,0,2,3,java.lang.Object,0.00,5,0,5,0,5,0,0,0,91,0
"org.apache.jackrabbit.core.NodeImpl$SessionOperation<NodeIterator>",2,0.00,2.00,8,0.10,2383.87,2,0,95,4,3,124.16,0,16,0,1,124.16,0.00,0.00,0.00,0,2.00,3,290.91,0,2,3,java.lang.Object,0.00,2,0,4,0,2,0,0,0,67,0
"org.apache.jackrabbit.core.NodeImpl$SessionOperation<Property>",2,0.00,2.50,12,0.12,3831.26,2,0,95,5,2,115.92,0,19,0,1,115.92,0.00,0.00,0.00,0,2.00,4,373.28,0,2,2,java.lang.Object,0.00,3,0,5,0,3,0,0,0,82,0
"org.apache.jackrabbit.core.NodeImpl$SessionOperation<PropertyImpl>",2,0.00,1.50,8,0.11,2313.33,2,0,95,8,3,124.33,0,15,0,1,124.33,0.00,0.00,0.00,0,2.00,2,318.78,0,2,3,java.lang.Object,0.00,6,0,3,0,6,0,0,0,71,0
"org.apache.jackrabbit.core.NodeImpl$SessionOperation<PropertyImpl>_1",2,0.00,2.00,13,0.12,3158.46,2,0,95,8,2,166.63,3,20,0,1,116.63,0.00,0.00,0.00,0,2.00,3,356.40,0,2,2,java.lang.Object,0.00,6,0,4,0,6,0,0,3,77,0
"org.apache.jackrabbit.core.NodeImpl$SessionOperation<PropertyIterator>",2,0.00,2.00,8,0.10,2383.87,2,0,95,4,3,124.16,0,16,0,1,124.16,0.00,0.00,0.00,0,2.00,3,290.91,0,2,3,java.lang.Object,0.00,2,0,4,0,2,0,0,0,67,0
"org.apache.jackrabbit.core.NodeImpl$SessionOperation<String>",2,0.00,2.00,13,0.13,3304.13,2,0,95,7,3,116.47,1,19,0,1,116.47,0.00,0.00,0.00,0,2.00,3,398.65,0,2,3,java.lang.Object,0.00,5,0,4,0,5,0,0,1,86,0
"org.apache.jackrabbit.core.NodeImpl$SetPropertyOperation",3,0.33,2.00,24,0.24,5952.64,6,3,95,11,4,67.06,33,35,0,1,111.19,0.00,0.00,0.56,0,1.00,4,723.22,0,2,4,java.lang.Object,0.00,8,0,6,0,8,1,1,7,155,1
"org.apache.jackrabbit.core.NodeImplTest",12,1.00,2.33,162,2.22,79361.24,13,1,21,61,7,119.78,47,212,1,4,99.17,0.00,0.75,0.08,2,0.00,7,6664.44,2,1,6,org.apache.jackrabbit.test.AbstractJCRTest,0.11,49,3,28,0,49,11,0,27,1258,1
"org.apache.jackrabbit.core.NodeTypeInstanceHandler",3,0.25,7.00,43,0.80,56494.39,5,2,9,27,9,64.76,41,63,3,1,94.14,0.00,0.00,0.33,1,5.00,16,2394.39,0,1,6,java.lang.Object,0.00,24,0,21,0,24,2,0,15,428,1
"org.apache.jackrabbit.core.PersistenceManagerTest",18,0.01,1.17,156,2.19,68563.03,24,6,24,105,27,109.08,0,203,1,2,109.08,0.00,0.50,0.18,6,94.00,4,6581.47,0,0,26,junit.framework.TestCase,0.00,87,1,21,0,87,18,0,0,1335,1
"org.apache.jackrabbit.core.PropertyData",3,0.00,1.00,7,0.04,384.21,3,0,3,3,4,110.95,20,11,2,2,143.18,0.00,0.50,0.00,0,3.00,1,132.32,2,2,3,org.apache.jackrabbit.core.ItemData,0.00,0,1,3,0,0,1,0,4,43,1
"org.apache.jackrabbit.core.PropertyImpl",49,0.38,2.33,361,4.45,186003.07,51,2,50,125,34,111.33,217,526,19,2,111.10,0.00,0.50,0.13,12,553.00,12,13364.80,5,18,17,org.apache.jackrabbit.core.ItemImpl,0.17,76,1,114,0,76,31,1,103,2617,1
"org.apache.jackrabbit.core.PropertyImpl$AutoCloseInputStream",1,0.00,1.00,4,0.03,258.22,1,0,50,2,0,129.55,0,5,0,1,129.55,0.00,0.00,0.00,0,1.00,1,83.40,1,0,0,java.lang.Object,0.00,1,0,1,0,1,1,0,0,25,0
"org.apache.jackrabbit.core.ProtectedItemModifier",14,0.46,2.07,90,1.31,37016.32,16,2,18,49,20,164.86,18,115,3,1,114.86,0.00,0.00,0.07,3,38.00,5,3923.90,0,6,20,java.lang.Object,0.00,35,0,29,5,35,8,0,11,790,2
"org.apache.jackrabbit.core.ReadVersionsWhileModified",1,1.00,3.00,14,0.18,4499.33,2,1,5,11,2,51.12,8,18,1,5,99.23,0.00,0.80,0.00,0,0.00,3,552.05,1,0,1,org.apache.jackrabbit.core.AbstractConcurrencyTest,0.00,10,4,3,0,10,1,0,2,108,1
"org.apache.jackrabbit.core.ReadVersionsWhileModified$Runnable",1,0.00,3.00,10,0.12,3179.38,1,0,5,8,0,105.87,0,15,0,1,105.87,0.00,0.00,0.00,0,0.00,3,356.06,0,0,0,java.lang.Object,0.00,7,0,3,0,7,1,0,0,73,0
"org.apache.jackrabbit.core.ReadWhileSaveTest",2,0.00,3.00,34,0.40,12013.09,2,0,14,20,1,115.71,6,38,0,4,95.09,0.00,0.75,0.00,1,2.00,4,1207.80,1,1,1,org.apache.jackrabbit.test.AbstractJCRTest,0.00,18,3,6,0,18,1,0,3,219,1
"org.apache.jackrabbit.core.ReadWhileSaveTest$Runnable",1,0.00,4.00,15,0.15,4391.71,1,0,14,10,0,98.13,0,18,0,1,98.13,0.00,0.00,0.00,0,1.00,4,443.99,0,0,0,java.lang.Object,0.00,9,0,4,0,9,1,0,0,89,0
"org.apache.jackrabbit.core.ReferencesTest",12,0.41,1.33,94,1.33,35316.74,14,2,6,30,2,112.33,49,115,1,4,112.09,0.00,0.75,0.12,5,28.00,3,3975.63,1,2,1,org.apache.jackrabbit.test.AbstractJCRTest,0.11,18,3,16,0,18,10,0,11,830,2
"org.apache.jackrabbit.core.RemoveMixinOperation",4,0.17,6.25,96,2.12,210709.31,6,2,37,70,23,61.77,56,166,1,1,81.91,0.00,0.00,0.38,1,0.00,22,6359.54,0,2,23,java.lang.Object,0.00,66,0,25,0,66,2,1,52,893,0
"org.apache.jackrabbit.core.ReplaceTest",1,0.00,1.00,10,0.10,1562.74,1,0,3,7,3,90.67,5,12,1,4,108.55,0.00,0.75,0.00,0,0.00,1,302.24,0,0,2,org.apache.jackrabbit.test.AbstractJCRTest,0.00,6,3,1,0,6,1,0,1,67,1
"org.apache.jackrabbit.core.RepositoryChecker",6,0.20,2.83,51,0.60,14967.30,10,4,20,30,10,160.32,9,79,1,1,110.32,0.00,0.00,0.42,4,0.00,5,1787.11,0,0,9,java.lang.Object,0.00,24,0,17,0,24,6,0,2,373,0
"org.apache.jackrabbit.core.RepositoryContext",22,0.05,1.00,75,0.47,6252.33,33,11,8,22,16,101.66,152,99,6,1,133.88,0.00,0.00,0.05,0,242.00,1,1409.69,0,8,11,java.lang.Object,0.00,0,0,22,0,0,14,0,34,374,1
"org.apache.jackrabbit.core.RepositoryCopier",11,0.13,1.91,79,1.17,39046.69,14,3,17,51,12,61.37,106,123,3,1,111.37,0.00,0.00,0.45,5,16.00,4,3495.35,0,0,9,java.lang.Object,0.00,40,0,21,0,40,11,0,21,700,1
"org.apache.jackrabbit.core.RepositoryCopierTest",5,0.32,1.40,112,2.04,91219.49,12,7,20,66,3,87.29,0,174,0,2,87.29,0.00,0.50,0.40,2,4.00,2,6129.26,0,0,3,junit.framework.TestCase,0.00,61,1,7,0,61,5,0,0,953,1
"org.apache.jackrabbit.core.RepositoryFactoryImpl",4,0.00,6.25,63,0.89,52435.36,8,4,17,34,9,46.18,32,94,3,1,94.28,0.00,0.00,0.25,2,8.00,12,2683.47,0,4,6,java.lang.Object,0.00,30,0,25,0,30,0,1,12,494,1
"org.apache.jackrabbit.core.RepositoryImpl",52,0.02,2.37,511,7.53,326954.28,75,23,97,245,105,56.82,549,763,50,2,105.29,0.00,0.50,0.07,27,992.00,16,22583.68,0,31,61,org.apache.jackrabbit.commons.AbstractRepository,0.00,193,1,123,0,193,21,4,166,3941,1
"org.apache.jackrabbit.core.RepositoryImpl$DescriptorValue",4,0.17,1.25,11,0.08,1237.27,6,2,97,4,0,140.11,0,16,0,1,140.11,0.00,0.00,0.38,0,4.00,2,238.42,0,2,0,java.lang.Object,0.00,0,0,5,0,0,2,0,0,68,2
"org.apache.jackrabbit.core.RepositoryImpl$ExternalEventListener",5,0.00,1.00,11,0.09,906.42,5,0,97,12,3,162.60,17,17,0,1,141.99,0.00,0.00,0.00,0,8.00,1,255.91,0,3,3,java.lang.Object,0.00,7,0,5,0,7,2,1,7,75,0
"org.apache.jackrabbit.core.RepositoryImpl$ThreadFactory",1,0.00,3.00,8,0.12,3265.74,2,1,97,9,0,130.00,3,13,0,1,109.39,0.00,0.00,1.00,0,0.00,3,355.64,0,1,0,java.lang.Object,0.00,8,0,3,0,8,0,0,1,77,0
"org.apache.jackrabbit.core.RepositoryImpl$WorkspaceInfo",23,0.08,2.78,213,2.48,76938.68,38,15,97,80,23,58.94,236,337,0,1,107.42,0.00,0.00,0.15,9,225.00,10,7444.58,0,10,23,java.lang.Object,0.00,57,0,64,0,57,13,1,71,1430,1
"org.apache.jackrabbit.core.RepositoryImpl$WorkspaceJanitor",2,0.50,3.50,27,0.27,9485.60,4,2,97,8,1,99.74,33,38,0,1,100.21,0.00,0.00,0.75,0,0.00,6,806.22,0,0,1,java.lang.Object,0.00,6,0,7,0,6,2,1,11,158,1
"org.apache.jackrabbit.core.RepositoryManagerImpl",3,0.50,1.33,12,0.09,1820.72,4,1,3,7,5,176.56,3,17,1,1,126.56,0.00,0.00,0.67,0,1.00,2,264.16,0,1,4,java.lang.Object,0.00,4,0,4,0,4,2,1,1,68,1
"org.apache.jackrabbit.core.RestoreAndCheckoutTest",1,1.00,3.00,33,0.35,15488.64,2,1,4,11,2,31.11,9,31,1,4,81.11,0.00,0.75,0.00,0,1.00,3,1043.90,1,0,1,org.apache.jackrabbit.test.AbstractJCRTest,0.00,10,3,3,0,10,1,0,5,198,1
"org.apache.jackrabbit.core.RetentionRegistryImplTest",13,0.15,1.85,194,3.03,130988.81,19,6,21,52,13,146.58,18,234,1,6,96.58,0.00,0.83,0.31,1,0.00,5,9085.85,4,1,12,org.apache.jackrabbit.core.retention.AbstractRetentionTest,0.27,39,5,24,0,39,12,0,16,1706,1
"org.apache.jackrabbit.core.SearchManager",11,0.08,3.82,128,1.85,105817.07,23,12,38,57,27,80.34,156,192,6,1,100.48,0.00,0.00,0.16,3,10.00,17,5555.93,0,4,21,java.lang.Object,0.00,46,0,42,0,46,7,1,48,991,1
"org.apache.jackrabbit.core.SearchManager$Iterator<NodeState>",3,0.50,1.67,17,0.20,6050.48,4,1,38,10,4,118.79,2,23,0,1,118.79,0.00,0.00,0.67,0,1.00,3,600.25,0,1,4,java.lang.Object,0.00,7,0,5,0,7,2,0,2,128,0
"org.apache.jackrabbit.core.SessionGarbageCollectedTest",1,0.00,7.00,27,0.36,21956.38,1,0,8,13,2,65.10,5,30,1,4,82.97,0.00,0.75,0.00,0,1.00,7,1082.93,1,0,1,org.apache.jackrabbit.test.AbstractJCRTest,0.00,12,3,7,0,12,1,0,3,189,1
"org.apache.jackrabbit.core.SessionImpl",75,0.01,1.85,357,4.76,157305.03,90,15,83,217,158,104.37,412,600,121,2,122.24,2.00,0.25,0.06,22,2515.00,13,14269.21,3,42,44,org.apache.jackrabbit.commons.AbstractSession,0.02,142,1,139,2,142,33,5,136,2941,1
"org.apache.jackrabbit.core.SessionImpl$SessionListener",2,0.00,1.00,4,0.02,145.26,2,0,83,3,1,145.12,0,6,0,1,145.12,0.00,0.00,0.00,0,2.00,1,69.16,0,0,1,java.lang.Object,0.00,1,0,2,0,1,2,0,0,23,0
"org.apache.jackrabbit.core.SessionListener",2,0.00,1.00,3,0.01,46.02,2,0,0,2,7,110.28,19,4,7,1,160.28,0.00,0.00,0.00,0,2.00,1,41.02,0,0,1,,0.00,0,0,2,0,0,2,0,3,17,1
"org.apache.jackrabbit.core.SessionMoveOperation",5,0.29,4.20,83,1.55,85957.60,12,7,18,47,14,60.18,30,130,1,1,92.40,0.00,0.00,0.37,1,6.00,12,4659.68,0,3,13,java.lang.Object,0.00,42,0,21,0,42,2,1,28,757,1
"org.apache.jackrabbit.core.ShareableNodeTest",2,0.00,1.00,57,0.99,40369.27,2,0,10,29,3,38.99,23,66,1,4,83.12,0.00,0.75,0.00,0,0.00,1,2966.13,1,0,2,org.apache.jackrabbit.test.AbstractJCRTest,0.00,27,3,2,0,27,2,0,16,511,1
"org.apache.jackrabbit.core.ShareableNodeTest$EventCounter",3,0.00,1.33,10,0.06,587.50,4,1,10,4,1,135.09,0,15,0,1,135.09,0.00,0.00,1.00,0,0.00,2,167.99,0,0,1,java.lang.Object,0.00,1,0,4,0,1,3,1,0,49,0
"org.apache.jackrabbit.core.SuppressWarnings",20,0.04,2.15,121,1.41,42300.14,27,7,18,50,13,73.32,155,183,0,3,115.61,0.00,0.67,0.11,4,178.00,9,4218.87,2,3,13,org.apache.jackrabbit.core.SessionImpl,0.05,30,2,43,0,30,17,2,32,882,1
"org.apache.jackrabbit.core.SystemSession",4,0.00,1.00,13,0.17,3300.25,4,0,23,11,19,80.24,39,25,6,3,130.24,0.00,0.67,0.00,0,4.00,1,507.63,0,3,13,org.apache.jackrabbit.core.SessionImpl,0.00,7,2,4,0,7,1,0,11,120,0
"org.apache.jackrabbit.core.SystemSession$SystemAccessManager",21,0.95,1.10,43,0.49,6886.66,22,1,23,30,10,140.17,91,75,0,2,139.94,0.00,0.50,0.10,1,55.00,3,1481.65,0,5,10,org.apache.jackrabbit.core.security.AbstractAccessControlManager,0.12,9,1,23,0,9,16,1,35,368,1
"org.apache.jackrabbit.core.TestAll",1,0.00,1.00,25,0.33,12524.06,1,0,4,3,22,38.11,10,27,0,2,86.59,0.00,0.50,0.00,0,1.00,1,979.26,0,1,22,junit.framework.TestCase,0.00,2,1,1,0,2,0,0,5,191,1
"org.apache.jackrabbit.core.TestContentLoader",9,0.88,1.89,108,1.74,53583.20,10,1,18,42,6,101.11,36,153,2,1,100.87,0.00,0.00,0.22,8,19.00,4,5226.53,0,1,4,java.lang.Object,0.00,33,0,17,0,33,8,0,12,962,1
"org.apache.jackrabbit.core.TestHelper",1,0.00,1.00,3,0.03,371.33,1,0,1,3,2,88.84,11,6,1,1,132.97,0.00,0.00,0.00,0,1.00,1,92.00,0,0,1,java.lang.Object,0.00,2,0,1,0,2,1,0,2,25,1
"org.apache.jackrabbit.core.TestRepository",4,0.08,2.00,26,0.34,9710.69,8,4,11,16,6,104.80,61,43,1,1,115.16,0.00,0.00,0.31,0,4.00,5,1012.74,0,2,5,java.lang.Object,0.00,12,0,8,0,12,2,0,11,208,1
"org.apache.jackrabbit.core.TestRepository$",2,0.00,1.00,5,0.04,502.06,2,0,11,3,0,140.87,0,7,0,1,140.87,0.00,0.00,0.00,0,2.00,1,114.91,0,2,0,java.lang.Object,0.00,1,0,2,0,1,0,0,0,32,0
"org.apache.jackrabbit.core.TestRepository$RepositoryFactory",1,0.00,1.00,3,0.01,111.66,1,0,11,1,0,137.08,0,4,0,1,137.08,0.00,0.00,0.00,0,1.00,1,41.22,0,1,0,java.lang.Object,0.00,0,0,1,0,0,0,0,0,14,0
"org.apache.jackrabbit.core.TransactionContext",15,0.07,2.27,129,1.28,53163.12,30,15,7,34,12,61.07,122,156,10,2,109.17,0.00,0.50,0.13,6,108.00,7,3849.31,0,2,3,Timer.Task,0.00,19,1,34,0,19,13,0,32,753,1
"org.apache.jackrabbit.core.TransactionException",2,0.00,1.00,5,0.03,221.18,2,0,0,2,7,95.57,16,8,7,2,143.68,0.00,0.50,0.00,0,2.00,1,88.69,0,0,0,java.lang.Exception,0.00,0,1,2,0,0,2,0,3,29,1
"org.apache.jackrabbit.core.TransientRepository",20,0.05,1.50,105,1.06,25104.31,30,10,18,58,13,72.33,177,184,6,2,120.43,0.00,0.50,0.14,2,52.00,3,3186.00,0,6,7,org.apache.jackrabbit.commons.AbstractRepository,0.00,38,1,30,0,38,14,2,41,700,1
"org.apache.jackrabbit.core.TransientRepository$RepositoryFactory",1,0.00,1.00,2,0.01,38.26,1,0,18,1,1,105.02,7,3,0,1,147.31,0.00,0.00,0.00,0,1.00,1,25.51,0,0,1,,0.00,0,0,1,0,0,1,0,1,11,1
"org.apache.jackrabbit.core.TransientRepository$RepositoryFactory_0",1,0.00,1.00,3,0.02,222.80,1,0,18,2,1,134.71,0,0,0,1,134.71,0.00,0.00,0.00,0,1.00,1,58.19,0,0,1,java.lang.Object,0.00,1,0,1,0,1,1,0,0,18,0
"org.apache.jackrabbit.core.TransientRepository$RepositoryFactory_1",1,0.00,3.00,6,0.08,2026.72,1,0,18,4,3,115.68,0,0,0,1,115.68,0.00,0.00,0.00,0,1.00,3,226.26,0,0,3,java.lang.Object,0.00,3,0,3,0,3,1,0,0,51,0
"org.apache.jackrabbit.core.TransientRepository$RepositoryFactory_2",1,0.00,3.00,6,0.08,2212.78,1,0,18,4,3,115.38,0,0,0,1,115.38,0.00,0.00,0.00,0,1.00,3,228.08,0,0,3,java.lang.Object,0.00,3,0,3,0,3,1,0,0,52,0
"org.apache.jackrabbit.core.TransientRepositoryTest",3,0.00,1.00,13,0.10,1217.13,4,1,5,10,2,95.78,19,17,1,2,128.00,0.00,0.50,1.00,0,0.00,1,303.04,0,0,1,junit.framework.TestCase,0.00,7,1,3,0,7,3,0,5,77,1
"org.apache.jackrabbit.core.TransientRepositoryTest$TransientRepository.RepositoryFactory",1,0.00,1.00,3,0.02,176.32,1,0,5,2,1,135.51,0,4,0,1,135.51,0.00,0.00,0.00,0,1.00,1,57.02,0,1,1,java.lang.Object,0.00,1,0,1,0,1,0,0,0,18,0
"org.apache.jackrabbit.core.UserPerWorkspaceSecurityManager",11,0.10,2.00,75,1.05,36360.87,14,3,27,46,19,64.10,101,114,2,2,114.10,0.00,0.50,0.24,2,46.00,4,3162.53,11,8,17,org.apache.jackrabbit.core.DefaultSecurityManager,0.30,35,1,22,0,35,3,0,26,640,1
"org.apache.jackrabbit.core.UserPerWorkspaceSecurityManager$WorkspaceAccessManagerImpl",3,0.00,2.33,14,0.17,5106.64,3,0,27,9,4,90.68,20,21,0,1,122.90,0.00,0.00,0.00,0,3.00,5,510.00,0,0,4,java.lang.Object,0.00,6,0,7,0,6,3,1,7,105,2
"org.apache.jackrabbit.core.UserPerWorkspaceSecurityManager$WorkspaceBasedPrincipalProviderRegistry",5,0.50,1.20,18,0.20,4373.97,6,1,27,18,2,129.99,0,25,0,1,129.99,0.00,0.00,0.60,0,2.00,2,592.85,0,4,2,java.lang.Object,0.00,13,0,6,0,13,1,1,0,144,2
"org.apache.jackrabbit.core.UserPerWorkspaceSecurityManagerTest",10,0.78,3.70,184,2.62,125030.74,11,1,19,64,12,112.23,33,237,1,4,91.61,0.00,0.75,0.30,1,0.00,7,7847.08,2,1,11,org.apache.jackrabbit.test.AbstractJCRTest,0.11,54,3,37,0,54,9,0,31,1386,1
"org.apache.jackrabbit.core.UserTransactionImpl",9,0.12,3.22,114,1.47,78626.13,13,4,15,31,16,81.57,49,138,15,1,99.44,0.00,0.00,0.36,0,0.00,10,4409.97,0,0,1,java.lang.Object,0.00,22,0,29,0,22,9,1,14,799,1
"org.apache.jackrabbit.core.UserTransactionImpl$Thread",1,0.00,3.00,11,0.11,2698.66,1,0,15,5,0,104.88,0,12,0,1,104.88,0.00,0.00,0.00,0,0.00,3,344.89,0,0,0,java.lang.Object,0.00,4,0,3,0,4,1,0,0,72,0
"org.apache.jackrabbit.core.UserTransactionImpl$XidImpl",4,1.00,1.00,10,0.06,808.47,5,1,15,4,0,162.23,15,15,0,1,141.61,0.00,0.00,0.25,0,6.00,1,193.11,0,0,0,java.lang.Object,0.00,0,0,4,0,0,4,1,5,57,0
"org.apache.jackrabbit.core.VersionManagerImpl",30,0.86,1.53,133,1.89,54942.67,31,1,42,73,27,122.99,137,230,2,5,122.75,0.00,0.80,0.17,8,198.00,5,5666.21,2,15,27,org.apache.jackrabbit.core.version.VersionManagerImplConfig,0.00,43,4,46,0,43,15,1,38,1165,1
"org.apache.jackrabbit.core.VersionManagerImpl$SessionOperation<Version>",2,0.00,1.00,7,0.07,933.63,2,0,42,6,3,132.18,0,10,0,1,132.18,0.00,0.00,0.00,0,2.00,1,219.49,0,2,3,java.lang.Object,0.00,4,0,2,0,4,0,0,0,54,0
"org.apache.jackrabbit.core.VersionManagerImpl$SessionOperation<VersionHistory>",2,0.00,1.00,7,0.07,933.63,2,0,42,6,3,132.18,0,10,0,1,132.18,0.00,0.00,0.00,0,2.00,1,219.49,0,2,3,java.lang.Object,0.00,4,0,2,0,4,0,0,0,54,0
"org.apache.jackrabbit.core.VersionManagerImpl$SessionWriteOperation<NodeId>",2,0.00,1.00,6,0.07,845.55,2,0,42,4,4,132.52,0,12,0,1,132.52,0.00,0.00,0.00,0,2.00,1,202.18,0,2,4,java.lang.Object,0.00,2,0,2,0,2,0,0,0,49,0
"org.apache.jackrabbit.core.VersionManagerImpl$SessionWriteOperation<NodeIterator>",2,0.00,1.00,8,0.12,2068.15,2,0,42,7,5,124.80,0,16,0,1,124.80,0.00,0.00,0.00,0,2.00,1,372.88,0,2,5,java.lang.Object,0.00,5,0,2,0,5,0,0,0,82,0
"org.apache.jackrabbit.core.VersionManagerImpl$SessionWriteOperation<Object>",2,0.00,3.00,21,0.28,10036.71,2,0,42,18,6,154.30,3,34,0,1,104.30,0.00,0.00,0.00,0,2.00,5,849.44,0,2,6,java.lang.Object,0.00,16,0,6,0,16,0,0,3,153,0
"org.apache.jackrabbit.core.VersionManagerImpl$SessionWriteOperation<Object>_1",2,0.00,1.00,7,0.09,1190.80,2,0,42,5,3,131.35,0,15,0,1,131.35,0.00,0.00,0.00,0,2.00,1,273.67,0,2,3,java.lang.Object,0.00,3,0,2,0,3,0,0,0,64,0
"org.apache.jackrabbit.core.VersionManagerImpl$SessionWriteOperation<Object>_2",2,0.00,2.00,18,0.26,7830.55,2,0,42,13,9,156.95,3,31,0,1,106.95,0.00,0.00,0.00,0,2.00,3,793.53,0,2,9,java.lang.Object,0.00,11,0,4,0,11,0,0,3,145,0
"org.apache.jackrabbit.core.VersionManagerImpl$SessionWriteOperation<Object>_3",2,0.00,1.00,7,0.09,1190.80,2,0,42,5,3,131.35,0,16,0,1,131.35,0.00,0.00,0.00,0,2.00,1,273.67,0,2,3,java.lang.Object,0.00,3,0,2,0,3,0,0,0,64,0
"org.apache.jackrabbit.core.VersionManagerImpl$SessionWriteOperation<Version>",2,0.00,1.00,7,0.10,1316.11,2,0,42,5,4,131.01,0,13,0,1,131.01,0.00,0.00,0.00,0,2.00,1,291.89,0,2,4,java.lang.Object,0.00,3,0,2,0,3,0,0,0,66,0
"org.apache.jackrabbit.core.VersionManagerImpl$SessionWriteOperation<Version>_0",2,0.00,1.00,7,0.09,1304.01,2,0,42,5,4,131.04,0,13,0,1,131.04,0.00,0.00,0.00,0,2.00,1,272.16,0,2,4,java.lang.Object,0.00,3,0,2,0,3,0,0,0,62,0
"org.apache.jackrabbit.core.WorkspaceImpl",33,0.06,2.33,280,3.62,138339.19,45,12,49,104,37,58.59,304,441,10,2,108.59,0.00,0.50,0.14,10,0.00,7,10855.27,0,19,31,org.apache.jackrabbit.commons.AbstractWorkspace,0.00,71,1,77,0,71,14,3,108,2044,1
"org.apache.jackrabbit.core.WorkspaceManager",7,0.17,1.00,16,0.14,1732.58,8,1,6,13,5,141.16,32,29,3,1,140.92,0.00,0.00,0.86,0,0.00,1,414.20,0,4,3,java.lang.Object,0.00,6,0,7,0,6,3,0,7,116,1
"org.apache.jackrabbit.core.XATest",49,0.88,1.94,890,11.18,412351.77,50,1,16,126,3,48.99,563,1032,1,4,93.11,0.00,0.75,0.14,2,0.00,9,33533.67,5,0,2,org.apache.jackrabbit.test.AbstractJCRTest,0.11,77,3,95,0,77,49,0,377,6109,1
"org.apache.jackrabbit.core.XATest$Operation",1,0.00,1.00,4,0.03,341.48,1,0,16,4,0,128.59,0,5,0,1,128.59,0.00,0.00,0.00,0,1.00,1,97.86,0,0,0,java.lang.Object,0.00,3,0,1,0,3,1,0,0,27,0
"org.apache.jackrabbit.core.XATest$Operation_0",1,0.00,1.00,5,0.05,791.76,1,0,16,4,0,122.10,0,6,0,1,122.10,0.00,0.00,0.00,0,1.00,1,159.62,0,0,0,java.lang.Object,0.00,3,0,1,0,3,1,0,0,38,0
"org.apache.jackrabbit.core.XATest$Operation_1",1,0.00,1.00,4,0.03,341.48,1,0,16,4,0,128.59,0,5,0,1,128.59,0.00,0.00,0.00,0,1.00,1,97.86,0,0,0,java.lang.Object,0.00,3,0,1,0,3,1,0,0,27,0
"org.apache.jackrabbit.core.XATest$Operation_2",1,0.00,1.00,4,0.04,441.18,1,0,16,4,0,127.72,0,5,0,1,127.72,0.00,0.00,0.00,0,1.00,1,110.19,0,0,0,java.lang.Object,0.00,3,0,1,0,3,1,0,0,29,0
"org.apache.jackrabbit.core.XATest$Operation_3",1,0.00,1.00,4,0.04,386.40,1,0,16,5,0,128.17,0,5,0,1,128.17,0.00,0.00,0.00,0,1.00,1,112.00,0,0,0,java.lang.Object,0.00,4,0,1,0,4,1,0,0,30,0
"org.apache.jackrabbit.core.XATest$Operation_4",1,0.00,1.00,2,0.01,42.34,1,0,16,1,0,129.09,5,3,0,1,146.96,0.00,0.00,0.00,0,1.00,1,30.34,0,0,0,,0.00,0,0,1,0,0,1,0,1,12,0
"org.apache.jackrabbit.core.ZombieHierarchyManager",6,0.80,2.50,35,0.35,9551.80,7,1,10,16,12,77.21,46,56,2,2,119.50,0.00,0.50,0.33,0,10.00,4,1041.69,4,4,10,org.apache.jackrabbit.core.HierarchyManagerImpl,0.00,10,1,15,0,10,2,0,17,242,1
"org.apache.jackrabbit.standalone.cli.AbstractParameter",14,0.12,1.07,38,0.27,4336.16,20,6,2,15,6,140.37,58,51,5,1,140.14,0.00,0.00,0.06,0,74.00,2,819.35,0,7,1,java.lang.Object,0.00,1,0,15,3,1,7,1,21,223,2
"org.apache.jackrabbit.standalone.cli.Argument",3,1.00,1.00,11,0.07,1315.42,4,1,0,4,6,114.52,16,15,5,3,132.40,0.00,0.67,0.33,1,4.00,1,215.93,0,1,1,org.apache.jackrabbit.standalone.cli.Option,0.12,1,2,3,0,1,2,0,5,61,1
"org.apache.jackrabbit.standalone.cli.CommandException",5,0.33,1.40,23,0.24,5690.00,8,3,3,11,21,82.11,37,32,21,2,124.40,3.00,0.20,0.07,0,8.00,3,705.18,0,1,1,java.lang.Exception,0.00,6,1,7,3,6,4,0,9,164,1
"org.apache.jackrabbit.standalone.cli.CommandHelper",17,0.05,2.18,104,1.21,38195.03,23,6,13,40,71,65.40,160,155,71,1,115.40,0.00,0.00,0.12,4,154.00,5,3637.87,0,11,1,java.lang.Object,0.00,23,0,37,0,23,6,0,24,780,2
"org.apache.jackrabbit.standalone.cli.CommandLine",27,0.07,1.37,105,1.22,29882.25,35,8,10,67,9,149.77,106,147,5,1,129.16,0.00,0.00,0.06,6,286.00,4,3674.26,0,14,4,java.lang.Object,0.00,40,0,37,0,40,13,2,42,839,1
"org.apache.jackrabbit.standalone.cli.CommandLine$Predicate",1,0.00,1.00,4,0.03,392.74,1,0,10,2,1,128.11,0,5,0,1,128.11,0.00,0.00,0.00,0,1.00,1,84.15,0,0,1,java.lang.Object,0.00,1,0,1,0,1,1,0,0,24,0
"org.apache.jackrabbit.standalone.cli.CommandLine$Predicate_0",1,0.00,1.00,4,0.03,392.74,1,0,10,2,1,128.11,0,5,0,1,128.11,0.00,0.00,0.00,0,1.00,1,84.15,0,0,1,java.lang.Object,0.00,1,0,1,0,1,1,0,0,24,0
"org.apache.jackrabbit.standalone.cli.CommandLineFactory",5,0.21,3.00,58,0.80,27872.61,12,7,17,38,8,54.30,40,82,4,1,102.40,0.00,0.00,0.31,0,1.00,6,2411.96,0,2,4,java.lang.Object,0.00,33,0,15,0,33,3,0,21,460,1
"org.apache.jackrabbit.standalone.cli.ConfigurationException",4,1.00,1.00,10,0.08,824.84,5,1,1,4,3,99.26,30,16,2,3,141.55,0.00,0.67,0.00,0,4.00,1,241.63,0,0,1,org.apache.jackrabbit.standalone.cli.CommandException,0.00,0,2,4,0,0,4,0,6,69,1
"org.apache.jackrabbit.standalone.cli.Flag",8,0.71,1.12,24,0.18,3100.34,9,1,0,12,5,153.41,31,34,4,2,132.79,0.00,0.50,0.38,1,20.00,2,543.89,2,4,1,org.apache.jackrabbit.standalone.cli.AbstractParameter,0.36,4,1,9,0,4,4,0,10,146,1
"org.apache.jackrabbit.standalone.cli.JcrClient",12,0.00,2.75,128,1.85,77108.29,17,5,28,74,10,55.37,96,176,3,1,103.48,0.00,0.00,0.20,8,44.00,8,5547.86,0,1,7,java.lang.Object,0.00,62,0,33,0,62,11,0,34,1030,1
"org.apache.jackrabbit.standalone.cli.JcrClient$JcrChildrenCompletor",1,0.00,6.00,18,0.24,8872.45,1,0,28,9,3,92.67,0,25,0,1,92.67,0.00,0.00,0.00,0,0.00,6,708.59,0,0,3,java.lang.Object,0.00,8,0,6,0,8,1,1,0,127,1
"org.apache.jackrabbit.standalone.cli.JcrParser",8,0.00,3.88,117,1.61,98169.34,12,4,12,52,9,45.74,72,157,1,1,95.74,0.00,0.00,0.25,3,16.00,10,4818.16,0,2,8,java.lang.Object,0.00,44,0,31,0,44,6,0,29,886,1
"org.apache.jackrabbit.standalone.cli.JcrParserException",4,1.00,1.00,10,0.08,824.84,5,1,1,4,4,123.67,22,16,3,3,141.55,0.00,0.67,0.00,0,4.00,1,241.63,0,0,1,org.apache.jackrabbit.standalone.cli.CommandException,0.00,0,2,4,0,0,4,0,6,69,1
"org.apache.jackrabbit.standalone.cli.Option",8,0.43,1.00,23,0.17,2240.86,10,2,0,10,7,140.73,32,32,6,2,140.50,1.00,0.33,0.12,2,28.00,1,502.15,2,4,1,org.apache.jackrabbit.standalone.cli.AbstractParameter,0.27,2,1,8,1,2,4,0,11,140,1
"org.apache.jackrabbit.standalone.cli.SourceCommand",3,0.25,1.67,20,0.28,9056.38,5,2,9,17,3,96.58,16,29,0,1,114.45,0.00,0.00,0.33,0,5.00,3,847.20,0,1,3,java.lang.Object,0.00,14,0,5,0,14,2,1,7,164,1
"org.apache.jackrabbit.core.query.lucene.constraint.AndConstraint",2,0.00,1.00,8,0.09,1858.54,4,2,3,3,5,75.17,18,15,1,1,125.17,0.00,0.00,0.50,0,2.00,1,269.76,0,0,4,java.lang.Object,0.00,1,0,2,0,1,2,1,5,70,1
"org.apache.jackrabbit.core.query.lucene.constraint.ChildNodeConstraint",2,0.00,2.00,13,0.17,4332.72,2,0,8,9,9,83.32,13,23,1,3,115.55,0.00,0.67,0.00,0,2.00,3,506.27,1,0,8,org.apache.jackrabbit.core.query.lucene.constraint.HierarchyConstraint,0.00,7,2,4,0,7,2,0,3,104,1
"org.apache.jackrabbit.core.query.lucene.constraint.ComparisonConstraint",3,0.00,4.33,37,0.41,17905.06,6,3,8,7,10,52.20,32,53,2,2,100.67,1.00,0.33,0.33,1,5.00,7,1235.77,0,0,8,org.apache.jackrabbit.core.query.lucene.constraint.SelectorBasedConstraint,0.00,4,1,13,1,4,3,0,7,247,1
"org.apache.jackrabbit.core.query.lucene.constraint.Constraint",1,0.00,1.00,2,0.02,154.78,1,0,3,1,11,113.15,13,5,8,1,142.53,0.00,0.00,0.00,0,1.00,1,65.11,0,0,3,,0.00,0,0,1,0,0,1,0,2,19,1
"org.apache.jackrabbit.core.query.lucene.constraint.ConstraintBuilder",1,0.00,3.00,7,0.12,3717.20,1,0,34,4,28,144.49,20,18,1,1,111.11,0.00,0.00,0.00,0,1.00,3,347.62,0,1,27,java.lang.Object,0.00,3,0,3,0,3,0,0,3,72,1
"org.apache.jackrabbit.core.query.lucene.constraint.ConstraintBuilder$Visitor",20,0.21,1.45,85,1.36,38593.01,24,4,34,71,44,172.58,25,145,0,2,122.58,0.00,0.50,0.05,1,88.00,6,4083.47,0,19,44,org.apache.jackrabbit.core.query.lucene.DefaultQOMTreeVisitor,0.00,51,1,29,0,51,1,0,10,851,3
"org.apache.jackrabbit.core.query.lucene.constraint.DescendantNodeConstraint",2,0.00,3.50,22,0.23,7206.37,2,0,9,9,10,61.57,14,32,1,3,103.86,0.00,0.67,0.00,0,2.00,6,684.33,1,0,9,org.apache.jackrabbit.core.query.lucene.constraint.HierarchyConstraint,0.00,7,2,7,0,7,2,0,4,134,1
"org.apache.jackrabbit.core.query.lucene.constraint.DynamicOperand",1,1.00,1.00,3,0.04,627.79,2,1,3,1,12,130.70,16,5,10,1,131.17,0.00,0.00,0.00,0,1.00,1,118.43,0,1,2,java.lang.Object,0.00,0,0,1,7,0,0,0,3,31,2
"org.apache.jackrabbit.core.query.lucene.constraint.EvaluationContext",4,0.00,1.00,5,0.02,121.30,4,0,6,4,22,141.46,21,6,19,1,159.33,0.00,0.00,0.00,0,4.00,1,71.36,0,4,3,,0.00,0,0,4,0,0,0,0,5,28,1
"org.apache.jackrabbit.core.query.lucene.constraint.FullTextConstraint",1,0.00,1.00,3,0.03,400.62,1,0,4,2,5,88.58,11,8,1,3,132.71,0.00,0.67,0.00,0,1.00,1,103.51,0,0,4,org.apache.jackrabbit.core.query.lucene.constraint.QueryConstraint,0.00,1,2,1,0,1,1,0,2,28,1
"org.apache.jackrabbit.core.query.lucene.constraint.FullTextSearchScoreOperand",1,0.00,1.00,3,0.05,823.11,1,0,3,5,4,87.95,7,6,1,2,130.24,0.00,0.50,0.00,0,1.00,1,153.81,0,1,3,org.apache.jackrabbit.core.query.lucene.constraint.DynamicOperand,0.00,4,1,1,0,4,0,0,2,38,1
"org.apache.jackrabbit.core.query.lucene.constraint.HierarchyConstraint",2,0.00,2.00,13,0.12,2674.79,4,2,4,5,8,79.63,24,19,3,2,117.20,3.00,0.20,0.50,0,2.00,3,370.16,0,1,5,org.apache.jackrabbit.core.query.lucene.constraint.SelectorBasedConstraint,0.00,3,1,4,3,3,1,0,5,86,2
"org.apache.jackrabbit.core.query.lucene.constraint.LengthOperand",2,1.00,3.00,28,0.40,19058.08,3,1,9,15,10,54.37,14,32,1,2,96.66,0.00,0.50,0.50,0,2.00,5,1207.49,0,1,9,org.apache.jackrabbit.core.query.lucene.constraint.DynamicOperand,0.00,13,1,6,0,13,1,0,4,218,1
"org.apache.jackrabbit.core.query.lucene.constraint.LikeConstraint",2,1.00,1.00,7,0.10,1276.67,3,1,6,7,6,81.11,18,12,1,3,131.11,0.00,0.67,0.50,0,2.00,1,303.74,0,0,5,org.apache.jackrabbit.core.query.lucene.constraint.ComparisonConstraint,0.00,5,2,2,0,5,2,0,4,72,1
"org.apache.jackrabbit.core.query.lucene.constraint.LowerCaseOperand",2,1.00,1.50,14,0.15,4024.97,3,1,4,8,4,71.08,14,16,1,2,113.37,0.00,0.50,0.50,0,2.00,2,446.75,0,1,3,org.apache.jackrabbit.core.query.lucene.constraint.DynamicOperand,0.00,6,1,3,0,6,1,0,4,98,1
"org.apache.jackrabbit.core.query.lucene.constraint.NodeLocalNameOperand",1,0.00,2.00,7,0.12,2686.68,1,0,6,8,6,92.17,14,13,1,2,112.31,0.00,0.50,0.00,0,1.00,2,351.28,0,1,5,org.apache.jackrabbit.core.query.lucene.constraint.DynamicOperand,0.00,7,1,2,0,7,0,0,3,72,1
"org.apache.jackrabbit.core.query.lucene.constraint.NodeNameOperand",1,0.00,2.00,7,0.12,2646.44,1,0,6,7,5,82.98,13,12,1,2,112.36,0.00,0.50,0.00,0,1.00,2,346.19,0,1,4,org.apache.jackrabbit.core.query.lucene.constraint.DynamicOperand,0.00,6,1,2,0,6,0,0,3,71,1
"org.apache.jackrabbit.core.query.lucene.constraint.NotConstraint",2,1.00,1.00,6,0.06,1034.46,3,1,3,3,5,89.54,15,12,1,1,131.83,0.00,0.00,0.50,0,2.00,1,185.92,0,0,4,java.lang.Object,0.00,1,0,2,0,1,2,1,4,49,1
"org.apache.jackrabbit.core.query.lucene.constraint.OrConstraint",2,0.00,1.00,8,0.09,1858.54,4,2,3,3,5,75.17,18,15,1,1,125.17,0.00,0.00,0.50,0,2.00,1,269.76,0,0,4,java.lang.Object,0.00,1,0,2,0,1,2,1,5,70,1
"org.apache.jackrabbit.core.query.lucene.constraint.PropertyExistenceConstraint",1,0.00,1.00,3,0.03,400.62,1,0,4,2,5,103.33,13,8,1,3,132.71,0.00,0.67,0.00,0,1.00,1,103.51,0,0,4,org.apache.jackrabbit.core.query.lucene.constraint.QueryConstraint,0.00,1,2,1,0,1,1,0,2,28,1
"org.apache.jackrabbit.core.query.lucene.constraint.PropertyValueOperand",4,0.67,2.50,28,0.33,8380.45,5,1,14,17,12,65.01,34,46,2,2,113.11,0.00,0.50,0.50,1,6.00,3,984.82,0,3,10,org.apache.jackrabbit.core.query.lucene.constraint.DynamicOperand,0.00,13,1,10,0,13,1,0,8,208,1
"org.apache.jackrabbit.core.query.lucene.constraint.QueryConstraint",4,0.00,2.00,34,0.46,15090.19,7,3,14,17,10,60.51,42,52,2,2,108.99,2.00,0.25,0.33,1,4.00,4,1387.28,1,0,8,org.apache.jackrabbit.core.query.lucene.constraint.SelectorBasedConstraint,0.00,13,1,8,2,13,4,0,10,271,2
"org.apache.jackrabbit.core.query.lucene.constraint.SameNodeConstraint",2,0.00,1.50,9,0.10,2079.44,2,0,5,5,7,92.47,12,16,1,3,124.69,0.00,0.67,0.00,0,2.00,2,298.81,1,0,6,org.apache.jackrabbit.core.query.lucene.constraint.HierarchyConstraint,0.00,3,2,3,0,3,2,0,3,69,1
"org.apache.jackrabbit.core.query.lucene.constraint.SelectorBasedConstraint",3,0.00,1.33,11,0.10,1698.70,5,2,3,6,6,83.35,24,17,3,1,131.46,0.00,0.00,0.50,0,1.00,2,296.86,0,1,3,java.lang.Object,0.00,3,0,4,9,3,2,1,6,74,2
"org.apache.jackrabbit.core.query.lucene.constraint.UpperCaseOperand",2,1.00,1.50,14,0.15,4024.97,3,1,4,8,4,71.08,14,16,1,2,113.37,0.00,0.50,0.50,0,2.00,2,446.75,0,1,3,org.apache.jackrabbit.core.query.lucene.constraint.DynamicOperand,0.00,6,1,3,0,6,1,0,4,98,1
"org.apache.jackrabbit.jcr.AccessManager",5,6.00,1.00,12,0.18,3505.61,11,6,6,5,8,93.23,55,13,5,1,137.36,0.00,0.00,0.00,0,5.00,1,543.80,0,0,3,,0.00,0,0,5,0,0,5,0,7,133,1
"org.apache.jackrabbit.jcr.SecurityConstants",0,0.00,0.00,2,0.01,87.17,1,1,0,0,0,171.00,10,4,0,1,171.00,0.00,0.00,0.00,0,0.00,0,34.87,0,0,0,,0.00,0,0,0,0,0,0,0,2,11,1
"org.apache.jackrabbit.core.persistence.bundle.AbstractBundlePersistenceManager",32,0.01,2.75,271,3.59,277718.62,43,11,31,99,27,63.77,252,359,2,1,106.07,0.00,0.00,0.08,13,328.00,27,10783.37,0,15,25,java.lang.Object,0.00,67,0,88,9,67,17,3,67,2042,2
"org.apache.jackrabbit.core.persistence.bundle.BundleDbPersistenceManager",66,0.02,2.47,584,7.84,476688.93,100,34,42,200,28,64.43,467,799,7,2,106.72,7.00,0.11,0.05,18,2086.00,22,23512.80,5,21,21,org.apache.jackrabbit.core.persistence.bundle.AbstractBundlePersistenceManager,0.06,134,1,163,7,134,45,0,154,4183,1
"org.apache.jackrabbit.core.persistence.bundle.BundleDbPersistenceManager$CloseableBLOBStore",1,0.00,1.00,2,0.01,64.15,1,0,42,1,0,145.54,0,3,0,2,145.54,0.00,0.50,0.00,0,1.00,1,30.46,0,0,0,,0.00,0,1,1,0,0,1,0,0,12,2
"org.apache.jackrabbit.core.persistence.bundle.BundleDbPersistenceManager$DbBlobStore",6,0.16,1.50,45,0.60,15626.31,11,5,42,26,1,133.10,21,55,0,1,112.48,0.00,0.00,0.33,0,0.00,3,1788.25,0,2,1,java.lang.Object,0.00,20,0,9,0,20,4,1,10,370,1
"org.apache.jackrabbit.core.persistence.bundle.BundleDbPersistenceManager$DbBlobStore$FilterInputStream",1,0.00,1.00,4,0.02,218.17,1,0,42,3,0,180.12,1,5,0,1,130.12,0.00,0.00,0.00,0,1.00,1,68.97,0,0,0,java.lang.Object,0.00,2,0,1,0,2,1,0,1,21,0
"org.apache.jackrabbit.core.persistence.bundle.BundleDbPersistenceManager$FSBlobStore",3,1.00,1.33,11,0.09,1127.40,4,1,42,6,3,132.86,1,17,0,2,132.86,0.00,0.50,0.33,0,4.00,2,256.14,0,1,3,org.apache.jackrabbit.core.persistence.util.FileSystemBLOBStore,0.00,3,1,4,0,3,2,1,1,69,1
"org.apache.jackrabbit.core.persistence.bundle.BundleFsPersistenceManager",25,0.03,2.52,228,2.99,121535.07,34,9,28,91,19,73.94,151,304,1,2,106.16,0.00,0.50,0.14,5,244.00,7,8983.87,3,10,18,org.apache.jackrabbit.core.persistence.bundle.AbstractBundlePersistenceManager,0.07,66,1,63,0,66,15,0,41,1703,1
"org.apache.jackrabbit.core.persistence.bundle.BundleFsPersistenceManager$CloseableBLOBStore",1,0.00,1.00,2,0.01,64.15,1,0,28,1,0,145.54,0,3,0,2,145.54,0.00,0.50,0.00,0,1.00,1,30.46,0,0,0,,0.00,0,1,1,0,0,1,0,0,12,2
"org.apache.jackrabbit.core.persistence.bundle.BundleFsPersistenceManager$FSBlobStore",3,1.00,1.33,11,0.09,1158.56,4,1,28,6,3,132.77,1,17,0,2,132.77,0.00,0.50,0.33,0,4.00,2,265.04,0,1,3,org.apache.jackrabbit.core.persistence.util.FileSystemBLOBStore,0.00,3,1,4,0,3,2,1,1,71,1
"org.apache.jackrabbit.core.persistence.bundle.ConnectionFactory",2,0.00,5.50,21,0.37,30058.04,2,0,7,10,1,80.27,29,36,1,1,100.41,0.00,0.00,0.00,0,2.00,10,1117.30,0,1,0,java.lang.Object,0.00,8,0,11,0,8,1,0,9,196,1
"org.apache.jackrabbit.core.persistence.bundle.ConnectionRecoveryManager",14,0.07,3.07,154,1.76,67428.24,26,12,11,48,5,73.51,186,211,4,1,102.90,0.00,0.00,0.15,8,58.00,7,5279.27,0,7,1,java.lang.Object,0.00,34,0,43,0,34,7,0,37,1029,1
"org.apache.jackrabbit.core.persistence.bundle.ConnectionRecoveryManager$StreamWrapper",1,2.00,1.00,6,0.04,562.20,3,2,11,1,0,72.21,8,8,0,1,120.32,0.00,0.00,0.00,0,1.00,1,134.95,0,0,0,java.lang.Object,0.00,0,0,1,0,0,1,0,1,37,2
"org.apache.jackrabbit.core.persistence.bundle.DbNameIndex",8,0.14,2.62,83,0.97,36063.61,14,6,5,25,7,62.41,61,121,5,1,104.70,0.00,0.00,0.29,2,10.00,4,2904.01,0,2,2,java.lang.Object,0.00,17,0,21,2,17,6,1,18,571,1
"org.apache.jackrabbit.core.persistence.bundle.DerbyPersistenceManager",14,0.00,1.57,64,0.78,17101.46,21,7,7,33,3,86.57,178,99,1,3,124.13,0.00,0.67,0.14,0,78.00,5,2342.49,11,5,2,org.apache.jackrabbit.core.persistence.bundle.BundleDbPersistenceManager,0.08,19,2,22,0,19,9,0,33,503,1
"org.apache.jackrabbit.core.persistence.bundle.H2PersistenceManager",5,0.75,1.80,23,0.23,3666.38,6,1,4,13,3,83.55,39,35,1,3,125.84,0.00,0.67,0.40,0,7.00,5,687.20,10,1,2,org.apache.jackrabbit.core.persistence.bundle.BundleDbPersistenceManager,0.03,8,2,9,0,8,4,0,8,156,1
"org.apache.jackrabbit.core.persistence.bundle.MSSqlPersistenceManager",4,0.67,1.25,14,0.12,2249.19,5,1,1,7,2,89.20,29,21,0,3,131.50,0.00,0.67,0.50,0,4.00,2,361.21,3,2,2,org.apache.jackrabbit.core.persistence.bundle.BundleDbPersistenceManager,0.00,3,2,5,0,3,2,0,4,92,1
"org.apache.jackrabbit.core.persistence.bundle.MySqlPersistenceManager",1,0.00,3.00,7,0.06,831.10,1,0,1,1,2,155.53,21,11,0,3,116.23,0.00,0.67,0.00,0,1.00,3,178.03,5,0,2,org.apache.jackrabbit.core.persistence.bundle.BundleDbPersistenceManager,0.00,0,2,3,0,0,1,0,3,43,1
"org.apache.jackrabbit.core.persistence.bundle.NGKDbNameIndex",3,0.00,1.33,14,0.15,3065.56,3,0,1,6,3,76.67,24,23,1,2,124.78,0.00,0.50,0.00,0,1.00,2,449.79,1,0,2,org.apache.jackrabbit.core.persistence.bundle.DbNameIndex,0.00,3,1,4,0,3,3,0,5,103,1
"org.apache.jackrabbit.core.persistence.bundle.Oracle9PersistenceManager",7,0.08,2.43,67,1.07,41769.48,11,4,20,35,6,56.99,72,98,0,4,105.47,0.00,0.75,0.32,1,0.00,6,3215.10,3,2,6,org.apache.jackrabbit.core.persistence.bundle.OraclePersistenceManager,0.00,28,3,17,0,28,5,0,22,585,1
"org.apache.jackrabbit.core.persistence.bundle.Oracle9PersistenceManager$OracleBLOBStore",2,0.00,2.50,15,0.20,7702.17,2,0,20,7,0,150.92,4,24,0,2,111.03,0.00,0.50,0.00,0,2.00,4,596.79,0,0,0,org.apache.jackrabbit.core.persistence.bundle.DbBlobStore,0.00,5,1,5,0,5,2,0,2,113,0
"org.apache.jackrabbit.core.persistence.bundle.OraclePersistenceManager",8,0.19,2.25,56,0.64,18654.42,11,3,6,29,6,70.48,61,76,1,3,112.77,0.50,0.50,0.17,0,14.00,7,1911.70,10,3,5,org.apache.jackrabbit.core.persistence.bundle.BundleDbPersistenceManager,0.08,21,2,18,1,21,5,0,17,383,1
"org.apache.jackrabbit.core.persistence.bundle.PostgreSQLNameIndex",4,0.67,1.75,28,0.28,7230.59,5,1,2,11,3,81.48,26,42,1,2,113.70,0.00,0.50,0.50,1,0.00,3,852.07,0,0,2,org.apache.jackrabbit.core.persistence.bundle.DbNameIndex,0.00,7,1,7,0,7,4,0,5,183,1
"org.apache.jackrabbit.core.persistence.bundle.PostgreSQLPersistenceManager",4,1.00,2.00,32,0.37,12394.21,5,1,12,19,8,61.56,33,48,0,3,109.66,0.00,0.67,0.25,0,6.00,3,1116.15,5,2,8,org.apache.jackrabbit.core.persistence.bundle.BundleDbPersistenceManager,0.06,15,2,8,0,15,2,0,6,217,1
"org.apache.jackrabbit.jca.AnonymousConnection",21,0.30,1.05,47,0.43,5913.36,24,3,11,23,1,180.36,54,70,1,1,140.47,0.00,0.00,0.05,0,59.00,2,1292.55,0,6,0,java.lang.Object,0.00,2,0,22,0,2,15,2,21,339,1
"org.apache.jackrabbit.jca.JCAConnectionManager",1,0.00,1.00,4,0.05,759.37,1,0,5,3,1,83.57,7,7,1,1,125.86,0.00,0.00,0.00,0,1.00,1,144.99,0,1,0,java.lang.Object,0.00,2,0,1,0,2,0,1,2,36,2
"org.apache.jackrabbit.jca.JCAConnectionRequestInfo",14,0.31,2.29,84,0.85,32326.99,16,2,5,27,6,135.91,54,104,6,1,115.30,0.00,0.00,0.21,3,42.00,4,2550.61,0,3,0,java.lang.Object,0.00,13,0,32,0,13,11,1,17,580,2
"org.apache.jackrabbit.jca.JCAManagedConnection",33,0.08,1.48,136,1.26,28346.02,40,7,15,69,4,145.96,129,207,3,1,125.35,0.00,0.00,0.07,8,426.00,7,3774.65,0,12,4,java.lang.Object,0.00,36,0,49,0,36,21,2,42,881,2
"org.apache.jackrabbit.jca.JCAManagedConnectionFactory",24,0.10,1.50,93,0.92,22863.24,28,4,16,47,11,150.27,91,143,5,1,129.65,0.00,0.00,0.16,6,144.00,5,2750.00,0,12,8,java.lang.Object,0.00,23,0,36,0,23,12,1,27,632,2
"org.apache.jackrabbit.jca.JCARepositoryHandle",4,0.11,2.50,29,0.30,12021.53,7,3,13,10,5,79.66,24,43,2,3,111.88,0.00,0.67,0.25,0,8.00,7,896.02,0,2,4,org.apache.jackrabbit.commons.repository.ProxyRepository,0.00,6,2,10,0,6,2,2,8,192,2
"org.apache.jackrabbit.jca.JCARepositoryHandle$JCARepositoryFactory",2,1.00,1.00,6,0.04,494.52,3,1,13,3,2,134.36,0,10,0,1,134.36,0.00,0.00,0.50,0,2.00,1,124.92,0,1,2,java.lang.Object,0.00,1,0,2,0,1,1,2,0,37,2
"org.apache.jackrabbit.jca.JCARepositoryManager",7,0.08,1.71,29,0.31,8331.61,11,4,6,14,5,106.33,37,45,3,1,124.20,0.00,0.00,0.18,1,20.00,3,930.87,0,2,2,java.lang.Object,0.00,7,0,12,0,7,5,0,10,216,2
"org.apache.jackrabbit.jca.JCAResourceAdapter",5,0.50,1.00,11,0.12,1358.69,7,2,8,8,1,180.49,10,17,0,1,140.60,0.00,0.00,0.10,0,8.00,1,352.91,0,1,1,java.lang.Object,0.00,3,0,5,0,3,4,2,3,93,1
"org.apache.jackrabbit.jca.JCASessionHandle",56,0.96,1.04,120,1.29,18897.20,57,1,33,108,3,179.74,112,215,3,1,139.85,0.00,0.00,0.05,2,206.00,2,3877.86,0,23,1,java.lang.Object,0.00,52,0,58,0,52,33,2,38,1021,2
"org.apache.jackrabbit.jca.TransactionBoundXAResource",11,0.00,1.09,33,0.30,4832.93,14,3,3,22,1,132.37,1,49,1,1,132.37,0.00,0.00,0.33,0,0.00,2,908.37,0,1,1,java.lang.Object,0.00,11,0,12,0,11,10,1,1,234,1
"org.apache.jackrabbit.core.cluster.ChangeLogRecord",23,0.01,2.17,194,2.50,99185.93,37,14,22,91,19,66.22,182,260,6,2,108.51,0.00,0.50,0.08,7,153.00,8,7499.96,0,5,14,org.apache.jackrabbit.core.cluster.ClusterRecord,0.23,68,1,50,0,68,18,0,45,1427,1
"org.apache.jackrabbit.core.cluster.ClusterContext",5,0.00,1.00,6,0.03,111.00,5,0,4,5,6,128.18,32,7,4,1,160.40,0.00,0.00,0.00,0,5.00,1,82.00,0,3,2,,0.00,0,0,5,0,0,2,0,6,33,1
"org.apache.jackrabbit.core.cluster.ClusterException",2,0.00,1.00,5,0.03,221.18,2,0,0,2,3,93.68,18,8,3,2,143.68,0.00,0.50,0.00,0,2.00,1,88.69,0,0,0,java.lang.Exception,0.00,0,1,2,0,0,2,0,3,29,1
"org.apache.jackrabbit.core.cluster.ClusterNode",29,0.06,3.38,321,3.90,145884.22,54,25,23,107,44,70.50,201,457,11,1,102.72,0.00,0.00,0.10,3,112.00,8,11706.00,0,4,34,java.lang.Object,0.00,78,0,98,0,78,25,6,62,2190,1
"org.apache.jackrabbit.core.cluster.ClusterNode$WorkspaceLockChannel",4,0.33,2.75,34,0.40,10790.91,5,1,23,7,9,110.30,17,50,0,1,110.06,0.00,0.00,0.75,0,0.00,4,1186.69,0,2,9,java.lang.Object,0.00,3,0,11,0,3,2,1,5,235,0
"org.apache.jackrabbit.core.cluster.ClusterNode$WorkspaceUpdateChannel",6,0.00,3.67,72,0.85,32281.04,8,2,23,20,8,101.30,26,102,0,1,101.07,0.00,0.00,0.50,0,0.00,6,2551.95,0,0,8,java.lang.Object,0.00,14,0,22,0,14,6,1,8,482,0
"org.apache.jackrabbit.core.cluster.ClusterOperation",1,0.00,1.00,2,0.01,30.51,1,0,0,1,4,103.95,11,3,4,1,148.08,0.00,0.00,0.00,0,1.00,1,25.51,0,0,0,,0.00,0,0,1,0,0,1,0,2,11,1
"org.apache.jackrabbit.core.cluster.ClusterRecord",12,0.09,1.08,32,0.23,3316.28,15,3,2,19,13,108.30,78,43,10,1,140.53,0.00,0.00,0.25,3,28.00,2,703.72,0,1,3,java.lang.Object,0.00,7,0,13,5,7,11,0,16,192,2
"org.apache.jackrabbit.core.cluster.ClusterRecordDeserializer",1,0.00,7.00,25,0.30,17876.12,1,0,2,11,10,36.44,10,38,2,1,84.92,0.00,0.00,0.00,0,1.00,7,896.76,0,1,8,java.lang.Object,0.00,10,0,7,0,10,0,0,2,171,1
"org.apache.jackrabbit.core.cluster.ClusterRecordDeserializer$ClusterRecord",3,0.00,1.00,4,0.02,81.72,3,0,2,3,1,209.70,3,7,0,1,159.70,0.00,0.00,0.00,0,3.00,1,54.48,0,0,1,java.lang.Object,0.00,0,0,3,0,0,3,0,3,22,0
"org.apache.jackrabbit.core.cluster.ClusterRecordProcessor",5,0.00,1.00,6,0.03,92.55,5,0,0,5,10,128.80,31,7,10,1,161.02,0.00,0.00,0.00,0,5.00,1,87.55,0,0,5,,0.00,0,0,5,0,0,5,0,6,35,1
"org.apache.jackrabbit.core.cluster.ClusterRecordTest",12,0.27,1.25,121,1.83,41667.46,18,6,20,68,20,87.89,69,139,1,3,105.77,0.00,0.67,0.42,0,0.00,3,5494.59,2,1,19,org.apache.jackrabbit.test.JUnitTest,0.43,56,2,15,0,56,11,0,19,1063,1
"org.apache.jackrabbit.core.cluster.ClusterRecordTest$JournalFactory",1,0.00,1.00,3,0.02,141.06,1,0,20,1,1,136.28,0,5,0,1,136.28,0.00,0.00,0.00,0,1.00,1,51.02,0,1,1,java.lang.Object,0.00,0,0,1,0,0,0,0,0,16,0
"org.apache.jackrabbit.core.cluster.ClusterSession",45,0.98,1.04,95,0.78,10186.11,46,1,16,48,3,181.10,119,152,3,1,141.22,0.00,0.00,0.04,1,127.00,2,2335.65,0,20,0,java.lang.Object,0.00,3,0,47,0,3,25,1,37,643,0
"org.apache.jackrabbit.core.cluster.DefaultClusterOperation",3,0.25,1.00,10,0.07,848.91,5,2,0,4,4,91.60,23,15,2,1,133.90,0.00,0.00,0.33,0,5.00,1,210.74,0,1,3,java.lang.Object,0.00,1,0,3,0,1,2,1,6,60,1
"org.apache.jackrabbit.core.cluster.LockEventChannel",3,0.00,1.00,4,0.02,79.24,3,0,1,3,8,109.80,27,5,5,1,159.80,0.00,0.00,0.00,0,3.00,1,74.24,0,2,3,,0.00,0,0,3,0,0,1,0,4,27,1
"org.apache.jackrabbit.core.cluster.LockEventListener",2,0.00,1.00,3,0.03,115.53,2,0,2,2,6,107.13,18,4,5,1,157.13,0.00,0.00,0.00,0,2.00,1,77.02,0,0,1,,0.00,0,0,2,0,0,2,0,3,25,1
"org.apache.jackrabbit.core.cluster.LockRecord",11,0.06,1.18,43,0.33,4691.02,16,5,3,19,10,90.16,80,57,6,2,132.45,0.00,0.50,0.25,0,26.00,2,986.55,0,3,5,org.apache.jackrabbit.core.cluster.ClusterRecord,0.26,8,1,13,0,8,8,0,17,249,1
"org.apache.jackrabbit.core.cluster.NamespaceEventChannel",2,0.00,1.00,3,0.02,70.51,2,0,0,2,3,116.52,15,4,2,1,158.82,0.00,0.00,0.00,0,2.00,1,55.51,0,0,1,,0.00,0,0,2,0,0,2,0,3,21,1
"org.apache.jackrabbit.core.cluster.NamespaceEventListener",1,0.00,1.00,2,0.02,91.88,1,0,1,1,5,100.18,11,4,5,1,144.31,0.00,0.00,0.00,0,1.00,1,49.86,0,0,0,,0.00,0,0,1,0,0,1,0,2,17,1
"org.apache.jackrabbit.core.cluster.NamespaceRecord",8,0.07,1.00,29,0.21,3061.50,12,4,2,12,8,100.64,53,38,5,2,132.86,0.00,0.50,0.31,0,10.00,1,627.61,0,3,4,org.apache.jackrabbit.core.cluster.ClusterRecord,0.30,4,1,8,0,4,5,0,13,168,1
"org.apache.jackrabbit.core.cluster.NodeTypeEventChannel",4,0.00,1.00,5,0.03,160.14,4,0,3,4,5,140.51,23,6,2,1,158.38,0.00,0.00,0.00,0,4.00,1,98.08,0,0,3,,0.00,0,0,4,0,0,4,0,5,35,1
"org.apache.jackrabbit.core.cluster.NodeTypeEventListener",3,0.00,1.00,4,0.04,279.93,3,0,6,3,8,107.38,25,8,5,1,155.49,0.00,0.00,0.00,0,3.00,1,129.26,0,0,3,,0.00,0,0,3,0,0,3,0,4,39,1
"org.apache.jackrabbit.core.cluster.NodeTypeRecord",9,0.20,2.00,72,0.74,28430.13,19,10,9,25,11,61.49,80,88,6,2,109.60,0.00,0.50,0.28,0,6.00,6,2214.20,0,1,6,org.apache.jackrabbit.core.cluster.ClusterRecord,0.19,16,1,18,0,16,8,0,20,454,1
"org.apache.jackrabbit.core.cluster.SimpleClusterContext",7,0.17,1.00,18,0.12,1337.54,10,3,6,9,7,109.59,42,26,2,1,141.81,0.00,0.00,0.19,0,23.00,1,373.69,0,3,5,java.lang.Object,0.00,2,0,7,0,2,4,1,14,106,1
"org.apache.jackrabbit.core.cluster.SimpleEventListener",12,0.36,1.67,57,0.73,20922.86,13,1,14,32,13,80.61,86,86,4,1,122.90,0.00,0.00,0.67,1,0.00,5,2179.67,0,1,9,java.lang.Object,0.00,20,0,20,0,20,11,4,23,498,1
"org.apache.jackrabbit.core.cluster.SimpleEventListener$LockEvent",6,0.13,1.17,21,0.17,3885.70,9,3,14,10,1,98.81,38,31,0,1,131.03,0.00,0.00,0.44,0,2.00,2,522.03,0,2,1,java.lang.Object,0.00,4,0,7,0,4,4,0,9,137,2
"org.apache.jackrabbit.core.cluster.SimpleEventListener$NamespaceEvent",6,0.20,1.67,28,0.23,7222.65,9,3,14,8,1,91.94,37,41,0,1,124.17,0.00,0.00,0.50,0,0.00,4,691.39,0,3,1,java.lang.Object,0.00,2,0,10,0,2,3,0,9,178,2
"org.apache.jackrabbit.core.cluster.SimpleEventListener$NodeTypeEvent",5,0.05,1.20,20,0.18,4202.52,10,5,14,7,2,83.18,38,28,0,1,125.47,0.00,0.00,0.24,0,0.00,2,536.13,0,1,2,java.lang.Object,0.00,2,0,6,0,2,4,0,10,136,2
"org.apache.jackrabbit.core.cluster.SimpleEventListener$UnlockEvent",4,0.33,1.25,13,0.09,1610.37,5,1,14,6,1,132.87,19,19,0,1,132.64,0.00,0.00,0.75,0,0.00,2,266.07,0,1,1,java.lang.Object,0.00,2,0,5,0,2,3,0,5,74,2
"org.apache.jackrabbit.core.cluster.SimpleEventListener$UpdateEvent",9,0.12,1.22,33,0.34,8514.06,14,5,14,16,3,111.85,48,49,0,1,129.72,0.00,0.00,0.31,0,25.00,2,1009.73,0,4,3,java.lang.Object,0.00,7,0,11,0,7,5,1,13,245,2
"org.apache.jackrabbit.core.cluster.TestAll",1,0.00,1.00,5,0.04,874.91,1,0,3,3,1,84.20,12,7,0,2,121.76,0.00,0.50,0.00,0,1.00,1,109.28,0,1,1,junit.framework.TestCase,0.00,2,1,1,0,2,0,0,2,30,1
"org.apache.jackrabbit.core.cluster.Update",6,0.00,1.00,7,0.03,117.81,6,0,3,6,6,128.60,37,8,4,1,160.82,0.00,0.00,0.00,0,6.00,1,93.16,0,4,2,,0.00,0,0,6,0,0,2,0,7,38,1
"org.apache.jackrabbit.core.cluster.UpdateEventChannel",5,0.00,1.00,6,0.03,101.04,5,0,0,5,9,142.85,29,7,7,1,160.72,0.00,0.00,0.00,0,5.00,1,96.04,0,0,2,,0.00,0,0,5,0,0,5,0,6,37,1
"org.apache.jackrabbit.core.cluster.UpdateEventFactory",8,0.00,1.25,68,1.19,31792.93,14,6,19,39,16,60.81,71,105,2,1,108.92,0.00,0.00,0.17,3,28.00,2,3569.88,0,7,14,java.lang.Object,0.00,31,0,10,0,31,1,0,15,688,1
"org.apache.jackrabbit.core.cluster.UpdateEventListener",1,0.00,1.00,2,0.03,188.72,1,0,4,1,9,104.29,12,4,7,1,141.85,0.00,0.00,0.00,0,1.00,1,79.49,0,0,2,,0.00,0,0,1,0,0,1,0,2,22,1
"org.apache.jackrabbit.core.cluster.WorkspaceEventChannel",2,0.00,1.00,3,0.02,54.51,2,0,1,2,4,209.70,3,4,2,1,159.70,0.00,0.00,0.00,0,2.00,1,49.51,0,0,2,,0.00,0,0,2,0,0,2,0,1,19,1
"org.apache.jackrabbit.core.cluster.WorkspaceListener",1,0.00,1.00,2,0.01,64.83,1,0,2,1,3,97.03,10,4,3,1,145.50,0.00,0.00,0.00,0,1.00,1,43.22,0,0,0,,0.00,0,0,1,0,0,1,0,2,15,1
"org.apache.jackrabbit.core.cluster.WorkspaceRecord",7,0.06,1.57,34,0.32,6747.78,10,3,6,17,9,107.07,35,46,5,2,124.94,0.00,0.50,0.29,1,4.00,3,945.33,1,1,5,org.apache.jackrabbit.core.cluster.ClusterRecord,0.32,10,1,11,0,10,6,0,10,220,1
"org.apache.jackrabbit.core.cluster.WorkspaceRecord$Action",3,0.00,1.00,4,0.03,170.31,3,0,6,3,2,157.19,0,5,0,1,157.19,0.00,0.00,0.00,0,3.00,1,84.18,0,0,2,java.lang.Object,0.00,0,0,3,0,0,3,0,0,29,3
"org.apache.jackrabbit.core.cluster.WorkspaceRecord$CreateWorkspaceAction",6,0.07,1.67,41,0.42,10875.10,9,3,6,29,3,116.20,4,50,0,2,116.20,0.00,0.50,0.39,0,10.00,3,1257.02,0,1,3,org.apache.jackrabbit.core.cluster.Action,0.00,23,1,10,0,23,5,0,4,274,2
"org.apache.jackrabbit.commons.json.JsonHandler",9,0.00,1.00,10,0.06,318.61,9,0,1,9,4,126.58,54,11,4,1,158.80,0.00,0.00,0.00,0,9.00,1,184.33,0,0,0,,0.00,0,0,9,0,0,9,0,10,69,1
"org.apache.jackrabbit.commons.json.JsonParser",8,0.05,6.75,149,1.91,153078.49,16,8,8,35,4,57.80,54,192,3,1,90.02,0.00,0.00,0.17,3,16.00,24,5743.78,0,3,1,java.lang.Object,0.00,27,0,54,0,27,5,0,15,1020,1
"org.apache.jackrabbit.commons.json.JsonParserTest",24,0.17,1.12,168,2.05,46661.58,25,1,8,41,3,113.55,11,187,1,2,113.55,0.00,0.50,0.83,2,0.00,2,6144.26,1,3,2,junit.framework.TestCase,0.00,17,1,27,0,17,21,0,7,1297,1
"org.apache.jackrabbit.commons.json.JsonParserTest$DummyJsonHandler",5,0.00,1.00,11,0.06,450.02,5,0,8,7,0,144.38,0,16,0,1,144.38,0.00,0.00,0.00,0,5.00,1,174.08,0,0,0,java.lang.Object,0.00,2,0,5,0,2,5,0,0,58,0
"org.apache.jackrabbit.commons.json.JsonParserTest$DummyJsonHandler_0",5,0.00,1.00,11,0.06,450.02,5,0,8,7,0,144.38,0,16,0,1,144.38,0.00,0.00,0.00,0,5.00,1,174.08,0,0,0,java.lang.Object,0.00,2,0,5,0,2,5,0,0,58,0
"org.apache.jackrabbit.commons.json.JsonParserTest$DummyJsonHandler_1",5,0.00,1.00,11,0.07,577.02,5,0,8,8,0,143.53,0,16,0,1,143.53,0.00,0.00,0.00,0,5.00,1,198.31,0,0,0,java.lang.Object,0.00,3,0,5,0,3,5,0,0,64,0
"org.apache.jackrabbit.commons.json.JsonParserTest$DummyJsonHandler_10",7,0.25,1.43,27,0.16,2255.20,9,2,8,11,0,133.37,0,32,0,1,133.37,0.00,0.00,0.29,0,10.00,4,494.39,0,0,0,java.lang.Object,0.00,4,0,10,0,4,7,0,0,133,0
"org.apache.jackrabbit.commons.json.JsonParserTest$DummyJsonHandler_11",7,0.25,1.43,27,0.16,2255.20,9,2,8,11,0,133.37,0,32,0,1,133.37,0.00,0.00,0.29,0,10.00,4,494.39,0,0,0,java.lang.Object,0.00,4,0,10,0,4,7,0,0,133,0
"org.apache.jackrabbit.commons.json.JsonParserTest$DummyJsonHandler_12",2,0.00,1.00,5,0.03,225.02,2,0,8,3,0,143.62,0,7,0,1,143.62,0.00,0.00,0.00,0,2.00,1,84.08,0,0,0,java.lang.Object,0.00,1,0,2,0,1,2,0,0,28,0
"org.apache.jackrabbit.commons.json.JsonParserTest$DummyJsonHandler_13",9,0.88,1.00,20,0.10,697.86,10,1,8,11,0,144.89,0,29,0,1,144.89,0.00,0.00,0.22,0,19.00,1,287.16,0,0,0,java.lang.Object,0.00,2,0,9,0,2,9,0,0,95,0
"org.apache.jackrabbit.commons.json.JsonParserTest$DummyJsonHandler_14",8,0.86,1.00,18,0.09,650.81,9,1,8,10,0,144.73,0,26,0,1,144.73,0.00,0.00,0.25,0,16.00,1,262.00,0,0,0,java.lang.Object,0.00,2,0,8,0,2,8,0,0,86,0
"org.apache.jackrabbit.commons.json.JsonParserTest$DummyJsonHandler_15",9,0.00,1.00,10,0.05,281.62,9,0,8,9,1,159.22,0,20,0,1,159.22,0.00,0.00,0.00,0,9.00,1,152.42,0,0,1,java.lang.Object,0.00,0,0,9,0,0,9,1,0,61,1
"org.apache.jackrabbit.commons.json.JsonParserTest$DummyJsonHandler_2",5,0.00,1.00,11,0.06,450.02,5,0,8,7,0,144.38,0,16,0,1,144.38,0.00,0.00,0.00,0,5.00,1,174.08,0,0,0,java.lang.Object,0.00,2,0,5,0,2,5,0,0,58,0
"org.apache.jackrabbit.commons.json.JsonParserTest$DummyJsonHandler_3",5,0.00,1.00,11,0.06,450.02,5,0,8,7,0,144.38,0,16,0,1,144.38,0.00,0.00,0.00,0,5.00,1,174.08,0,0,0,java.lang.Object,0.00,2,0,5,0,2,5,0,0,58,0
"org.apache.jackrabbit.commons.json.JsonParserTest$DummyJsonHandler_4",5,0.00,1.00,11,0.06,450.02,5,0,8,7,0,144.38,0,16,0,1,144.38,0.00,0.00,0.00,0,5.00,1,174.08,0,0,0,java.lang.Object,0.00,2,0,5,0,2,5,0,0,58,0
"org.apache.jackrabbit.commons.json.JsonParserTest$DummyJsonHandler_5",5,0.00,1.00,11,0.06,450.02,5,0,8,7,0,144.38,0,16,0,1,144.38,0.00,0.00,0.00,0,5.00,1,174.08,0,0,0,java.lang.Object,0.00,2,0,5,0,2,5,0,0,58,0
"org.apache.jackrabbit.commons.json.JsonParserTest$DummyJsonHandler_6",5,0.00,1.00,11,0.06,450.02,5,0,8,7,0,144.38,0,16,0,1,144.38,0.00,0.00,0.00,0,5.00,1,174.08,0,0,0,java.lang.Object,0.00,2,0,5,0,2,5,0,0,58,0
"org.apache.jackrabbit.commons.json.JsonParserTest$DummyJsonHandler_7",5,0.00,1.00,11,0.06,450.02,5,0,8,7,0,144.38,0,16,0,1,144.38,0.00,0.00,0.00,0,5.00,1,174.08,0,0,0,java.lang.Object,0.00,2,0,5,0,2,5,0,0,58,0
"org.apache.jackrabbit.commons.json.JsonParserTest$DummyJsonHandler_8",2,0.00,1.00,5,0.03,225.02,2,0,8,3,0,143.62,0,7,0,1,143.62,0.00,0.00,0.00,0,2.00,1,84.08,0,0,0,java.lang.Object,0.00,1,0,2,0,1,2,0,0,28,0
"org.apache.jackrabbit.commons.json.JsonParserTest$DummyJsonHandler_9",2,0.00,1.00,5,0.03,217.51,2,0,8,4,0,143.73,0,7,0,1,143.73,0.00,0.00,0.00,0,2.00,1,79.04,0,0,0,java.lang.Object,0.00,2,0,2,0,2,2,0,0,27,0
"org.apache.jackrabbit.commons.json.JsonUtil",1,0.00,11.00,36,0.43,33777.19,1,0,0,8,4,94.87,18,48,4,1,76.73,0.00,0.00,0.00,0,1.00,11,1289.80,0,1,0,java.lang.Object,0.00,7,0,11,0,7,0,0,10,221,1
"org.apache.jackrabbit.commons.json.JsonUtilTest",1,0.00,2.00,19,0.26,5693.85,1,0,4,9,2,43.57,9,19,1,2,93.57,0.00,0.50,0.00,0,1.00,2,793.15,0,0,1,junit.framework.TestCase,0.00,8,1,2,0,8,1,0,7,146,1
"org.apache.jackrabbit.commons.json.TestAll",1,0.00,1.00,6,0.05,1283.53,1,0,3,3,2,75.20,7,8,0,2,117.50,0.00,0.50,0.00,0,1.00,1,150.40,0,1,2,junit.framework.TestCase,0.00,2,1,1,0,2,0,0,2,39,1
"org.apache.jackrabbit.commons.visitor.FilteringItemVisitor",11,0.05,2.55,72,0.88,57516.88,19,8,9,22,1,70.19,84,103,0,1,112.48,0.00,0.00,0.08,2,30.00,15,2625.91,0,0,1,java.lang.Object,0.00,11,0,28,0,11,11,1,15,523,2
"org.apache.jackrabbit.api.security.JackrabbitAccessControlEntry",3,0.00,1.00,4,0.02,119.49,3,0,3,3,8,110.29,25,5,8,2,158.40,0.00,0.50,0.00,0,3.00,1,69.75,0,2,0,,0.00,0,1,3,0,0,1,0,4,26,1
"org.apache.jackrabbit.api.security.JackrabbitAccessControlList",7,0.00,1.00,8,0.08,553.50,7,0,10,7,30,118.49,87,13,30,3,156.05,0.00,0.67,0.00,0,7.00,1,243.86,0,1,0,,0.00,0,2,7,0,0,6,0,8,73,1
"org.apache.jackrabbit.api.security.JackrabbitAccessControlManager",5,0.00,1.00,6,0.10,909.77,5,0,10,5,11,202.48,121,9,10,2,153.20,0.00,0.50,0.00,0,5.00,1,312.93,0,4,1,,0.00,0,1,5,0,0,1,0,6,82,1
"org.apache.jackrabbit.api.security.JackrabbitAccessControlManagerTest",5,0.00,2.40,38,0.45,10054.88,6,1,11,15,5,163.26,8,58,1,5,113.26,0.00,0.80,1.00,0,0.00,3,1362.93,2,0,4,org.apache.jackrabbit.test.api.security.AbstractAccessControlTest,0.13,10,4,12,0,10,5,0,6,280,1
"org.apache.jackrabbit.api.security.JackrabbitAccessControlPolicy",1,0.00,1.00,2,0.01,44.19,1,0,1,1,9,98.34,10,3,9,2,146.81,0.00,0.50,0.00,0,1.00,1,26.09,0,1,0,,0.00,0,1,1,0,0,0,0,2,11,1
"org.apache.jackrabbit.api.security.TestAll",1,0.00,1.00,5,0.04,864.35,1,0,3,3,2,73.32,10,7,0,4,121.80,0.00,0.75,0.00,0,1.00,1,115.51,0,1,2,org.apache.jackrabbit.test.AbstractJCRTest,0.00,2,3,1,0,2,0,0,2,31,1
"org.apache.jackrabbit.jcr.AbstractCopy",6,0.00,1.17,30,0.34,7313.66,11,5,8,17,8,141.21,19,40,2,2,120.59,2.00,0.25,0.20,0,26.00,2,1009.50,1,4,6,org.apache.jackrabbit.jcr2spi.operation.AbstractOperation,0.00,11,1,7,2,11,2,0,8,215,2
"org.apache.jackrabbit.jcr.AbstractOperation",7,0.25,1.14,22,0.20,3436.36,9,2,9,18,29,132.22,32,32,24,1,131.98,0.00,0.00,0.29,0,19.00,2,601.75,0,3,5,java.lang.Object,0.00,11,0,8,28,11,4,1,6,152,2
"org.apache.jackrabbit.jcr.AddLabel",8,0.03,1.25,33,0.35,6468.23,13,5,15,18,14,125.83,33,45,6,2,125.59,0.00,0.50,0.18,0,32.00,3,1057.42,0,4,9,org.apache.jackrabbit.jcr2spi.operation.AbstractOperation,0.00,10,1,10,0,10,4,0,8,243,1
"org.apache.jackrabbit.jcr.AddNode",12,0.04,1.00,44,0.43,7917.66,19,7,16,20,14,170.89,28,60,8,2,131.00,0.00,0.50,0.11,0,88.00,1,1276.92,2,6,7,org.apache.jackrabbit.jcr2spi.operation.AbstractOperation,0.11,8,1,12,0,8,6,0,10,298,1
"org.apache.jackrabbit.jcr.AddProperty",12,0.05,1.00,42,0.38,6057.39,18,6,13,18,15,171.80,25,59,8,2,131.92,0.00,0.50,0.12,0,88.00,1,1139.25,1,5,8,org.apache.jackrabbit.jcr2spi.operation.AbstractOperation,0.11,6,1,12,0,6,7,0,8,272,1
"org.apache.jackrabbit.jcr.Checkin",7,0.12,1.43,32,0.36,8758.84,11,4,15,20,12,144.68,25,44,6,2,124.07,0.00,0.50,0.14,0,14.00,4,1074.65,0,3,7,org.apache.jackrabbit.jcr2spi.operation.AbstractOperation,0.00,13,1,10,0,13,4,0,9,235,1
"org.apache.jackrabbit.jcr.Checkout",9,0.00,1.33,43,0.45,10120.52,14,5,15,21,13,145.07,30,57,6,2,124.45,0.00,0.50,0.20,0,34.00,4,1338.68,0,4,8,org.apache.jackrabbit.jcr2spi.operation.AbstractOperation,0.00,12,1,12,0,12,5,0,11,296,1
"org.apache.jackrabbit.jcr.Checkpoint",11,0.03,1.27,48,0.48,10716.54,17,6,15,23,12,164.84,30,64,6,2,124.95,0.00,0.50,0.14,0,50.00,4,1439.18,0,5,7,org.apache.jackrabbit.jcr2spi.operation.AbstractOperation,0.00,12,1,14,0,12,6,0,11,324,1
"org.apache.jackrabbit.jcr.Clone",5,0.38,1.40,24,0.29,6145.64,7,2,13,11,11,164.02,14,41,6,3,124.13,0.00,0.67,0.20,0,6.00,3,872.85,1,1,6,org.apache.jackrabbit.jcr2spi.operation.AbstractCopy,0.17,6,2,7,0,6,4,0,7,191,1
"org.apache.jackrabbit.jcr.Copy",3,0.00,1.00,9,0.14,2146.82,3,0,10,5,10,151.34,9,19,6,3,130.72,0.00,0.67,0.00,0,4.00,1,409.22,0,1,5,org.apache.jackrabbit.jcr2spi.operation.AbstractCopy,0.00,2,2,3,0,2,2,0,4,94,1
"org.apache.jackrabbit.jcr.CreateActivity",7,0.25,1.00,22,0.19,2822.68,11,4,11,10,9,172.57,17,30,6,2,132.68,0.00,0.50,0.04,0,18.00,1,581.19,0,3,4,org.apache.jackrabbit.jcr2spi.operation.AbstractOperation,0.00,3,1,7,0,3,4,0,8,147,1
"org.apache.jackrabbit.jcr.CreateConfiguration",7,0.17,1.00,23,0.21,3097.62,11,4,12,14,10,172.25,18,31,6,2,132.37,0.00,0.50,0.11,0,19.00,1,641.78,0,3,5,org.apache.jackrabbit.jcr2spi.operation.AbstractOperation,0.00,7,1,7,0,7,4,0,8,160,1
"org.apache.jackrabbit.jcr.LockOperation",12,0.08,1.25,45,0.40,6851.02,18,6,10,19,10,181.44,22,62,6,2,131.44,0.00,0.50,0.10,1,84.00,3,1198.55,0,5,5,org.apache.jackrabbit.jcr2spi.operation.AbstractOperation,0.00,7,1,15,0,7,7,0,9,294,1
"org.apache.jackrabbit.jcr.LockRefresh",5,1.00,1.00,15,0.12,1668.08,6,1,9,8,10,153.95,19,21,6,2,133.33,0.00,0.50,0.20,0,10.00,1,366.49,0,1,5,org.apache.jackrabbit.jcr2spi.operation.AbstractOperation,0.00,3,1,5,0,3,4,0,9,96,1
"org.apache.jackrabbit.jcr.LockRelease",5,0.75,1.20,21,0.20,3861.99,6,1,12,13,12,125.99,22,28,6,2,125.76,0.00,0.50,0.40,0,6.00,2,607.78,0,1,7,org.apache.jackrabbit.jcr2spi.operation.AbstractOperation,0.00,8,1,6,0,8,4,0,9,142,1
"org.apache.jackrabbit.jcr.Merge",11,0.03,1.64,54,0.56,13572.21,18,7,15,26,12,163.97,23,74,6,2,124.09,0.00,0.50,0.12,1,71.00,5,1673.67,0,4,7,org.apache.jackrabbit.jcr2spi.operation.AbstractOperation,0.00,15,1,18,0,15,7,0,10,369,1
"org.apache.jackrabbit.jcr.Move",11,0.05,2.00,85,1.10,51554.62,19,8,19,37,18,150.29,30,116,8,2,110.41,0.00,0.50,0.17,0,65.00,9,3288.97,4,6,11,org.apache.jackrabbit.jcr2spi.operation.AbstractOperation,0.11,26,1,22,0,26,5,0,17,615,1
"org.apache.jackrabbit.jcr.Operation",6,3.00,1.00,10,0.08,556.61,9,3,9,6,42,137.63,34,11,40,1,155.51,0.00,0.00,0.00,0,6.00,1,230.24,0,2,2,,0.00,0,0,6,0,0,4,0,7,70,1
"org.apache.jackrabbit.jcr.OperationVisitor",27,0.00,1.00,28,0.36,2136.00,27,0,12,27,32,156.05,18,29,32,1,156.05,0.00,0.00,0.00,0,27.00,1,1070.00,0,0,27,,0.00,0,0,27,0,0,27,0,6,306,1
"org.apache.jackrabbit.jcr.Remove",8,0.11,1.12,32,0.31,5770.95,12,4,9,18,15,165.89,17,43,10,2,126.01,2.00,0.25,0.16,0,24.00,2,937.84,2,4,6,org.apache.jackrabbit.jcr2spi.operation.AbstractOperation,0.13,10,1,9,2,10,4,0,9,222,1
"org.apache.jackrabbit.jcr.RemoveActivity",5,0.08,1.40,24,0.28,5618.71,8,3,12,16,13,145.06,17,37,6,3,124.44,0.00,0.67,0.27,0,9.00,3,851.09,0,2,8,org.apache.jackrabbit.jcr2spi.operation.Remove,0.30,11,2,7,0,11,3,0,8,189,1
"org.apache.jackrabbit.jcr.RemoveLabel",7,0.08,1.29,28,0.30,5363.99,11,4,15,17,14,126.01,31,39,6,2,125.77,0.00,0.50,0.18,0,24.00,3,893.17,0,4,9,org.apache.jackrabbit.jcr2spi.operation.AbstractOperation,0.00,10,1,9,0,10,3,0,8,209,1
"org.apache.jackrabbit.jcr.RemoveVersion",5,0.25,1.60,26,0.32,7453.91,7,2,13,17,14,140.44,18,41,6,3,119.83,0.00,0.67,0.30,0,9.00,3,950.36,0,1,9,org.apache.jackrabbit.jcr2spi.operation.Remove,0.45,12,2,8,0,12,4,0,9,207,1
"org.apache.jackrabbit.jcr.ReorderNodes",11,0.05,1.18,43,0.43,11563.75,17,6,9,19,12,179.37,19,58,7,2,129.37,0.00,0.50,0.12,0,72.00,2,1304.67,2,7,6,org.apache.jackrabbit.jcr2spi.operation.AbstractOperation,0.11,8,1,13,0,8,4,0,8,305,1
"org.apache.jackrabbit.jcr.ResolveMergeConflict",8,0.11,1.12,32,0.32,6208.59,12,4,12,17,12,146.37,24,42,6,2,125.76,0.00,0.50,0.16,0,36.00,2,962.04,0,3,7,org.apache.jackrabbit.jcr2spi.operation.AbstractOperation,0.00,9,1,9,0,9,5,0,9,229,1
"org.apache.jackrabbit.jcr.Restore",9,0.06,1.78,49,0.53,16919.59,13,4,13,16,12,119.25,44,60,6,2,119.01,0.00,0.50,0.19,0,35.00,4,1585.09,0,3,7,org.apache.jackrabbit.jcr2spi.operation.AbstractOperation,0.00,7,1,16,0,7,6,0,14,352,1
"org.apache.jackrabbit.jcr.SetMixin",8,0.14,1.38,34,0.33,7588.65,11,3,9,16,15,164.91,21,49,9,2,125.02,0.00,0.50,0.21,0,24.00,3,993.01,1,3,7,org.apache.jackrabbit.jcr2spi.operation.AbstractOperation,0.13,8,1,11,0,8,5,0,11,230,1
"org.apache.jackrabbit.jcr.SetPrimaryType",8,0.14,1.12,31,0.27,5017.90,11,3,8,14,13,171.03,18,43,8,2,131.15,0.00,0.50,0.21,0,24.00,2,822.24,1,3,6,org.apache.jackrabbit.jcr2spi.operation.AbstractOperation,0.13,6,1,9,0,6,5,0,8,199,1
"org.apache.jackrabbit.jcr.SetPropertyValue",10,0.06,1.20,43,0.43,11701.69,14,4,13,20,13,174.34,18,56,8,2,124.34,0.00,0.50,0.20,0,46.00,3,1281.31,1,4,6,org.apache.jackrabbit.jcr2spi.operation.AbstractOperation,0.12,10,1,12,0,10,6,0,8,288,1
"org.apache.jackrabbit.jcr.TransientOperationVisitor",19,0.00,1.00,39,0.47,4935.71,19,0,12,20,21,140.99,79,59,1,1,140.76,0.00,0.00,0.00,0,19.00,1,1415.82,0,0,20,java.lang.Object,0.00,1,0,19,1,1,19,1,20,348,2
"org.apache.jackrabbit.jcr.Update",6,0.30,1.00,20,0.17,2342.34,8,2,9,12,10,153.41,22,27,6,2,132.79,0.00,0.50,0.25,0,14.00,1,521.14,0,3,5,org.apache.jackrabbit.jcr2spi.operation.AbstractOperation,0.00,6,1,6,0,6,3,0,8,133,1
"org.apache.jackrabbit.jcr.WorkspaceImport",7,0.11,1.43,32,0.31,7512.13,10,3,12,15,11,145.21,25,44,6,2,124.59,0.00,0.50,0.24,0,20.00,3,924.97,0,2,6,org.apache.jackrabbit.jcr2spi.operation.AbstractOperation,0.00,8,1,10,0,8,5,0,11,213,1
"org.apache.jackrabbit.spi.commons.identifier.AbstractIdFactory",7,0.83,1.57,39,0.49,14970.08,8,1,10,22,10,100.73,35,55,2,1,118.60,0.00,0.00,0.29,2,13.00,3,1482.19,0,7,8,java.lang.Object,0.00,15,0,11,2,15,0,1,13,322,2
"org.apache.jackrabbit.spi.commons.identifier.AbstractIdFactory$ItemIdImpl",9,0.00,2.33,46,0.53,19587.07,12,3,10,23,5,158.33,19,68,0,1,118.45,0.00,0.00,0.33,1,8.00,4,1598.57,0,3,5,java.lang.Object,0.00,14,0,21,0,14,6,2,4,361,3
"org.apache.jackrabbit.spi.commons.identifier.AbstractIdFactory$NodeIdImpl",5,1.00,1.60,16,0.18,3185.99,6,1,10,8,3,131.01,0,27,0,2,131.01,0.00,0.50,0.00,0,5.00,3,526.93,1,0,3,org.apache.jackrabbit.spi.commons.identifier.ItemIdImpl,0.00,3,1,8,0,3,5,1,0,130,2
"org.apache.jackrabbit.spi.commons.identifier.AbstractIdFactory$PropertyIdImpl",5,0.50,1.40,18,0.16,2730.43,7,2,10,8,4,131.57,0,29,0,2,131.57,0.00,0.50,0.10,0,8.00,3,478.83,1,2,4,org.apache.jackrabbit.spi.commons.identifier.ItemIdImpl,0.00,3,1,7,0,3,3,2,0,121,2
"org.apache.jackrabbit.spi.commons.identifier.IdFactoryImpl",3,1.00,1.33,9,0.07,1218.81,4,1,3,5,15,172.48,6,15,11,2,132.59,0.00,0.50,0.33,0,4.00,2,196.79,0,2,4,org.apache.jackrabbit.spi.commons.identifier.AbstractIdFactory,0.20,2,1,4,0,2,1,0,2,54,2
"org.apache.jackrabbit.spi.commons.identifier.SerializationTest",3,0.25,1.00,20,0.28,5458.31,7,4,12,18,8,166.30,4,25,0,2,116.30,0.00,0.50,0.42,1,1.00,1,845.83,0,0,8,junit.framework.TestCase,0.00,15,1,3,0,15,3,0,1,186,1
"org.apache.jackrabbit.core.persistence.mem.InMemPersistenceManager",27,0.10,2.56,262,3.18,149375.78,42,15,31,99,21,87.84,136,349,1,2,105.71,0.00,0.50,0.17,2,0.00,6,9535.87,1,6,20,org.apache.jackrabbit.core.persistence.AbstractPersistenceManager,0.00,72,1,69,0,72,21,0,80,1801,1
"org.apache.jackrabbit.spi.TestAll",1,0.00,1.00,4,0.03,257.45,1,0,3,2,0,179.56,1,6,0,2,129.56,0.00,0.50,0.00,0,1.00,1,79.73,0,1,0,junit.framework.TestCase,0.00,1,1,1,0,1,0,0,1,24,1
"org.apache.jackrabbit.spi.TestAll$SpiTestSuite",1,0.00,1.00,4,0.04,273.77,1,0,3,3,1,179.35,1,6,0,2,129.35,0.00,0.50,0.00,0,1.00,1,109.51,0,0,1,junit.framework.TestSuite,0.00,2,1,1,0,2,1,0,1,30,2
"org.apache.jackrabbit.util.Base64",11,0.12,2.36,111,1.81,230741.63,15,4,8,20,7,51.36,97,147,7,1,99.47,0.00,0.00,0.14,2,39.00,8,5442.94,0,0,0,java.lang.Object,0.00,9,0,26,0,9,11,0,24,1010,1
"org.apache.jackrabbit.util.Base64Test",5,1.00,1.40,40,0.43,12395.72,6,1,6,19,1,160.51,9,42,0,2,110.51,0.00,0.50,0.00,2,5.00,2,1283.37,0,1,1,junit.framework.TestCase,0.00,14,1,7,0,14,4,0,3,273,1
"org.apache.jackrabbit.util.ChildrenCollector",3,0.17,1.67,15,0.15,2436.59,6,3,5,4,0,79.61,21,23,0,2,121.90,0.00,0.50,0.44,0,1.00,2,463.16,0,0,0,TraversingItemVisitor.Default,0.00,1,1,5,0,1,3,0,4,111,1
"org.apache.jackrabbit.util.ChildrenCollectorFilter",11,0.01,3.18,96,1.16,52645.51,18,7,12,24,9,58.07,103,143,7,2,108.07,0.00,0.50,0.16,2,45.00,13,3474.59,0,4,2,TraversingItemVisitor.Default,0.00,13,1,35,0,13,7,0,19,718,1
"org.apache.jackrabbit.util.ISO8601",4,0.00,7.00,129,1.93,217295.90,4,0,3,26,12,109.03,126,156,12,1,77.12,0.00,0.00,0.00,2,4.00,17,5801.22,0,2,0,java.lang.Object,0.00,22,0,28,0,22,2,0,49,952,2
"org.apache.jackrabbit.util.ISO9075",6,0.20,3.67,74,1.07,65439.96,9,3,2,26,25,48.65,58,94,23,1,98.65,0.00,0.00,0.17,2,18.00,9,3206.82,0,3,2,java.lang.Object,0.00,20,0,22,0,20,3,0,21,621,1
"org.apache.jackrabbit.util.ISO9075Test",3,0.00,1.00,27,0.33,6451.71,3,0,1,7,1,159.16,3,37,0,2,109.16,0.00,0.50,0.00,0,3.00,1,986.45,0,0,1,junit.framework.TestCase,0.00,4,1,3,0,4,3,0,1,228,1
"org.apache.jackrabbit.util.LazyFileInputStream",13,0.03,1.54,54,0.44,9099.72,16,3,6,28,3,108.17,65,77,3,2,126.04,1.00,0.33,0.36,1,0.00,4,1329.86,0,0,0,java.io.InputStream,0.00,15,1,20,1,15,13,0,18,333,1
"org.apache.jackrabbit.util.Locked",6,0.40,3.00,56,0.72,37792.51,8,2,11,26,4,144.53,131,81,4,1,105.23,0.00,0.00,0.17,5,10.00,12,2157.34,0,5,0,java.lang.Object,0.00,20,0,18,0,20,1,0,23,392,2
"org.apache.jackrabbit.util.Locked$EventListener",1,0.00,1.00,4,0.03,297.46,1,0,11,2,1,129.06,0,6,0,1,129.06,0.00,0.00,0.00,0,1.00,1,82.01,0,0,1,java.lang.Object,0.00,1,0,1,0,1,1,0,0,24,0
"org.apache.jackrabbit.util.Text",32,0.30,2.88,290,4.15,271978.27,35,3,7,65,88,55.74,337,377,88,1,104.22,0.00,0.00,0.04,8,88.00,13,12459.58,0,27,0,java.lang.Object,0.00,33,0,92,0,33,5,0,49,2416,1
"org.apache.jackrabbit.util.TextTest",8,0.00,2.12,136,1.53,65867.77,8,0,4,25,1,114.71,26,136,0,2,94.09,0.00,0.50,0.00,2,8.00,5,4603.75,0,0,1,junit.framework.TestCase,0.00,17,1,17,0,17,8,0,22,913,1
"org.apache.jackrabbit.util.Timer",5,0.25,1.80,36,0.36,9978.59,11,6,1,12,5,103.00,77,50,5,1,113.35,0.00,0.00,0.37,0,0.00,4,1068.07,0,0,0,java.lang.Object,0.00,7,0,9,0,7,5,0,15,225,1
"org.apache.jackrabbit.util.Timer$IdleCheckerTask",1,0.00,3.00,7,0.07,1572.76,1,0,1,2,1,114.05,0,13,0,2,114.05,0.00,0.50,0.00,0,0.00,3,208.23,0,0,1,org.apache.jackrabbit.util.Task,0.00,1,1,3,0,1,1,0,0,47,1
"org.apache.jackrabbit.util.Timer$Task",2,1.00,1.50,9,0.07,1275.30,3,1,1,3,1,108.49,11,13,0,2,126.36,0.00,0.50,0.50,0,2.00,2,199.58,1,0,1,java.util.TimerTask,0.00,1,1,3,0,1,2,0,3,53,3
"org.apache.jackrabbit.util.TimerTest",6,0.40,1.00,28,0.29,4156.27,8,2,1,15,1,126.17,4,35,0,2,126.17,0.00,0.50,0.83,0,0.00,1,875.61,2,0,1,junit.framework.TestCase,0.00,9,1,6,0,9,6,0,1,202,1
"org.apache.jackrabbit.util.TimerTest$DummyTask",2,1.00,1.50,10,0.06,732.29,3,1,1,4,0,124.65,0,16,0,2,124.65,0.00,0.50,0.50,0,2.00,2,188.61,0,0,0,Timer.Task,0.00,2,1,3,0,2,2,0,0,51,2
"org.apache.jackrabbit.util.TransientFileFactory",5,0.15,2.00,39,0.42,11075.10,10,5,8,24,12,112.50,84,53,12,1,112.97,0.00,0.00,0.32,1,9.00,4,1257.36,0,2,0,java.lang.Object,0.00,19,0,10,0,19,3,0,26,268,1
"org.apache.jackrabbit.util.TransientFileFactory$MoribundFileReference",2,1.00,1.00,7,0.06,869.30,3,1,8,5,0,90.14,15,10,0,2,132.43,0.00,0.50,0.50,0,2.00,1,194.69,0,0,0,java.lang.ref.PhantomReference,0.00,3,1,2,0,3,2,0,3,52,1
"org.apache.jackrabbit.util.TransientFileFactory$ReaperThread",3,0.50,2.33,18,0.13,3236.76,4,1,8,6,0,138.51,10,27,0,2,117.89,0.00,0.50,0.67,0,1.00,5,400.61,0,0,0,org.apache.jackrabbit.util.Thread,0.00,3,1,7,0,3,3,0,5,95,1
"org.apache.jackrabbit.util.TransientFileFactory$Thread",1,0.00,1.00,3,0.01,56.92,1,0,8,2,0,139.38,0,4,0,1,139.38,0.00,0.00,0.00,0,1.00,1,30.46,0,0,0,java.lang.Object,0.00,1,0,1,0,1,1,0,0,12,0
"org.apache.jackrabbit.util.WeakIdentityCollection",16,0.05,2.00,97,0.96,32032.48,20,4,7,33,3,83.59,111,115,3,1,115.82,0.00,0.00,0.30,2,16.00,4,2885.32,0,3,0,java.lang.Object,0.00,17,0,32,0,17,13,1,25,619,1
"org.apache.jackrabbit.util.WeakIdentityCollection$Iter",3,0.33,1.33,12,0.10,1648.60,6,3,7,6,1,94.68,18,17,0,1,126.90,0.00,0.00,0.56,0,1.00,2,307.64,0,1,1,java.lang.Object,0.00,3,0,4,0,3,2,1,6,77,2
"org.apache.jackrabbit.util.WeakIdentityCollection$WeakRef",1,1.00,1.00,5,0.04,427.96,2,1,7,1,0,74.21,9,7,0,2,124.21,0.00,0.50,0.00,0,0.00,1,115.52,0,0,0,java.lang.ref.WeakReference,0.00,0,1,1,0,0,1,0,2,32,2
"org.apache.jackrabbit.util.XMLChar",21,0.03,1.95,724,20.15,1282085.56,30,9,1,23,6,117.51,615,757,6,1,76.03,0.00,0.00,0.08,4,61.00,6,60456.28,0,0,0,java.lang.Object,0.00,2,0,41,0,2,21,0,463,6924,1
"org.apache.jackrabbit.core.integration.AxisQueryTest",6,0.20,3.67,90,1.20,50631.55,13,7,8,41,1,63.69,40,111,0,5,95.91,0.00,0.80,0.31,4,0.00,7,3597.25,2,2,1,org.apache.jackrabbit.core.query.AbstractQueryTest,0.11,35,4,22,0,35,4,0,18,648,1
"org.apache.jackrabbit.core.integration.BackwardsCompatibilityTest",8,0.86,1.88,102,1.55,49675.36,9,1,27,74,2,100.73,3,136,0,2,100.73,0.00,0.50,0.25,7,16.00,5,4638.83,0,1,2,junit.framework.TestCase,0.00,66,1,15,0,66,7,0,1,844,1
"org.apache.jackrabbit.core.integration.ConcurrentQueriesWithUpdatesTest",3,0.50,2.00,31,0.35,13040.82,5,2,15,17,2,144.77,7,37,1,5,104.89,0.00,0.80,0.17,0,1.00,4,1037.84,1,0,1,org.apache.jackrabbit.core.AbstractConcurrencyTest,0.14,14,4,6,0,14,3,0,3,214,1
"org.apache.jackrabbit.core.integration.ConcurrentQueriesWithUpdatesTest$Runnable",1,0.00,2.00,6,0.04,421.16,1,0,15,5,0,121.15,0,8,0,1,121.15,0.00,0.00,0.00,0,1.00,2,114.27,0,0,0,java.lang.Object,0.00,4,0,2,0,4,1,0,0,30,0
"org.apache.jackrabbit.core.integration.ConcurrentQueriesWithUpdatesTest$Runnable$Task",1,0.00,2.00,8,0.13,2276.52,1,0,15,10,0,110.72,0,11,0,1,110.72,0.00,0.00,0.00,0,0.00,2,383.26,0,0,0,java.lang.Object,0.00,9,0,2,0,9,1,0,0,75,0
"org.apache.jackrabbit.core.integration.ConcurrentQueriesWithUpdatesTest$Runnable_0",1,0.00,2.00,6,0.04,421.16,1,0,15,5,0,121.15,0,8,0,1,121.15,0.00,0.00,0.00,0,1.00,2,114.27,0,0,0,java.lang.Object,0.00,4,0,2,0,4,1,0,0,30,0
"org.apache.jackrabbit.core.integration.ConcurrentQueriesWithUpdatesTest$Runnable_0$Task_1",1,0.00,4.00,16,0.24,6942.47,1,0,15,13,0,135.40,2,19,0,1,95.51,0.00,0.00,0.00,0,0.00,4,705.10,0,0,0,java.lang.Object,0.00,12,0,4,0,12,1,0,2,123,0
"org.apache.jackrabbit.core.integration.ConcurrentQueryTest",4,0.33,4.25,89,0.99,39368.57,6,2,12,27,1,39.15,39,74,0,4,89.15,0.00,0.75,0.25,0,4.00,8,2976.81,3,0,1,org.apache.jackrabbit.test.AbstractJCRTest,0.27,23,3,17,0,23,4,0,17,533,1
"org.apache.jackrabbit.core.integration.ConcurrentQueryTest$QueryWorker",3,0.33,3.00,40,0.46,17149.25,9,6,12,16,0,99.61,2,50,0,2,99.61,0.00,0.50,0.39,0,1.00,7,1379.93,0,0,0,org.apache.jackrabbit.core.integration.Thread,0.00,13,1,9,0,13,3,0,2,256,3
"org.apache.jackrabbit.core.integration.ConcurrentQueryTest$Thread",1,0.00,5.00,20,0.17,5957.41,1,0,12,6,0,92.37,0,17,0,1,92.37,0.00,0.00,0.00,0,1.00,5,524.99,0,0,0,java.lang.Object,0.00,5,0,5,0,5,1,0,0,104,0
"org.apache.jackrabbit.core.integration.ConcurrentQueryTest$Thread_0",1,0.00,5.00,20,0.17,5994.86,1,0,12,6,0,92.35,0,17,0,1,92.35,0.00,0.00,0.00,0,1.00,5,506.57,0,0,0,java.lang.Object,0.00,5,0,5,0,5,1,0,0,102,0
"org.apache.jackrabbit.core.integration.GQLTest",22,0.62,1.27,235,3.22,93375.53,23,1,10,42,2,155.07,34,263,0,5,105.07,0.00,0.80,0.41,3,0.00,4,9671.66,2,2,2,org.apache.jackrabbit.core.query.AbstractQueryTest,0.00,20,4,28,0,20,20,0,24,1864,1
"org.apache.jackrabbit.core.integration.GQLTest$GQL.Filter",1,0.00,1.00,3,0.04,531.50,1,0,10,5,0,131.74,0,4,0,1,131.74,0.00,0.00,0.00,0,1.00,1,130.20,0,0,0,java.lang.Object,0.00,4,0,1,0,4,1,0,0,33,0
"org.apache.jackrabbit.core.integration.GQLTest$GQL.Filter_0",1,0.00,1.00,3,0.04,531.50,1,0,10,5,0,131.74,0,4,0,1,131.74,0.00,0.00,0.00,0,1.00,1,130.20,0,0,0,java.lang.Object,0.00,4,0,1,0,4,1,0,0,33,0
"org.apache.jackrabbit.core.integration.ItemSequenceTest",21,0.65,2.24,200,2.88,117350.57,22,1,27,74,10,105.71,5,242,1,4,105.71,0.00,0.75,0.38,9,61.00,10,8654.69,1,2,9,org.apache.jackrabbit.test.AbstractJCRTest,0.09,53,3,47,0,53,19,0,2,1617,1
"org.apache.jackrabbit.core.integration.ItemSequenceTest$ErrorHandler",1,0.00,1.00,3,0.03,233.04,1,0,27,2,0,134.56,0,4,0,1,134.56,0.00,0.00,0.00,0,1.00,1,80.34,0,0,0,java.lang.Object,0.00,1,0,1,0,1,1,0,0,23,0
"org.apache.jackrabbit.core.integration.JCRAPITest",1,0.00,1.00,3,0.02,158.91,1,0,3,2,1,156.48,3,5,0,2,135.87,0.00,0.50,0.00,0,1.00,1,52.05,0,1,1,junit.framework.TestCase,0.00,1,1,1,0,1,0,0,1,17,1
"org.apache.jackrabbit.core.integration.JCRBenchmark",1,0.00,1.00,3,0.02,158.91,1,0,3,2,0,156.48,3,5,0,2,135.87,0.00,0.50,0.00,0,1.00,1,52.05,0,1,0,junit.framework.TestCase,0.00,1,1,1,0,1,0,0,1,17,1
"org.apache.jackrabbit.core.integration.MassiveRangeTest",1,0.00,3.00,19,0.21,5401.07,1,0,6,8,1,51.36,7,17,0,5,93.65,0.00,0.80,0.00,0,0.00,3,643.18,1,0,1,org.apache.jackrabbit.core.query.AbstractQueryTest,0.00,7,4,3,0,7,1,0,3,119,1
"org.apache.jackrabbit.core.integration.MassiveWildcardTest",1,0.00,3.00,23,0.29,9165.09,1,0,6,8,1,46.46,7,21,0,5,88.75,0.00,0.80,0.00,0,0.00,3,867.73,1,0,1,org.apache.jackrabbit.core.query.AbstractQueryTest,0.00,7,4,3,0,7,1,0,3,157,1
"org.apache.jackrabbit.core.integration.NodeImplTest",4,0.00,1.00,28,0.39,13850.02,5,1,7,16,1,132.22,13,43,0,4,111.60,0.00,0.75,1.00,0,0.00,1,1175.44,2,0,1,org.apache.jackrabbit.test.AbstractJCRTest,0.27,12,3,4,0,12,4,0,3,247,1
"org.apache.jackrabbit.core.integration.RepositoryFactoryImplTest",11,0.05,1.18,61,0.71,16743.20,15,4,16,27,6,140.44,43,75,0,4,119.83,0.00,0.75,0.30,4,0.00,2,2116.55,2,1,6,org.apache.jackrabbit.test.AbstractJCRTest,0.11,16,3,13,0,16,10,0,9,469,1
"org.apache.jackrabbit.core.integration.RepositoryLockTest",2,0.50,2.50,21,0.25,6714.39,6,4,5,10,2,87.85,11,26,0,2,105.72,0.00,0.50,0.50,0,0.00,3,743.67,1,0,2,junit.framework.TestCase,0.00,8,1,5,0,8,2,0,5,156,1
"org.apache.jackrabbit.core.integration.RestoreSameNameSiblingTest",1,0.00,1.00,16,0.19,4461.66,1,0,5,15,1,53.22,11,20,0,4,97.34,0.00,0.75,0.00,0,0.00,1,578.13,1,0,1,org.apache.jackrabbit.test.AbstractJCRTest,0.00,14,3,1,0,14,1,0,7,114,1
"org.apache.jackrabbit.core.integration.SessionImplTest",3,0.00,2.67,53,0.78,61945.03,3,0,10,28,4,58.68,19,74,0,4,90.90,0.00,0.75,0.00,0,4.00,4,2347.79,1,0,4,org.apache.jackrabbit.test.AbstractJCRTest,0.00,25,3,8,0,25,3,0,5,432,1
"org.apache.jackrabbit.core.integration.TreeTraverserTest",16,0.07,1.62,93,1.30,34758.50,19,3,22,51,6,118.54,2,137,0,4,118.54,0.00,0.75,0.27,8,30.00,4,3887.42,1,5,6,org.apache.jackrabbit.test.AbstractJCRTest,0.10,35,3,26,0,35,11,0,2,812,1
"org.apache.jackrabbit.core.integration.TreeTraverserTest$HashSet<String>",0,0.00,0.00,9,0.05,802.63,0,0,22,0,0,171.00,0,9,0,1,171.00,0.00,0.00,0.00,0,0.00,0,163.50,0,0,0,java.lang.Object,0.00,0,0,0,0,0,0,0,0,40,0
"org.apache.jackrabbit.core.integration.TreeTraverserTest$Predicate<Property>",1,0.00,2.00,5,0.06,1230.91,1,0,22,5,0,120.43,0,9,0,1,120.43,0.00,0.00,0.00,0,1.00,2,191.55,0,0,0,java.lang.Object,0.00,4,0,2,0,4,1,0,0,45,0
"org.apache.jackrabbit.core.integration.TreeTraverserTest$Transformer<Property,String>",1,0.00,2.00,5,0.05,937.91,1,0,22,4,0,121.36,0,9,0,1,121.36,0.00,0.00,0.00,0,1.00,2,155.69,0,1,0,java.lang.Object,0.00,3,0,2,0,3,0,0,0,39,0
"org.apache.jackrabbit.core.integration.TreeTraverserTest$Transformer<String,String>",1,0.00,1.00,3,0.02,235.37,1,0,22,2,0,134.53,0,4,0,1,134.53,0.00,0.00,0.00,0,1.00,1,65.64,0,1,0,java.lang.Object,0.00,1,0,1,0,1,0,0,0,21,0
"org.apache.jackrabbit.core.integration.TreeTraverserTest$TreeTraverser.ErrorHandler",1,0.00,1.00,3,0.03,372.87,1,0,22,3,0,132.95,0,4,0,1,132.95,0.00,0.00,0.00,0,1.00,1,93.65,0,0,0,java.lang.Object,0.00,2,0,1,0,2,1,0,0,26,0
"org.apache.jackrabbit.core.integration.VersioningTest",5,0.12,2.60,133,1.76,80510.96,7,2,7,38,1,124.76,14,151,0,4,84.87,0.00,0.75,0.60,2,2.00,5,5285.05,3,0,1,org.apache.jackrabbit.test.AbstractJCRTest,0.26,33,3,13,0,33,5,0,5,941,1
"org.apache.jackrabbit.core.integration.WorkspaceInitTest",3,0.00,1.67,21,0.17,3550.72,3,0,6,11,2,165.16,5,21,0,4,115.16,0.00,0.75,0.00,0,3.00,3,521.91,2,0,2,org.apache.jackrabbit.test.AbstractJCRTest,0.28,8,3,5,0,8,3,0,3,117,1
"org.apache.jackrabbit.core.integration.WorkspaceInitTest$Runnable",1,0.00,2.00,5,0.04,595.79,1,0,6,5,0,122.91,0,8,0,1,122.91,0.00,0.00,0.00,0,1.00,2,124.76,0,0,0,java.lang.Object,0.00,4,0,2,0,4,1,0,0,32,0
"org.apache.jackrabbit.webdav.header.CodedUrlHeader",6,0.20,2.00,36,0.42,19606.68,9,3,3,15,8,81.92,37,45,7,1,114.14,0.00,0.00,0.17,1,14.00,5,1255.80,0,5,1,java.lang.Object,0.00,9,0,12,0,9,1,1,6,272,1
"org.apache.jackrabbit.webdav.header.DepthHeader",7,0.42,2.00,36,0.38,11574.69,9,2,4,14,10,87.20,47,48,8,1,119.42,0.00,0.00,0.14,1,24.00,4,1136.93,0,3,2,java.lang.Object,0.00,7,0,14,0,7,4,2,8,256,1
"org.apache.jackrabbit.webdav.header.Header",2,0.00,1.00,3,0.01,46.83,2,0,0,2,10,210.22,3,4,10,1,160.22,0.00,0.00,0.00,0,2.00,1,31.22,0,2,0,,0.00,0,0,2,0,0,0,0,1,14,1
"org.apache.jackrabbit.webdav.header.IfHeader",15,0.07,3.60,168,1.92,86366.20,20,5,12,47,9,120.38,281,222,7,1,102.25,0.00,0.00,0.27,4,40.00,16,5759.11,0,5,2,java.lang.Object,0.00,32,0,54,0,32,10,1,61,1087,1
"org.apache.jackrabbit.webdav.header.IfHeader$IfHeaderInterface",1,0.00,1.00,2,0.02,92.96,1,0,12,1,0,133.91,15,3,0,1,144.27,0.00,0.00,0.00,0,1.00,1,46.48,0,0,0,,0.00,0,0,1,0,0,1,0,1,16,2
"org.apache.jackrabbit.webdav.header.IfHeader$IfHeaderList",1,0.00,3.00,9,0.10,2173.33,1,0,12,2,0,108.40,16,12,0,2,108.87,0.00,0.50,0.00,0,0.00,3,295.03,0,0,0,java.util.ArrayList,0.00,1,1,3,0,1,1,1,2,65,2
"org.apache.jackrabbit.webdav.header.IfHeader$IfHeaderMap",1,0.00,2.00,9,0.12,3327.44,1,0,12,3,0,78.13,13,12,0,2,107.51,0.00,0.50,0.00,0,0.00,2,359.02,0,0,0,java.util.HashMap,0.00,2,1,2,0,2,1,1,1,77,2
"org.apache.jackrabbit.webdav.header.IfHeader$IfList",3,0.00,1.67,16,0.19,5089.63,3,0,12,6,0,69.38,28,21,0,2,119.38,0.00,0.50,0.00,0,4.00,3,563.42,1,0,0,java.util.ArrayList,0.00,3,1,5,0,3,3,0,4,123,2
"org.apache.jackrabbit.webdav.header.IfHeader$IfListEntry",6,0.07,1.33,17,0.15,2418.43,9,3,12,7,0,90.71,64,24,0,1,139.19,0.00,0.00,0.28,0,10.00,3,448.29,0,3,0,java.lang.Object,0.00,1,0,8,0,1,3,0,9,118,3
"org.apache.jackrabbit.webdav.header.IfHeader$IfListEntryEtag",3,0.00,1.00,7,0.06,667.12,3,0,12,3,0,93.18,25,13,0,2,141.29,0.00,0.50,0.00,0,3.00,1,169.38,1,1,0,org.apache.jackrabbit.webdav.header.IfListEntry,0.00,0,1,3,0,0,2,0,3,50,2
"org.apache.jackrabbit.webdav.header.IfHeader$IfListEntryToken",3,0.00,1.00,7,0.06,667.12,3,0,12,3,0,93.18,25,13,0,2,141.29,0.00,0.50,0.00,0,3.00,1,169.38,1,1,0,org.apache.jackrabbit.webdav.header.IfListEntry,0.00,0,1,3,0,0,2,0,3,50,2
"org.apache.jackrabbit.webdav.header.LabelHeader",5,0.38,1.40,19,0.16,3227.18,7,2,5,11,6,131.00,3,27,2,1,131.00,0.00,0.00,0.20,0,7.00,2,490.68,0,4,4,java.lang.Object,0.00,6,0,7,0,6,1,1,1,120,1
"org.apache.jackrabbit.webdav.header.OverwriteHeader",5,0.06,1.40,19,0.17,2753.38,9,4,4,8,5,152.16,17,26,3,1,131.54,0.00,0.00,0.30,0,2.00,2,510.42,0,2,2,java.lang.Object,0.00,3,0,7,0,3,3,1,4,124,1
"org.apache.jackrabbit.webdav.header.PollTimeoutHeader",3,0.00,1.00,9,0.08,1328.29,3,0,2,5,5,132.60,13,14,3,2,132.36,0.00,0.50,0.00,0,3.00,1,248.19,1,2,2,org.apache.jackrabbit.webdav.header.TimeoutHeader,0.22,2,1,3,0,2,1,0,2,64,1
"org.apache.jackrabbit.webdav.header.TimeoutHeader",6,0.30,2.00,33,0.38,16458.02,8,2,4,15,8,117.93,27,46,6,1,117.69,0.00,0.00,0.25,1,14.00,6,1138.55,0,3,2,java.lang.Object,0.00,9,0,12,1,9,3,2,5,234,1
"org.apache.jackrabbit.test.api.security.AbstractAccessControlTest",8,0.71,1.88,45,0.48,12081.20,9,1,8,15,15,119.75,3,60,13,4,119.75,11.33,0.08,0.38,1,10.00,2,1439.09,3,5,2,org.apache.jackrabbit.test.AbstractJCRTest,0.12,7,3,15,34,7,3,0,1,319,2
"org.apache.jackrabbit.test.api.security.AccessControlDiscoveryTest",19,0.00,1.89,172,2.55,95166.19,19,0,13,54,3,106.36,89,193,1,5,106.12,0.00,0.80,0.00,1,0.00,4,7637.73,2,1,2,org.apache.jackrabbit.test.api.security.AbstractAccessControlTest,0.00,35,4,36,0,35,18,0,30,1466,1
"org.apache.jackrabbit.test.api.security.AccessControlListTest",23,0.25,3.22,312,4.08,165255.98,28,5,20,75,3,148.81,31,357,1,5,98.81,0.00,0.80,0.44,2,0.00,7,12243.37,6,2,2,org.apache.jackrabbit.test.api.security.AbstractAccessControlTest,0.18,52,4,74,0,52,21,0,29,2275,1
"org.apache.jackrabbit.test.api.security.AccessControlListTest$AccessControlEntry",2,0.00,1.00,5,0.02,157.59,2,0,20,2,0,144.84,0,7,0,1,144.84,0.00,0.00,0.00,0,2.00,1,60.53,0,2,0,java.lang.Object,0.00,0,0,2,0,0,0,0,0,21,0
"org.apache.jackrabbit.test.api.security.AccessControlListTest$Privilege",5,0.00,1.00,11,0.05,564.06,5,0,20,5,0,143.61,0,16,0,1,143.61,0.00,0.00,0.00,0,5.00,1,159.73,0,3,0,java.lang.Object,0.00,0,0,5,0,0,2,0,0,52,0
"org.apache.jackrabbit.test.api.security.AccessControlPolicyIteratorTest",5,0.00,1.60,36,0.40,8424.58,6,1,6,19,3,163.96,7,46,1,5,113.96,0.00,0.80,1.00,0,0.00,3,1191.79,2,0,2,org.apache.jackrabbit.test.api.security.AbstractAccessControlTest,0.13,14,4,8,0,14,5,0,5,249,1
"org.apache.jackrabbit.test.api.security.AccessControlPolicyTest",24,0.04,2.67,275,3.33,106119.16,27,3,21,67,3,153.22,30,337,1,5,103.22,0.00,0.80,0.38,0,0.00,4,9995.26,7,0,2,org.apache.jackrabbit.test.api.security.AbstractAccessControlTest,0.17,43,4,64,0,43,24,0,28,1909,1
"org.apache.jackrabbit.test.api.security.AccessControlPolicyTest$AccessControlPolicy",0,0.00,0.00,1,0.00,12.00,0,0,21,0,0,171.00,0,0,0,1,171.00,0.00,0.00,0.00,0,0.00,0,8.00,0,0,0,java.lang.Object,0.00,0,0,0,0,0,0,0,0,4,0
"org.apache.jackrabbit.test.api.security.RSessionAccessControlDiscoveryTest",6,0.40,1.17,27,0.31,4520.49,9,3,7,18,3,125.85,5,38,1,5,125.85,0.00,0.80,0.67,0,0.00,2,927.95,2,0,2,org.apache.jackrabbit.test.api.security.AbstractAccessControlTest,0.25,12,4,7,0,12,6,0,1,214,1
"org.apache.jackrabbit.test.api.security.RSessionAccessControlPolicyTest",7,0.39,2.00,38,0.37,5558.31,10,3,9,21,3,171.93,10,58,1,5,121.93,0.00,0.80,0.67,0,0.00,3,1096.76,2,0,2,org.apache.jackrabbit.test.api.security.AbstractAccessControlTest,0.24,14,4,14,0,14,7,0,8,248,1
"org.apache.jackrabbit.test.api.security.RSessionAccessControlPolicyTest$AccessControlPolicy",2,0.00,1.00,5,0.03,323.55,2,0,9,4,0,142.38,0,7,0,1,142.38,0.00,0.00,0.00,0,2.00,1,89.65,0,2,0,java.lang.Object,0.00,2,0,2,0,2,0,0,0,28,0
"org.apache.jackrabbit.test.api.security.RSessionAccessControlTest",9,0.38,1.89,64,0.77,13137.03,13,4,10,30,3,114.41,8,89,1,4,114.41,0.00,0.75,0.58,0,0.00,2,2311.11,3,0,2,org.apache.jackrabbit.test.AbstractJCRTest,0.23,21,3,17,0,21,9,0,8,481,1
"org.apache.jackrabbit.test.api.security.TestAll",1,0.00,1.00,11,0.11,3828.97,1,0,3,3,8,83.80,14,13,1,2,103.94,0.00,0.50,0.00,0,1.00,1,341.05,0,1,7,junit.framework.TestCase,0.00,2,1,1,0,2,0,0,4,79,1
"org.apache.jackrabbit.jcr.Dumpable",1,0.00,1.00,2,0.01,30.51,1,0,1,1,1,110.52,12,3,1,1,148.08,0.00,0.00,0.00,0,1.00,1,25.51,0,0,0,,0.00,0,0,1,0,0,1,0,2,11,1
"org.apache.jackrabbit.jcr.LogUtil",4,0.33,2.50,32,0.40,13782.50,5,1,10,20,15,59.25,37,47,9,1,109.25,0.00,0.00,0.75,1,0.00,4,1200.02,0,4,6,java.lang.Object,0.00,16,0,10,0,16,0,0,6,250,1
"org.apache.jackrabbit.jcr.ReferenceChangeTracker",6,0.07,1.83,27,0.33,7837.29,9,3,12,22,5,91.64,41,40,2,1,123.86,0.00,0.00,0.39,0,2.00,4,992.64,0,2,3,java.lang.Object,0.00,16,0,11,0,16,4,0,10,221,1
"org.apache.jackrabbit.jcr.StateUtility",4,0.00,2.50,29,0.34,13277.48,4,0,8,15,9,132.15,12,38,3,1,111.54,0.00,0.00,0.00,0,4.00,5,1034.99,0,2,7,java.lang.Object,0.00,11,0,10,0,11,2,0,4,212,1
"org.apache.jackrabbit.spi.commons.logging.AbstractLogger",3,0.50,2.00,27,0.26,9025.87,4,1,1,8,8,70.29,36,39,7,1,107.85,0.00,0.00,0.67,0,1.00,3,767.97,0,2,1,java.lang.Object,0.00,5,0,6,8,5,1,0,7,169,1
"org.apache.jackrabbit.spi.commons.logging.AbstractLogger$Callable",1,0.00,1.00,2,0.01,51.30,1,0,1,1,0,146.30,0,3,0,1,146.30,0.00,0.00,0.00,0,1.00,1,27.65,0,1,0,,0.00,0,0,1,0,0,0,0,0,11,1
"org.apache.jackrabbit.spi.commons.logging.AbstractLogger$SafeCallable",1,0.00,1.00,2,0.01,29.41,1,0,1,1,0,148.21,0,3,0,1,148.21,0.00,0.00,0.00,0,1.00,1,19.61,0,1,0,,0.00,0,0,1,0,0,0,0,0,9,1
"org.apache.jackrabbit.spi.commons.logging.BatchLogger",12,1.00,1.00,37,0.40,6063.67,13,1,7,13,10,181.91,13,45,2,2,131.91,0.00,0.50,0.08,0,22.00,1,1209.92,1,1,8,org.apache.jackrabbit.spi.commons.logging.AbstractLogger,0.00,1,1,12,0,1,11,1,4,293,1
"org.apache.jackrabbit.spi.commons.logging.BatchLogger$Callable",1,0.00,1.00,4,0.03,283.82,1,0,7,1,0,129.22,0,4,0,1,129.22,0.00,0.00,0.00,0,0.00,1,85.66,0,1,0,java.lang.Object,0.00,0,0,1,0,0,0,0,0,23,0
"org.apache.jackrabbit.spi.commons.logging.BatchLogger$Callable_0",1,0.00,1.00,4,0.03,264.00,1,0,7,1,0,129.47,0,4,0,1,129.47,0.00,0.00,0.00,0,0.00,1,80.00,0,1,0,java.lang.Object,0.00,0,0,1,0,0,0,0,0,22,0
"org.apache.jackrabbit.spi.commons.logging.BatchLogger$Callable_1",1,0.00,1.00,4,0.03,264.00,1,0,7,1,0,129.47,0,4,0,1,129.47,0.00,0.00,0.00,0,0.00,1,80.00,0,1,0,java.lang.Object,0.00,0,0,1,0,0,0,0,0,22,0
"org.apache.jackrabbit.spi.commons.logging.BatchLogger$Callable_2",1,0.00,1.00,4,0.02,244.46,1,0,7,1,0,129.74,0,4,0,1,129.74,0.00,0.00,0.00,0,0.00,1,74.42,0,1,0,java.lang.Object,0.00,0,0,1,0,0,0,0,0,21,0
"org.apache.jackrabbit.spi.commons.logging.BatchLogger$Callable_3",1,0.00,1.00,4,0.02,244.46,1,0,7,1,0,129.74,0,4,0,1,129.74,0.00,0.00,0.00,0,0.00,1,74.42,0,1,0,java.lang.Object,0.00,0,0,1,0,0,0,0,0,21,0
"org.apache.jackrabbit.spi.commons.logging.BatchLogger$Callable_4",1,0.00,1.00,4,0.02,225.21,1,0,7,1,0,130.02,0,4,0,1,130.02,0.00,0.00,0.00,0,0.00,1,68.92,0,1,0,java.lang.Object,0.00,0,0,1,0,0,0,0,0,20,0
"org.apache.jackrabbit.spi.commons.logging.BatchLogger$Callable_5",1,0.00,1.00,4,0.03,264.00,1,0,7,1,0,129.47,0,4,0,1,129.47,0.00,0.00,0.00,0,0.00,1,80.00,0,1,0,java.lang.Object,0.00,0,0,1,0,0,0,0,0,22,0
"org.apache.jackrabbit.spi.commons.logging.BatchLogger$Callable_6",1,0.00,1.00,4,0.02,244.46,1,0,7,1,0,129.74,0,4,0,1,129.74,0.00,0.00,0.00,0,0.00,1,74.42,0,1,0,java.lang.Object,0.00,0,0,1,0,0,0,0,0,21,0
"org.apache.jackrabbit.spi.commons.logging.BatchLogger$Callable_7",1,0.00,1.00,4,0.02,244.46,1,0,7,1,0,129.74,0,4,0,1,129.74,0.00,0.00,0.00,0,0.00,1,74.42,0,1,0,java.lang.Object,0.00,0,0,1,0,0,0,0,0,21,0
"org.apache.jackrabbit.spi.commons.logging.BatchLogger$Callable_8",1,0.00,1.00,4,0.03,264.00,1,0,7,1,0,129.47,0,4,0,1,129.47,0.00,0.00,0.00,0,0.00,1,80.00,0,1,0,java.lang.Object,0.00,0,0,1,0,0,0,0,0,22,0
"org.apache.jackrabbit.spi.commons.logging.IdFactoryLogger",8,1.00,1.00,25,0.22,3424.36,9,1,5,9,8,182.48,12,28,1,2,132.48,0.00,0.50,0.12,0,14.00,1,667.41,1,7,7,org.apache.jackrabbit.spi.commons.logging.AbstractLogger,0.00,1,1,8,0,1,1,1,3,172,1
"org.apache.jackrabbit.spi.commons.logging.IdFactoryLogger$SafeCallable",1,0.00,1.00,3,0.02,151.81,1,0,5,1,0,136.03,0,3,0,1,136.03,0.00,0.00,0.00,0,0.00,1,54.60,0,1,0,java.lang.Object,0.00,0,0,1,0,0,0,0,0,17,0
"org.apache.jackrabbit.spi.commons.logging.IdFactoryLogger$SafeCallable_0",1,0.00,1.00,3,0.02,151.81,1,0,5,1,0,136.03,0,3,0,1,136.03,0.00,0.00,0.00,0,0.00,1,54.60,0,1,0,java.lang.Object,0.00,0,0,1,0,0,0,0,0,17,0
"org.apache.jackrabbit.spi.commons.logging.IdFactoryLogger$SafeCallable_1",1,0.00,1.00,3,0.02,151.81,1,0,5,1,0,136.03,0,3,0,1,136.03,0.00,0.00,0.00,0,0.00,1,54.60,0,1,0,java.lang.Object,0.00,0,0,1,0,0,0,0,0,17,0
"org.apache.jackrabbit.spi.commons.logging.IdFactoryLogger$SafeCallable_2",1,0.00,1.00,3,0.02,136.54,1,0,5,1,0,136.39,0,3,0,1,136.39,0.00,0.00,0.00,0,0.00,1,49.51,0,1,0,java.lang.Object,0.00,0,0,1,0,0,0,0,0,16,0
"org.apache.jackrabbit.spi.commons.logging.IdFactoryLogger$SafeCallable_3",1,0.00,1.00,3,0.02,136.54,1,0,5,1,0,136.39,0,3,0,1,136.39,0.00,0.00,0.00,0,0.00,1,49.51,0,1,0,java.lang.Object,0.00,0,0,1,0,0,0,0,0,16,0
"org.apache.jackrabbit.spi.commons.logging.IdFactoryLogger$SafeCallable_4",1,0.00,1.00,3,0.02,136.54,1,0,5,1,0,136.39,0,3,0,1,136.39,0.00,0.00,0.00,0,0.00,1,49.51,0,1,0,java.lang.Object,0.00,0,0,1,0,0,0,0,0,16,0
"org.apache.jackrabbit.spi.commons.logging.LogWriter",4,0.00,1.00,5,0.05,276.78,4,0,0,4,15,114.22,31,6,15,1,156.51,0.00,0.00,0.00,0,4.00,1,137.36,0,0,0,,0.00,0,0,4,0,0,4,0,5,43,1
"org.apache.jackrabbit.spi.commons.logging.LogWriterProvider",7,0.00,1.00,8,0.05,218.34,7,0,7,7,14,159.47,32,9,6,1,159.23,0.00,0.00,0.00,0,7.00,1,145.56,0,7,8,,0.00,0,0,7,0,0,0,0,8,53,1
"org.apache.jackrabbit.spi.commons.logging.NameFactoryLogger",4,1.00,1.00,13,0.10,1574.26,5,1,2,5,5,153.38,12,16,1,2,132.77,0.00,0.50,0.25,0,6.00,1,314.94,1,3,4,org.apache.jackrabbit.spi.commons.logging.AbstractLogger,0.00,1,1,4,0,1,1,1,3,84,1
"org.apache.jackrabbit.spi.commons.logging.NameFactoryLogger$SafeCallable",1,0.00,1.00,3,0.02,151.81,1,0,2,1,0,136.03,0,3,0,1,136.03,0.00,0.00,0.00,0,0.00,1,54.60,0,1,0,java.lang.Object,0.00,0,0,1,0,0,0,0,0,17,0
"org.apache.jackrabbit.spi.commons.logging.NameFactoryLogger$SafeCallable_0",1,0.00,1.00,3,0.02,136.54,1,0,2,1,0,136.39,0,3,0,1,136.39,0.00,0.00,0.00,0,0.00,1,49.51,0,1,0,java.lang.Object,0.00,0,0,1,0,0,0,0,0,16,0
"org.apache.jackrabbit.spi.commons.logging.PathFactoryLogger",17,1.00,1.00,52,0.53,8793.01,18,1,5,21,6,131.83,12,59,1,2,131.83,0.00,0.50,0.06,0,32.00,1,1578.07,1,16,5,org.apache.jackrabbit.spi.commons.logging.AbstractLogger,0.00,4,1,17,0,4,1,1,3,390,1
"org.apache.jackrabbit.spi.commons.logging.PathFactoryLogger$Callable",1,0.00,1.00,3,0.02,230.79,1,0,5,1,0,134.59,0,3,0,1,134.59,0.00,0.00,0.00,0,0.00,1,70.51,0,1,0,java.lang.Object,0.00,0,0,1,0,0,0,0,0,20,0
"org.apache.jackrabbit.spi.commons.logging.PathFactoryLogger$Callable_0",1,0.00,1.00,3,0.02,230.79,1,0,5,1,0,134.59,0,3,0,1,134.59,0.00,0.00,0.00,0,0.00,1,70.51,0,1,0,java.lang.Object,0.00,0,0,1,0,0,0,0,0,20,0
"org.apache.jackrabbit.spi.commons.logging.PathFactoryLogger$Callable_1",1,0.00,1.00,3,0.03,250.00,1,0,5,1,0,134.32,0,3,0,1,134.32,0.00,0.00,0.00,0,0.00,1,76.00,0,1,0,java.lang.Object,0.00,0,0,1,0,0,0,0,0,21,0
"org.apache.jackrabbit.spi.commons.logging.PathFactoryLogger$SafeCallable",1,0.00,1.00,3,0.02,136.54,1,0,5,1,0,136.39,0,3,0,1,136.39,0.00,0.00,0.00,0,0.00,1,49.51,0,1,0,java.lang.Object,0.00,0,0,1,0,0,0,0,0,16,0
"org.apache.jackrabbit.spi.commons.logging.PathFactoryLogger$SafeCallable_10",1,0.00,1.00,3,0.01,121.62,1,0,5,1,0,136.78,0,3,0,1,136.78,0.00,0.00,0.00,0,0.00,1,44.54,0,1,0,java.lang.Object,0.00,0,0,1,0,0,0,0,0,15,0
"org.apache.jackrabbit.spi.commons.logging.PathFactoryLogger$SafeCallable_11",1,0.00,1.00,3,0.01,121.62,1,0,5,1,0,136.78,0,3,0,1,136.78,0.00,0.00,0.00,0,0.00,1,44.54,0,1,0,java.lang.Object,0.00,0,0,1,0,0,0,0,0,15,0
"org.apache.jackrabbit.spi.commons.logging.PathFactoryLogger$SafeCallable_12",1,0.00,1.00,3,0.01,121.62,1,0,5,1,0,136.78,0,3,0,1,136.78,0.00,0.00,0.00,0,0.00,1,44.54,0,1,0,java.lang.Object,0.00,0,0,1,0,0,0,0,0,15,0
"org.apache.jackrabbit.spi.commons.logging.PathFactoryLogger$SafeCallable_2",1,0.00,1.00,3,0.02,151.81,1,0,5,1,0,136.03,0,3,0,1,136.03,0.00,0.00,0.00,0,0.00,1,54.60,0,1,0,java.lang.Object,0.00,0,0,1,0,0,0,0,0,17,0
"org.apache.jackrabbit.spi.commons.logging.PathFactoryLogger$SafeCallable_3",1,0.00,1.00,3,0.02,136.54,1,0,5,1,0,136.39,0,3,0,1,136.39,0.00,0.00,0.00,0,0.00,1,49.51,0,1,0,java.lang.Object,0.00,0,0,1,0,0,0,0,0,16,0
"org.apache.jackrabbit.spi.commons.logging.PathFactoryLogger$SafeCallable_4",1,0.00,1.00,3,0.02,136.54,1,0,5,1,0,136.39,0,3,0,1,136.39,0.00,0.00,0.00,0,0.00,1,49.51,0,1,0,java.lang.Object,0.00,0,0,1,0,0,0,0,0,16,0
"org.apache.jackrabbit.spi.commons.logging.PathFactoryLogger$SafeCallable_5",1,0.00,1.00,3,0.02,136.54,1,0,5,1,0,136.39,0,3,0,1,136.39,0.00,0.00,0.00,0,0.00,1,49.51,0,1,0,java.lang.Object,0.00,0,0,1,0,0,0,0,0,16,0
"org.apache.jackrabbit.spi.commons.logging.PathFactoryLogger$SafeCallable_6",1,0.00,1.00,3,0.02,136.54,1,0,5,1,0,136.39,0,3,0,1,136.39,0.00,0.00,0.00,0,0.00,1,49.51,0,1,0,java.lang.Object,0.00,0,0,1,0,0,0,0,0,16,0
"org.apache.jackrabbit.spi.commons.logging.PathFactoryLogger$SafeCallable_7",1,0.00,1.00,3,0.02,151.81,1,0,5,1,0,136.03,0,3,0,1,136.03,0.00,0.00,0.00,0,0.00,1,54.60,0,1,0,java.lang.Object,0.00,0,0,1,0,0,0,0,0,17,0
"org.apache.jackrabbit.spi.commons.logging.PathFactoryLogger$SafeCallable_8",1,0.00,1.00,3,0.02,136.54,1,0,5,1,0,136.39,0,3,0,1,136.39,0.00,0.00,0.00,0,0.00,1,49.51,0,1,0,java.lang.Object,0.00,0,0,1,0,0,0,0,0,16,0
"org.apache.jackrabbit.spi.commons.logging.PathFactoryLogger$SafeCallable_9",1,0.00,1.00,3,0.01,121.62,1,0,5,1,0,136.78,0,3,0,1,136.78,0.00,0.00,0.00,0,0.00,1,44.54,0,1,0,java.lang.Object,0.00,0,0,1,0,0,0,0,0,15,0
"org.apache.jackrabbit.spi.commons.logging.QValueFactoryLogger",15,1.00,1.13,58,0.62,13709.25,16,1,12,20,8,129.86,12,63,1,2,129.86,0.00,0.50,0.07,0,28.00,2,1856.81,1,14,7,org.apache.jackrabbit.spi.commons.logging.AbstractLogger,0.00,5,1,17,0,5,1,1,3,430,1
"org.apache.jackrabbit.spi.commons.logging.QValueFactoryLogger$Callable",1,0.00,1.00,3,0.02,211.89,1,0,12,1,0,134.88,0,3,0,1,134.88,0.00,0.00,0.00,0,0.00,1,65.11,0,1,0,java.lang.Object,0.00,0,0,1,0,0,0,0,0,19,0
"org.apache.jackrabbit.spi.commons.logging.QValueFactoryLogger$Callable_0",1,0.00,1.00,3,0.02,193.32,1,0,12,1,0,135.20,0,3,0,1,135.20,0.00,0.00,0.00,0,0.00,1,59.81,0,1,0,java.lang.Object,0.00,0,0,1,0,0,0,0,0,18,0
"org.apache.jackrabbit.spi.commons.logging.QValueFactoryLogger$Callable_1",1,0.00,1.00,3,0.02,193.32,1,0,12,1,0,135.20,0,3,0,1,135.20,0.00,0.00,0.00,0,0.00,1,59.81,0,1,0,java.lang.Object,0.00,0,0,1,0,0,0,0,0,18,0
"org.apache.jackrabbit.spi.commons.logging.QValueFactoryLogger$Callable_10",1,0.00,2.00,6,0.05,814.70,1,0,12,1,0,118.89,0,9,0,1,118.89,0.00,0.00,0.00,0,0.00,2,141.78,0,1,0,java.lang.Object,0.00,0,0,2,0,0,0,0,0,34,0
"org.apache.jackrabbit.spi.commons.logging.QValueFactoryLogger$Callable_11",1,0.00,1.00,3,0.02,193.32,1,0,12,1,0,135.20,0,3,0,1,135.20,0.00,0.00,0.00,0,0.00,1,59.81,0,1,0,java.lang.Object,0.00,0,0,1,0,0,0,0,0,18,0
"org.apache.jackrabbit.spi.commons.logging.QValueFactoryLogger$Callable_2",1,0.00,1.00,3,0.02,193.32,1,0,12,1,0,135.20,0,3,0,1,135.20,0.00,0.00,0.00,0,0.00,1,59.81,0,1,0,java.lang.Object,0.00,0,0,1,0,0,0,0,0,18,0
"org.apache.jackrabbit.spi.commons.logging.QValueFactoryLogger$Callable_3",1,0.00,1.00,3,0.02,193.32,1,0,12,1,0,135.20,0,3,0,1,135.20,0.00,0.00,0.00,0,0.00,1,59.81,0,1,0,java.lang.Object,0.00,0,0,1,0,0,0,0,0,18,0
"org.apache.jackrabbit.spi.commons.logging.QValueFactoryLogger$Callable_4",1,0.00,1.00,3,0.02,193.32,1,0,12,1,0,135.20,0,3,0,1,135.20,0.00,0.00,0.00,0,0.00,1,59.81,0,1,0,java.lang.Object,0.00,0,0,1,0,0,0,0,0,18,0
"org.apache.jackrabbit.spi.commons.logging.QValueFactoryLogger$Callable_5",1,0.00,1.00,3,0.02,193.32,1,0,12,1,0,135.20,0,3,0,1,135.20,0.00,0.00,0.00,0,0.00,1,59.81,0,1,0,java.lang.Object,0.00,0,0,1,0,0,0,0,0,18,0
"org.apache.jackrabbit.spi.commons.logging.QValueFactoryLogger$Callable_6",1,0.00,1.00,3,0.02,193.32,1,0,12,1,0,135.20,0,3,0,1,135.20,0.00,0.00,0.00,0,0.00,1,59.81,0,1,0,java.lang.Object,0.00,0,0,1,0,0,0,0,0,18,0
"org.apache.jackrabbit.spi.commons.logging.QValueFactoryLogger$Callable_7",1,0.00,1.00,3,0.02,193.32,1,0,12,1,0,135.20,0,3,0,1,135.20,0.00,0.00,0.00,0,0.00,1,59.81,0,1,0,java.lang.Object,0.00,0,0,1,0,0,0,0,0,18,0
"org.apache.jackrabbit.spi.commons.logging.QValueFactoryLogger$Callable_8",1,0.00,1.00,3,0.02,193.32,1,0,12,1,0,135.20,0,3,0,1,135.20,0.00,0.00,0.00,0,0.00,1,59.81,0,1,0,java.lang.Object,0.00,0,0,1,0,0,0,0,0,18,0
"org.apache.jackrabbit.spi.commons.logging.QValueFactoryLogger$Callable_9",1,0.00,2.00,6,0.05,814.70,1,0,12,1,0,118.89,0,9,0,1,118.89,0.00,0.00,0.00,0,0.00,2,141.78,0,1,0,java.lang.Object,0.00,0,0,2,0,0,0,0,0,34,0
"org.apache.jackrabbit.spi.commons.logging.RepositoryServiceLogger",72,1.00,1.04,227,3.23,61687.64,73,1,35,75,31,130.10,13,308,1,2,130.10,1.00,0.33,0.01,0,142.00,2,9687.83,1,44,30,org.apache.jackrabbit.spi.commons.logging.AbstractLogger,0.00,3,1,75,1,3,28,1,4,2201,1
"org.apache.jackrabbit.spi.commons.logging.RepositoryServiceLogger$Callable",1,0.00,1.00,3,0.02,175.12,1,0,35,1,0,135.54,0,4,0,1,135.54,0.00,0.00,0.00,0,0.00,1,54.60,0,1,0,java.lang.Object,0.00,0,0,1,0,0,0,0,0,17,0
"org.apache.jackrabbit.spi.commons.logging.RepositoryServiceLogger$Callable_0",1,0.00,1.00,3,0.02,175.12,1,0,35,1,0,135.54,0,4,0,1,135.54,0.00,0.00,0.00,0,0.00,1,54.60,0,1,0,java.lang.Object,0.00,0,0,1,0,0,0,0,0,17,0
"org.apache.jackrabbit.spi.commons.logging.RepositoryServiceLogger$Callable_1",1,0.00,1.00,3,0.02,175.12,1,0,35,1,0,135.54,0,4,0,1,135.54,0.00,0.00,0.00,0,0.00,1,54.60,0,1,0,java.lang.Object,0.00,0,0,1,0,0,0,0,0,17,0
"org.apache.jackrabbit.spi.commons.logging.RepositoryServiceLogger$Callable_10",1,0.00,1.00,3,0.03,333.08,1,0,35,3,0,133.34,0,4,0,1,133.34,0.00,0.00,0.00,0,0.00,1,99.74,0,1,0,java.lang.Object,0.00,2,0,1,0,2,0,0,0,26,0
"org.apache.jackrabbit.spi.commons.logging.RepositoryServiceLogger$Callable_11",1,0.00,1.00,3,0.02,244.46,1,0,35,2,0,134.40,0,4,0,1,134.40,0.00,0.00,0.00,0,0.00,1,74.42,0,1,0,java.lang.Object,0.00,1,0,1,0,1,0,0,0,21,0
"org.apache.jackrabbit.spi.commons.logging.RepositoryServiceLogger$Callable_12",1,0.00,1.00,3,0.02,244.46,1,0,35,2,0,134.40,0,4,0,1,134.40,0.00,0.00,0.00,0,0.00,1,74.42,0,1,0,java.lang.Object,0.00,1,0,1,0,1,0,0,0,21,0
"org.apache.jackrabbit.spi.commons.logging.RepositoryServiceLogger$Callable_13",1,0.00,1.00,3,0.02,244.46,1,0,35,2,0,134.40,0,4,0,1,134.40,0.00,0.00,0.00,0,0.00,1,74.42,0,1,0,java.lang.Object,0.00,1,0,1,0,1,0,0,0,21,0
"org.apache.jackrabbit.spi.commons.logging.RepositoryServiceLogger$Callable_14",1,0.00,1.00,3,0.02,244.46,1,0,35,2,0,134.40,0,4,0,1,134.40,0.00,0.00,0.00,0,0.00,1,74.42,0,1,0,java.lang.Object,0.00,1,0,1,0,1,0,0,0,21,0
"org.apache.jackrabbit.spi.commons.logging.RepositoryServiceLogger$Callable_15",1,0.00,1.00,3,0.02,244.46,1,0,35,2,0,134.40,0,4,0,1,134.40,0.00,0.00,0.00,0,0.00,1,74.42,0,1,0,java.lang.Object,0.00,1,0,1,0,1,0,0,0,21,0
"org.apache.jackrabbit.spi.commons.logging.RepositoryServiceLogger$Callable_16",1,0.00,1.00,3,0.03,283.82,1,0,35,2,0,133.89,0,4,0,1,133.89,0.00,0.00,0.00,0,0.00,1,85.66,0,1,0,java.lang.Object,0.00,1,0,1,0,1,0,0,0,23,0
"org.apache.jackrabbit.spi.commons.logging.RepositoryServiceLogger$Callable_17",1,0.00,1.00,3,0.02,244.46,1,0,35,2,0,134.40,0,4,0,1,134.40,0.00,0.00,0.00,0,0.00,1,74.42,0,1,0,java.lang.Object,0.00,1,0,1,0,1,0,0,0,21,0
"org.apache.jackrabbit.spi.commons.logging.RepositoryServiceLogger$Callable_18",1,0.00,1.00,3,0.02,244.46,1,0,35,2,0,134.40,0,4,0,1,134.40,0.00,0.00,0.00,0,0.00,1,74.42,0,1,0,java.lang.Object,0.00,1,0,1,0,1,0,0,0,21,0
"org.apache.jackrabbit.spi.commons.logging.RepositoryServiceLogger$Callable_19",1,0.00,1.00,4,0.03,258.13,1,0,35,2,0,129.55,0,5,0,1,129.55,0.00,0.00,0.00,0,0.00,1,78.32,0,1,0,java.lang.Object,0.00,1,0,1,0,1,0,0,0,22,0
"org.apache.jackrabbit.spi.commons.logging.RepositoryServiceLogger$Callable_2",1,0.00,1.00,3,0.02,175.12,1,0,35,1,0,135.54,0,4,0,1,135.54,0.00,0.00,0.00,0,0.00,1,54.60,0,1,0,java.lang.Object,0.00,0,0,1,0,0,0,0,0,17,0
"org.apache.jackrabbit.spi.commons.logging.RepositoryServiceLogger$Callable_20",1,0.00,1.00,4,0.03,318.49,1,0,35,2,0,128.83,0,5,0,1,128.83,0.00,0.00,0.00,0,0.00,1,95.57,0,1,0,java.lang.Object,0.00,1,0,1,0,1,0,0,0,25,0
"org.apache.jackrabbit.spi.commons.logging.RepositoryServiceLogger$Callable_21",1,0.00,1.00,4,0.03,318.49,1,0,35,2,0,128.83,0,5,0,1,128.83,0.00,0.00,0.00,0,0.00,1,95.57,0,1,0,java.lang.Object,0.00,1,0,1,0,1,0,0,0,25,0
"org.apache.jackrabbit.spi.commons.logging.RepositoryServiceLogger$Callable_22",1,0.00,1.00,4,0.03,339.09,1,0,35,2,0,128.62,0,5,0,1,128.62,0.00,0.00,0.00,0,0.00,1,101.45,0,1,0,java.lang.Object,0.00,1,0,1,0,1,0,0,0,26,0
"org.apache.jackrabbit.spi.commons.logging.RepositoryServiceLogger$Callable_23",1,0.00,1.00,4,0.03,298.12,1,0,35,2,0,129.06,0,5,0,1,129.06,0.00,0.00,0.00,0,0.00,1,89.75,0,1,0,java.lang.Object,0.00,1,0,1,0,1,0,0,0,24,0
"org.apache.jackrabbit.spi.commons.logging.RepositoryServiceLogger$Callable_24",1,0.00,1.00,4,0.04,359.92,1,0,35,2,0,128.41,0,6,0,1,128.41,0.00,0.00,0.00,0,0.00,1,107.40,0,1,0,java.lang.Object,0.00,1,0,1,0,1,0,0,0,27,0
"org.apache.jackrabbit.spi.commons.logging.RepositoryServiceLogger$Callable_25",1,0.00,1.00,3,0.02,244.46,1,0,35,2,0,134.40,0,4,0,1,134.40,0.00,0.00,0.00,0,0.00,1,74.42,0,1,0,java.lang.Object,0.00,1,0,1,0,1,0,0,0,21,0
"org.apache.jackrabbit.spi.commons.logging.RepositoryServiceLogger$Callable_26",1,0.00,1.00,3,0.03,283.82,1,0,35,2,0,133.89,0,4,0,1,133.89,0.00,0.00,0.00,0,0.00,1,85.66,0,1,0,java.lang.Object,0.00,1,0,1,0,1,0,0,0,23,0
"org.apache.jackrabbit.spi.commons.logging.RepositoryServiceLogger$Callable_27",1,0.00,1.00,3,0.03,324.22,1,0,35,2,0,133.43,0,4,0,1,133.43,0.00,0.00,0.00,0,0.00,1,97.21,0,1,0,java.lang.Object,0.00,1,0,1,0,1,0,0,0,25,0
"org.apache.jackrabbit.spi.commons.logging.RepositoryServiceLogger$Callable_28",1,0.00,1.00,4,0.03,278.00,1,0,35,2,0,129.30,0,5,0,1,129.30,0.00,0.00,0.00,0,0.00,1,84.00,0,1,0,java.lang.Object,0.00,1,0,1,0,1,0,0,0,23,0
"org.apache.jackrabbit.spi.commons.logging.RepositoryServiceLogger$Callable_29",1,0.00,1.00,4,0.03,278.00,1,0,35,2,0,129.30,0,5,0,1,129.30,0.00,0.00,0.00,0,0.00,1,84.00,0,1,0,java.lang.Object,0.00,1,0,1,0,1,0,0,0,23,0
"org.apache.jackrabbit.spi.commons.logging.RepositoryServiceLogger$Callable_3",1,0.00,1.00,3,0.02,175.12,1,0,35,1,0,135.54,0,4,0,1,135.54,0.00,0.00,0.00,0,0.00,1,54.60,0,1,0,java.lang.Object,0.00,0,0,1,0,0,0,0,0,17,0
"org.apache.jackrabbit.spi.commons.logging.RepositoryServiceLogger$Callable_30",1,0.00,1.00,3,0.02,244.46,1,0,35,2,0,134.40,0,4,0,1,134.40,0.00,0.00,0.00,0,0.00,1,74.42,0,1,0,java.lang.Object,0.00,1,0,1,0,1,0,0,0,21,0
"org.apache.jackrabbit.spi.commons.logging.RepositoryServiceLogger$Callable_31",1,0.00,1.00,4,0.03,278.00,1,0,35,2,0,129.30,0,5,0,1,129.30,0.00,0.00,0.00,0,0.00,1,84.00,0,1,0,java.lang.Object,0.00,1,0,1,0,1,0,0,0,23,0
"org.apache.jackrabbit.spi.commons.logging.RepositoryServiceLogger$Callable_32",1,0.00,1.00,4,0.03,298.12,1,0,35,2,0,129.06,0,5,0,1,129.06,0.00,0.00,0.00,0,0.00,1,89.75,0,1,0,java.lang.Object,0.00,1,0,1,0,1,0,0,0,24,0
"org.apache.jackrabbit.spi.commons.logging.RepositoryServiceLogger$Callable_33",1,0.00,1.00,3,0.02,244.46,1,0,35,2,0,134.40,0,4,0,1,134.40,0.00,0.00,0.00,0,0.00,1,74.42,0,1,0,java.lang.Object,0.00,1,0,1,0,1,0,0,0,21,0
"org.apache.jackrabbit.spi.commons.logging.RepositoryServiceLogger$Callable_34",1,0.00,1.00,3,0.03,264.00,1,0,35,2,0,134.13,0,4,0,1,134.13,0.00,0.00,0.00,0,0.00,1,80.00,0,1,0,java.lang.Object,0.00,1,0,1,0,1,0,0,0,22,0
"org.apache.jackrabbit.spi.commons.logging.RepositoryServiceLogger$Callable_35",1,0.00,1.00,4,0.03,298.12,1,0,35,2,0,129.06,0,5,0,1,129.06,0.00,0.00,0.00,0,0.00,1,89.75,0,1,0,java.lang.Object,0.00,1,0,1,0,1,0,0,0,24,0
"org.apache.jackrabbit.spi.commons.logging.RepositoryServiceLogger$Callable_36",1,0.00,1.00,4,0.03,318.49,1,0,35,2,0,128.83,0,5,0,1,128.83,0.00,0.00,0.00,0,0.00,1,95.57,0,1,0,java.lang.Object,0.00,1,0,1,0,1,0,0,0,25,0
"org.apache.jackrabbit.spi.commons.logging.RepositoryServiceLogger$Callable_37",1,0.00,1.00,4,0.03,298.12,1,0,35,2,0,129.06,0,5,0,1,129.06,0.00,0.00,0.00,0,0.00,1,89.75,0,1,0,java.lang.Object,0.00,1,0,1,0,1,0,0,0,24,0
"org.apache.jackrabbit.spi.commons.logging.RepositoryServiceLogger$Callable_38",1,0.00,1.00,3,0.03,283.82,1,0,35,2,0,133.89,0,4,0,1,133.89,0.00,0.00,0.00,0,0.00,1,85.66,0,1,0,java.lang.Object,0.00,1,0,1,0,1,0,0,0,23,0
"org.apache.jackrabbit.spi.commons.logging.RepositoryServiceLogger$Callable_39",1,0.00,1.00,3,0.03,303.89,1,0,35,2,0,133.65,0,4,0,1,133.65,0.00,0.00,0.00,0,0.00,1,91.40,0,1,0,java.lang.Object,0.00,1,0,1,0,1,0,0,0,24,0
"org.apache.jackrabbit.spi.commons.logging.RepositoryServiceLogger$Callable_4",1,0.00,1.00,3,0.02,193.32,1,0,35,1,0,135.20,0,4,0,1,135.20,0.00,0.00,0.00,0,0.00,1,59.81,0,1,0,java.lang.Object,0.00,0,0,1,0,0,0,0,0,18,0
"org.apache.jackrabbit.spi.commons.logging.RepositoryServiceLogger$Callable_40",1,0.00,1.00,4,0.03,318.49,1,0,35,2,0,128.83,0,5,0,1,128.83,0.00,0.00,0.00,0,0.00,1,95.57,0,1,0,java.lang.Object,0.00,1,0,1,0,1,0,0,0,25,0
"org.apache.jackrabbit.spi.commons.logging.RepositoryServiceLogger$Callable_41",1,0.00,1.00,4,0.03,339.09,1,0,35,2,0,128.62,0,5,0,1,128.62,0.00,0.00,0.00,0,0.00,1,101.45,0,1,0,java.lang.Object,0.00,1,0,1,0,1,0,0,0,26,0
"org.apache.jackrabbit.spi.commons.logging.RepositoryServiceLogger$Callable_42",1,0.00,1.00,4,0.03,318.49,1,0,35,2,0,128.83,0,5,0,1,128.83,0.00,0.00,0.00,0,0.00,1,95.57,0,1,0,java.lang.Object,0.00,1,0,1,0,1,0,0,0,25,0
"org.apache.jackrabbit.spi.commons.logging.RepositoryServiceLogger$Callable_43",1,0.00,1.00,3,0.02,244.46,1,0,35,2,0,134.40,0,4,0,1,134.40,0.00,0.00,0.00,0,0.00,1,74.42,0,1,0,java.lang.Object,0.00,1,0,1,0,1,0,0,0,21,0
"org.apache.jackrabbit.spi.commons.logging.RepositoryServiceLogger$Callable_44",1,0.00,1.00,4,0.03,278.00,1,0,35,2,0,129.30,0,5,0,1,129.30,0.00,0.00,0.00,0,0.00,1,84.00,0,1,0,java.lang.Object,0.00,1,0,1,0,1,0,0,0,23,0
"org.apache.jackrabbit.spi.commons.logging.RepositoryServiceLogger$Callable_45",1,0.00,1.00,3,0.02,244.46,1,0,35,2,0,134.40,0,4,0,1,134.40,0.00,0.00,0.00,0,0.00,1,74.42,0,1,0,java.lang.Object,0.00,1,0,1,0,1,0,0,0,21,0
"org.apache.jackrabbit.spi.commons.logging.RepositoryServiceLogger$Callable_46",1,0.00,1.00,3,0.02,244.46,1,0,35,2,0,134.40,0,4,0,1,134.40,0.00,0.00,0.00,0,0.00,1,74.42,0,1,0,java.lang.Object,0.00,1,0,1,0,1,0,0,0,21,0
"org.apache.jackrabbit.spi.commons.logging.RepositoryServiceLogger$Callable_47",1,0.00,1.00,3,0.02,225.21,1,0,35,2,0,134.68,0,4,0,1,134.68,0.00,0.00,0.00,0,0.00,1,68.92,0,1,0,java.lang.Object,0.00,1,0,1,0,1,0,0,0,20,0
"org.apache.jackrabbit.spi.commons.logging.RepositoryServiceLogger$Callable_48",1,0.00,1.00,3,0.03,283.82,1,0,35,2,0,133.89,0,4,0,1,133.89,0.00,0.00,0.00,0,0.00,1,85.66,0,1,0,java.lang.Object,0.00,1,0,1,0,1,0,0,0,23,0
"org.apache.jackrabbit.spi.commons.logging.RepositoryServiceLogger$Callable_49",1,0.00,1.00,3,0.03,344.79,1,0,35,2,0,133.22,0,4,0,1,133.22,0.00,0.00,0.00,0,0.00,1,103.08,0,1,0,java.lang.Object,0.00,1,0,1,0,1,0,0,0,26,0
"org.apache.jackrabbit.spi.commons.logging.RepositoryServiceLogger$Callable_5",1,0.00,1.00,3,0.02,211.89,1,0,35,1,0,134.88,0,4,0,1,134.88,0.00,0.00,0.00,0,0.00,1,65.11,0,1,0,java.lang.Object,0.00,0,0,1,0,0,0,0,0,19,0
"org.apache.jackrabbit.spi.commons.logging.RepositoryServiceLogger$Callable_50",1,0.00,1.00,3,0.03,344.79,1,0,35,2,0,133.22,0,5,0,1,133.22,0.00,0.00,0.00,0,0.00,1,103.08,0,1,0,java.lang.Object,0.00,1,0,1,0,1,0,0,0,26,0
"org.apache.jackrabbit.spi.commons.logging.RepositoryServiceLogger$Callable_51",1,0.00,1.00,3,0.02,244.46,1,0,35,2,0,134.40,0,4,0,1,134.40,0.00,0.00,0.00,0,0.00,1,74.42,0,1,0,java.lang.Object,0.00,1,0,1,0,1,0,0,0,21,0
"org.apache.jackrabbit.spi.commons.logging.RepositoryServiceLogger$Callable_52",1,0.00,2.00,7,0.06,1159.41,1,0,35,2,0,115.19,0,10,0,1,115.19,0.00,0.00,0.00,0,0.00,2,193.44,0,1,0,java.lang.Object,0.00,1,0,2,0,1,0,0,0,43,0
"org.apache.jackrabbit.spi.commons.logging.RepositoryServiceLogger$Callable_53",1,0.00,1.00,3,0.02,230.79,1,0,35,1,0,134.59,0,4,0,1,134.59,0.00,0.00,0.00,0,0.00,1,70.51,0,1,0,java.lang.Object,0.00,0,0,1,0,0,0,0,0,20,0
"org.apache.jackrabbit.spi.commons.logging.RepositoryServiceLogger$Callable_54",1,0.00,1.00,4,0.02,244.46,1,0,35,1,0,129.74,0,5,0,1,129.74,0.00,0.00,0.00,0,0.00,1,74.42,0,1,0,java.lang.Object,0.00,0,0,1,0,0,0,0,0,21,0
"org.apache.jackrabbit.spi.commons.logging.RepositoryServiceLogger$Callable_55",1,0.00,1.00,4,0.02,225.21,1,0,35,1,0,130.02,0,5,0,1,130.02,0.00,0.00,0.00,0,0.00,1,68.92,0,1,0,java.lang.Object,0.00,0,0,1,0,0,0,0,0,20,0
"org.apache.jackrabbit.spi.commons.logging.RepositoryServiceLogger$Callable_56",1,0.00,1.00,3,0.02,225.21,1,0,35,2,0,134.68,0,4,0,1,134.68,0.00,0.00,0.00,0,0.00,1,68.92,0,1,0,java.lang.Object,0.00,1,0,1,0,1,0,0,0,20,0
"org.apache.jackrabbit.spi.commons.logging.RepositoryServiceLogger$Callable_57",1,0.00,1.00,3,0.02,244.46,1,0,35,2,0,134.40,0,4,0,1,134.40,0.00,0.00,0.00,0,0.00,1,74.42,0,1,0,java.lang.Object,0.00,1,0,1,0,1,0,0,0,21,0
"org.apache.jackrabbit.spi.commons.logging.RepositoryServiceLogger$Callable_58",1,0.00,1.00,3,0.02,244.46,1,0,35,2,0,134.40,0,4,0,1,134.40,0.00,0.00,0.00,0,0.00,1,74.42,0,1,0,java.lang.Object,0.00,1,0,1,0,1,0,0,0,21,0
"org.apache.jackrabbit.spi.commons.logging.RepositoryServiceLogger$Callable_59",1,0.00,1.00,4,0.03,298.12,1,0,35,2,0,129.06,0,5,0,1,129.06,0.00,0.00,0.00,0,0.00,1,89.75,0,1,0,java.lang.Object,0.00,1,0,1,0,1,0,0,0,24,0
"org.apache.jackrabbit.spi.commons.logging.RepositoryServiceLogger$Callable_6",1,0.00,1.00,3,0.02,244.46,1,0,35,2,0,134.40,0,4,0,1,134.40,0.00,0.00,0.00,0,0.00,1,74.42,0,1,0,java.lang.Object,0.00,1,0,1,0,1,0,0,0,21,0
"org.apache.jackrabbit.spi.commons.logging.RepositoryServiceLogger$Callable_60",1,0.00,1.00,4,0.03,278.00,1,0,35,2,0,129.30,0,5,0,1,129.30,0.00,0.00,0.00,0,0.00,1,84.00,0,1,0,java.lang.Object,0.00,1,0,1,0,1,0,0,0,23,0
"org.apache.jackrabbit.spi.commons.logging.RepositoryServiceLogger$Callable_61",1,0.00,1.00,3,0.02,225.21,1,0,35,2,0,134.68,0,4,0,1,134.68,0.00,0.00,0.00,0,0.00,1,68.92,0,1,0,java.lang.Object,0.00,1,0,1,0,1,0,0,0,20,0
"org.apache.jackrabbit.spi.commons.logging.RepositoryServiceLogger$Callable_62",1,0.00,1.00,3,0.02,244.46,1,0,35,2,0,134.40,0,4,0,1,134.40,0.00,0.00,0.00,0,0.00,1,74.42,0,1,0,java.lang.Object,0.00,1,0,1,0,1,0,0,0,21,0
"org.apache.jackrabbit.spi.commons.logging.RepositoryServiceLogger$Callable_63",1,0.00,1.00,4,0.03,298.12,1,0,35,2,0,129.06,0,5,0,1,129.06,0.00,0.00,0.00,0,0.00,1,89.75,0,1,0,java.lang.Object,0.00,1,0,1,0,1,0,0,0,24,0
"org.apache.jackrabbit.spi.commons.logging.RepositoryServiceLogger$Callable_64",1,0.00,1.00,4,0.03,278.00,1,0,35,2,0,129.30,0,5,0,1,129.30,0.00,0.00,0.00,0,0.00,1,84.00,0,1,0,java.lang.Object,0.00,1,0,1,0,1,0,0,0,23,0
"org.apache.jackrabbit.spi.commons.logging.RepositoryServiceLogger$Callable_65",1,0.00,1.00,4,0.03,298.12,1,0,35,2,0,129.06,0,5,0,1,129.06,0.00,0.00,0.00,0,0.00,1,89.75,0,1,0,java.lang.Object,0.00,1,0,1,0,1,0,0,0,24,0
"org.apache.jackrabbit.spi.commons.logging.RepositoryServiceLogger$Callable_66",1,0.00,1.00,4,0.03,278.00,1,0,35,2,0,129.30,0,5,0,1,129.30,0.00,0.00,0.00,0,0.00,1,84.00,0,1,0,java.lang.Object,0.00,1,0,1,0,1,0,0,0,23,0
"org.apache.jackrabbit.spi.commons.logging.RepositoryServiceLogger$Callable_7",1,0.00,1.00,3,0.02,244.46,1,0,35,2,0,134.40,0,4,0,1,134.40,0.00,0.00,0.00,0,0.00,1,74.42,0,1,0,java.lang.Object,0.00,1,0,1,0,1,0,0,0,21,0
"org.apache.jackrabbit.spi.commons.logging.RepositoryServiceLogger$Callable_8",1,0.00,1.00,4,0.03,258.13,1,0,35,2,0,129.55,0,5,0,1,129.55,0.00,0.00,0.00,0,0.00,1,78.32,0,1,0,java.lang.Object,0.00,1,0,1,0,1,0,0,0,22,0
"org.apache.jackrabbit.spi.commons.logging.RepositoryServiceLogger$Callable_9",1,0.00,1.00,3,0.02,225.21,1,0,35,2,0,134.68,0,4,0,1,134.68,0.00,0.00,0.00,0,0.00,1,68.92,0,1,0,java.lang.Object,0.00,1,0,1,0,1,0,0,0,20,0
"org.apache.jackrabbit.spi.commons.logging.SessionInfoLogger",8,1.00,1.00,25,0.19,2459.58,9,1,2,10,5,183.61,13,28,2,2,133.61,0.00,0.50,0.12,0,14.00,1,559.66,1,4,3,org.apache.jackrabbit.spi.commons.logging.AbstractLogger,0.00,2,1,8,0,2,4,1,4,149,1
"org.apache.jackrabbit.spi.commons.logging.SessionInfoLogger$Callable",1,0.00,1.00,3,0.02,175.12,1,0,2,1,0,135.54,0,4,0,1,135.54,0.00,0.00,0.00,0,0.00,1,54.60,0,1,0,java.lang.Object,0.00,0,0,1,0,0,0,0,0,17,0
"org.apache.jackrabbit.spi.commons.logging.SessionInfoLogger$Callable_1",1,0.00,1.00,4,0.02,225.21,1,0,2,1,0,130.02,0,5,0,1,130.02,0.00,0.00,0.00,0,0.00,1,68.92,0,1,0,java.lang.Object,0.00,0,0,1,0,0,0,0,0,20,0
"org.apache.jackrabbit.spi.commons.logging.SessionInfoLogger$Callable_2",1,0.00,1.00,4,0.02,225.21,1,0,2,1,0,130.02,0,5,0,1,130.02,0.00,0.00,0.00,0,0.00,1,68.92,0,1,0,java.lang.Object,0.00,0,0,1,0,0,0,0,0,20,0
"org.apache.jackrabbit.spi.commons.logging.SessionInfoLogger$Callable_3",1,0.00,1.00,4,0.02,225.21,1,0,2,1,0,130.02,0,5,0,1,130.02,0.00,0.00,0.00,0,0.00,1,68.92,0,1,0,java.lang.Object,0.00,0,0,1,0,0,0,0,0,20,0
"org.apache.jackrabbit.spi.commons.logging.SessionInfoLogger$SafeCallable",1,0.00,1.00,3,0.01,121.62,1,0,2,1,0,136.78,0,4,0,1,136.78,0.00,0.00,0.00,0,0.00,1,44.54,0,1,0,java.lang.Object,0.00,0,0,1,0,0,0,0,0,15,0
"org.apache.jackrabbit.spi.commons.logging.SessionInfoLogger$SafeCallable_0",1,0.00,1.00,3,0.01,121.62,1,0,2,1,0,136.78,0,4,0,1,136.78,0.00,0.00,0.00,0,0.00,1,44.54,0,1,0,java.lang.Object,0.00,0,0,1,0,0,0,0,0,15,0
"org.apache.jackrabbit.spi.commons.logging.Slf4jLogWriter",10,0.78,1.50,44,0.50,9652.41,11,1,3,20,2,164.83,28,60,1,1,124.95,0.00,0.00,0.30,2,22.00,2,1490.25,0,3,1,java.lang.Object,0.00,10,0,15,0,10,7,1,7,344,1
"org.apache.jackrabbit.spi.commons.logging.Slf4jLogWriterProvider",8,0.00,1.12,18,0.15,1894.43,8,0,9,12,12,123.17,46,29,2,1,141.05,0.00,0.00,0.00,1,8.00,2,443.83,0,8,10,java.lang.Object,0.00,4,0,9,0,4,0,1,9,123,1
"org.apache.jackrabbit.spi.commons.logging.SpiLoggerFactory",9,0.00,3.33,76,0.71,25807.80,9,0,10,19,19,72.25,113,114,2,1,109.81,0.00,0.00,0.00,1,9.00,4,2125.10,0,8,17,java.lang.Object,0.00,10,0,30,0,10,1,0,11,463,2
"org.apache.jackrabbit.spi.commons.logging.SpiLoggerFactory$ServiceLogger",9,0.12,1.89,29,0.45,13549.28,10,1,10,9,11,128.03,0,67,0,3,128.03,0.00,0.67,0.89,0,0.00,2,1364.26,7,8,11,org.apache.jackrabbit.spi.commons.logging.RepositoryServiceLogger,0.14,0,2,17,0,0,1,0,0,306,2
"org.apache.jackrabbit.spi.commons.logging.WriterLogWriter",11,0.45,1.18,46,0.49,8435.76,13,2,3,22,2,165.67,29,62,1,1,125.79,0.00,0.00,0.09,3,20.00,2,1466.29,0,3,1,java.lang.Object,0.00,11,0,13,0,11,8,1,7,353,1
"org.apache.jackrabbit.spi.commons.logging.WriterLogWriterProvider",9,0.25,1.00,20,0.16,1702.48,10,1,8,12,10,123.97,53,30,0,1,141.84,0.00,0.00,0.78,1,0.00,1,490.20,0,8,10,java.lang.Object,0.00,3,0,9,0,3,1,1,11,138,1
"org.apache.jackrabbit.jcr.AbstractJCR2SPITest",80,0.03,1.04,186,2.64,57686.63,85,5,51,156,38,137.26,31,307,4,2,137.26,2.00,0.25,0.18,1,0.00,3,7923.38,1,50,34,junit.framework.TestCase,0.00,76,1,83,2,76,30,1,19,1881,2
"org.apache.jackrabbit.jcr.AbstractJCR2SPITest$AbstractReadableRepositoryService",7,0.00,1.00,15,0.26,4225.35,7,0,51,14,8,137.87,0,34,0,1,137.87,0.00,0.00,0.00,0,7.00,1,781.93,0,6,8,java.lang.Object,0.00,7,0,7,0,7,1,0,0,186,0
"org.apache.jackrabbit.jcr.AbstractJCR2SPITest$AbstractRepositoryConfig",1,0.00,1.00,3,0.02,162.57,1,0,51,1,2,135.79,0,4,0,1,135.79,0.00,0.00,0.00,0,1.00,1,51.02,0,1,2,java.lang.Object,0.00,0,0,1,0,0,0,0,0,16,0
"org.apache.jackrabbit.jcr.AbstractJCR2SPITest$ItemInfoBuilder.Listener",3,0.00,1.00,7,0.06,618.47,3,0,51,3,3,141.55,0,10,0,1,141.55,0.00,0.00,0.00,0,0.00,1,181.45,0,0,3,java.lang.Object,0.00,0,0,3,0,0,3,0,0,51,0
"org.apache.jackrabbit.jcr.AbstractMoveTest",4,0.20,1.25,24,0.25,4955.58,9,5,9,11,9,167.56,7,32,8,4,117.57,3.00,0.23,0.35,1,6.00,2,756.52,2,0,1,org.apache.jackrabbit.test.AbstractJCRTest,0.27,7,3,5,9,7,4,0,5,170,1
"org.apache.jackrabbit.jcr.AbstractMoveTreeTest",5,0.22,1.40,39,0.45,11032.89,14,9,12,15,3,113.07,3,47,2,4,113.07,0.67,0.50,0.29,3,6.00,3,1358.62,2,0,1,org.apache.jackrabbit.test.AbstractJCRTest,0.26,10,3,7,2,10,5,0,1,280,1
"org.apache.jackrabbit.jcr.AbstractRepositoryConfig",4,0.08,1.00,13,0.11,2067.42,8,4,4,5,5,181.83,4,18,3,1,131.84,0.00,0.00,0.19,0,10.00,1,323.78,0,1,2,java.lang.Object,0.00,1,0,4,0,1,3,1,2,82,2
"org.apache.jackrabbit.jcr.AccessByRelativePathTest",14,0.00,1.64,67,0.80,18270.12,16,2,7,31,3,91.67,97,97,1,4,123.89,0.00,0.75,0.50,0,0.00,4,2385.13,0,0,2,org.apache.jackrabbit.test.AbstractJCRTest,0.00,17,3,23,0,17,14,0,18,517,1
"org.apache.jackrabbit.jcr.AddNewPropertyTest",5,0.25,1.80,26,0.30,5650.27,7,2,11,14,3,102.88,26,41,1,4,120.75,0.00,0.75,0.30,0,0.00,2,906.60,2,0,2,org.apache.jackrabbit.test.AbstractJCRTest,0.26,9,3,9,0,9,5,0,6,200,1
"org.apache.jackrabbit.jcr.AddNodeTest",1,1.00,2.00,11,0.15,2924.93,2,1,7,10,2,84.56,14,16,1,4,104.70,0.00,0.75,0.00,0,0.00,2,441.96,1,0,1,org.apache.jackrabbit.test.AbstractJCRTest,0.00,9,3,2,0,9,1,0,4,91,1
"org.apache.jackrabbit.jcr.AddPropertyTest",9,0.06,1.11,87,1.09,24209.73,11,2,9,26,5,108.37,1,106,1,4,108.37,0.00,0.75,0.44,1,0.00,2,3265.82,2,0,4,org.apache.jackrabbit.test.AbstractJCRTest,0.23,17,3,10,0,17,9,0,1,675,1
"org.apache.jackrabbit.jcr.BinaryTest",2,0.00,1.50,23,0.26,7330.65,2,0,7,16,2,124.61,7,28,1,4,103.99,0.00,0.75,0.00,1,2.00,2,791.25,1,0,1,org.apache.jackrabbit.test.AbstractJCRTest,0.00,14,3,3,0,14,2,0,5,155,1
"org.apache.jackrabbit.jcr.ExternalModificationTest",16,0.48,1.81,231,3.59,102777.90,20,4,11,52,5,138.01,32,269,1,4,98.12,0.00,0.75,0.70,1,0.00,4,10782.40,2,0,4,org.apache.jackrabbit.test.AbstractJCRTest,0.19,36,3,29,0,36,16,0,32,1973,1
"org.apache.jackrabbit.jcr.GetItemsTest",11,0.60,1.36,46,0.73,15880.04,12,1,22,40,12,173.59,15,96,1,3,123.59,0.00,0.67,0.45,1,31.00,4,2203.82,3,5,11,org.apache.jackrabbit.jcr2spi.AbstractJCR2SPITest,0.07,29,2,15,0,29,6,0,4,467,1
"org.apache.jackrabbit.jcr.GetItemsTest$Predicate<ItemInfo>",1,0.00,1.00,3,0.03,323.26,1,0,22,3,1,133.44,0,4,0,1,133.44,0.00,0.00,0.00,0,1.00,1,88.18,0,0,1,java.lang.Object,0.00,2,0,1,0,2,1,0,0,25,0
"org.apache.jackrabbit.jcr.GetPropertyTest",13,0.27,1.38,134,2.02,47947.13,18,5,13,58,4,145.42,29,162,1,4,105.54,0.00,0.75,0.45,0,0.00,4,6053.99,3,0,3,org.apache.jackrabbit.test.AbstractJCRTest,0.21,45,3,18,0,45,13,0,29,1172,1
"org.apache.jackrabbit.jcr.HierarchyNodeTest",4,0.50,2.50,55,0.88,36132.37,10,6,10,29,3,148.09,6,69,1,4,98.09,0.00,0.75,0.54,1,0.00,6,2650.40,3,0,2,org.apache.jackrabbit.test.AbstractJCRTest,0.27,25,3,10,0,25,4,0,4,487,1
"org.apache.jackrabbit.jcr.IsSameTest",19,1.00,1.26,199,2.86,65937.26,20,1,10,45,2,145.65,44,251,1,4,105.76,0.00,0.75,0.00,0,0.00,3,8594.15,1,0,1,org.apache.jackrabbit.test.AbstractJCRTest,0.00,26,3,24,0,26,19,0,23,1666,1
"org.apache.jackrabbit.jcr.ItemCache",2,0.00,1.00,3,0.01,59.70,2,0,2,2,4,117.09,15,4,3,2,159.39,0.00,0.50,0.00,0,2.00,1,41.60,0,1,1,,0.00,0,1,2,0,0,1,0,3,17,1
"org.apache.jackrabbit.jcr.ItemCacheImpl",9,0.06,2.67,65,0.82,23599.96,11,2,9,31,5,112.56,38,88,1,1,112.33,0.00,0.00,0.56,3,0.00,6,2445.83,0,1,4,java.lang.Object,0.00,22,0,24,0,22,8,2,17,493,1
"org.apache.jackrabbit.jcr.ItemImpl",32,0.01,2.12,172,2.09,65250.25,36,4,33,92,24,76.40,250,234,8,1,118.69,0.00,0.00,0.24,11,250.00,8,6260.01,0,9,16,java.lang.Object,0.00,60,0,68,4,60,23,2,78,1302,2
"org.apache.jackrabbit.jcr.ItemInfoStore",12,0.12,1.67,40,0.69,19680.75,15,3,16,29,10,109.90,64,66,1,1,127.77,0.00,0.00,0.22,1,64.00,2,2072.84,0,7,9,java.lang.Object,0.00,17,0,20,0,17,5,0,12,468,1
"org.apache.jackrabbit.jcr.ItemLifeCycleListener",3,0.00,1.00,4,0.02,80.99,3,0,1,3,6,109.73,29,5,6,1,159.73,0.00,0.00,0.00,0,3.00,1,67.16,0,0,0,,0.00,0,0,3,0,0,3,0,4,25,1
"org.apache.jackrabbit.jcr.ItemManager",11,0.00,1.00,12,0.10,582.92,11,0,11,11,18,109.32,92,13,15,1,157.42,0.00,0.00,0.00,0,11.00,1,311.10,0,5,3,,0.00,0,0,11,0,0,6,0,12,100,1
"org.apache.jackrabbit.jcr.ItemManagerImpl",18,0.09,2.50,125,1.45,34889.30,22,4,29,60,24,83.65,109,183,1,1,115.87,0.00,0.00,0.33,4,0.00,4,4351.08,0,6,24,java.lang.Object,0.00,42,0,45,0,42,12,3,57,920,1
"org.apache.jackrabbit.jcr.Jcr2SpiTestSuite",1,0.00,1.00,11,0.22,6177.17,1,0,1,10,10,102.54,4,13,2,2,102.30,0.00,0.50,0.00,0,1.00,1,648.75,0,0,8,junit.framework.TestSuite,0.00,9,1,1,0,9,1,0,2,148,1
"org.apache.jackrabbit.jcr.Jcr2spiRepositoryFactory",2,0.30,7.50,61,0.79,47469.38,12,10,12,15,7,39.48,88,85,0,1,80.98,0.00,0.00,0.25,1,0.00,10,2375.67,0,2,7,java.lang.Object,0.00,13,0,15,0,13,0,1,14,429,1
"org.apache.jackrabbit.jcr.Jcr2spiRepositoryFactory$RepositoryConfigImpl",8,0.05,3.75,88,1.01,67650.16,14,6,12,13,4,100.92,1,120,0,1,100.92,0.00,0.00,0.12,0,38.00,8,3036.62,0,3,4,java.lang.Object,0.00,5,0,30,0,5,5,1,1,585,2
"org.apache.jackrabbit.jcr.Jcr2spiRepositoryFactory$SpiLoggerConfig",6,0.10,2.00,24,0.25,7614.48,8,2,12,14,5,123.94,0,35,0,1,123.94,0.00,0.00,0.42,0,10.00,4,738.86,0,3,5,java.lang.Object,0.00,8,0,12,0,8,3,1,0,172,2
"org.apache.jackrabbit.jcr.JcrLockManager",9,0.22,1.00,30,0.40,6085.53,13,4,8,23,6,113.04,45,40,1,1,130.92,0.00,0.00,0.44,0,0.00,1,1201.22,0,3,5,java.lang.Object,0.00,14,0,9,0,14,6,1,11,280,1
"org.apache.jackrabbit.jcr.JcrVersionManager",23,0.30,1.39,138,1.96,41775.12,29,6,28,70,13,116.47,95,167,1,1,116.23,0.00,0.00,0.45,4,0.00,3,5880.21,0,12,12,java.lang.Object,0.00,47,0,32,0,47,11,1,32,1196,1
"org.apache.jackrabbit.jcr.LazyItemIterator",12,0.12,2.08,77,0.79,25373.54,19,7,21,30,10,67.51,99,104,4,1,115.62,0.00,0.00,0.25,1,12.00,6,2384.99,0,5,6,java.lang.Object,0.00,18,0,25,0,18,7,3,30,490,1
"org.apache.jackrabbit.jcr.LazyItemIteratorTest",4,0.00,2.25,41,0.44,16078.45,4,0,5,14,3,105.36,16,53,1,4,105.13,0.00,0.75,0.00,0,0.00,3,1329.64,1,0,2,org.apache.jackrabbit.test.AbstractJCRTest,0.13,10,3,9,0,10,4,0,11,272,1
"org.apache.jackrabbit.jcr.LoginTest",3,1.00,1.00,17,0.20,3284.69,4,1,5,10,2,120.99,1,27,1,4,120.99,0.00,0.75,0.00,0,3.00,1,610.75,1,0,1,org.apache.jackrabbit.test.AbstractJCRTest,0.00,7,3,3,0,7,3,0,1,139,1
"org.apache.jackrabbit.jcr.ManagerProvider",13,0.00,1.00,14,0.09,491.11,13,0,13,13,24,198.46,26,15,12,1,158.58,0.00,0.00,0.00,0,13.00,1,273.68,0,13,12,,0.00,0,0,13,0,0,0,0,4,97,1
"org.apache.jackrabbit.jcr.MixinModificationTest",4,1.00,3.00,55,0.70,24352.57,5,1,11,27,5,139.28,11,77,1,4,99.39,0.00,0.75,0.00,1,0.00,5,2105.94,1,0,4,org.apache.jackrabbit.test.AbstractJCRTest,0.00,23,3,12,0,23,4,0,11,398,1
"org.apache.jackrabbit.jcr.MoveCombinedTest",8,0.07,1.12,45,0.50,8062.77,10,2,6,24,2,121.25,1,58,1,5,121.25,0.00,0.80,0.44,0,0.00,2,1510.64,3,0,1,org.apache.jackrabbit.jcr2spi.AbstractMoveTest,0.39,16,4,9,0,16,8,0,1,337,1
"org.apache.jackrabbit.jcr.MoveMultipleTest",11,0.25,1.09,126,1.99,55581.80,13,2,8,40,3,103.21,47,144,1,5,102.97,0.00,0.80,0.27,0,0.00,2,5978.09,3,0,2,org.apache.jackrabbit.jcr2spi.AbstractMoveTest,0.24,29,4,12,0,29,11,0,21,1162,1
"org.apache.jackrabbit.jcr.MoveNewTreeTest",9,1.00,1.56,58,0.70,15896.17,10,1,8,28,2,156.19,18,76,1,5,116.30,0.00,0.80,0.00,0,0.00,4,2101.35,0,0,1,org.apache.jackrabbit.jcr2spi.AbstractMoveTreeTest,0.25,19,4,14,0,19,9,0,7,446,1
"org.apache.jackrabbit.jcr.MoveReferenceableTest",7,1.00,1.14,38,0.42,6782.65,8,1,5,19,3,121.62,31,49,1,5,121.38,0.00,0.80,0.00,0,0.00,2,1273.05,2,0,2,org.apache.jackrabbit.jcr2spi.AbstractMoveTest,0.27,12,4,8,0,12,7,0,13,285,1
"org.apache.jackrabbit.jcr.MoveSNSTest",9,0.04,2.00,72,0.82,17008.04,12,3,8,25,3,111.59,44,90,1,5,111.35,0.00,0.80,0.37,0,0.00,4,2445.49,3,0,2,org.apache.jackrabbit.jcr2spi.AbstractMoveTest,0.38,16,4,18,0,16,9,0,15,500,1
"org.apache.jackrabbit.jcr.MoveTest",15,1.00,2.20,125,1.63,47193.26,16,1,15,55,6,91.71,81,170,2,5,109.59,0.25,0.67,0.00,1,0.00,4,4898.81,2,0,4,org.apache.jackrabbit.jcr2spi.AbstractMoveTest,0.11,40,4,33,1,40,15,0,35,951,1
"org.apache.jackrabbit.jcr.MoveToNewTest",9,0.75,1.44,109,1.41,36246.78,13,4,7,40,3,152.27,14,130,1,4,102.27,0.00,0.75,0.92,0,0.00,2,4233.00,3,0,2,org.apache.jackrabbit.test.AbstractJCRTest,0.23,31,3,13,0,31,9,0,14,819,1
"org.apache.jackrabbit.jcr.MoveTreeTest",10,1.00,1.70,58,0.67,13893.45,11,1,5,25,2,120.06,8,77,1,5,120.06,0.00,0.80,0.00,0,0.00,3,1998.49,0,0,1,org.apache.jackrabbit.jcr2spi.AbstractMoveTreeTest,0.24,15,4,17,0,15,10,0,6,434,1
"org.apache.jackrabbit.jcr.MultiValuedPropertyTest",7,1.00,3.00,57,0.56,13656.42,8,1,8,18,4,68.86,51,92,1,4,111.15,0.00,0.75,0.00,0,0.00,3,1682.35,0,0,3,org.apache.jackrabbit.test.AbstractJCRTest,0.00,11,3,21,0,11,7,0,15,347,1
"org.apache.jackrabbit.jcr.NamespaceRegistryImpl",7,0.08,1.29,25,0.31,6987.63,9,2,7,19,2,129.76,32,37,1,1,129.53,0.00,0.00,0.57,0,0.00,2,940.08,0,4,1,java.lang.Object,0.00,12,0,9,0,12,3,1,11,219,1
"org.apache.jackrabbit.jcr.NamespaceStorage",5,0.00,1.00,6,0.07,502.35,5,0,5,5,2,155.23,3,7,2,1,155.23,0.00,0.00,0.00,0,5.00,1,202.77,0,3,0,,0.00,0,0,5,0,0,2,0,1,61,1
"org.apache.jackrabbit.jcr.NodeImpl",109,0.85,2.17,721,10.31,335335.05,110,1,68,305,48,96.45,610,976,11,2,114.33,2.00,0.25,0.16,37,0.00,7,30918.60,7,68,38,org.apache.jackrabbit.jcr2spi.ItemImpl,0.04,196,1,237,2,196,41,1,242,6019,1
"org.apache.jackrabbit.jcr.NodeOrderTest",7,0.08,1.57,53,0.72,19112.86,9,2,8,23,3,152.20,19,73,1,4,112.31,0.00,0.75,0.43,1,0.00,4,2150.61,3,0,2,org.apache.jackrabbit.test.AbstractJCRTest,0.24,16,3,11,0,16,7,0,5,444,1
"org.apache.jackrabbit.jcr.PropertyImpl",43,0.50,1.98,258,3.35,119848.87,45,2,31,99,19,114.92,191,342,5,2,114.69,0.00,0.50,0.01,13,103.00,9,10041.41,5,15,14,org.apache.jackrabbit.jcr2spi.ItemImpl,0.08,56,1,85,0,56,28,1,68,2028,1
"org.apache.jackrabbit.jcr.PropertyLengthTest",12,1.00,2.25,81,1.08,46344.00,13,1,12,41,3,113.54,3,109,0,4,113.54,0.00,0.75,0.08,2,22.00,13,3233.62,0,1,3,org.apache.jackrabbit.test.AbstractJCRTest,0.00,29,3,27,0,29,11,0,1,617,1
"org.apache.jackrabbit.jcr.RefreshFalseTest",6,0.00,1.83,48,0.57,11024.45,8,2,11,25,3,161.47,10,65,1,4,111.47,0.00,0.75,0.50,0,0.00,3,1719.64,2,0,2,org.apache.jackrabbit.test.AbstractJCRTest,0.25,19,3,11,0,19,6,0,8,353,1
"org.apache.jackrabbit.jcr.RefreshMovedTest",4,0.42,1.25,32,0.42,7975.01,8,4,7,20,2,93.40,23,43,1,4,111.28,0.00,0.75,0.56,0,0.00,2,1251.61,3,0,1,org.apache.jackrabbit.test.AbstractJCRTest,0.27,16,3,5,0,16,4,0,11,262,1
"org.apache.jackrabbit.jcr.RefreshTrueTest",6,0.00,1.67,52,0.64,13649.24,8,2,9,31,3,160.76,11,68,1,4,110.76,0.00,0.75,0.50,0,0.00,3,1928.68,2,0,2,org.apache.jackrabbit.test.AbstractJCRTest,0.25,25,3,10,0,25,6,0,9,396,1
"org.apache.jackrabbit.jcr.RemoveItemTest",11,0.07,1.73,60,0.52,8043.15,14,3,13,22,4,142.86,42,89,2,4,122.25,1.33,0.38,0.39,0,0.00,4,1573.69,2,1,2,org.apache.jackrabbit.test.AbstractJCRTest,0.22,11,3,19,4,11,10,0,18,370,2
"org.apache.jackrabbit.jcr.RemoveMovedNodeTest",7,1.00,1.00,54,0.62,12162.91,8,1,3,19,2,163.96,9,65,1,5,113.96,0.00,0.80,0.00,0,3.00,1,1846.71,3,0,1,org.apache.jackrabbit.jcr2spi.AbstractMoveTest,0.41,12,4,7,0,12,7,0,9,399,1
"org.apache.jackrabbit.jcr.RemoveNewNodeTest",6,0.00,2.17,39,0.37,7013.19,8,2,8,21,2,138.25,23,61,0,4,117.64,0.00,0.75,0.50,0,0.00,6,1097.68,2,0,2,org.apache.jackrabbit.test.AbstractJCRTest,0.25,15,3,13,0,15,6,0,12,248,1
"org.apache.jackrabbit.jcr.RemoveNodeTest",6,1.00,2.33,52,0.57,11446.79,7,1,9,25,5,93.41,30,77,3,5,111.28,0.50,0.57,0.00,0,0.00,3,1717.47,1,1,2,org.apache.jackrabbit.jcr2spi.RemoveItemTest,0.12,19,4,14,2,19,5,0,16,359,1
"org.apache.jackrabbit.jcr.RemovePropertyTest",5,1.00,2.60,40,0.42,9460.75,6,1,13,18,3,93.41,27,61,1,5,111.29,0.00,0.80,0.00,0,0.00,3,1263.23,0,1,2,org.apache.jackrabbit.jcr2spi.RemoveItemTest,0.12,13,4,13,0,13,4,0,13,271,1
"org.apache.jackrabbit.jcr.RemoveReferenceableNodeTest",3,0.00,2.33,23,0.25,5623.81,5,2,7,13,3,95.63,16,34,1,6,113.51,0.00,0.83,0.50,0,0.00,3,741.02,1,1,2,org.apache.jackrabbit.jcr2spi.RemoveNodeTest,0.13,10,5,7,0,10,2,0,8,159,1
"org.apache.jackrabbit.jcr.RemoveSNSTest",6,0.20,2.00,43,0.48,8823.72,9,3,7,19,3,96.50,32,62,1,6,114.37,0.00,0.83,0.50,0,0.00,3,1432.23,1,1,2,org.apache.jackrabbit.jcr2spi.RemoveNodeTest,0.24,13,5,12,0,13,5,0,14,300,1
"org.apache.jackrabbit.jcr.RenameTest",4,0.22,1.00,20,0.20,2913.20,7,3,3,10,2,122.39,3,27,1,5,122.39,0.00,0.80,0.50,0,0.00,1,603.67,2,0,1,org.apache.jackrabbit.jcr2spi.AbstractMoveTest,0.29,6,4,4,0,6,4,0,1,144,1
"org.apache.jackrabbit.jcr.ReorderMixedTest",1,1.00,1.00,8,0.12,2260.51,2,1,8,4,2,131.51,3,11,1,5,110.90,0.00,0.80,0.00,0,0.00,1,346.27,0,0,1,org.apache.jackrabbit.jcr2spi.ReorderTest,0.13,3,4,1,0,3,1,0,1,76,1
"org.apache.jackrabbit.jcr.ReorderMoveTest",13,0.25,1.38,120,2.03,65473.82,17,4,10,37,5,126.79,51,142,1,4,106.18,0.00,0.75,0.48,3,0.00,2,6100.64,2,2,4,org.apache.jackrabbit.test.AbstractJCRTest,0.21,24,3,18,0,24,11,0,23,1190,1
"org.apache.jackrabbit.jcr.ReorderNewAndSavedTest",3,1.00,1.00,18,0.26,5411.88,4,1,9,8,2,166.33,3,25,1,5,116.33,0.00,0.80,0.00,0,0.00,1,794.97,2,0,1,org.apache.jackrabbit.jcr2spi.ReorderTest,0.37,5,4,3,0,5,3,0,1,172,1
"org.apache.jackrabbit.jcr.ReorderNewSNSTest",3,1.00,1.67,21,0.30,6381.58,4,1,10,10,2,163.15,5,30,1,5,113.15,0.00,0.80,0.00,0,0.00,2,904.44,2,0,1,org.apache.jackrabbit.jcr2spi.ReorderTest,0.37,7,4,5,0,7,3,0,3,187,1
"org.apache.jackrabbit.jcr.ReorderNewTest",3,1.00,1.67,21,0.30,6117.74,4,1,10,10,2,163.30,5,30,1,5,113.30,0.00,0.80,0.00,0,0.00,2,897.66,2,0,1,org.apache.jackrabbit.jcr2spi.ReorderTest,0.37,7,4,5,0,7,3,0,3,185,1
"org.apache.jackrabbit.jcr.ReorderReferenceableSNSTest",1,1.00,3.00,17,0.21,10405.06,2,1,5,7,3,113.83,3,19,1,5,93.21,0.00,0.80,0.00,0,0.00,3,640.25,0,0,2,org.apache.jackrabbit.jcr2spi.ReorderTest,0.13,6,4,3,0,6,1,0,1,126,1
"org.apache.jackrabbit.jcr.ReorderSNSTest",3,1.00,1.00,27,0.38,8411.30,4,1,9,13,2,158.25,3,32,1,5,108.25,0.00,0.80,0.00,0,0.00,1,1130.66,1,0,1,org.apache.jackrabbit.jcr2spi.ReorderTest,0.12,10,4,3,0,10,3,0,1,245,1
"org.apache.jackrabbit.jcr.ReorderTest",12,0.44,1.50,83,1.08,28992.63,17,5,14,32,9,115.24,3,106,7,4,115.24,2.00,0.30,0.60,3,0.00,4,3253.26,3,1,2,org.apache.jackrabbit.test.AbstractJCRTest,0.21,20,3,18,6,20,11,0,1,697,1
"org.apache.jackrabbit.jcr.ReplaceNodeTest",4,0.33,2.25,33,0.42,9920.60,7,3,7,18,3,110.63,17,47,1,4,110.40,0.00,0.75,0.58,0,0.00,4,1257.52,2,0,2,org.apache.jackrabbit.test.AbstractJCRTest,0.27,14,3,9,0,14,4,0,15,258,1
"org.apache.jackrabbit.jcr.RepositoryImpl",9,0.03,2.22,67,0.94,34285.25,13,4,33,41,21,78.87,61,82,9,2,111.09,0.00,0.50,0.22,2,30.00,4,2826.71,0,7,12,org.apache.jackrabbit.commons.AbstractRepository,0.00,32,1,20,0,32,2,1,16,559,1
"org.apache.jackrabbit.jcr.RepositoryImpl$Factory",1,0.00,11.00,37,0.69,55244.40,3,2,33,16,2,124.61,1,46,0,1,74.61,0.00,0.00,1.00,0,0.00,11,2061.12,0,1,2,java.lang.Object,0.00,15,0,11,0,15,0,1,1,341,2
"org.apache.jackrabbit.jcr.RepositoryImpl$NamespaceResolver",2,0.00,1.00,5,0.03,370.77,2,0,33,2,0,141.91,0,7,0,1,141.91,0.00,0.00,0.00,0,2.00,1,87.73,0,2,0,java.lang.Object,0.00,0,0,2,0,0,0,0,0,28,0
"org.apache.jackrabbit.jcr.RevertMoveTest",3,1.00,1.33,21,0.27,4738.52,4,1,4,15,2,96.35,17,28,1,5,114.22,0.00,0.80,0.00,0,1.00,2,806.72,1,0,1,org.apache.jackrabbit.jcr2spi.AbstractMoveTest,0.15,12,4,4,0,12,3,0,4,171,1
"org.apache.jackrabbit.jcr.SNSIndexTest",11,0.15,1.64,93,1.08,33039.78,19,8,9,26,3,149.70,31,118,1,4,109.81,0.00,0.75,0.26,2,31.00,3,3253.06,3,1,2,org.apache.jackrabbit.test.AbstractJCRTest,0.22,15,3,18,0,15,10,0,12,676,1
"org.apache.jackrabbit.jcr.SessionImpl",75,0.01,1.56,351,3.96,105829.73,88,13,82,187,62,123.87,308,491,15,2,123.64,1.00,0.33,0.07,18,3001.00,5,11867.53,3,45,53,org.apache.jackrabbit.commons.AbstractSession,0.02,112,1,117,1,112,30,2,112,2521,1
"org.apache.jackrabbit.jcr.SessionImpl$IdResolver",2,0.00,2.00,10,0.14,3241.88,2,0,82,8,4,140.11,7,17,0,1,119.49,0.00,0.00,0.00,0,2.00,2,412.78,0,1,4,java.lang.Object,0.00,6,0,4,0,6,1,1,3,90,2
"org.apache.jackrabbit.jcr.SessionListener",2,0.00,1.00,3,0.01,46.02,2,0,1,2,3,110.28,19,4,3,1,160.28,0.00,0.00,0.00,0,2.00,1,41.02,0,0,0,,0.00,0,0,2,0,0,2,0,3,17,1
"org.apache.jackrabbit.jcr.SingleValuedPropertyTest",1,1.00,3.00,9,0.10,2154.06,2,1,8,6,4,66.61,7,14,1,4,108.90,0.00,0.75,0.00,0,0.00,3,298.61,0,0,3,org.apache.jackrabbit.test.AbstractJCRTest,0.00,5,3,3,0,5,1,0,3,65,1
"org.apache.jackrabbit.jcr.TestAll",1,0.00,1.00,51,0.79,33331.01,1,0,4,3,48,71.22,16,53,1,2,71.69,0.00,0.50,0.00,0,1.00,1,2355.51,0,1,47,junit.framework.TestCase,0.00,2,1,1,0,2,0,0,14,399,1
"org.apache.jackrabbit.jcr.TestConnect",1,0.00,2.00,8,0.09,1553.91,1,0,3,5,1,132.64,3,8,0,4,112.02,0.00,0.75,0.00,0,0.00,2,261.63,0,0,1,org.apache.jackrabbit.test.AbstractJCRTest,0.00,4,3,2,0,4,1,0,1,59,1
"org.apache.jackrabbit.jcr.UpdateTest",11,0.35,3.00,108,1.40,43378.19,13,2,14,39,3,146.72,22,155,1,4,106.84,0.00,0.75,0.18,1,0.00,6,4198.73,2,1,2,org.apache.jackrabbit.test.AbstractJCRTest,0.11,28,3,33,0,28,10,0,18,813,1
"org.apache.jackrabbit.jcr.WorkspaceImpl",45,0.03,1.22,185,2.18,44239.45,55,10,61,100,44,145.54,173,260,4,1,124.93,0.00,0.00,0.13,7,0.00,3,6541.28,0,33,41,java.lang.Object,0.00,55,0,55,0,55,12,2,70,1391,1
"org.apache.jackrabbit.jcr.WorkspaceManager",47,0.05,1.66,244,2.78,74029.00,65,18,97,129,81,101.76,255,348,9,1,119.63,0.00,0.00,0.11,5,94.00,13,8327.72,0,27,73,java.lang.Object,0.00,82,0,78,0,82,20,3,67,1726,1
"org.apache.jackrabbit.jcr.WorkspaceManager$ChangePolling",2,1.00,5.00,29,0.39,21290.39,3,1,97,4,3,63.94,12,45,0,1,96.16,0.00,0.00,0.50,0,2.00,9,1184.57,0,0,3,java.lang.Object,0.00,2,0,10,0,2,2,1,6,210,2
"org.apache.jackrabbit.jcr.WorkspaceManager$NodeTypeStorage",4,0.00,1.00,9,0.11,1521.95,4,0,97,4,2,139.45,0,13,0,1,139.45,0.00,0.00,0.00,0,0.00,1,321.41,0,2,2,java.lang.Object,0.00,0,0,4,0,0,2,0,0,81,0
"org.apache.jackrabbit.jcr.WorkspaceManager$OperationVisitorImpl",30,0.00,1.47,144,2.06,45498.59,32,2,97,125,40,144.02,95,191,0,1,123.41,0.00,0.00,0.50,0,0.00,7,6174.12,0,0,40,java.lang.Object,0.00,95,0,44,0,95,30,1,35,1309,2
"org.apache.jackrabbit.jcr.WorkspaceMoveTest",4,0.00,2.50,29,0.37,11132.30,4,0,5,13,3,79.92,25,47,1,6,112.14,0.00,0.83,0.00,0,4.00,4,1111.25,3,0,2,org.apache.jackrabbit.jcr2spi.MoveTest,0.37,9,5,10,0,9,4,0,15,219,1
"org.apache.jackrabbit.jcr.XASession",1,0.00,1.00,2,0.01,44.19,1,0,2,1,1,173.10,19,3,1,2,146.81,0.00,0.50,0.00,0,1.00,1,26.09,0,1,0,,0.00,0,1,1,0,0,0,0,2,11,1
"org.apache.jackrabbit.jcr.XASessionImpl",2,1.00,1.00,7,0.06,760.70,3,1,5,3,5,82.89,19,11,2,3,132.88,0.00,0.67,0.50,0,2.00,1,178.68,0,1,4,org.apache.jackrabbit.jcr2spi.SessionImpl,0.00,1,2,2,0,1,1,1,5,48,1
"org.apache.jackrabbit.spi.commons.value.AbstractQValue",26,0.03,2.42,153,1.69,56732.58,29,3,16,52,11,100.56,142,215,7,1,118.43,0.00,0.00,0.36,2,0.00,6,5058.05,0,8,4,java.lang.Object,0.00,26,0,63,4,26,18,2,30,1069,2
"org.apache.jackrabbit.spi.commons.value.AbstractQValue$Binary",4,0.00,1.50,17,0.15,6097.06,4,0,16,9,1,123.38,0,25,0,1,123.38,0.00,0.00,0.00,1,4.00,3,457.99,0,1,1,java.lang.Object,0.00,5,0,6,0,5,3,0,0,104,0
"org.apache.jackrabbit.spi.commons.value.AbstractQValueFactory",12,0.27,2.08,71,0.98,38684.31,15,3,19,33,15,117.37,54,111,4,1,117.13,0.00,0.00,0.08,1,22.00,6,2954.04,0,12,12,java.lang.Object,0.00,21,0,25,3,21,0,1,19,587,2
"org.apache.jackrabbit.spi.commons.value.DefaultQValue",10,3.00,1.10,26,0.22,4585.28,13,3,11,14,6,138.79,9,41,1,2,138.79,0.00,0.50,0.00,0,10.00,2,671.03,1,1,6,org.apache.jackrabbit.spi.commons.value.AbstractQValue,0.00,4,1,11,0,4,9,1,4,177,1
"org.apache.jackrabbit.spi.commons.value.QValueFactoryImpl",5,1.00,1.60,18,0.16,2934.36,6,1,19,8,24,151.91,19,26,18,2,131.29,1.00,0.33,0.20,0,8.00,2,484.78,0,4,6,org.apache.jackrabbit.spi.commons.value.AbstractQValueFactory,0.00,3,1,8,1,3,1,0,6,119,1
"org.apache.jackrabbit.spi.commons.value.QValueFactoryImpl$BinaryQValue",14,0.11,2.64,125,1.39,60791.21,19,5,19,45,4,58.44,135,172,0,2,108.44,0.00,0.50,0.30,0,0.00,5,4177.69,0,4,4,org.apache.jackrabbit.spi.commons.value.AbstractQValue,0.30,31,1,37,0,31,10,1,48,833,2
"org.apache.jackrabbit.spi.commons.value.QValueFactoryImpl$BinaryQValue$Serializable",0,0.00,0.00,2,0.02,186.42,1,1,19,0,0,171.00,0,2,0,1,171.00,0.00,0.00,0.00,0,0.00,0,46.60,0,0,0,java.lang.Object,0.00,0,0,0,0,0,0,0,0,13,0
"org.apache.jackrabbit.spi.commons.value.QValueTest",60,0.05,1.45,328,4.37,96025.23,65,5,29,126,8,169.61,65,444,0,2,119.61,0.00,0.50,0.25,2,0.00,4,13124.48,0,0,8,junit.framework.TestCase,0.00,66,1,87,0,66,60,0,43,2790,1
"org.apache.jackrabbit.spi.commons.value.QValueValue",13,0.03,1.69,57,0.67,18254.88,16,3,13,34,8,123.87,61,90,6,1,123.64,0.00,0.00,0.36,2,0.00,4,2019.97,0,6,2,java.lang.Object,0.00,21,0,22,0,21,7,1,25,450,2
"org.apache.jackrabbit.spi.commons.value.QValueValue$Binary",4,0.00,1.25,14,0.13,3591.83,4,0,13,7,0,129.89,0,19,0,1,129.89,0.00,0.00,0.00,0,4.00,2,377.81,0,1,0,java.lang.Object,0.00,3,0,5,0,3,3,0,0,90,0
"org.apache.jackrabbit.spi.commons.value.ValueFactoryQImpl",15,0.21,2.27,79,0.93,26217.03,17,2,20,25,22,139.82,54,122,13,1,119.20,0.00,0.00,0.70,1,0.00,8,2801.48,0,14,9,java.lang.Object,0.00,10,0,34,1,10,1,1,15,600,1
"org.apache.jackrabbit.spi.commons.value.ValueFormat",5,0.00,6.60,87,1.54,82193.05,5,0,12,37,41,41.47,48,149,34,1,91.47,0.00,0.00,0.00,1,5.00,11,4609.51,0,5,7,java.lang.Object,0.00,32,0,33,0,32,0,0,8,815,1
"org.apache.jackrabbit.spi.commons.value.ValueFormatTest",6,0.65,1.33,59,1.03,30586.55,10,4,26,32,18,156.14,10,67,0,2,106.14,0.00,0.50,0.79,0,0.00,2,3097.47,1,0,18,junit.framework.TestCase,0.00,26,1,8,0,26,6,0,4,588,1
"org.apache.jackrabbit.spi.commons.value.ValueFormatTest$IdentifierResolver",2,0.00,1.00,4,0.03,250.38,2,0,26,3,2,143.25,1,6,0,1,143.25,0.00,0.00,0.00,0,2.00,1,88.34,0,1,2,java.lang.Object,0.00,1,0,2,0,1,1,0,1,27,0
"org.apache.jackrabbit.webdav.jcr.search.SearchResourceImpl",12,0.21,2.92,139,2.22,118679.40,15,3,37,97,15,82.57,60,178,1,1,100.45,0.00,0.00,0.14,5,44.00,12,6663.02,0,6,14,java.lang.Object,0.00,85,0,35,0,85,6,1,19,1137,1
"org.apache.jackrabbit.webdav.jcr.search.SearchResourceImpl$PathValue",2,0.00,2.00,10,0.11,3245.75,2,0,37,4,0,119.49,0,16,0,2,119.49,0.00,0.50,0.00,0,2.00,3,329.33,0,1,0,org.apache.jackrabbit.webdav.jcr.search.SelectorValue,0.00,2,1,4,0,2,1,0,0,76,3
"org.apache.jackrabbit.webdav.jcr.search.SearchResourceImpl$PlainValue",2,0.00,1.00,5,0.05,522.26,2,0,37,3,0,140.74,0,10,0,2,140.74,0.00,0.50,0.00,0,2.00,1,138.56,0,1,0,org.apache.jackrabbit.webdav.jcr.search.SelectorValue,0.00,1,1,2,0,1,1,0,0,40,3
"org.apache.jackrabbit.webdav.jcr.search.SearchResourceImpl$RowValue",3,0.00,1.00,4,0.03,147.66,3,0,37,3,0,157.67,0,5,0,1,157.67,0.00,0.00,0.00,0,3.00,1,75.83,0,3,0,,0.00,0,0,3,0,0,0,0,0,27,1
"org.apache.jackrabbit.webdav.jcr.search.SearchResourceImpl$ScoreValue",2,0.00,1.50,10,0.09,1900.45,2,0,37,4,0,121.38,0,16,0,2,121.38,0.00,0.50,0.00,0,2.00,2,269.34,0,1,0,org.apache.jackrabbit.webdav.jcr.search.SelectorValue,0.00,2,1,3,0,2,1,0,0,66,3
"org.apache.jackrabbit.webdav.jcr.search.SearchResourceImpl$SelectorValue",3,0.17,1.00,12,0.09,1444.66,6,3,37,3,0,127.42,0,18,0,1,127.42,0.00,0.00,0.22,0,5.00,1,274.05,0,2,0,java.lang.Object,0.00,0,0,3,0,0,1,1,0,74,3
"org.apache.jackrabbit.webdav.jcr.search.SearchResultProperty",8,0.19,2.62,75,1.23,61426.35,14,6,17,39,8,56.11,84,100,2,2,104.59,0.00,0.50,0.33,1,8.00,8,3692.96,1,5,6,org.apache.jackrabbit.webdav.property.AbstractDavProperty,0.00,31,1,21,0,31,3,1,9,670,1
"org.apache.jackrabbit.servlet.login.AbstractLoginFilter",4,0.33,3.00,37,0.51,19505.35,8,4,18,19,4,156.11,4,59,3,1,106.11,0.00,0.00,0.50,1,4.00,7,1525.21,0,1,1,java.lang.Object,0.00,15,0,12,3,15,3,1,1,291,2
"org.apache.jackrabbit.servlet.login.BasicLoginFilter",1,0.00,2.00,7,0.06,1258.41,1,0,3,4,1,115.14,4,10,0,2,114.91,0.00,0.50,0.00,0,1.00,2,182.88,0,1,1,org.apache.jackrabbit.servlet.login.AbstractLoginFilter,0.00,3,1,2,0,3,0,0,1,43,1
"org.apache.jackrabbit.servlet.login.ContainerLoginFilter",2,1.00,2.00,13,0.12,2425.07,3,1,4,6,1,67.53,18,18,0,2,117.53,0.00,0.50,0.50,0,2.00,2,369.58,1,1,1,org.apache.jackrabbit.servlet.login.AbstractLoginFilter,0.00,4,1,4,0,4,1,0,2,87,1
"org.apache.jackrabbit.servlet.login.NullLoginFilter",1,0.00,1.00,3,0.02,114.07,1,0,2,1,1,126.65,15,5,0,2,137.00,0.00,0.50,0.00,0,1.00,1,48.73,0,1,1,org.apache.jackrabbit.servlet.login.AbstractLoginFilter,0.00,0,1,1,0,0,0,0,2,16,1
"org.apache.jackrabbit.spi.commons.batch.AbstractChangeLog",6,0.80,2.67,36,0.37,11035.61,7,1,5,16,6,136.65,18,47,3,2,116.04,3.00,0.20,0.33,1,10.00,6,1101.18,0,2,3,Operation>,0.00,10,1,16,3,10,4,1,4,245,2
"org.apache.jackrabbit.spi.commons.batch.ChangeLog",1,0.00,1.00,2,0.01,98.52,1,0,2,1,3,114.69,13,3,2,2,144.07,0.00,0.50,0.00,0,1.00,1,42.51,0,1,1,,0.00,0,1,1,0,0,0,0,2,15,1
"org.apache.jackrabbit.spi.commons.batch.ChangeLogImpl",10,0.00,1.00,21,0.30,3950.75,10,0,7,18,10,139.32,6,35,1,3,139.32,0.50,0.50,0.00,0,10.00,1,900.08,1,0,9,org.apache.jackrabbit.spi.commons.batch.AbstractChangeLog,0.00,8,2,10,1,8,10,0,1,227,1
"org.apache.jackrabbit.spi.commons.batch.ConsolidatedBatchTest",9,0.02,1.67,44,2.37,417154.37,14,5,17,38,15,132.30,32,342,0,2,111.68,0.00,0.50,0.18,3,46.00,4,7107.91,0,7,15,junit.framework.TestCase,0.00,29,1,15,0,29,2,0,32,1379,1
"org.apache.jackrabbit.spi.commons.batch.ConsolidatedBatchTest$TestChangeLog",7,0.00,1.00,27,0.35,5332.87,7,0,17,14,4,130.51,0,36,0,4,130.51,0.00,0.75,0.00,1,7.00,1,1052.62,6,7,4,org.apache.jackrabbit.spi.commons.batch.ChangeLogImpl,0.00,7,3,7,0,7,0,0,0,239,1
"org.apache.jackrabbit.spi.commons.batch.ConsolidatingChangeLog",14,1.00,1.21,53,0.66,17636.67,15,1,12,31,17,149.36,50,75,7,3,128.74,0.00,0.67,0.07,1,26.00,2,1979.45,1,2,10,org.apache.jackrabbit.spi.commons.batch.AbstractChangeLog,0.00,17,2,17,0,17,12,0,10,447,1
"org.apache.jackrabbit.spi.commons.batch.ConsolidatingChangeLog$CancelableOperation",1,4.00,1.00,6,0.07,1096.68,5,4,12,1,0,151.42,20,7,0,2,118.03,0.00,0.50,0.00,0,1.00,1,210.05,0,0,0,,0.00,0,1,1,0,0,1,0,5,51,1
"org.apache.jackrabbit.spi.commons.batch.ConsolidatingChangeLog$CancelableOperations",12,0.00,1.00,34,0.42,10271.59,12,0,12,21,5,92.55,141,48,0,1,136.68,0.00,0.00,0.00,0,12.00,1,1250.25,0,11,5,java.lang.Object,0.00,9,0,12,0,9,1,0,29,311,3
"org.apache.jackrabbit.spi.commons.batch.ConsolidatingChangeLog$CancelableOperations$AddNode",2,0.00,2.50,11,0.14,3440.00,2,0,12,5,4,76.95,14,18,0,2,119.24,0.00,0.50,0.00,0,2.00,4,428.87,0,0,4,Operations.AddNode,0.00,3,1,5,0,3,2,1,1,95,2
"org.apache.jackrabbit.spi.commons.batch.ConsolidatingChangeLog$CancelableOperations$AddProperty",3,0.00,4.00,28,0.38,26335.39,3,0,12,7,5,71.81,20,39,0,2,104.03,0.00,0.50,0.00,0,3.00,10,1128.15,0,0,5,Operations.AddProperty,0.00,4,1,12,0,4,3,1,1,217,2
"org.apache.jackrabbit.spi.commons.batch.ConsolidatingChangeLog$CancelableOperations$Empty",1,0.00,1.00,3,0.03,299.58,1,0,12,1,0,154.32,3,5,0,2,133.70,0.00,0.50,0.00,0,1.00,1,79.56,0,0,0,Operations.Empty,0.00,0,1,1,0,0,1,1,1,23,2
"org.apache.jackrabbit.spi.commons.batch.ConsolidatingChangeLog$CancelableOperations$Move",2,0.00,1.00,5,0.04,427.53,2,0,12,2,2,191.42,3,8,0,2,141.42,0.00,0.50,0.00,0,2.00,1,125.11,0,0,2,Operations.Move,0.00,0,1,2,0,0,2,1,1,37,2
"org.apache.jackrabbit.spi.commons.batch.ConsolidatingChangeLog$CancelableOperations$Remove",2,0.00,1.00,5,0.03,328.57,2,0,12,2,1,192.32,3,8,0,2,142.32,0.00,0.50,0.00,0,2.00,1,99.76,0,0,1,Operations.Remove,0.00,0,1,2,0,0,2,1,1,31,2
"org.apache.jackrabbit.spi.commons.batch.ConsolidatingChangeLog$CancelableOperations$ReorderNodes",3,0.00,2.33,16,0.25,11077.58,3,0,12,8,3,116.88,13,26,0,2,116.64,0.00,0.50,0.00,0,3.00,5,762.74,0,0,3,Operations.ReorderNodes,0.00,5,1,7,0,5,3,1,1,162,2
"org.apache.jackrabbit.spi.commons.batch.ConsolidatingChangeLog$CancelableOperations$SetMixins",2,0.00,4.50,22,0.29,22747.13,2,0,12,6,4,67.65,12,30,0,2,99.87,0.00,0.50,0.00,0,2.00,8,883.04,0,0,4,Operations.SetMixins,0.00,4,1,9,0,4,2,1,1,173,2
"org.apache.jackrabbit.spi.commons.batch.ConsolidatingChangeLog$CancelableOperations$SetPrimaryType",2,0.00,3.50,16,0.21,10017.33,2,0,12,6,4,75.67,12,25,0,2,107.89,0.00,0.50,0.00,0,2.00,6,644.70,0,0,4,Operations.SetPrimaryType,0.00,4,1,7,0,4,2,1,1,136,2
"org.apache.jackrabbit.spi.commons.batch.ConsolidatingChangeLog$CancelableOperations$SetValue",3,0.00,2.33,16,0.20,8512.01,3,0,12,6,4,117.78,12,25,0,2,117.54,0.00,0.50,0.00,0,3.00,5,613.67,0,0,4,Operations.SetValue,0.00,3,1,7,0,3,3,1,1,136,2
"org.apache.jackrabbit.spi.commons.batch.ConsolidatingChangeLog$OperationsBackwardWithSentinel",3,0.67,1.67,19,0.17,3389.49,6,3,12,10,0,117.81,0,27,0,1,117.81,0.00,0.00,0.78,0,0.00,2,505.40,0,0,0,java.lang.Object,0.00,7,0,5,0,7,3,1,0,118,1
"org.apache.jackrabbit.spi.commons.batch.Operation",1,0.00,1.00,2,0.01,69.06,1,0,2,1,13,97.18,8,3,12,1,145.29,0.00,0.00,0.00,0,1.00,1,36.53,0,0,1,,0.00,0,0,1,0,0,1,0,2,13,1
"org.apache.jackrabbit.spi.commons.batch.Operations",14,0.00,1.14,38,0.42,7102.63,14,0,8,24,16,89.96,143,57,9,1,138.44,0.00,0.00,0.00,0,14.00,2,1258.19,0,11,7,java.lang.Object,0.00,10,0,16,0,10,3,0,31,321,2
"org.apache.jackrabbit.spi.commons.batch.Operations$AddNode",6,0.50,1.50,27,0.34,7323.90,10,4,8,9,5,164.03,12,49,0,1,124.14,0.00,0.00,0.67,1,0.00,4,1011.46,0,1,5,java.lang.Object,0.00,3,0,9,0,3,5,1,2,247,2
"org.apache.jackrabbit.spi.commons.batch.Operations$AddProperty",8,0.21,1.50,35,0.40,8054.71,12,4,8,12,6,164.69,19,58,0,1,124.80,0.00,0.00,0.44,1,8.00,4,1188.87,0,1,6,java.lang.Object,0.00,4,0,12,0,4,7,1,3,287,2
"org.apache.jackrabbit.spi.commons.batch.Operations$Empty",5,1.00,1.20,13,0.10,1809.64,6,1,8,7,2,189.58,5,22,0,1,139.58,0.00,0.00,0.00,0,5.00,2,307.16,0,1,2,java.lang.Object,0.00,2,0,6,0,2,4,1,2,85,2
"org.apache.jackrabbit.spi.commons.batch.Operations$Move",6,0.40,1.50,25,0.28,5752.05,9,3,8,9,5,174.97,11,44,0,1,124.97,0.00,0.00,0.67,1,0.00,4,840.83,0,1,5,java.lang.Object,0.00,3,0,9,0,3,5,1,2,210,2
"org.apache.jackrabbit.spi.commons.batch.Operations$Remove",6,0.40,1.50,21,0.17,2954.73,7,1,8,9,4,181.91,9,34,0,1,131.91,0.00,0.00,0.67,1,0.00,4,522.09,0,1,4,java.lang.Object,0.00,3,0,9,0,3,5,1,2,136,2
"org.apache.jackrabbit.spi.commons.batch.Operations$ReorderNodes",6,0.40,1.50,25,0.28,5896.54,9,3,8,9,4,174.88,11,44,0,1,124.88,0.00,0.00,0.67,1,0.00,4,835.03,0,1,4,java.lang.Object,0.00,3,0,9,0,3,5,1,2,210,2
"org.apache.jackrabbit.spi.commons.batch.Operations$SetMixins",6,0.20,1.50,23,0.23,4336.18,8,2,8,10,5,180.60,10,39,0,1,130.60,0.00,0.00,0.67,1,0.00,4,697.15,0,1,5,java.lang.Object,0.00,4,0,9,0,4,5,1,2,175,2
"org.apache.jackrabbit.spi.commons.batch.Operations$SetPrimaryType",6,0.20,1.50,23,0.23,4159.89,8,2,8,10,5,180.74,10,39,0,1,130.74,0.00,0.00,0.67,1,0.00,4,678.69,0,1,5,java.lang.Object,0.00,4,0,9,0,4,5,1,2,172,2
"org.apache.jackrabbit.spi.commons.batch.Operations$SetValue",8,0.10,1.50,33,0.33,6268.43,11,3,8,12,5,165.54,17,53,0,1,125.66,0.00,0.00,0.42,1,8.00,4,982.28,0,1,5,java.lang.Object,0.00,4,0,12,0,4,7,1,3,243,2
"org.apache.jackrabbit.rmi.ConformanceTest",1,0.00,2.00,6,0.05,1152.15,1,0,3,5,1,138.32,3,9,0,2,117.71,0.00,0.50,0.00,0,1.00,2,146.31,0,1,1,junit.framework.TestCase,0.00,4,1,2,0,4,0,0,1,38,1
"org.apache.jackrabbit.rmi.RepositoryStubImpl",4,0.11,2.00,33,0.41,14640.02,7,3,20,24,8,159.09,4,52,0,3,109.09,0.00,0.67,0.42,0,0.00,3,1242.47,1,3,8,org.apache.jackrabbit.core.JackrabbitRepositoryStub,0.14,20,2,8,0,20,1,0,2,242,1
"org.apache.jackrabbit.webdav.version.report.CompareBaselineReport",6,0.09,3.33,75,1.19,57087.18,15,9,18,41,15,66.92,38,94,0,1,99.14,0.00,0.00,0.19,2,14.00,6,3582.28,0,3,15,java.lang.Object,0.00,35,0,20,0,35,3,1,19,649,1
"org.apache.jackrabbit.webdav.version.report.ExpandPropertyReport",9,0.16,2.22,57,0.77,30712.26,13,4,22,32,18,69.84,103,76,1,1,113.97,0.00,0.00,0.11,5,29.00,7,2301.52,0,4,18,java.lang.Object,0.00,23,0,20,0,23,5,2,16,453,1
"org.apache.jackrabbit.webdav.version.report.ExpandPropertyReport$ExpandProperty",2,0.00,2.00,13,0.17,3864.21,3,1,22,10,7,83.72,12,18,0,2,115.94,0.00,0.50,1.00,0,0.00,3,510.23,0,1,7,org.apache.jackrabbit.webdav.property.AbstractDavProperty,0.00,8,1,4,0,8,1,0,3,109,1
"org.apache.jackrabbit.webdav.version.report.LatestActivityVersionReport",5,0.04,2.60,45,0.65,22434.83,11,6,16,29,14,58.32,43,59,0,1,106.43,0.00,0.00,0.20,1,13.00,6,1952.79,0,3,14,java.lang.Object,0.00,24,0,13,0,24,2,1,15,374,1
"org.apache.jackrabbit.webdav.version.report.LocateByHistoryReport",7,0.08,2.57,47,0.66,22570.39,11,4,18,30,15,66.02,60,68,1,1,114.13,0.00,0.00,0.18,3,18.00,7,1987.79,0,3,15,java.lang.Object,0.00,23,0,18,0,23,4,2,10,389,1
"org.apache.jackrabbit.webdav.version.report.Report",3,0.00,1.00,4,0.03,141.96,3,0,4,3,28,109.33,31,5,24,2,157.81,0.00,0.50,0.00,0,3.00,1,76.78,0,1,6,,0.00,0,1,3,0,0,2,0,4,27,1
"org.apache.jackrabbit.webdav.version.report.ReportInfo",12,0.02,2.25,77,0.90,27873.47,18,6,15,42,39,72.99,87,101,31,1,115.28,0.00,0.00,0.18,1,46.00,5,2704.08,0,5,9,java.lang.Object,0.00,30,0,27,0,30,7,1,13,559,1
"org.apache.jackrabbit.webdav.version.report.ReportType",9,0.01,2.33,58,0.85,37813.29,18,9,12,25,33,70.95,64,80,26,1,113.24,0.00,0.00,0.10,1,46.00,7,2560.82,0,6,12,java.lang.Object,0.00,16,0,21,0,16,3,2,12,505,1
"org.apache.jackrabbit.webdav.version.report.SupportedReportSetProperty",6,0.40,1.67,28,0.29,6830.75,8,2,9,14,9,82.07,44,37,4,2,124.36,0.00,0.50,0.17,1,10.00,3,873.32,1,2,5,org.apache.jackrabbit.webdav.property.AbstractDavProperty,0.00,8,1,10,0,8,4,0,7,200,1
"org.apache.jackrabbit.webdav.version.report.VersionTreeReport",9,0.25,2.11,48,0.57,19379.07,12,3,13,27,12,70.40,75,68,1,1,118.51,0.00,0.00,0.11,4,23.00,6,1714.28,0,4,12,java.lang.Object,0.00,18,0,19,0,18,5,2,10,367,1
"org.apache.jackrabbit.standalone.cli.ext.ConnectToJNDIServer",3,0.25,1.33,17,0.21,4548.86,5,2,9,12,3,101.94,16,22,0,1,119.81,0.00,0.00,0.33,0,5.00,2,627.64,0,1,3,java.lang.Object,0.00,9,0,4,0,9,2,1,7,132,1
"org.apache.jackrabbit.standalone.cli.ext.ConnectToRmiServer",3,0.25,1.33,15,0.17,3535.76,5,2,7,10,2,102.80,16,20,0,1,120.67,0.00,0.00,0.33,0,5.00,2,519.44,0,1,2,java.lang.Object,0.00,7,0,4,0,7,2,1,7,114,1
"org.apache.jackrabbit.standalone.cli.ext.CreateWorkspace",3,0.00,1.67,18,0.23,5531.01,6,3,8,13,2,83.92,18,25,0,1,116.14,0.00,0.00,0.33,0,5.00,3,681.02,0,1,2,java.lang.Object,0.00,10,0,5,0,10,2,1,8,141,1
"org.apache.jackrabbit.standalone.cli.ext.StartJackrabbit",5,0.17,1.20,21,0.25,5113.67,8,3,8,12,3,125.03,23,30,0,1,124.80,0.00,0.00,0.20,0,14.00,2,735.30,0,2,3,java.lang.Object,0.00,7,0,6,0,7,3,1,9,162,1
"org.apache.jackrabbit.standalone.cli.ext.StartJackrabbitSingleton",5,0.06,1.60,32,0.40,14500.37,9,4,10,17,3,96.73,29,46,0,1,114.60,0.00,0.00,0.20,0,14.00,4,1201.46,0,2,3,java.lang.Object,0.00,12,0,8,0,12,3,1,10,236,1
"org.apache.jackrabbit.standalone.cli.ext.StopJackrabbit",1,0.00,4.00,13,0.15,4740.14,2,1,6,8,2,57.89,7,19,0,1,100.18,0.00,0.00,1.00,0,0.00,4,461.56,0,0,2,java.lang.Object,0.00,7,0,4,0,7,1,1,3,95,1
"org.apache.jackrabbit.core.id.ItemId",1,0.00,1.00,2,0.01,44.19,1,0,1,1,81,146.34,16,3,81,2,146.81,0.00,0.50,0.00,0,1.00,1,26.09,0,0,0,,0.00,0,1,1,0,0,1,0,2,11,1
"org.apache.jackrabbit.core.id.NodeId",15,0.03,1.80,72,1.31,67875.63,20,5,2,25,239,77.33,114,125,237,1,119.62,0.00,0.00,0.17,0,39.00,8,3920.14,0,2,2,java.lang.Object,0.00,10,0,27,0,10,13,2,32,825,1
"org.apache.jackrabbit.core.id.NodeIdTest",7,1.00,2.29,63,0.71,42299.05,8,1,1,20,2,105.44,3,76,1,2,105.44,0.00,0.50,0.00,1,7.00,5,2117.33,0,0,1,junit.framework.TestCase,0.00,13,1,16,0,13,7,0,3,454,1
"org.apache.jackrabbit.core.id.PropertyId",8,0.04,1.75,42,0.43,14364.07,12,4,2,19,80,76.88,59,58,76,1,119.17,0.00,0.00,0.22,0,18.00,3,1288.02,0,3,4,java.lang.Object,0.00,11,0,14,0,11,5,1,14,285,1
"org.apache.jackrabbit.core.id.SeededSecureRandom",3,0.17,2.67,27,0.24,7846.99,6,3,2,10,2,64.14,35,34,2,2,108.27,0.00,0.50,0.44,0,2.00,5,727.59,0,1,0,java.security.SecureRandom,0.00,7,1,8,0,7,2,1,13,155,0
"org.apache.jackrabbit.core.id.TestAll",1,0.00,1.00,5,0.04,864.35,1,0,3,3,1,73.70,8,7,0,2,121.80,0.00,0.50,0.00,0,1.00,1,115.51,0,1,1,junit.framework.TestCase,0.00,2,1,1,0,2,0,0,2,31,1
"org.apache.jackrabbit.core.integration.daily.DailyIntegrationTest",1,0.00,1.00,19,0.23,8770.19,1,0,17,3,15,74.38,5,21,0,2,92.25,0.00,0.50,0.00,0,1.00,1,687.75,0,1,15,junit.framework.TestCase,0.00,2,1,1,0,2,0,0,3,143,1
"org.apache.jackrabbit.core.integration.daily.ItemStateHierarchyManagerDeadlockTest",13,0.07,2.62,139,1.73,54240.57,18,5,17,51,2,104.97,4,182,0,2,104.97,0.00,0.50,0.14,6,55.00,5,5195.41,0,2,2,junit.framework.TestCase,0.00,38,1,34,0,38,11,0,4,990,1
"org.apache.jackrabbit.core.integration.daily.ItemStateHierarchyManagerDeadlockTest$Runnable",1,0.00,4.00,12,0.07,2275.61,1,0,17,4,0,103.99,0,13,0,1,103.99,0.00,0.00,0.00,0,1.00,4,217.59,0,0,0,java.lang.Object,0.00,3,0,4,0,3,1,0,0,51,0
"org.apache.jackrabbit.core.integration.daily.RandomOperationTest",9,0.64,1.00,51,0.67,17794.87,16,7,4,14,4,119.21,39,62,1,5,118.97,0.00,0.80,0.71,0,0.00,1,2015.03,3,0,3,org.apache.jackrabbit.core.AbstractConcurrencyTest,0.12,5,4,9,0,5,9,0,9,432,1
"org.apache.jackrabbit.standalone.cli.info.AbstractLs",10,0.09,1.30,34,0.39,6773.09,15,5,7,21,4,112.98,55,49,3,1,130.85,0.00,0.00,0.12,1,46.00,3,1165.40,0,1,1,java.lang.Object,0.00,11,0,13,9,11,9,1,16,274,2
"org.apache.jackrabbit.standalone.cli.info.AbstractLsItems",2,0.33,3.00,36,0.67,40835.76,5,3,10,21,6,69.84,28,53,2,2,89.98,2.00,0.25,0.50,1,2.00,5,1999.02,3,1,4,org.apache.jackrabbit.standalone.cli.info.AbstractLs,0.00,19,1,6,2,19,1,0,15,329,2
"org.apache.jackrabbit.standalone.cli.info.AbstractLsNodes",32,0.03,2.09,215,3.15,187503.04,52,20,11,78,7,79.91,200,281,2,2,112.13,2.00,0.25,0.02,3,482.00,21,9455.39,2,15,5,org.apache.jackrabbit.standalone.cli.info.AbstractLs,0.00,46,1,67,2,46,17,0,89,1670,2
"org.apache.jackrabbit.standalone.cli.info.AbstractLsNodes$OptionHolder",16,0.06,1.06,66,0.51,7117.65,31,15,11,20,0,127.91,64,84,0,1,127.67,0.00,0.00,0.12,0,184.00,2,1526.34,0,0,0,java.lang.Object,0.00,4,0,17,0,4,16,0,30,358,1
"org.apache.jackrabbit.standalone.cli.info.AbstractLsProperties",4,0.17,2.75,56,0.93,52628.06,6,2,11,29,5,53.29,30,70,2,2,95.58,2.00,0.25,0.38,3,4.00,6,2804.88,2,3,3,org.apache.jackrabbit.standalone.cli.info.AbstractLs,0.00,25,1,11,2,25,1,0,9,476,2
"org.apache.jackrabbit.standalone.cli.info.Cat",8,0.43,1.75,42,0.55,11838.31,10,2,15,29,2,77.54,56,67,0,1,119.83,0.00,0.00,0.12,3,20.00,3,1637.51,0,2,2,java.lang.Object,0.00,21,0,14,0,21,6,1,11,341,1
"org.apache.jackrabbit.standalone.cli.info.Describe",1,0.00,1.00,3,0.02,212.34,1,0,2,2,0,102.66,6,5,0,1,134.88,0.00,0.00,0.00,0,1.00,1,67.32,0,0,0,java.lang.Object,0.00,1,0,1,0,1,1,1,2,20,1
"org.apache.jackrabbit.standalone.cli.info.Dump",4,1.00,2.25,32,0.40,15768.46,5,1,10,20,1,90.94,22,39,0,1,108.81,0.00,0.00,0.25,1,6.00,6,1194.70,0,1,1,java.lang.Object,0.00,16,0,9,0,16,3,1,6,233,1
"org.apache.jackrabbit.standalone.cli.info.Help",7,0.04,3.14,93,1.61,71120.88,11,4,16,46,9,65.41,45,126,0,1,97.63,0.00,0.00,0.21,4,19.00,9,4837.71,0,2,9,java.lang.Object,0.00,39,0,22,0,39,5,1,20,858,1
"org.apache.jackrabbit.standalone.cli.info.Info",1,0.00,5.00,29,0.35,14387.77,1,0,6,13,2,83.34,0,37,0,1,83.34,0.00,0.00,0.00,0,1.00,5,1037.05,0,0,2,java.lang.Object,0.00,12,0,5,0,12,1,1,0,187,1
"org.apache.jackrabbit.standalone.cli.info.JcrInfoCommandException",4,1.00,1.00,10,0.08,824.84,5,1,1,4,4,99.26,30,16,3,3,141.55,0.00,0.67,0.00,0,4.00,1,241.63,0,0,1,org.apache.jackrabbit.standalone.cli.CommandException,0.00,0,2,4,0,0,4,0,6,69,1
"org.apache.jackrabbit.standalone.cli.info.LsCollectedItems",3,0.50,1.33,12,0.13,3650.25,4,1,4,5,3,91.96,18,21,0,3,124.18,0.00,0.67,0.67,0,1.00,2,394.65,1,2,3,org.apache.jackrabbit.standalone.cli.info.AbstractLsItems,0.00,2,2,4,0,2,1,0,6,89,1
"org.apache.jackrabbit.standalone.cli.info.LsCollectedNodes",3,0.50,1.33,12,0.13,3650.25,4,1,4,5,3,106.31,17,21,0,3,124.18,0.00,0.67,0.67,0,1.00,2,394.65,1,2,3,org.apache.jackrabbit.standalone.cli.info.AbstractLsNodes,0.00,2,2,4,0,2,1,0,5,89,1
"org.apache.jackrabbit.standalone.cli.info.LsCollectedProperties",3,0.50,1.33,12,0.13,3431.52,4,1,4,5,3,106.52,17,21,0,3,124.39,0.00,0.67,0.67,0,1.00,2,382.93,1,2,3,org.apache.jackrabbit.standalone.cli.info.AbstractLsProperties,0.00,2,2,4,0,2,1,0,6,87,1
"org.apache.jackrabbit.standalone.cli.info.LsItems",3,1.00,1.00,10,0.10,1523.76,4,1,6,6,3,89.60,23,15,0,3,131.89,0.00,0.67,0.33,0,4.00,1,302.68,0,2,3,org.apache.jackrabbit.standalone.cli.info.AbstractLsItems,0.00,3,2,3,0,3,1,0,5,75,1
"org.apache.jackrabbit.standalone.cli.info.LsNamespaces",1,0.00,1.00,3,0.02,212.34,1,0,2,2,0,102.66,6,5,0,1,134.88,0.00,0.00,0.00,0,1.00,1,67.32,0,0,0,java.lang.Object,0.00,1,0,1,0,1,1,1,2,20,1
"org.apache.jackrabbit.standalone.cli.info.LsNodes",3,1.00,1.00,10,0.10,1549.53,4,1,6,6,3,113.96,15,15,0,3,131.84,0.00,0.67,0.33,0,4.00,1,301.04,0,2,3,org.apache.jackrabbit.standalone.cli.info.AbstractLsNodes,0.00,3,2,3,0,3,1,0,5,75,1
"org.apache.jackrabbit.standalone.cli.info.LsProperties",3,1.00,1.00,10,0.10,1523.76,4,1,6,6,3,89.60,22,15,0,3,131.89,0.00,0.67,0.33,0,4.00,1,302.68,0,2,3,org.apache.jackrabbit.standalone.cli.info.AbstractLsProperties,0.00,3,2,3,0,3,1,0,5,75,1
"org.apache.jackrabbit.standalone.cli.info.LsReferences",3,0.25,1.33,21,0.33,9468.40,5,2,7,15,2,79.63,19,33,0,1,111.85,0.00,0.00,0.33,0,5.00,2,983.71,0,1,2,java.lang.Object,0.00,12,0,4,0,12,2,1,10,188,1
"org.apache.jackrabbit.standalone.cli.info.LsVersions",3,0.25,1.33,22,0.34,8673.32,5,2,10,17,2,79.93,18,32,0,1,112.15,0.00,0.00,0.33,0,5.00,2,1026.56,0,1,2,java.lang.Object,0.00,14,0,4,0,14,2,1,9,193,1
"org.apache.jackrabbit.standalone.cli.info.PrintHelper",7,0.00,3.71,95,1.15,85621.86,7,0,6,24,8,48.85,57,109,6,1,96.96,0.00,0.00,0.00,2,7.00,9,3438.75,0,0,2,java.lang.Object,0.00,17,0,26,0,17,7,0,10,633,1
"org.apache.jackrabbit.core.value.BLOBFileValue",7,0.00,1.29,19,0.16,5981.31,7,0,5,11,11,136.86,34,26,10,1,136.63,0.00,0.00,0.00,0,7.00,3,477.55,0,3,1,java.lang.Object,0.00,4,0,9,6,4,4,1,5,116,1
"org.apache.jackrabbit.core.value.BLOBInDataStore",15,0.07,1.13,46,0.43,8529.82,19,4,8,28,8,181.48,24,65,3,2,131.48,0.00,0.50,0.18,1,54.00,2,1300.78,0,7,5,org.apache.jackrabbit.core.value.BLOBFileValue,0.45,13,1,17,0,13,8,0,8,322,0
"org.apache.jackrabbit.core.value.BLOBInMemory",12,0.05,1.58,63,0.74,45136.02,17,5,6,28,3,116.90,53,78,2,2,116.67,0.00,0.50,0.15,0,46.00,4,2213.13,0,5,1,org.apache.jackrabbit.core.value.BLOBFileValue,0.42,16,1,19,0,16,7,0,17,456,0
"org.apache.jackrabbit.core.value.BLOBInResource",10,0.03,1.60,40,0.41,10678.13,14,4,7,26,6,145.20,35,63,2,2,124.59,0.00,0.50,0.22,1,22.00,3,1234.07,0,4,4,org.apache.jackrabbit.core.value.BLOBFileValue,0.47,16,1,16,0,16,6,0,10,288,0
"org.apache.jackrabbit.core.value.BLOBInTempFile",13,0.02,1.69,65,0.63,17468.94,17,4,11,32,7,160.06,38,94,3,2,120.17,0.00,0.50,0.27,2,12.00,4,1901.05,0,5,4,org.apache.jackrabbit.core.value.BLOBFileValue,0.50,19,1,22,0,19,8,0,7,433,0
"org.apache.jackrabbit.core.value.BinaryValueImpl",3,0.50,1.33,10,0.08,1254.07,4,1,4,5,6,132.73,13,14,2,3,132.49,0.00,0.67,0.67,0,1.00,2,241.80,0,2,4,org.apache.jackrabbit.value.BinaryValue,0.00,2,2,4,0,2,1,1,3,65,0
"org.apache.jackrabbit.core.value.BinaryValueTest",7,0.00,1.29,31,0.31,6548.90,7,0,7,17,2,175.09,13,42,1,4,125.09,0.00,0.75,0.00,3,17.00,2,917.50,0,1,1,org.apache.jackrabbit.test.AbstractJCRTest,0.00,10,3,9,0,10,6,0,3,206,1
"org.apache.jackrabbit.core.value.InternalValue",47,0.24,1.81,258,3.55,183307.41,51,4,32,109,84,116.75,210,392,61,2,116.51,0.00,0.50,0.02,2,407.00,14,10636.40,4,29,24,org.apache.jackrabbit.spi.commons.value.AbstractQValue,0.08,62,1,85,0,62,18,0,56,2077,1
"org.apache.jackrabbit.core.value.InternalValueFactory",15,0.46,1.07,37,0.36,5589.40,17,2,15,20,13,139.51,4,54,6,2,139.51,0.00,0.50,0.07,0,41.00,2,1086.89,0,14,8,org.apache.jackrabbit.spi.commons.value.AbstractQValueFactory,0.22,5,1,16,0,5,1,0,1,282,2
"org.apache.jackrabbit.core.value.InternalValueFactoryTest",2,1.00,1.00,8,0.11,1571.96,3,1,7,10,7,146.36,6,11,1,4,125.74,0.00,0.75,0.00,0,2.00,1,326.41,0,0,6,org.apache.jackrabbit.spi.QValueFactoryTest,0.16,8,3,2,0,8,2,0,2,75,1
"org.apache.jackrabbit.core.value.InternalValueTest",2,1.00,1.00,8,0.11,1571.96,3,1,7,10,7,146.36,6,11,1,4,125.74,0.00,0.75,0.00,0,2.00,1,326.41,0,0,6,org.apache.jackrabbit.spi.QValueTest,0.16,8,3,2,0,8,2,0,2,75,1
"org.apache.jackrabbit.core.value.PathTest",5,0.00,1.00,32,0.47,7858.16,7,2,12,23,2,166.80,6,39,1,4,116.80,0.00,0.75,0.50,0,0.00,1,1414.71,1,0,1,org.apache.jackrabbit.test.AbstractJCRTest,0.13,18,3,5,0,18,5,0,2,292,1
"org.apache.jackrabbit.core.value.RefCountingBLOBFileValue",10,0.06,1.50,42,0.37,8282.87,14,4,4,21,4,125.70,46,60,3,2,125.47,0.00,0.50,0.30,1,6.00,3,1119.61,1,3,1,org.apache.jackrabbit.core.value.BLOBFileValue,0.47,11,1,15,0,11,7,0,12,267,1
"org.apache.jackrabbit.core.value.RefCountingBLOBFileValue$RefCountBinary",11,0.90,1.27,34,0.23,3333.79,12,1,4,20,2,133.61,0,49,0,2,133.61,0.00,0.50,0.18,3,25.00,2,681.35,1,4,2,org.apache.jackrabbit.core.value.BLOBFileValue,0.44,9,1,14,0,9,7,0,0,191,2
"org.apache.jackrabbit.core.value.TestAll",1,0.00,1.00,8,0.07,2228.14,1,0,3,3,4,68.66,7,10,0,2,110.95,0.00,0.50,0.00,0,1.00,1,223.66,0,1,4,junit.framework.TestCase,0.00,2,1,1,0,2,0,0,2,55,1
"org.apache.jackrabbit.core.value.ValueFactoryImpl",6,0.30,3.00,46,0.62,19062.28,8,2,15,23,13,151.53,16,69,2,2,111.65,0.00,0.50,0.25,1,10.00,5,1856.27,2,5,11,org.apache.jackrabbit.spi.commons.value.ValueFactoryQImpl,0.00,17,1,18,0,17,1,0,6,381,1
"org.apache.jackrabbit.performance.AbstractPerformanceTest",7,0.00,2.43,77,1.29,51745.31,7,0,15,64,25,151.48,13,129,1,1,101.48,0.00,0.00,0.00,3,7.00,7,3866.67,0,3,24,java.lang.Object,0.00,57,0,17,1,57,4,0,7,706,2
"org.apache.jackrabbit.performance.AbstractTest",14,0.09,1.36,62,0.53,10532.27,19,5,6,28,21,146.44,51,84,21,1,125.82,0.00,0.00,0.11,5,58.00,4,1584.08,0,5,0,java.lang.Object,0.00,14,0,19,20,14,9,0,9,371,2
"org.apache.jackrabbit.performance.AbstractTest$Thread",1,0.00,2.00,4,0.02,310.63,1,0,6,2,0,128.76,0,7,0,1,128.76,0.00,0.00,0.00,0,1.00,2,68.94,0,0,0,java.lang.Object,0.00,1,0,2,0,1,1,0,0,21,0
"org.apache.jackrabbit.performance.AddGroupMembersTest",4,0.47,1.25,25,0.25,4577.59,9,5,6,14,6,117.84,0,32,1,2,117.84,0.00,0.50,0.55,0,0.00,2,747.76,1,0,5,org.apache.jackrabbit.performance.AbstractTest,0.44,10,1,5,0,10,4,0,0,166,1
"org.apache.jackrabbit.performance.AddGroupMembersTest$Principal",1,0.00,1.00,3,0.01,72.00,1,0,6,1,0,138.58,0,4,0,1,138.58,0.00,0.00,0.00,0,1.00,1,32.00,0,1,0,java.lang.Object,0.00,0,0,1,0,0,0,0,0,12,0
"org.apache.jackrabbit.performance.BigFileReadTest",3,0.60,1.33,30,0.38,9188.19,8,5,7,19,3,106.18,0,36,1,2,106.18,0.00,0.50,0.60,0,0.00,2,1137.95,1,0,2,org.apache.jackrabbit.performance.AbstractTest,0.35,16,1,4,0,16,3,0,0,225,1
"org.apache.jackrabbit.performance.BigFileWriteTest",3,0.50,1.00,16,0.18,2811.17,6,3,4,11,3,121.52,0,22,1,2,121.52,0.00,0.50,0.67,0,0.00,1,536.55,0,0,2,org.apache.jackrabbit.performance.AbstractTest,0.35,8,1,3,0,8,3,0,0,119,1
"org.apache.jackrabbit.performance.ConcurrentReadTest",3,0.12,2.67,41,0.35,10144.61,7,4,4,12,3,151.43,4,35,2,2,101.43,1.00,0.33,0.33,0,1.00,4,1042.41,1,0,1,org.apache.jackrabbit.performance.AbstractTest,0.35,9,1,8,1,9,3,0,1,218,1
"org.apache.jackrabbit.performance.ConcurrentReadTest$Reader",1,0.00,2.00,9,0.11,2431.55,3,2,4,6,0,108.58,0,14,0,1,108.58,0.00,0.00,1.00,0,0.00,2,342.50,0,0,0,java.lang.Object,0.00,5,0,2,0,5,1,1,0,76,1
"org.apache.jackrabbit.performance.ConcurrentReadWriteTest",1,0.00,1.00,5,0.04,391.57,1,0,4,2,2,124.74,4,7,1,3,124.51,0.00,0.67,0.00,0,1.00,1,106.47,2,0,1,org.apache.jackrabbit.performance.ConcurrentReadTest,0.17,1,2,1,0,1,1,0,1,30,1
"org.apache.jackrabbit.performance.ConcurrentReadWriteTest$Writer",1,0.00,2.00,12,0.16,3554.69,4,3,4,8,0,102.62,0,17,0,1,102.62,0.00,0.00,1.00,0,0.00,2,476.79,0,0,0,java.lang.Object,0.00,7,0,2,0,7,1,1,0,99,1
"org.apache.jackrabbit.performance.CreateManyChildNodesTest",4,0.17,1.25,17,0.16,2739.57,6,2,3,10,2,176.16,4,20,1,2,126.16,0.00,0.50,0.38,0,0.00,2,474.90,0,0,1,org.apache.jackrabbit.performance.AbstractTest,0.44,6,1,5,0,6,4,0,1,113,1
"org.apache.jackrabbit.performance.CreateUserTest",3,0.50,1.33,17,0.16,2797.28,6,3,3,9,4,121.48,0,22,1,2,121.48,0.00,0.50,0.67,0,0.00,2,487.15,1,0,3,org.apache.jackrabbit.performance.AbstractTest,0.35,6,1,4,0,6,3,0,0,113,1
"org.apache.jackrabbit.performance.GroupGetMembersTest",3,0.50,2.33,31,0.31,7347.99,7,4,6,15,5,106.82,2,32,1,2,106.82,0.00,0.50,0.58,0,0.00,3,934.55,1,0,4,org.apache.jackrabbit.performance.AbstractTest,0.35,12,1,7,0,12,3,0,2,193,1
"org.apache.jackrabbit.performance.GroupGetMembersTest$Principal",1,0.00,1.00,3,0.01,72.00,1,0,6,1,0,138.58,0,4,0,1,138.58,0.00,0.00,0.00,0,1.00,1,32.00,0,1,0,java.lang.Object,0.00,0,0,1,0,0,0,0,0,12,0
"org.apache.jackrabbit.performance.GroupMemberLookupTest",4,0.44,1.50,31,0.33,6987.38,10,6,7,17,6,113.85,0,36,1,2,113.85,0.00,0.50,0.50,0,0.00,2,1004.11,1,0,5,org.apache.jackrabbit.performance.AbstractTest,0.44,13,1,6,0,13,4,0,0,211,1
"org.apache.jackrabbit.performance.GroupMemberLookupTest$Principal",1,0.00,1.00,3,0.01,72.00,1,0,7,1,0,138.58,0,4,0,1,138.58,0.00,0.00,0.00,0,1.00,1,32.00,0,1,0,java.lang.Object,0.00,0,0,1,0,0,0,0,0,12,0
"org.apache.jackrabbit.performance.LoginLogoutTest",1,0.00,2.00,7,0.05,808.97,1,0,1,3,3,116.42,0,7,2,2,116.42,0.00,0.50,0.00,0,1.00,2,145.17,1,0,1,org.apache.jackrabbit.performance.AbstractTest,0.13,2,1,2,0,2,1,0,0,36,1
"org.apache.jackrabbit.performance.LoginTest",2,0.00,2.00,14,0.11,2568.09,3,1,2,4,3,114.84,0,13,2,2,114.84,0.00,0.50,1.00,0,0.00,2,344.93,0,0,1,org.apache.jackrabbit.performance.AbstractTest,0.25,2,1,4,0,2,2,0,0,81,1
"org.apache.jackrabbit.performance.PerformanceTest",1,0.00,1.00,3,0.02,234.43,1,0,1,1,1,134.54,0,6,0,2,134.54,0.00,0.50,0.00,1,1.00,1,63.94,0,0,1,org.apache.jackrabbit.performance.AbstractPerformanceTest,0.00,0,1,1,0,0,1,0,0,20,1
"org.apache.jackrabbit.performance.PerformanceTestSuite",4,0.00,1.50,40,0.71,22589.26,8,4,8,30,7,154.06,7,79,2,1,104.06,0.00,0.00,0.25,1,6.00,3,2134.26,0,1,5,java.lang.Object,0.00,26,0,6,0,26,3,0,7,397,1
"org.apache.jackrabbit.performance.RefreshTest",3,0.00,1.33,12,0.08,1128.59,4,1,2,6,1,128.19,0,14,0,2,128.19,0.00,0.50,1.00,0,0.00,2,250.25,0,0,1,org.apache.jackrabbit.performance.AbstractTest,0.35,3,1,4,0,3,3,0,0,65,1
"org.apache.jackrabbit.performance.SetPropertyTest",5,0.25,1.20,22,0.19,2422.17,7,2,3,13,2,127.35,4,26,1,2,127.35,0.00,0.50,0.70,0,0.00,2,567.12,1,0,1,org.apache.jackrabbit.performance.AbstractTest,0.53,8,1,6,0,8,5,0,1,139,1
"org.apache.jackrabbit.performance.SimpleSearchTest",3,0.33,3.00,41,0.46,13516.03,6,3,6,23,2,100.42,0,40,1,2,100.42,0.00,0.50,0.56,0,0.00,4,1367.10,1,0,1,org.apache.jackrabbit.performance.AbstractTest,0.35,20,1,9,0,20,3,0,0,268,1
"org.apache.jackrabbit.performance.SmallFileReadTest",3,0.38,1.67,33,0.38,9757.60,7,4,7,19,3,104.38,0,37,1,2,104.38,0.00,0.50,0.50,0,0.00,2,1150.48,1,0,2,org.apache.jackrabbit.performance.AbstractTest,0.35,16,1,5,0,16,3,0,0,226,1
"org.apache.jackrabbit.performance.SmallFileWriteTest",4,0.25,1.25,23,0.24,4932.39,8,4,4,12,3,120.53,0,27,1,2,120.53,0.00,0.50,0.44,0,0.00,2,730.01,0,0,2,org.apache.jackrabbit.performance.AbstractTest,0.44,8,1,5,0,8,4,0,0,159,1
"org.apache.jackrabbit.performance.TestInputStream",3,0.83,1.67,24,0.24,8435.59,6,3,2,7,4,130.65,10,32,4,2,110.04,0.00,0.50,0.89,0,0.00,2,720.85,0,0,0,java.io.InputStream,0.00,4,1,5,0,4,3,0,2,155,0
"org.apache.jackrabbit.performance.ThreeWayJoinTest",3,0.50,3.67,55,0.75,32208.50,7,4,7,25,2,142.13,5,65,1,2,92.13,0.00,0.50,0.58,0,0.00,5,2258.77,1,0,1,org.apache.jackrabbit.performance.AbstractTest,0.35,22,1,11,0,22,3,0,1,407,1
"org.apache.jackrabbit.performance.TransientManyChildNodesTest",5,0.06,1.40,25,0.23,4178.03,9,4,3,13,2,171.84,5,27,1,2,121.84,0.00,0.50,0.20,0,6.00,2,701.65,1,0,1,org.apache.jackrabbit.performance.AbstractTest,0.53,8,1,7,0,8,5,0,1,162,1
"org.apache.jackrabbit.performance.TwoWayJoinTest",3,0.50,3.33,48,0.64,23105.72,7,4,7,25,2,145.20,5,58,1,2,95.20,0.00,0.50,0.58,0,0.00,4,1919.65,1,0,1,org.apache.jackrabbit.performance.AbstractTest,0.35,22,1,10,0,22,3,0,1,352,1
"org.apache.jackrabbit.performance.UpdateManyChildNodesTest",5,0.17,1.20,23,0.22,3450.23,8,3,3,14,2,126.14,4,27,1,2,126.14,0.00,0.50,0.47,0,0.00,2,658.60,1,0,1,org.apache.jackrabbit.performance.AbstractTest,0.53,9,1,6,0,9,5,0,1,155,1
"org.apache.jackrabbit.jcr.AbstractLockTest",13,0.13,1.38,111,1.24,27043.41,18,5,10,45,4,111.34,52,142,2,4,111.11,0.67,0.50,0.32,0,0.00,3,3725.46,2,0,2,org.apache.jackrabbit.test.AbstractJCRTest,0.21,32,3,18,2,32,13,0,33,779,2
"org.apache.jackrabbit.jcr.DeepLockTest",15,0.13,1.40,72,0.78,13248.84,21,6,9,41,3,125.26,9,102,1,4,125.26,0.00,0.75,0.29,0,0.00,4,2337.16,3,0,2,org.apache.jackrabbit.test.AbstractJCRTest,0.20,26,3,21,0,26,15,0,7,522,1
"org.apache.jackrabbit.jcr.LockManagerImpl",18,0.01,2.72,167,2.04,71306.05,25,7,31,68,20,56.84,177,210,2,1,106.84,0.00,0.00,0.15,7,58.00,9,6118.94,0,5,18,java.lang.Object,0.00,50,0,49,0,50,13,2,78,1202,1
"org.apache.jackrabbit.jcr.LockManagerImpl$LockImpl",14,0.10,1.86,69,0.58,11328.85,17,3,31,28,2,107.63,78,96,0,1,125.50,0.00,0.00,0.24,4,34.00,4,1728.33,0,4,2,java.lang.Object,0.00,14,0,26,0,14,10,2,36,411,1
"org.apache.jackrabbit.jcr.LockManagerImpl$LockState",12,0.05,2.67,83,0.78,17723.60,16,4,31,28,11,117.03,52,117,0,1,116.79,0.00,0.00,0.29,5,28.00,5,2341.89,0,0,11,java.lang.Object,0.00,16,0,32,0,16,12,1,23,513,1
"org.apache.jackrabbit.jcr.LockManagerImpl$LockTokenListener",2,0.00,1.00,3,0.02,87.00,2,0,31,2,0,125.88,12,4,0,1,158.10,0.00,0.00,0.00,0,2.00,1,58.00,0,0,0,,0.00,0,0,2,0,0,2,0,2,21,1
"org.apache.jackrabbit.jcr.LockStateManager",9,0.00,1.00,10,0.11,512.49,9,0,4,9,6,107.18,85,13,5,1,157.18,0.00,0.00,0.00,0,9.00,1,315.25,0,4,1,,0.00,0,0,9,0,0,5,0,10,96,1
"org.apache.jackrabbit.jcr.OpenScopedLockTest",10,1.00,1.70,95,1.10,25873.60,11,1,6,40,2,129.02,39,126,1,5,108.41,0.00,0.80,0.00,0,0.00,3,3314.23,0,0,1,org.apache.jackrabbit.jcr2spi.lock.AbstractLockTest,0.10,30,4,17,0,30,10,0,28,670,1
"org.apache.jackrabbit.jcr.SessionScopedLockTest",1,1.00,1.00,4,0.04,565.73,2,1,2,2,2,147.48,3,7,1,5,126.87,0.00,0.80,0.00,0,1.00,1,111.70,0,0,1,org.apache.jackrabbit.jcr2spi.lock.AbstractLockTest,0.12,1,4,1,0,1,1,0,1,30,1
"org.apache.jackrabbit.jcr.TestAll",1,0.00,1.00,7,0.06,1740.69,1,0,3,3,4,134.57,3,9,1,2,113.96,0.00,0.50,0.00,0,1.00,1,186.48,0,1,3,junit.framework.TestCase,0.00,2,1,1,0,2,0,0,1,47,1
"org.apache.jackrabbit.core.integration.random.operation.AddNode",2,0.00,1.00,10,0.12,1988.59,4,2,5,6,2,141.94,6,13,1,2,121.32,0.00,0.50,0.50,0,2.00,1,355.19,2,1,1,org.apache.jackrabbit.core.integration.random.operation.Operation,0.12,4,1,2,0,4,1,0,2,84,1
"org.apache.jackrabbit.core.integration.random.operation.AddVersionLabel",2,1.00,1.00,11,0.15,2676.45,3,1,5,9,2,140.92,7,14,1,3,120.31,0.00,0.67,0.50,0,2.00,1,446.09,3,1,1,org.apache.jackrabbit.core.integration.random.operation.VersionOperation,0.17,7,2,2,0,7,1,0,2,98,1
"org.apache.jackrabbit.core.integration.random.operation.Checkin",2,1.00,1.50,10,0.12,2177.43,3,1,6,8,2,141.53,7,14,1,3,120.92,0.00,0.67,0.50,0,2.00,2,359.34,2,1,1,org.apache.jackrabbit.core.integration.random.operation.VersionOperation,0.17,6,2,3,0,6,1,0,2,83,1
"org.apache.jackrabbit.core.integration.random.operation.Checkout",2,1.00,1.50,10,0.12,2389.44,3,1,5,9,2,141.22,7,14,1,3,120.60,0.00,0.67,0.50,0,2.00,2,364.04,2,1,1,org.apache.jackrabbit.core.integration.random.operation.VersionOperation,0.17,7,2,3,0,7,1,0,2,84,1
"org.apache.jackrabbit.core.integration.random.operation.CreateNodes",4,0.07,2.50,42,0.46,18729.18,9,5,6,12,2,144.47,8,53,1,2,104.58,0.00,0.50,0.25,2,10.00,5,1368.71,3,1,1,org.apache.jackrabbit.core.integration.random.operation.Operation,0.11,8,1,10,0,8,3,0,3,282,1
"org.apache.jackrabbit.core.integration.random.operation.GetNode",2,0.00,1.00,6,0.04,420.31,2,0,3,2,2,155.53,6,9,1,2,134.91,0.00,0.50,0.00,0,2.00,1,127.23,2,1,1,org.apache.jackrabbit.core.integration.random.operation.Operation,0.12,0,1,2,0,0,1,0,2,37,1
"org.apache.jackrabbit.core.integration.random.operation.GetRandomNodes",2,1.00,1.50,13,0.11,2160.41,3,1,8,8,3,118.23,9,14,1,2,117.99,0.00,0.50,0.00,0,2.00,2,332.28,0,1,2,org.apache.jackrabbit.core.integration.random.operation.Operation,0.12,6,1,3,0,6,1,0,2,79,1
"org.apache.jackrabbit.core.integration.random.operation.GetRandomNodes$Iterator",3,0.00,1.33,10,0.09,1531.73,3,0,8,11,0,131.81,1,15,0,1,131.81,0.00,0.00,0.00,0,3.00,2,268.03,0,1,0,java.lang.Object,0.00,8,0,4,0,8,2,0,1,66,0
"org.apache.jackrabbit.core.integration.random.operation.Operation",14,0.06,1.14,42,0.35,6349.34,19,5,8,23,19,182.25,20,55,18,1,132.25,0.00,0.00,0.14,1,86.00,2,1045.54,0,8,1,java.lang.Object,0.00,9,0,16,20,9,6,0,5,263,2
"org.apache.jackrabbit.core.integration.random.operation.OperationFactory",12,0.12,2.25,65,0.89,33796.75,15,3,7,40,22,138.19,47,106,6,1,117.57,0.00,0.00,0.44,0,0.00,10,2678.69,0,11,18,java.lang.Object,0.00,28,0,27,0,28,1,0,16,531,1
"org.apache.jackrabbit.core.integration.random.operation.OperationSequence",2,1.00,1.50,13,0.13,3341.96,3,1,5,8,4,156.39,4,14,2,2,116.50,0.00,0.50,0.50,0,2.00,2,401.54,0,1,2,org.apache.jackrabbit.core.integration.random.operation.Operation,0.12,6,1,3,0,6,1,0,1,92,1
"org.apache.jackrabbit.core.integration.random.operation.RandomContentOperations",3,0.00,1.00,8,0.08,994.10,3,0,2,5,3,189.92,3,15,1,3,139.92,0.00,0.67,0.00,0,3.00,1,241.24,2,2,3,org.apache.jackrabbit.core.integration.random.operation.RandomOperations,0.14,2,2,3,0,2,1,0,1,64,1
"org.apache.jackrabbit.core.integration.random.operation.RandomOperations",5,0.17,1.20,23,0.21,4157.94,8,3,5,11,5,125.51,4,29,2,2,125.51,2.00,0.25,0.20,1,14.00,2,644.96,1,2,3,org.apache.jackrabbit.core.integration.random.operation.Operation,0.11,6,1,6,2,6,3,0,1,149,2
"org.apache.jackrabbit.core.integration.random.operation.RandomVersionOperations",3,0.00,1.00,8,0.08,994.10,3,0,2,5,3,189.92,3,15,1,3,139.92,0.00,0.67,0.00,0,3.00,1,241.24,2,2,3,org.apache.jackrabbit.core.integration.random.operation.RandomOperations,0.14,2,2,3,0,2,1,0,1,64,1
"org.apache.jackrabbit.core.integration.random.operation.Remove",2,0.00,2.00,18,0.18,3843.69,4,2,5,9,2,149.27,4,20,1,2,109.39,0.00,0.50,0.50,0,2.00,3,533.22,2,1,1,org.apache.jackrabbit.core.integration.random.operation.Operation,0.12,7,1,4,0,7,1,0,1,117,1
"org.apache.jackrabbit.core.integration.random.operation.RemoveVersion",2,1.00,1.50,11,0.14,2844.86,3,1,6,8,2,170.00,3,15,1,3,120.00,0.00,0.67,0.50,0,2.00,2,418.53,3,1,1,org.apache.jackrabbit.core.integration.random.operation.VersionOperation,0.17,6,2,3,0,6,1,0,1,93,1
"org.apache.jackrabbit.core.integration.random.operation.RemoveVersionLabel",2,1.00,1.50,13,0.17,4225.22,3,1,6,9,2,155.58,4,17,1,3,115.70,0.00,0.67,0.50,0,2.00,2,518.85,2,1,1,org.apache.jackrabbit.core.integration.random.operation.VersionOperation,0.17,7,2,3,0,7,1,0,1,110,1
"org.apache.jackrabbit.core.integration.random.operation.Restore",2,1.00,1.50,11,0.13,2583.51,3,1,6,7,1,170.33,3,15,0,3,120.33,0.00,0.67,0.50,0,2.00,2,393.99,3,1,1,org.apache.jackrabbit.core.integration.random.operation.VersionOperation,0.17,5,2,3,0,5,1,0,1,88,1
"org.apache.jackrabbit.core.integration.random.operation.Save",2,1.00,1.00,9,0.09,1357.97,3,1,5,6,2,176.24,3,12,1,2,126.24,0.00,0.50,0.50,0,2.00,1,264.96,2,1,1,org.apache.jackrabbit.core.integration.random.operation.Operation,0.12,4,1,2,0,4,1,0,1,66,1
"org.apache.jackrabbit.core.integration.random.operation.SetProperty",2,0.00,1.00,12,0.14,2497.38,4,2,5,6,2,157.47,4,15,1,2,117.59,0.00,0.50,0.50,0,2.00,1,427.64,3,1,1,org.apache.jackrabbit.core.integration.random.operation.Operation,0.12,4,1,2,0,4,1,0,1,97,1
"org.apache.jackrabbit.core.integration.random.operation.TraverseNodes",2,0.00,1.00,7,0.07,1012.53,2,0,5,7,5,181.91,3,10,1,2,131.91,0.00,0.50,0.00,0,2.00,1,209.96,2,1,4,org.apache.jackrabbit.core.integration.random.operation.Operation,0.12,5,1,2,0,5,1,0,1,54,1
"org.apache.jackrabbit.core.integration.random.operation.VersionOperation",2,0.00,4.00,21,0.26,9402.63,2,0,7,13,7,72.24,13,27,6,2,104.46,6.00,0.12,0.00,0,2.00,7,769.85,2,1,1,org.apache.jackrabbit.core.integration.random.operation.Operation,0.00,11,1,8,6,11,1,0,3,148,2
"org.apache.jackrabbit.core.integration.random.operation.XATransaction",2,0.00,1.00,14,0.14,2661.97,4,2,5,8,3,164.87,3,17,1,2,114.87,0.00,0.50,0.50,0,2.00,1,406.58,1,1,2,org.apache.jackrabbit.core.integration.random.operation.Operation,0.12,6,1,2,0,6,1,0,1,95,1
"org.apache.jackrabbit.commons.packaging.ContentPackage",1,0.00,1.00,2,0.01,51.00,1,0,3,1,2,146.32,0,3,2,1,146.32,0.00,0.00,0.00,0,1.00,1,34.00,0,1,0,,0.00,0,0,1,0,0,0,0,0,13,1
"org.apache.jackrabbit.commons.packaging.ContentPackageExporter",1,0.00,1.00,2,0.01,64.83,1,0,2,1,1,145.50,0,4,0,1,145.50,0.00,0.00,0.00,0,1.00,1,43.22,0,0,1,,0.00,0,0,1,0,0,1,0,0,15,1
"org.apache.jackrabbit.commons.packaging.FilterContentPackage",5,0.50,1.00,16,0.17,2430.33,7,2,11,9,3,132.05,3,22,1,1,132.05,0.00,0.00,0.10,0,8.00,1,517.24,0,1,2,java.lang.Object,0.00,4,0,5,0,4,4,1,1,127,1
"org.apache.jackrabbit.commons.packaging.FilterContentPackage$Content",1,2.00,1.00,6,0.05,724.49,3,2,11,1,1,119.45,0,8,0,1,119.45,0.00,0.00,0.00,0,1.00,1,142.24,0,0,1,java.lang.Object,0.00,0,0,1,0,0,1,0,0,39,2
"org.apache.jackrabbit.commons.packaging.FilterContentPackage$FilteringIterator",5,0.10,4.00,71,0.95,80215.49,15,10,11,20,1,95.05,22,94,0,1,94.81,0.00,0.00,0.02,3,8.00,13,2856.57,0,1,1,java.lang.Object,0.00,15,0,20,0,15,4,1,7,522,2
"org.apache.jackrabbit.spi.commons.name.AbstractElement",8,1.00,1.00,18,0.09,851.41,9,1,2,9,6,125.94,47,27,5,1,143.81,0.00,0.00,0.00,0,8.00,1,275.25,0,1,1,java.lang.Object,0.00,1,0,8,5,1,7,1,10,85,1
"org.apache.jackrabbit.spi.commons.name.AbstractPath",7,1.00,4.14,78,1.07,75022.05,8,1,2,32,7,57.80,55,116,3,1,100.09,0.00,0.00,0.00,0,7.00,12,3199.54,0,4,6,java.lang.Object,0.00,25,0,29,6,25,3,1,9,615,1
"org.apache.jackrabbit.spi.commons.name.CurrentElement",5,0.25,1.00,13,0.11,2058.79,8,3,1,8,6,139.42,24,21,3,2,139.18,0.00,0.50,0.13,0,11.00,1,332.76,0,3,3,org.apache.jackrabbit.spi.commons.name.AbstractElement,0.15,3,1,5,0,3,2,0,10,85,1
"org.apache.jackrabbit.spi.commons.name.CurrentPath",9,1.00,1.44,32,0.21,3904.85,10,1,2,15,7,182.35,12,47,4,3,132.35,0.00,0.67,0.00,0,4.00,2,641.92,0,5,4,org.apache.jackrabbit.spi.commons.name.RelativePath,0.20,6,2,13,0,6,4,0,3,168,1
"org.apache.jackrabbit.spi.commons.name.ElementTest",7,0.00,1.00,69,0.87,13860.26,7,0,4,24,8,109.44,3,78,0,2,109.44,0.00,0.50,0.00,1,7.00,1,2606.74,0,1,8,junit.framework.TestCase,0.00,17,1,7,0,17,6,0,1,542,1
"org.apache.jackrabbit.spi.commons.name.HashCache",3,1.00,1.33,15,0.14,3828.23,4,1,0,5,2,70.40,28,20,2,1,120.40,0.00,0.00,0.33,0,4.00,2,406.91,0,0,0,java.lang.Object,0.00,2,0,4,0,2,3,0,5,97,1
"org.apache.jackrabbit.spi.commons.name.IdentifierElement",6,0.40,1.33,21,0.17,4071.72,8,2,2,10,4,88.55,42,33,2,2,130.84,0.00,0.50,0.17,0,10.00,3,523.16,0,2,2,org.apache.jackrabbit.spi.commons.name.AbstractElement,0.14,4,1,8,0,4,4,0,10,132,1
"org.apache.jackrabbit.spi.commons.name.IdentifierPath",18,0.38,1.28,55,0.40,8723.33,20,2,2,24,4,182.00,30,82,3,2,132.00,0.00,0.50,0.14,0,58.00,3,1189.66,0,7,2,org.apache.jackrabbit.spi.commons.name.AbstractPath,0.00,6,1,23,0,6,11,0,7,308,1
"org.apache.jackrabbit.spi.commons.name.JcrName",5,0.10,1.20,68,1.09,41537.31,10,5,1,11,3,138.43,10,76,3,1,98.54,0.00,0.00,0.12,1,14.00,2,3279.21,0,2,0,java.lang.Object,0.00,6,0,6,0,6,3,0,8,609,2
"org.apache.jackrabbit.spi.commons.name.JcrPath",8,0.04,1.62,101,1.89,79607.80,15,7,1,17,5,139.04,19,115,5,1,99.15,0.00,0.00,0.18,3,28.00,5,5655.31,0,2,0,java.lang.Object,0.00,9,0,13,0,9,6,0,11,969,2
"org.apache.jackrabbit.spi.commons.name.MatchResult",9,0.09,1.33,36,0.26,4339.90,13,4,1,13,7,147.96,32,48,6,1,127.35,0.00,0.00,0.33,0,3.00,2,777.61,0,3,1,java.lang.Object,0.00,4,0,12,0,4,6,0,7,198,1
"org.apache.jackrabbit.spi.commons.name.Matcher",5,0.00,1.60,21,0.23,8758.62,5,0,1,14,5,80.60,36,27,2,1,122.89,0.00,0.00,0.00,1,5.00,4,703.51,0,3,3,java.lang.Object,0.00,9,0,8,0,9,2,0,6,156,2
"org.apache.jackrabbit.spi.commons.name.MatcherTest",3,0.00,2.00,34,0.63,24122.04,6,3,4,22,6,101.24,0,41,0,2,101.24,0.00,0.50,0.33,0,2.00,3,1901.36,0,0,6,junit.framework.TestCase,0.00,19,1,6,0,19,3,0,0,368,1
"org.apache.jackrabbit.spi.commons.name.NameConstants",0,0.00,0.00,121,5.07,273009.11,120,120,2,2,128,171.00,383,125,125,1,171.00,0.00,0.00,0.00,0,0.00,0,15199.79,0,0,3,java.lang.Object,0.00,2,0,0,0,2,0,0,129,1918,1
"org.apache.jackrabbit.spi.commons.name.NameElement",9,0.03,1.67,46,0.46,12921.24,13,4,3,19,8,77.66,70,70,4,2,119.95,0.00,0.50,0.22,0,22.00,3,1369.92,0,3,4,org.apache.jackrabbit.spi.commons.name.AbstractElement,0.35,10,1,15,0,10,6,0,15,313,1
"org.apache.jackrabbit.spi.commons.name.NameFactoryImpl",4,0.17,2.50,24,0.34,13825.83,6,2,2,14,68,96.02,20,38,65,1,113.90,0.00,0.00,0.38,0,6.00,5,1013.06,0,3,3,java.lang.Object,0.00,10,0,10,0,10,1,1,8,212,1
"org.apache.jackrabbit.spi.commons.name.NameFactoryImpl$NameImpl",9,0.18,1.89,51,0.51,15715.85,14,5,2,18,1,71.14,74,73,0,1,119.25,0.00,0.00,0.36,0,0.00,4,1517.19,1,5,1,java.lang.Object,0.00,9,0,17,0,9,4,1,27,348,2
"org.apache.jackrabbit.spi.commons.name.NameFactoryTest",4,0.67,2.50,40,0.49,16340.17,6,2,3,19,4,105.05,3,42,0,2,105.05,0.00,0.50,1.00,0,0.00,3,1460.22,0,0,4,junit.framework.TestCase,0.00,15,1,10,0,15,4,0,1,295,1
"org.apache.jackrabbit.spi.commons.name.NameFactoryTest$Name",3,0.00,1.00,7,0.04,335.86,3,0,3,4,0,143.64,0,10,0,1,143.64,0.00,0.00,0.00,0,3.00,1,115.95,0,2,0,java.lang.Object,0.00,1,0,3,0,1,1,0,0,36,0
"org.apache.jackrabbit.spi.commons.name.NameFactoryTest$Name_0",5,0.00,1.20,14,0.13,2404.91,5,0,3,9,0,138.61,0,20,0,1,138.61,0.00,0.00,0.00,0,5.00,2,389.62,0,3,0,java.lang.Object,0.00,4,0,6,0,4,2,0,0,100,0
"org.apache.jackrabbit.spi.commons.name.NamePath",9,0.31,1.67,40,0.34,7262.34,11,2,2,21,7,125.53,3,58,5,3,125.53,0.00,0.67,0.22,2,0.00,3,1016.59,0,5,3,org.apache.jackrabbit.spi.commons.name.RelativePath,0.20,12,2,15,0,12,4,0,3,248,1
"org.apache.jackrabbit.spi.commons.name.ParentElement",5,0.25,1.00,13,0.11,2058.79,8,3,1,8,6,139.42,24,21,3,2,139.18,0.00,0.50,0.13,0,11.00,1,332.76,0,3,3,org.apache.jackrabbit.spi.commons.name.AbstractElement,0.15,3,1,5,0,3,2,0,10,85,1
"org.apache.jackrabbit.spi.commons.name.ParentPath",9,1.00,1.67,38,0.31,6412.71,10,1,2,20,7,175.96,15,56,5,3,125.96,0.00,0.67,0.00,1,4.00,4,944.69,0,5,3,org.apache.jackrabbit.spi.commons.name.RelativePath,0.20,11,2,15,0,11,4,0,6,230,1
"org.apache.jackrabbit.spi.commons.name.PathBuilder",13,0.04,1.46,49,0.41,7695.13,15,2,4,21,32,99.06,85,68,24,1,131.28,0.00,0.00,0.54,2,0.00,3,1232.55,0,1,8,java.lang.Object,0.00,8,0,19,0,8,12,0,16,310,2
"org.apache.jackrabbit.spi.commons.name.PathBuilderTest",6,0.13,5.17,115,1.80,117633.74,9,3,11,38,13,109.74,18,132,0,2,89.12,0.00,0.50,0.44,3,2.00,8,5406.26,0,3,13,junit.framework.TestCase,0.00,32,1,31,0,32,3,0,9,960,1
"org.apache.jackrabbit.spi.commons.name.PathBuilderTest$NamespaceResolver",2,0.00,1.00,5,0.02,262.00,2,0,11,2,0,143.10,0,7,0,1,143.10,0.00,0.00,0.00,0,2.00,1,68.00,0,2,0,java.lang.Object,0.00,0,0,2,0,0,0,0,0,24,0
"org.apache.jackrabbit.spi.commons.name.PathFactoryImpl",18,0.03,3.50,162,2.20,109039.82,25,7,6,57,66,145.22,47,214,51,1,105.33,0.00,0.00,0.12,1,74.00,10,6593.14,0,17,15,java.lang.Object,0.00,39,0,63,0,39,1,1,17,1274,1
"org.apache.jackrabbit.spi.commons.name.PathFactoryTest",17,0.00,2.53,170,2.32,102330.07,19,2,13,76,9,153.72,25,231,0,2,103.72,0.00,0.50,0.50,0,0.00,7,6953.08,2,1,9,junit.framework.TestCase,0.00,59,1,43,0,59,16,0,23,1329,1
"org.apache.jackrabbit.spi.commons.name.PathFactoryTest$NamespaceResolver",2,0.00,1.50,8,0.06,1022.92,2,0,13,4,1,127.12,0,11,0,1,127.12,0.00,0.00,0.00,0,2.00,2,176.73,0,2,1,java.lang.Object,0.00,2,0,3,0,2,0,0,0,47,0
"org.apache.jackrabbit.spi.commons.name.PathFactoryTest$ParentPathNameIndexDoNormalize",1,4.00,1.00,10,0.09,1247.10,5,4,13,1,2,109.32,0,13,0,1,109.32,0.00,0.00,0.00,0,1.00,1,257.30,0,0,2,java.lang.Object,0.00,0,0,1,0,0,1,0,0,65,2
"org.apache.jackrabbit.spi.commons.name.PathMap",5,0.12,2.40,49,0.59,24980.98,7,2,9,15,9,56.08,46,54,4,1,106.08,0.00,0.00,0.40,1,0.00,4,1765.64,0,0,5,java.lang.Object,0.00,10,0,12,0,10,5,0,9,366,1
"org.apache.jackrabbit.spi.commons.name.PathMap$Element",30,0.05,2.47,198,2.33,97779.20,36,6,9,65,4,81.88,205,260,0,1,114.10,0.00,0.00,0.21,8,290.00,8,6980.44,0,10,4,java.lang.Object,0.00,35,0,74,0,35,20,0,47,1465,3
"org.apache.jackrabbit.spi.commons.name.PathMap$ElementVisitor",1,0.00,1.00,2,0.02,113.21,1,0,9,1,0,143.83,4,3,0,1,143.60,0.00,0.00,0.00,0,1.00,1,50.99,0,0,0,,0.00,0,0,1,0,0,1,0,1,17,1
"org.apache.jackrabbit.spi.commons.name.PathTest",38,0.19,3.08,396,5.72,213762.25,41,3,14,89,12,103.91,29,448,0,2,103.91,0.00,0.50,0.52,0,0.00,6,17153.86,0,0,12,junit.framework.TestCase,0.00,51,1,117,0,51,38,0,19,3272,1
"org.apache.jackrabbit.spi.commons.name.PathTest$Equivalent",1,4.00,1.00,17,0.19,4857.47,5,4,14,2,0,96.07,0,20,0,1,96.07,0.00,0.00,0.00,0,1.00,1,570.64,0,0,0,java.lang.Object,0.00,1,0,1,0,1,1,0,0,140,2
"org.apache.jackrabbit.spi.commons.name.PathTest$JcrPathAndAncestor",1,4.00,1.00,44,0.75,37417.33,5,4,14,2,0,113.57,2,47,0,1,73.68,0.00,0.00,0.00,0,1.00,1,2242.26,0,0,0,java.lang.Object,0.00,1,0,1,0,1,1,0,2,437,2
"org.apache.jackrabbit.spi.commons.name.PathTest$NamespaceResolver",2,0.00,1.00,5,0.03,370.77,2,0,14,2,0,141.91,0,7,0,1,141.91,0.00,0.00,0.00,0,2.00,1,87.73,0,2,0,java.lang.Object,0.00,0,0,2,0,0,0,0,0,28,0
"org.apache.jackrabbit.spi.commons.name.PathTest$NotAncestor",1,3.00,1.00,54,0.83,62315.92,4,3,14,2,0,50.75,5,57,0,1,68.62,0.00,0.00,0.00,0,1.00,1,2487.19,0,0,0,java.lang.Object,0.00,1,0,1,0,1,1,0,5,509,2
"org.apache.jackrabbit.spi.commons.name.Pattern",11,0.00,1.73,50,0.50,13520.39,11,0,4,22,12,81.80,84,72,9,1,124.09,0.00,0.00,0.00,1,11.00,2,1511.36,0,9,3,java.lang.Object,0.00,11,0,19,5,11,2,0,19,358,2
"org.apache.jackrabbit.spi.commons.name.Pattern$AbstractNamePattern",2,0.00,2.50,12,0.15,5325.28,2,0,4,9,2,114.79,0,17,0,2,114.79,0.00,0.50,0.00,0,2.00,4,460.08,0,1,2,org.apache.jackrabbit.spi.commons.name.Pattern,0.00,7,1,5,0,7,1,0,0,97,3
"org.apache.jackrabbit.spi.commons.name.Pattern$Context",10,0.22,1.30,37,0.29,4793.68,14,4,4,15,2,132.03,0,51,0,1,132.03,0.00,0.00,0.45,0,0.00,2,868.17,0,5,2,java.lang.Object,0.00,5,0,13,0,5,5,0,0,222,2
"org.apache.jackrabbit.spi.commons.name.Pattern$NamePattern",3,0.50,1.00,9,0.08,1130.68,4,1,4,8,1,132.92,0,17,0,2,132.92,0.00,0.50,0.67,0,1.00,1,252.28,0,1,1,org.apache.jackrabbit.spi.commons.name.AbstractNamePattern,0.00,5,1,3,0,5,2,0,0,70,2
"org.apache.jackrabbit.spi.commons.name.Pattern$PathPattern",3,0.00,2.67,27,0.29,12144.27,5,2,4,14,2,106.77,0,37,0,2,106.77,0.00,0.50,0.50,0,2.00,6,867.41,0,2,2,org.apache.jackrabbit.spi.commons.name.Pattern,0.00,11,1,8,0,11,1,0,0,183,2
"org.apache.jackrabbit.spi.commons.name.Pattern$Pattern",2,0.00,1.00,5,0.03,266.33,2,0,4,3,0,143.04,0,7,0,1,143.04,0.00,0.00,0.00,0,2.00,1,75.19,0,1,0,java.lang.Object,0.00,1,0,2,0,1,1,0,0,25,0
"org.apache.jackrabbit.spi.commons.name.Pattern$Pattern_0",2,0.00,1.00,5,0.03,316.16,2,0,4,3,0,142.46,0,7,0,1,142.46,0.00,0.00,0.00,0,2.00,1,78.51,0,1,0,java.lang.Object,0.00,1,0,2,0,1,1,0,0,26,0
"org.apache.jackrabbit.spi.commons.name.Pattern$RegexPattern",3,0.12,1.00,18,0.26,4820.02,7,4,4,12,1,116.73,0,28,0,2,116.73,0.00,0.50,0.33,0,5.00,1,771.27,0,1,1,org.apache.jackrabbit.spi.commons.name.AbstractNamePattern,0.00,9,1,3,0,9,2,0,0,181,2
"org.apache.jackrabbit.spi.commons.name.Pattern$RepeatPattern",5,0.00,1.20,31,0.30,11190.96,9,4,4,12,1,115.55,0,43,0,2,115.55,0.00,0.50,0.25,0,10.00,2,894.07,0,2,1,org.apache.jackrabbit.spi.commons.name.Pattern,0.00,7,1,6,0,7,3,0,0,204,2
"org.apache.jackrabbit.spi.commons.name.Pattern$SelectPattern",3,0.25,1.33,13,0.15,3777.06,5,2,4,7,1,124.06,0,24,0,2,124.06,0.00,0.50,0.67,0,1.00,2,453.06,0,2,1,org.apache.jackrabbit.spi.commons.name.Pattern,0.00,4,1,4,0,4,1,0,0,115,2
"org.apache.jackrabbit.spi.commons.name.Pattern$SequencePattern",3,0.25,1.33,15,0.15,3163.24,5,2,4,9,1,121.06,0,27,0,2,121.06,0.00,0.50,0.67,0,1.00,2,450.10,0,2,1,org.apache.jackrabbit.spi.commons.name.Pattern,0.00,6,1,4,0,6,1,0,0,115,2
"org.apache.jackrabbit.spi.commons.name.PatternTest",14,0.05,1.50,181,3.36,139309.15,19,5,6,40,8,99.17,1,210,0,2,99.17,0.00,0.50,0.24,1,34.00,4,10091.86,0,1,8,junit.framework.TestCase,0.00,26,1,21,0,26,13,0,1,1983,1
"org.apache.jackrabbit.spi.commons.name.RelativePath",14,0.03,2.21,87,0.90,38352.40,20,6,2,37,6,114.72,3,112,4,2,114.72,3.00,0.20,0.14,1,82.00,8,2697.80,0,4,5,org.apache.jackrabbit.spi.commons.name.AbstractPath,0.00,23,1,31,3,23,10,0,3,577,1
"org.apache.jackrabbit.spi.commons.name.RootElement",5,0.25,1.00,13,0.11,2058.79,8,3,1,8,6,139.42,24,21,3,2,139.18,0.00,0.50,0.13,0,11.00,1,332.76,0,3,3,org.apache.jackrabbit.spi.commons.name.AbstractElement,0.15,3,1,5,0,3,2,0,10,85,1
"org.apache.jackrabbit.spi.commons.name.RootPath",17,0.50,1.18,44,0.30,6372.54,19,2,2,20,5,160.08,55,68,3,2,139.46,0.00,0.50,0.03,0,32.00,3,892.15,0,6,3,org.apache.jackrabbit.spi.commons.name.AbstractPath,0.00,3,1,20,0,3,11,0,15,239,1
"org.apache.jackrabbit.core.session.AddNodeOperation",3,0.50,3.67,38,0.59,24365.87,7,4,13,24,9,99.89,12,64,1,1,99.66,0.00,0.00,0.58,0,1.00,9,1763.73,0,2,9,java.lang.Object,0.00,21,0,11,0,21,1,1,8,318,1
"org.apache.jackrabbit.core.session.SessionContext",29,0.01,1.03,95,0.80,15169.99,42,13,27,48,95,132.02,132,136,77,1,131.79,0.00,0.00,0.06,0,553.00,2,2401.31,0,24,24,java.lang.Object,0.00,19,0,30,0,19,5,1,34,580,1
"org.apache.jackrabbit.core.session.SessionItemOperation",11,0.40,1.27,32,0.32,7394.45,13,2,9,22,10,95.16,84,49,2,1,137.45,0.00,0.00,0.14,1,25.00,4,972.42,0,8,8,java.lang.Object,0.00,11,0,14,0,11,3,1,17,236,2
"org.apache.jackrabbit.core.session.SessionItemOperation$SessionItemOperation<Boolean>",1,0.00,1.00,3,0.04,499.08,1,0,9,2,2,131.95,0,5,0,1,131.95,0.00,0.00,0.00,0,1.00,1,122.54,0,1,2,java.lang.Object,0.00,1,0,1,0,1,0,0,0,32,0
"org.apache.jackrabbit.core.session.SessionItemOperation$SessionItemOperation<Boolean>_0",1,0.00,1.00,3,0.03,428.56,1,0,9,2,2,132.48,0,5,0,1,132.48,0.00,0.00,0.00,0,1.00,1,102.76,0,1,2,java.lang.Object,0.00,1,0,1,0,1,0,0,0,28,0
"org.apache.jackrabbit.core.session.SessionItemOperation$SessionItemOperation<Boolean>_1",1,0.00,1.00,3,0.03,428.56,1,0,9,2,2,132.48,0,5,0,1,132.48,0.00,0.00,0.00,0,1.00,1,102.76,0,1,2,java.lang.Object,0.00,1,0,1,0,1,0,0,0,28,0
"org.apache.jackrabbit.core.session.SessionItemOperation$SessionItemOperation<ItemImpl>",1,0.00,1.00,3,0.04,611.97,1,0,9,2,3,131.26,0,6,0,1,131.26,0.00,0.00,0.00,0,1.00,1,134.73,0,1,3,java.lang.Object,0.00,1,0,1,0,1,0,0,0,34,0
"org.apache.jackrabbit.core.session.SessionItemOperation$SessionItemOperation<NodeImpl>",1,0.00,1.00,3,0.04,529.12,1,0,9,2,3,131.75,0,6,0,1,131.75,0.00,0.00,0.00,0,1.00,1,114.37,0,1,3,java.lang.Object,0.00,1,0,1,0,1,0,0,0,30,0
"org.apache.jackrabbit.core.session.SessionItemOperation$SessionItemOperation<Object>",1,0.00,1.00,4,0.05,720.03,1,0,9,3,2,126.04,0,7,0,1,126.04,0.00,0.00,0.00,0,1.00,1,160.30,0,1,2,java.lang.Object,0.00,2,0,1,0,2,0,0,0,39,0
"org.apache.jackrabbit.core.session.SessionItemOperation$SessionItemOperation<PropertyImpl>",1,0.00,1.00,3,0.04,529.12,1,0,9,2,3,131.75,0,6,0,1,131.75,0.00,0.00,0.00,0,1.00,1,114.37,0,1,3,java.lang.Object,0.00,1,0,1,0,1,0,0,0,30,0
"org.apache.jackrabbit.core.session.SessionOperation",1,0.00,1.00,2,0.02,92.15,1,0,1,1,13,100.17,11,3,12,1,144.30,0.00,0.00,0.00,0,1.00,1,46.46,0,0,1,,0.00,0,0,1,0,0,1,0,2,16,1
"org.apache.jackrabbit.core.session.SessionRefreshOperation",3,0.00,2.00,18,0.18,4770.32,5,2,3,9,5,68.50,26,27,1,1,116.60,0.00,0.00,0.50,0,1.00,4,528.79,0,2,4,java.lang.Object,0.00,6,0,6,0,6,1,1,11,118,1
"org.apache.jackrabbit.core.session.SessionSaveOperation",2,0.00,1.50,11,0.11,2139.92,2,0,3,10,4,88.76,13,15,1,1,120.98,0.00,0.00,0.00,0,2.00,2,344.01,0,2,3,java.lang.Object,0.00,8,0,3,0,8,0,1,5,77,1
"org.apache.jackrabbit.core.session.SessionState",5,0.25,2.60,61,0.74,35163.17,12,7,7,19,2,118.36,90,108,1,1,100.23,0.00,0.00,0.34,2,1.00,6,2225.57,0,0,2,java.lang.Object,0.00,14,0,13,0,14,5,0,22,412,1
"org.apache.jackrabbit.core.session.SessionState$LogState",2,1.00,3.00,20,0.21,8122.37,3,1,7,6,0,105.03,0,21,0,1,105.03,0.00,0.00,0.50,0,2.00,3,631.38,0,0,0,java.lang.Object,0.00,4,0,6,0,4,2,0,0,133,2
"org.apache.jackrabbit.core.session.SessionWriteOperation",0,0.00,0.00,1,0.01,152.16,0,0,0,0,5,171.00,4,2,5,1,171.00,0.00,0.00,0.00,0,0.00,0,38.04,0,0,0,,0.00,0,0,0,0,0,0,0,1,12,1
"org.apache.jackrabbit.webdav.jcr.transaction.TransactionListener",2,0.00,1.00,3,0.02,111.87,2,0,1,2,5,109.13,17,4,4,1,157.24,0.00,0.00,0.00,0,2.00,1,74.58,0,0,1,,0.00,0,0,2,0,0,2,0,3,24,1
"org.apache.jackrabbit.webdav.jcr.transaction.TxLockManagerImpl",18,0.18,2.67,151,2.23,98446.37,21,3,32,74,24,59.17,183,209,4,1,107.65,0.00,0.00,0.17,8,106.00,9,6692.62,0,8,20,java.lang.Object,0.00,56,0,48,0,56,10,1,36,1286,1
"org.apache.jackrabbit.webdav.jcr.transaction.TxLockManagerImpl$AbstractTransaction",5,0.12,1.60,21,0.19,3492.44,7,2,32,12,4,165.92,13,30,0,2,126.04,0.00,0.50,0.40,1,9.00,4,562.78,0,3,4,org.apache.jackrabbit.webdav.jcr.transaction.TransactionMap,0.00,7,1,8,0,7,2,1,5,136,3
"org.apache.jackrabbit.webdav.jcr.transaction.TxLockManagerImpl$GlobalTransaction",8,0.57,1.62,36,0.41,8843.12,9,1,32,19,6,145.08,24,53,0,2,124.46,0.00,0.50,0.50,2,8.00,2,1242.60,1,2,6,org.apache.jackrabbit.webdav.jcr.transaction.AbstractTransaction,0.00,11,1,13,0,11,6,0,8,276,2
"org.apache.jackrabbit.webdav.jcr.transaction.TxLockManagerImpl$LocalTransaction",7,0.00,1.57,24,0.30,5605.04,7,0,32,17,7,130.47,30,40,0,2,130.23,0.00,0.50,0.00,1,12.00,3,892.73,0,2,7,org.apache.jackrabbit.webdav.jcr.transaction.AbstractTransaction,0.00,10,1,11,0,10,5,0,10,204,3
"org.apache.jackrabbit.webdav.jcr.transaction.TxLockManagerImpl$Transaction",8,0.00,1.00,9,0.04,170.51,8,0,32,8,4,160.77,35,10,0,1,160.54,0.00,0.00,0.00,0,8.00,1,129.51,0,3,4,,0.00,0,0,8,0,0,5,0,7,51,1
"org.apache.jackrabbit.webdav.jcr.transaction.TxLockManagerImpl$TransactionMap",2,0.00,1.50,8,0.08,1302.42,2,0,32,3,1,126.29,1,12,0,2,126.29,0.00,0.50,0.00,0,2.00,2,228.28,2,2,1,java.util.HashMap,0.00,1,1,3,0,1,0,0,1,59,2
"org.apache.jackrabbit.webdav.jcr.transaction.TxLockManagerImpl$XidImpl",4,1.00,1.00,10,0.06,728.11,5,1,32,5,0,142.21,18,15,0,1,141.97,0.00,0.00,0.25,0,6.00,1,190.21,0,0,0,java.lang.Object,0.00,1,0,4,0,1,4,1,5,57,2
"org.apache.jackrabbit.spi.commons.nodetype.compact.CompactNodeTypeDefTest",1,0.00,4.00,24,0.45,26798.07,2,1,13,21,8,104.94,3,30,0,2,84.33,0.00,0.50,1.00,0,0.00,4,1343.12,0,0,8,junit.framework.TestCase,0.00,20,1,4,0,20,1,0,3,227,1
"org.apache.jackrabbit.spi.commons.nodetype.compact.CompactNodeTypeDefWriter",24,0.01,3.58,253,3.38,159444.58,30,6,37,101,22,61.01,179,326,3,1,103.30,0.00,0.00,0.15,16,74.00,19,10147.65,0,3,19,java.lang.Object,0.00,77,0,86,0,77,21,0,35,1879,1
"org.apache.jackrabbit.webdav.jcr.nodetype.ItemDefinitionImpl",9,0.05,1.22,41,0.40,8524.34,16,7,8,22,5,145.67,34,52,3,1,125.06,0.00,0.00,0.19,6,41.00,2,1212.75,0,4,2,java.lang.Object,0.00,13,0,11,2,13,5,3,11,268,2
"org.apache.jackrabbit.webdav.jcr.nodetype.NodeDefinitionImpl",9,0.03,1.44,47,0.44,12687.61,13,4,7,21,5,140.66,33,59,3,2,120.04,0.00,0.50,0.22,2,37.00,3,1322.10,1,7,2,org.apache.jackrabbit.webdav.jcr.nodetype.ItemDefinitionImpl,0.11,12,1,13,0,12,2,1,12,297,2
"org.apache.jackrabbit.webdav.jcr.nodetype.NodeTypeConstants",0,0.00,0.00,39,0.55,9649.74,38,38,2,0,7,171.00,62,40,5,1,171.00,0.00,0.00,0.00,0,0.00,0,1642.95,0,0,2,,0.00,0,0,0,0,0,0,0,34,255,1
"org.apache.jackrabbit.webdav.jcr.nodetype.NodeTypeProperty",8,0.00,2.88,54,0.69,22835.42,10,2,13,26,9,154.40,23,70,4,2,114.52,0.00,0.50,0.50,1,0.00,6,2064.58,1,3,5,org.apache.jackrabbit.webdav.property.AbstractDavProperty,0.00,18,1,23,0,18,5,1,6,423,1
"org.apache.jackrabbit.webdav.jcr.nodetype.PropertyDefinitionImpl",11,0.05,1.55,71,0.78,30135.60,19,8,9,29,5,135.42,42,89,3,2,114.80,0.00,0.50,0.17,5,73.00,6,2339.09,1,6,2,org.apache.jackrabbit.webdav.jcr.nodetype.ItemDefinitionImpl,0.10,18,1,17,0,18,5,1,17,459,2
"org.apache.jackrabbit.core.security.authorization.AbstractACLTemplate",10,0.30,1.50,35,0.46,12320.85,13,3,14,22,3,110.90,52,53,1,1,128.77,0.00,0.00,0.07,2,26.00,5,1369.39,0,3,2,java.lang.Object,0.00,12,0,15,2,12,7,2,17,301,2
"org.apache.jackrabbit.core.security.authorization.AbstractACLTemplateTest",19,0.22,1.84,143,2.05,66868.91,21,2,15,54,11,111.41,16,183,0,5,111.41,0.50,0.57,0.29,3,41.00,4,6164.29,2,3,11,org.apache.jackrabbit.test.api.security.AbstractAccessControlTest,0.09,35,4,35,2,35,16,0,14,1200,2
"org.apache.jackrabbit.core.security.authorization.AbstractACLTemplateTest$AccessControlEntry",2,0.00,1.00,5,0.02,258.03,2,0,15,2,0,143.15,0,7,0,1,143.15,0.00,0.00,0.00,0,2.00,1,71.86,0,2,0,java.lang.Object,0.00,0,0,2,0,0,0,0,0,24,0
"org.apache.jackrabbit.core.security.authorization.AbstractACLTemplateTest$JackrabbitAccessControlEntry",6,0.00,1.17,15,0.10,1350.27,6,0,15,8,2,141.21,0,23,0,1,141.21,0.00,0.00,0.00,0,10.00,2,311.36,0,4,2,java.lang.Object,0.00,2,0,7,0,2,2,0,0,87,0
"org.apache.jackrabbit.core.security.authorization.AbstractACLTemplateTest$JackrabbitAccessControlEntry_0",6,0.00,1.00,13,0.06,647.10,6,0,15,6,0,143.76,0,19,0,1,143.76,0.00,0.00,0.00,0,10.00,1,192.95,0,4,0,java.lang.Object,0.00,0,0,6,0,0,2,0,0,62,0
"org.apache.jackrabbit.core.security.authorization.AbstractAccessControlProvider",11,0.01,1.82,54,0.62,17517.22,18,7,17,27,19,90.97,71,73,4,1,123.19,0.00,0.00,0.13,1,41.00,4,1866.02,0,1,15,java.lang.Object,0.00,16,0,20,4,16,10,3,19,393,2
"org.apache.jackrabbit.core.security.authorization.AbstractAccessControlProvider$CompiledPermissions",5,0.00,1.00,10,0.06,439.92,5,0,17,5,2,144.46,1,15,0,1,144.46,0.00,0.00,0.00,0,8.00,1,173.15,0,0,2,java.lang.Object,0.00,0,0,5,0,0,5,0,1,53,0
"org.apache.jackrabbit.core.security.authorization.AbstractAccessControlProvider$CompiledPermissions_0",5,0.00,1.60,19,0.15,2623.90,5,0,17,7,4,131.67,2,27,0,1,131.67,0.00,0.00,0.00,0,11.00,2,447.13,0,0,4,java.lang.Object,0.00,2,0,8,0,2,5,0,2,109,0
"org.apache.jackrabbit.core.security.authorization.AbstractCompiledPermissions",8,0.21,1.12,27,0.23,4754.94,10,2,4,15,5,131.57,36,38,3,1,131.33,0.00,0.00,0.31,2,14.00,2,690.18,0,0,2,java.lang.Object,0.00,7,0,9,4,7,8,1,12,172,2
"org.apache.jackrabbit.core.security.authorization.AbstractCompiledPermissions$Result",6,0.27,1.50,38,0.46,16413.17,12,6,4,8,2,164.81,6,53,0,1,114.81,0.00,0.00,0.39,0,0.00,3,1388.12,0,1,2,java.lang.Object,0.00,2,0,9,0,2,5,0,2,314,2
"org.apache.jackrabbit.core.security.authorization.AbstractEffectivePolicyTest",1,0.00,1.00,17,0.20,4205.32,5,4,8,5,2,96.80,4,20,0,6,96.57,0.40,0.62,1.00,0,0.00,1,609.45,1,0,2,org.apache.jackrabbit.core.security.authorization.AbstractEvaluationTest,0.12,4,5,1,2,4,1,0,2,125,2
"org.apache.jackrabbit.core.security.authorization.AbstractEntryTest",11,0.60,1.73,101,1.44,60998.35,12,1,11,36,4,105.80,10,126,0,5,105.80,0.50,0.57,0.45,1,28.00,6,4330.72,3,2,4,org.apache.jackrabbit.test.api.security.AbstractAccessControlTest,0.11,25,4,19,2,25,9,0,8,855,2
"org.apache.jackrabbit.core.security.authorization.AbstractEntryTest$JackrabbitAccessControlEntry",6,0.00,1.00,13,0.07,667.99,6,0,11,7,1,143.65,0,19,0,1,143.65,0.00,0.00,0.00,0,10.00,1,209.42,0,4,1,java.lang.Object,0.00,1,0,6,0,1,2,0,0,65,0
"org.apache.jackrabbit.core.security.authorization.AbstractEntryTest$Principal",1,0.00,1.00,3,0.01,72.00,1,0,11,1,0,138.58,0,4,0,1,138.58,0.00,0.00,0.00,0,1.00,1,32.00,0,1,0,java.lang.Object,0.00,0,0,1,0,0,0,0,0,12,0
"org.apache.jackrabbit.core.security.authorization.AbstractEntryTest$Principal_0",1,0.00,1.00,3,0.01,72.00,1,0,11,1,0,138.58,0,4,0,1,138.58,0.00,0.00,0.00,0,1.00,1,32.00,0,1,0,java.lang.Object,0.00,0,0,1,0,0,0,0,0,12,0
"org.apache.jackrabbit.core.security.authorization.AbstractEntryTest$Privilege",5,0.00,1.00,11,0.05,564.06,5,0,11,5,0,143.61,0,16,0,1,143.61,0.00,0.00,0.00,0,5.00,1,159.73,0,3,0,java.lang.Object,0.00,0,0,5,0,0,2,0,0,52,0
"org.apache.jackrabbit.core.security.authorization.AbstractEvaluationTest",16,0.02,1.94,84,1.16,32427.74,24,8,23,47,12,118.73,4,123,5,5,118.73,4.25,0.18,0.11,5,90.00,8,3484.56,3,12,7,org.apache.jackrabbit.test.api.security.AbstractAccessControlTest,0.20,31,4,31,17,31,4,0,4,714,2
"org.apache.jackrabbit.core.security.authorization.AbstractLockManagementTest",6,0.00,1.83,62,0.83,18941.66,6,0,6,26,3,156.00,10,77,0,6,106.00,0.40,0.62,0.00,2,0.00,3,2484.83,3,2,3,org.apache.jackrabbit.core.security.authorization.AbstractEvaluationTest,0.00,20,5,11,2,20,4,0,10,488,2
"org.apache.jackrabbit.core.security.authorization.AbstractNodeTypeManagementTest",13,0.12,2.38,156,1.96,51014.76,15,2,11,46,4,122.86,43,215,1,6,102.24,0.40,0.62,0.62,1,0.00,3,5869.06,4,1,3,org.apache.jackrabbit.core.security.authorization.AbstractEvaluationTest,0.10,33,5,31,2,33,12,0,32,1148,2
"org.apache.jackrabbit.core.security.authorization.AbstractVersionManagementTest",7,0.50,2.14,94,1.31,33379.15,8,1,11,42,4,140.19,17,115,0,6,100.31,0.40,0.62,0.57,1,0.00,3,3917.03,4,1,4,org.apache.jackrabbit.core.security.authorization.AbstractEvaluationTest,0.00,35,5,15,2,35,6,0,17,724,2
"org.apache.jackrabbit.core.security.authorization.AbstractWriteTest",37,0.12,2.03,553,8.69,288037.24,45,8,30,121,11,48.96,392,673,1,6,97.44,0.60,0.56,0.24,2,0.00,8,26081.12,12,2,10,org.apache.jackrabbit.core.security.authorization.AbstractEvaluationTest,0.14,84,5,75,3,84,35,0,178,4715,2
"org.apache.jackrabbit.core.security.authorization.AbstractWriteTest$AccessControlPolicy",0,0.00,0.00,1,0.00,12.00,0,0,30,0,0,171.00,0,0,0,1,171.00,0.00,0.00,0.00,0,0.00,0,8.00,0,0,0,java.lang.Object,0.00,0,0,0,0,0,0,0,0,4,0
"org.apache.jackrabbit.core.security.authorization.AbstractWriteTest$AccessControlPolicy_0",0,0.00,0.00,1,0.00,12.00,0,0,30,0,0,171.00,0,0,0,1,171.00,0.00,0.00,0.00,0,0.00,0,8.00,0,0,0,java.lang.Object,0.00,0,0,0,0,0,0,0,0,4,0
"org.apache.jackrabbit.core.security.authorization.AccessControlConstants",0,0.00,0.00,14,0.30,8746.51,13,13,3,2,9,171.00,47,15,6,1,171.00,0.00,0.00,0.00,0,0.00,0,898.52,0,0,3,,0.00,2,0,0,0,2,0,0,17,170,1
"org.apache.jackrabbit.core.security.authorization.AccessControlEditor",6,0.00,1.00,7,0.08,438.82,6,0,7,6,9,165.45,106,14,8,1,156.32,0.00,0.00,0.00,0,6.00,1,243.42,0,4,1,,0.00,0,0,6,0,0,2,0,7,72,1
"org.apache.jackrabbit.core.security.authorization.AccessControlEntryImpl",16,0.01,1.81,89,1.11,43468.30,22,6,14,35,11,85.53,104,119,6,1,117.75,0.00,0.00,0.18,2,86.00,6,3338.33,0,8,5,java.lang.Object,0.00,19,0,29,2,19,8,1,30,676,2
"org.apache.jackrabbit.core.security.authorization.AccessControlListener",1,0.00,1.00,2,0.01,30.51,1,0,0,1,4,99.98,8,3,3,1,148.08,0.00,0.00,0.00,0,1.00,1,25.51,0,0,1,,0.00,0,0,1,0,0,1,0,2,11,1
"org.apache.jackrabbit.core.security.authorization.AccessControlModifications",3,0.25,1.00,9,0.11,1813.62,5,2,5,7,9,81.30,27,13,9,1,131.30,0.00,0.00,0.33,0,1.00,1,322.55,0,2,0,java.lang.Object,0.00,4,0,3,0,4,1,0,5,80,1
"org.apache.jackrabbit.core.security.authorization.AccessControlObserver",4,0.27,1.25,22,0.22,4815.60,9,5,3,12,3,120.85,19,31,0,1,120.62,0.00,0.00,0.40,0,0.00,2,655.72,0,0,3,java.lang.Object,0.00,8,0,5,3,8,4,1,4,150,2
"org.apache.jackrabbit.core.security.authorization.AccessControlProvider",8,0.00,1.00,9,0.09,553.05,8,0,8,8,17,118.95,103,10,14,1,156.51,0.00,0.00,0.00,0,8.00,1,255.65,0,4,3,,0.00,0,0,8,0,0,4,0,9,79,1
"org.apache.jackrabbit.core.security.authorization.AccessControlProviderFactory",3,0.00,1.00,4,0.03,124.09,3,0,3,3,3,138.13,44,5,1,1,158.27,0.00,0.00,0.00,0,3.00,1,82.73,0,0,2,,0.00,0,0,3,0,0,3,0,4,29,1
"org.apache.jackrabbit.core.security.authorization.AccessControlProviderFactoryImpl",3,0.33,2.00,27,0.38,13552.36,6,3,12,19,9,58.36,24,35,1,1,106.46,0.00,0.00,0.56,0,1.00,3,1144.58,0,0,8,java.lang.Object,0.00,16,0,6,0,16,3,1,12,221,1
"org.apache.jackrabbit.core.security.authorization.AccessControlUtils",4,0.00,1.00,5,0.04,201.12,4,0,5,4,5,107.60,39,6,3,1,157.60,0.00,0.00,0.00,0,4.00,1,115.06,0,0,2,,0.00,0,0,4,0,0,4,0,5,39,1
"org.apache.jackrabbit.core.security.authorization.CompiledPermissions",5,0.00,1.00,8,0.06,696.22,5,0,3,6,12,124.74,66,9,10,1,154.12,0.00,0.00,0.00,0,5.00,1,172.76,0,0,2,,0.00,1,0,5,0,1,5,0,7,55,1
"org.apache.jackrabbit.core.security.authorization.CompiledPermissions$CompiledPermissions",5,0.00,1.00,10,0.06,485.93,5,0,3,5,3,144.12,2,15,0,1,144.12,0.00,0.00,0.00,0,5.00,1,182.95,0,0,3,java.lang.Object,0.00,0,0,5,0,0,5,0,2,55,0
"org.apache.jackrabbit.core.security.authorization.GlobPattern",8,0.05,2.25,58,0.65,26939.87,14,6,5,25,6,69.22,57,81,5,1,111.51,0.00,0.00,0.21,2,28.00,5,1964.03,0,3,1,java.lang.Object,0.00,17,0,18,0,17,5,0,10,417,2
"org.apache.jackrabbit.core.security.authorization.GlobPattern$PathPattern",3,1.00,1.67,13,0.11,1953.26,4,1,5,4,1,126.27,2,19,0,2,126.27,0.00,0.50,0.33,0,4.00,3,331.69,0,0,1,org.apache.jackrabbit.core.security.authorization.Pattern,0.00,1,1,5,0,1,3,0,2,83,2
"org.apache.jackrabbit.core.security.authorization.GlobPattern$Pattern",1,0.00,1.00,2,0.01,52.70,1,0,5,1,0,146.21,0,3,0,1,146.21,0.00,0.00,0.00,0,1.00,1,31.26,0,0,0,java.lang.Object,0.00,0,0,1,0,0,1,0,0,12,2
"org.apache.jackrabbit.core.security.authorization.GlobPattern$WildcardPattern",3,0.00,4.67,32,0.32,23245.90,5,2,5,5,0,54.61,24,49,0,2,102.72,0.00,0.50,0.50,1,2.00,11,969.78,0,0,0,org.apache.jackrabbit.core.security.authorization.Pattern,0.00,2,1,14,0,2,3,0,13,211,2
"org.apache.jackrabbit.core.security.authorization.GlobPatternTest",4,0.33,3.50,190,3.35,488551.63,5,1,5,12,3,30.72,50,195,1,3,68.28,0.00,0.67,0.75,0,0.00,9,10061.68,0,0,2,org.apache.jackrabbit.test.JUnitTest,0.00,8,2,14,0,8,4,0,48,1580,1
"org.apache.jackrabbit.core.security.authorization.JackrabbitAccessControlListTest",11,0.20,2.64,113,1.56,64889.69,12,1,19,43,10,103.78,4,138,1,5,103.78,0.00,0.80,0.82,1,0.00,5,4685.33,3,1,9,org.apache.jackrabbit.test.api.security.AbstractAccessControlTest,0.22,32,4,29,0,32,10,0,2,871,1
"org.apache.jackrabbit.core.security.authorization.NamedAccessControlPolicyImpl",2,1.00,1.50,8,0.06,957.77,3,1,2,3,1,167.23,5,12,1,1,127.34,0.00,0.00,0.50,0,2.00,2,176.29,0,1,0,java.lang.Object,0.00,1,0,3,0,1,1,1,3,47,2
"org.apache.jackrabbit.core.security.authorization.Permission",1,14.00,1.00,17,0.29,7230.87,15,14,0,1,49,94.24,16,19,49,1,94.71,0.00,0.00,0.00,0,1.00,1,865.54,0,0,0,java.lang.Object,0.00,0,0,1,0,0,1,0,2,170,2
"org.apache.jackrabbit.core.security.authorization.PrivilegeRegistry",8,0.16,5.88,165,2.78,180699.69,46,38,15,31,39,43.65,93,227,34,1,87.78,0.00,0.00,0.17,1,16.00,17,8327.84,0,3,5,java.lang.Object,0.00,23,0,47,0,23,5,0,17,1421,2
"org.apache.jackrabbit.core.security.authorization.PrivilegeRegistry$InternalPrivilege",5,0.21,2.20,44,0.43,14121.53,11,6,15,11,1,149.84,11,57,0,1,109.96,0.00,0.00,0.33,0,0.00,4,1279.91,0,0,1,java.lang.Object,0.00,6,0,11,0,6,5,0,3,266,2
"org.apache.jackrabbit.core.security.authorization.PrivilegeRegistry$PrivilegeImpl",8,0.00,1.88,46,0.41,11676.63,10,2,15,13,1,119.86,2,62,0,1,119.86,0.00,0.00,0.50,0,0.00,3,1223.79,0,3,1,java.lang.Object,0.00,5,0,15,0,5,5,1,2,279,1
"org.apache.jackrabbit.core.security.authorization.PrivilegeRegistryTest",20,0.11,1.50,157,2.60,124136.94,22,2,13,44,7,109.51,12,207,1,2,109.51,0.00,0.50,0.40,3,0.00,3,7799.74,1,2,6,junit.framework.TestCase,0.00,24,1,30,0,24,18,0,10,1543,1
"org.apache.jackrabbit.core.security.authorization.PrivilegeRegistryTest$NamespaceResolver",2,0.00,4.00,19,0.19,6281.66,2,0,13,9,1,107.55,0,23,0,1,107.55,0.00,0.00,0.00,0,2.00,4,577.97,0,2,1,java.lang.Object,0.00,7,0,8,0,7,0,0,0,130,0
"org.apache.jackrabbit.core.security.authorization.PrivilegeRegistryTest$Privilege",5,0.00,1.40,11,0.09,1724.93,5,0,13,6,0,139.71,0,16,0,1,139.71,0.00,0.00,0.00,0,5.00,2,267.08,0,3,0,java.lang.Object,0.00,1,0,7,0,1,2,0,0,75,0
"org.apache.jackrabbit.core.security.authorization.TestAll",1,0.00,1.00,7,0.06,1740.69,1,0,3,3,3,65.48,10,9,0,2,113.96,0.00,0.50,0.00,0,1.00,1,186.48,0,1,3,junit.framework.TestCase,0.00,2,1,1,0,2,0,0,2,47,1
"org.apache.jackrabbit.core.security.authorization.UnmodifiableAccessControlList",16,0.02,1.75,69,0.85,28558.81,20,4,14,37,4,123.04,69,99,3,1,122.81,0.00,0.00,0.23,0,54.00,5,2559.31,0,3,1,java.lang.Object,0.00,21,0,28,0,21,13,1,20,559,1
"org.apache.jackrabbit.core.security.authorization.WorkspaceAccessManager",3,0.00,1.00,4,0.03,194.53,3,0,4,3,10,106.73,27,6,10,1,156.73,0.00,0.00,0.00,0,3.00,1,97.62,0,0,0,,0.00,0,0,3,0,0,3,0,4,32,1
"org.apache.jackrabbit.core.security.principal.AbstractPrincipalIterator",9,0.06,1.22,29,0.18,2708.20,13,4,5,12,3,183.64,17,40,2,1,133.64,0.00,0.00,0.19,2,24.00,2,530.79,0,3,1,java.lang.Object,0.00,3,0,11,2,3,6,1,5,143,1
"org.apache.jackrabbit.core.security.principal.AbstractPrincipalProvider",8,0.11,1.50,35,0.33,6491.13,13,5,3,18,3,83.25,60,47,2,1,125.54,0.00,0.00,0.30,2,0.00,3,976.68,0,2,1,java.lang.Object,0.00,10,0,12,2,10,6,1,15,226,2
"org.apache.jackrabbit.core.security.principal.AbstractPrincipalProviderTest",1,0.00,2.00,18,0.20,6130.21,1,0,7,8,5,44.19,9,22,1,2,94.19,0.00,0.50,0.00,0,1.00,2,607.39,0,0,4,junit.framework.TestCase,0.00,7,1,2,0,7,1,0,7,123,1
"org.apache.jackrabbit.core.security.principal.AbstractPrincipalProviderTest$DummyProvider",6,1.00,1.17,18,0.13,1584.99,7,1,7,7,2,134.10,0,27,0,2,134.10,0.00,0.50,0.17,0,10.00,2,385.35,0,5,2,org.apache.jackrabbit.core.security.principal.AbstractPrincipalProvider,0.00,1,1,7,0,1,1,0,0,103,1
"org.apache.jackrabbit.core.security.principal.AdminPrincipal",4,0.67,1.25,12,0.10,1648.84,5,1,1,6,11,182.56,5,20,10,1,132.56,0.00,0.00,0.50,0,4.00,2,288.04,0,1,1,java.lang.Object,0.00,2,0,5,1,2,3,1,1,77,1
"org.apache.jackrabbit.core.security.principal.DefaultPrincipalProvider",13,0.08,2.15,102,1.40,47121.92,17,4,25,52,20,63.17,115,152,4,2,111.27,0.00,0.50,0.33,2,33.00,4,4203.73,5,8,16,org.apache.jackrabbit.core.security.principal.AbstractPrincipalProvider,0.10,39,1,28,0,39,5,1,29,813,1
"org.apache.jackrabbit.core.security.principal.DefaultPrincipalProvider$PrincipalIteratorImpl",2,0.00,2.50,19,0.17,3686.73,4,2,25,6,2,130.09,6,27,0,2,109.48,0.00,0.50,0.50,0,2.00,4,499.75,0,1,2,org.apache.jackrabbit.core.security.principal.AbstractPrincipalIterator,0.18,4,1,5,0,4,1,0,4,110,1
"org.apache.jackrabbit.core.security.principal.EveryonePrincipal",9,0.38,1.00,20,0.18,2725.43,11,2,2,13,9,140.23,6,31,9,1,140.23,0.00,0.00,0.17,0,26.00,1,527.75,0,3,0,java.lang.Object,0.00,4,0,9,0,4,6,1,4,141,2
"org.apache.jackrabbit.core.security.principal.FallbackPrincipalProvider",8,0.36,1.12,18,0.15,1583.11,10,2,4,11,5,123.79,47,27,1,1,141.66,0.00,0.00,0.19,0,16.00,2,457.64,0,5,4,java.lang.Object,0.00,3,0,9,0,3,3,1,11,123,1
"org.apache.jackrabbit.core.security.principal.PrincipalImpl",5,0.12,1.60,19,0.18,3417.76,7,2,3,11,15,112.90,29,31,14,1,130.77,0.00,0.00,0.40,0,0.00,3,553.40,0,2,1,java.lang.Object,0.00,6,0,8,2,6,3,2,11,135,1
"org.apache.jackrabbit.core.security.principal.PrincipalIteratorAdapter",3,1.00,1.67,8,0.09,1763.62,4,1,7,5,7,95.55,23,13,4,2,137.85,0.00,0.50,0.00,0,3.00,2,273.76,1,1,3,org.apache.jackrabbit.commons.iterator.RangeIteratorDecorator,0.00,2,1,5,0,2,2,1,6,71,1
"org.apache.jackrabbit.core.security.principal.PrincipalManagerImpl",11,0.13,2.27,77,0.84,25798.22,14,3,12,27,8,70.46,82,98,3,1,112.75,0.00,0.00,0.21,4,46.00,4,2505.37,0,8,5,java.lang.Object,0.00,16,0,25,0,16,3,1,27,529,1
"org.apache.jackrabbit.core.security.principal.PrincipalManagerImpl$CheckedGroup",8,0.14,1.12,22,0.20,3503.48,10,2,12,18,2,138.94,1,33,0,1,138.94,0.00,0.00,0.38,0,0.00,2,613.40,0,2,2,java.lang.Object,0.00,10,0,9,0,10,6,1,1,161,1
"org.apache.jackrabbit.core.security.principal.PrincipalManagerImpl$CheckedGroup$Enumeration<Principal>",2,0.00,1.00,5,0.03,268.38,2,0,12,4,0,143.02,0,7,0,1,143.02,0.00,0.00,0.00,0,2.00,1,92.73,0,1,0,java.lang.Object,0.00,2,0,2,0,2,1,0,0,29,0
"org.apache.jackrabbit.core.security.principal.PrincipalManagerImpl$CheckedIteratorEntry",1,2.00,2.00,6,0.06,1315.88,3,2,12,1,1,117.25,0,8,0,1,117.25,0.00,0.00,0.00,0,1.00,2,190.19,0,0,1,java.lang.Object,0.00,0,0,2,0,0,1,0,0,47,2
"org.apache.jackrabbit.core.security.principal.PrincipalManagerImpl$CheckedPrincipalIterator",3,0.50,2.67,19,0.26,9940.04,4,1,12,11,2,164.03,5,28,0,2,114.03,0.00,0.50,0.67,0,0.00,5,792.58,0,1,2,org.apache.jackrabbit.core.security.principal.AbstractPrincipalIterator,0.17,8,1,8,0,8,2,0,3,166,1
"org.apache.jackrabbit.core.security.principal.PrincipalManagerImpl$ItemBasedCheckedGroup",2,0.00,1.50,7,0.06,958.48,2,0,12,4,2,132.00,0,11,0,2,132.00,0.00,0.50,0.00,0,2.00,2,187.63,0,1,2,org.apache.jackrabbit.core.security.principal.CheckedGroup,0.00,2,1,3,0,2,1,1,0,50,1
"org.apache.jackrabbit.core.security.principal.PrincipalProvider",8,0.00,1.00,9,0.05,148.55,8,0,4,8,18,112.53,82,10,17,1,161.01,0.00,0.00,0.00,0,8.00,1,143.55,0,5,1,,0.00,0,0,8,0,0,3,0,9,55,1
"org.apache.jackrabbit.core.security.principal.PrincipalProviderRegistry",4,0.00,1.00,5,0.02,91.92,4,0,2,4,9,112.17,33,6,8,1,160.28,0.00,0.00,0.00,0,4.00,1,69.12,0,4,1,,0.00,0,0,4,0,0,0,0,5,28,1
"org.apache.jackrabbit.core.security.principal.ProviderRegistryImpl",6,0.00,2.50,43,0.57,20353.41,9,3,9,24,8,79.24,39,66,4,1,111.46,0.00,0.00,0.33,1,2.00,7,1710.81,0,0,4,java.lang.Object,0.00,18,0,15,0,18,6,1,12,349,1
"org.apache.jackrabbit.core.security.principal.TestAll",1,0.00,1.00,5,0.04,864.35,1,0,3,3,1,73.32,10,7,0,2,121.80,0.00,0.50,0.00,0,1.00,1,115.51,0,1,1,junit.framework.TestCase,0.00,2,1,1,0,2,0,0,2,31,1
"org.apache.jackrabbit.core.security.principal.UnknownPrincipal",1,0.00,1.00,3,0.02,106.02,1,0,0,1,4,137.49,4,5,3,2,137.25,0.00,0.50,0.00,0,1.00,1,45.51,0,0,1,org.apache.jackrabbit.core.security.principal.PrincipalImpl,0.00,0,1,1,0,0,1,0,1,16,1
"org.apache.jackrabbit.JcrConstants",0,0.00,0.00,71,1.53,23803.38,70,70,1,0,28,171.00,217,72,28,1,171.00,0.00,0.00,0.00,0,0.00,0,4576.95,0,0,0,,0.00,0,0,0,0,0,0,0,71,634,1
